Date;Time;PewDiePie;T-Series;Difference;
09.01.2019;17:09:12;80285013;79605037;679976;
09.01.2019;17:10:06;80285069;79605215;679854;
09.01.2019;17:11:09;80285158;79605378;679780;
09.01.2019;17:12:05;80285225;79605544;679681;
09.01.2019;17:13:10;80285304;79605712;679592;
09.01.2019;17:14:10;80285388;79605894;679494;
09.01.2019;17:15:06;80285440;79606055;679385;
09.01.2019;17:16:08;80285526;79606242;679284;
09.01.2019;17:17:06;80285600;79606427;679173;
09.01.2019;17:18:11;80285686;79606610;679076;
09.01.2019;17:19:04;80285740;79606738;679002;
09.01.2019;17:20:04;80285820;79606902;678918;
09.01.2019;17:21:06;80285904;79607067;678837;
09.01.2019;17:22:05;80285999;79607238;678761;
09.01.2019;17:23:07;80286094;79607380;678714;
09.01.2019;17:24:07;80286182;79607565;678617;
09.01.2019;17:25:05;80286265;79607743;678522;
09.01.2019;17:26:05;80286345;79607919;678426;
09.01.2019;17:27:07;80286413;79608086;678327;
09.01.2019;17:28:05;80286507;79608270;678237;
09.01.2019;17:29:10;80286594;79608446;678148;
09.01.2019;17:30:06;80286675;79608603;678072;
09.01.2019;17:31:05;80286762;79608785;677977;
09.01.2019;17:32:06;80286836;79608962;677874;
09.01.2019;17:33:08;80286904;79609131;677773;
09.01.2019;17:34:10;80286994;79609300;677694;
09.01.2019;17:35:06;80287081;79609465;677616;
09.01.2019;17:36:10;80287181;79609656;677525;
09.01.2019;17:37:10;80287270;79609840;677430;
09.01.2019;17:38:05;80287345;79610021;677324;
09.01.2019;17:39:05;80287413;79610210;677203;
09.01.2019;17:40:05;80287501;79610378;677123;
09.01.2019;17:41:11;80287592;79610547;677045;
09.01.2019;17:42:07;80287667;79610701;676966;
09.01.2019;17:43:05;80287757;79610867;676890;
09.01.2019;17:44:04;80287834;79611038;676796;
09.01.2019;17:45:09;80287917;79611210;676707;
09.01.2019;17:46:11;80287988;79611379;676609;
09.01.2019;17:47:04;80288060;79611521;676539;
09.01.2019;17:48:06;80288138;79611675;676463;
09.01.2019;17:49:05;80288201;79611820;676381;
09.01.2019;17:50:04;80288290;79611997;676293;
09.01.2019;17:51:05;80288378;79612182;676196;
09.01.2019;17:52:06;80288462;79612329;676133;
09.01.2019;17:53:07;80288552;79612496;676056;
09.01.2019;17:54:10;80288626;79612662;675964;
09.01.2019;17:55:04;80288699;79612813;675886;
09.01.2019;17:56:05;80288783;79612961;675822;
09.01.2019;17:57:05;80288870;79613099;675771;
09.01.2019;17:58:06;80288939;79613286;675653;
09.01.2019;17:59:06;80289009;79613444;675565;
09.01.2019;18:00:04;80289106;79613595;675511;
09.01.2019;18:01:05;80289190;79613761;675429;
09.01.2019;18:02:10;80289246;79613910;675336;
09.01.2019;18:03:06;80289323;79614036;675287;
09.01.2019;18:04:08;80289405;79614196;675209;
09.01.2019;18:05:08;80289491;79614357;675134;
09.01.2019;18:06:05;80289560;79614480;675080;
09.01.2019;18:07:09;80289646;79614646;675000;
09.01.2019;18:08:07;80289730;79614802;674928;
09.01.2019;18:09:06;80289812;79614956;674856;
09.01.2019;18:10:04;80289905;79615130;674775;
09.01.2019;18:11:05;80289969;79615284;674685;
09.01.2019;18:12:06;80290045;79615411;674634;
09.01.2019;18:13:05;80290114;79615518;674596;
09.01.2019;18:14:06;80290172;79615648;674524;
09.01.2019;18:15:07;80290236;79615752;674484;
09.01.2019;18:17:05;80290375;79615971;674404;
09.01.2019;18:18:05;80290439;79616092;674347;
09.01.2019;18:19:06;80290525;79616253;674272;
09.01.2019;18:20:04;80290592;79616374;674218;
09.01.2019;18:21:04;80290662;79616482;674180;
09.01.2019;18:22:07;80290727;79616607;674120;
09.01.2019;18:23:06;80290774;79616742;674032;
09.01.2019;18:24:11;80290846;79616870;673976;
09.01.2019;18:25:11;80290925;79617033;673892;
09.01.2019;18:26:06;80290985;79617153;673832;
09.01.2019;18:27:06;80291069;79617273;673796;
09.01.2019;18:28:04;80291148;79617393;673755;
09.01.2019;18:29:04;80291223;79617503;673720;
09.01.2019;18:30:06;80291303;79617620;673683;
09.01.2019;18:31:06;80291371;79617762;673609;
09.01.2019;18:32:10;80291466;79617910;673556;
09.01.2019;18:33:06;80291530;79618033;673497;
09.01.2019;18:34:11;80291613;79618162;673451;
09.01.2019;18:35:07;80291694;79618280;673414;
09.01.2019;18:36:04;80291781;79618426;673355;
09.01.2019;18:37:05;80291871;79618547;673324;
09.01.2019;18:38:09;80291949;79618699;673250;
09.01.2019;18:39:05;80292014;79618807;673207;
09.01.2019;18:40:04;80292087;79618947;673140;
09.01.2019;18:41:04;80292178;79619096;673082;
09.01.2019;18:42:04;80292241;79619228;673013;
09.01.2019;18:43:05;80292332;79619365;672967;
09.01.2019;18:44:06;80292418;79619509;672909;
09.01.2019;18:45:05;80292408;79619574;672834;
09.01.2019;18:46:06;80292485;79619720;672765;
09.01.2019;18:47:06;80292545;79619858;672687;
09.01.2019;18:48:05;80292653;79619989;672664;
09.01.2019;18:49:04;80292717;79620127;672590;
09.01.2019;18:50:05;80292774;79620253;672521;
09.01.2019;18:51:05;80292841;79620393;672448;
09.01.2019;18:52:10;80292942;79620539;672403;
09.01.2019;18:53:04;80293025;79620669;672356;
09.01.2019;18:54:05;80293103;79620807;672296;
09.01.2019;18:55:12;80293176;79620945;672231;
09.01.2019;18:56:06;80293257;79621046;672211;
09.01.2019;18:57:05;80293349;79621187;672162;
09.01.2019;18:58:11;80293436;79621322;672114;
09.01.2019;18:59:06;80293513;79621443;672070;
09.01.2019;19:00:07;80293596;79621551;672045;
09.01.2019;19:01:10;80293671;79621693;671978;
09.01.2019;19:02:05;80293735;79621804;671931;
09.01.2019;19:03:11;80293823;79621935;671888;
09.01.2019;19:04:06;80293896;79622037;671859;
09.01.2019;19:05:04;80293962;79622161;671801;
09.01.2019;19:06:06;80294054;79622273;671781;
09.01.2019;19:07:07;80294113;79622405;671708;
09.01.2019;19:08:05;80294192;79622536;671656;
09.01.2019;19:09:04;80294279;79622666;671613;
09.01.2019;19:10:06;80294343;79622783;671560;
09.01.2019;19:11:06;80294428;79622889;671539;
09.01.2019;19:12:10;80294495;79623013;671482;
09.01.2019;19:13:04;80294575;79623101;671474;
09.01.2019;19:14:12;80294643;79623243;671400;
09.01.2019;19:15:06;80294730;79623343;671387;
09.01.2019;19:16:05;80294810;79623459;671351;
09.01.2019;19:17:05;80294874;79623563;671311;
09.01.2019;19:18:09;80294976;79623659;671317;
09.01.2019;19:19:06;80295059;79623754;671305;
09.01.2019;19:20:05;80295114;79623848;671266;
09.01.2019;19:21:05;80295175;79623927;671248;
09.01.2019;19:22:06;80295254;79624020;671234;
09.01.2019;19:23:05;80295316;79624139;671177;
09.01.2019;19:24:04;80295376;79624228;671148;
09.01.2019;19:25:04;80295453;79624352;671101;
09.01.2019;19:26:10;80295515;79624446;671069;
09.01.2019;19:27:05;80295603;79624561;671042;
09.01.2019;19:28:20;80295692;79624679;671013;
09.01.2019;19:29:06;80295750;79624752;670998;
09.01.2019;19:30:04;80295834;79624846;670988;
09.01.2019;19:31:05;80295914;79624921;670993;
09.01.2019;19:32:05;80295992;79625008;670984;
09.01.2019;19:33:05;80296068;79625082;670986;
09.01.2019;19:34:11;80296154;79625174;670980;
09.01.2019;19:35:06;80296233;79625250;670983;
09.01.2019;19:36:05;80296300;79625345;670955;
09.01.2019;19:37:05;80296379;79625424;670955;
09.01.2019;19:38:11;80296472;79625522;670950;
09.01.2019;19:39:16;80296525;79625616;670909;
09.01.2019;19:40:06;80296611;79625694;670917;
09.01.2019;19:41:06;80296677;79625773;670904;
09.01.2019;19:42:05;80296766;79625863;670903;
09.01.2019;19:43:07;80296851;79625952;670899;
09.01.2019;19:44:05;80296920;79626031;670889;
09.01.2019;19:45:05;80297000;79626109;670891;
09.01.2019;19:46:04;80297078;79626201;670877;
09.01.2019;19:47:04;80297153;79626292;670861;
09.01.2019;19:48:05;80297237;79626363;670874;
09.01.2019;19:49:05;80297297;79626456;670841;
09.01.2019;19:50:04;80297384;79626536;670848;
09.01.2019;19:51:04;80297476;79626621;670855;
09.01.2019;19:52:05;80297526;79626699;670827;
09.01.2019;19:53:05;80297505;79626773;670732;
09.01.2019;19:54:05;80297525;79626838;670687;
09.01.2019;19:55:10;80297580;79626933;670647;
09.01.2019;19:56:06;80297616;79627012;670604;
09.01.2019;19:57:04;80297661;79627081;670580;
09.01.2019;19:58:04;80297709;79627137;670572;
09.01.2019;19:59:07;80297743;79627224;670519;
09.01.2019;20:00:06;80297796;79627312;670484;
09.01.2019;20:01:10;80297852;79627394;670458;
09.01.2019;20:02:05;80297910;79627452;670458;
09.01.2019;20:03:05;80297965;79627540;670425;
09.01.2019;20:04:06;80298022;79627630;670392;
09.01.2019;20:05:06;80298091;79627688;670403;
09.01.2019;20:06:08;80298145;79627758;670387;
09.01.2019;20:07:06;80298199;79627816;670383;
09.01.2019;20:08:05;80298272;79627875;670397;
09.01.2019;20:09:06;80298333;79627953;670380;
09.01.2019;20:10:06;80298401;79628030;670371;
09.01.2019;20:11:06;80298467;79628105;670362;
09.01.2019;20:12:04;80298528;79628166;670362;
09.01.2019;20:13:04;80298568;79628254;670314;
09.01.2019;20:14:10;80298647;79628322;670325;
09.01.2019;20:15:05;80298686;79628363;670323;
09.01.2019;20:16:05;80298746;79628423;670323;
09.01.2019;20:17:07;80298806;79628474;670332;
09.01.2019;20:18:06;80298887;79628542;670345;
09.01.2019;20:19:04;80298947;79628607;670340;
09.01.2019;20:20:04;80298992;79628662;670330;
09.01.2019;20:21:05;80299041;79628725;670316;
09.01.2019;20:22:05;80299106;79628769;670337;
09.01.2019;20:23:04;80299132;79628791;670341;
09.01.2019;20:24:04;80299173;79628832;670341;
09.01.2019;20:25:05;80299230;79628879;670351;
09.01.2019;20:26:15;80299304;79628945;670359;
09.01.2019;20:27:10;80299352;79629008;670344;
09.01.2019;20:28:04;80299397;79629054;670343;
09.01.2019;20:29:06;80299467;79629104;670363;
09.01.2019;20:30:05;80299523;79629147;670376;
09.01.2019;20:31:05;80299593;79629202;670391;
09.01.2019;20:32:04;80299667;79629251;670416;
09.01.2019;20:33:04;80299718;79629288;670430;
09.01.2019;20:34:05;80299794;79629351;670443;
09.01.2019;20:35:11;80299876;79629384;670492;
09.01.2019;20:36:04;80299952;79629421;670531;
09.01.2019;20:37:04;80300029;79629473;670556;
09.01.2019;20:38:05;80300095;79629536;670559;
09.01.2019;20:39:05;80300154;79629596;670558;
09.01.2019;20:40:06;80300216;79629660;670556;
09.01.2019;20:41:06;80300292;79629717;670575;
09.01.2019;20:42:04;80300387;79629794;670593;
09.01.2019;20:43:04;80300476;79629858;670618;
09.01.2019;20:44:04;80300547;79629915;670632;
09.01.2019;20:45:05;80300603;79629987;670616;
09.01.2019;20:46:06;80300706;79630039;670667;
09.01.2019;20:47:06;80300787;79630088;670699;
09.01.2019;20:48:05;80300872;79630148;670724;
09.01.2019;20:49:05;80300972;79630197;670775;
09.01.2019;20:50:05;80301068;79630250;670818;
09.01.2019;20:51:05;80301156;79630291;670865;
09.01.2019;20:52:04;80301239;79630339;670900;
09.01.2019;20:53:05;80301307;79630382;670925;
09.01.2019;20:54:05;80301379;79630429;670950;
09.01.2019;20:55:05;80301460;79630489;670971;
09.01.2019;20:56:06;80301515;79630538;670977;
09.01.2019;20:57:05;80301570;79630571;670999;
09.01.2019;20:58:05;80301641;79630610;671031;
09.01.2019;20:59:04;80301717;79630662;671055;
09.01.2019;21:00:07;80301772;79630707;671065;
09.01.2019;21:01:05;80301839;79630766;671073;
09.01.2019;21:02:05;80301914;79630811;671103;
09.01.2019;21:03:05;80302010;79630853;671157;
09.01.2019;21:04:05;80302084;79630919;671165;
09.01.2019;21:05:06;80302169;79630958;671211;
09.01.2019;21:06:11;80302232;79631014;671218;
09.01.2019;21:07:04;80302307;79631054;671253;
09.01.2019;21:08:04;80302386;79631107;671279;
09.01.2019;21:09:07;80302460;79631155;671305;
09.01.2019;21:10:07;80302518;79631200;671318;
09.01.2019;21:11:04;80302585;79631242;671343;
09.01.2019;21:12:06;80302668;79631299;671369;
09.01.2019;21:13:05;80302744;79631347;671397;
09.01.2019;21:14:10;80302835;79631385;671450;
09.01.2019;21:15:04;80302902;79631426;671476;
09.01.2019;21:16:05;80302973;79631464;671509;
09.01.2019;21:17:06;80303053;79631513;671540;
09.01.2019;21:18:05;80303123;79631572;671551;
09.01.2019;21:19:05;80303204;79631614;671590;
09.01.2019;21:20:05;80303288;79631655;671633;
09.01.2019;21:21:05;80303394;79631693;671701;
09.01.2019;21:22:04;80303475;79631739;671736;
09.01.2019;21:23:05;80303548;79631791;671757;
09.01.2019;21:24:04;80303625;79646430;657195;
09.01.2019;21:25:04;80303689;79646472;657217;
09.01.2019;21:26:05;80303763;79646517;657246;
09.01.2019;21:27:05;80303844;79646547;657297;
09.01.2019;21:28:05;80303900;79646596;657304;
09.01.2019;21:29:05;80303996;79646643;657353;
09.01.2019;21:30:04;80302208;79646671;655537;
09.01.2019;21:31:04;80302299;79646704;655595;
09.01.2019;21:32:10;80302379;79646753;655626;
09.01.2019;21:33:05;80302429;79646780;655649;
09.01.2019;21:34:11;80302522;79646826;655696;
09.01.2019;21:35:04;80302603;79646851;655752;
09.01.2019;21:36:04;80302683;79646888;655795;
09.01.2019;21:37:05;80302771;79646929;655842;
09.01.2019;21:38:05;80302855;79646970;655885;
09.01.2019;21:39:05;80302945;79646996;655949;
09.01.2019;21:40:05;80303022;79647029;655993;
09.01.2019;21:41:04;80303101;79647071;656030;
09.01.2019;21:42:05;80303178;79647098;656080;
09.01.2019;21:43:05;80303250;79647140;656110;
09.01.2019;21:44:04;80303317;79647179;656138;
09.01.2019;21:45:05;80303380;79647225;656155;
09.01.2019;21:46:04;80303400;79647209;656191;
09.01.2019;21:47:04;80303499;79647242;656257;
09.01.2019;21:48:05;80303592;79647282;656310;
09.01.2019;21:49:05;80303680;79647314;656366;
09.01.2019;21:50:05;80303788;79647347;656441;
09.01.2019;21:51:04;80303893;79647377;656516;
09.01.2019;21:52:04;80303962;79647412;656550;
09.01.2019;21:53:05;80304034;79647460;656574;
09.01.2019;21:54:05;80304101;79647480;656621;
09.01.2019;21:55:05;80304169;79647512;656657;
09.01.2019;21:56:04;80304249;79647544;656705;
09.01.2019;21:57:04;80304333;79647588;656745;
09.01.2019;21:58:05;80304411;79647631;656780;
09.01.2019;21:59:05;80304510;79647668;656842;
09.01.2019;22:00:10;80304565;79647701;656864;
09.01.2019;22:01:05;80304665;79647729;656936;
09.01.2019;22:02:05;80304736;79647765;656971;
09.01.2019;22:03:04;80304813;79647796;657017;
09.01.2019;22:04:04;80304896;79647832;657064;
09.01.2019;22:05:05;80304996;79647883;657113;
09.01.2019;22:06:04;80305067;79647899;657168;
09.01.2019;22:07:04;80305143;79647932;657211;
09.01.2019;22:08:04;80305224;79647951;657273;
09.01.2019;22:09:05;80305322;79647985;657337;
09.01.2019;22:10:05;80305387;79648020;657367;
09.01.2019;22:11:05;80305453;79648056;657397;
09.01.2019;22:12:04;80305515;79648087;657428;
09.01.2019;22:13:04;80305590;79648101;657489;
09.01.2019;22:14:04;80305658;79648123;657535;
09.01.2019;22:15:04;80305735;79648146;657589;
09.01.2019;22:16:05;80305837;79648170;657667;
09.01.2019;22:17:05;80305897;79648209;657688;
09.01.2019;22:18:05;80305951;79648232;657719;
09.01.2019;22:19:06;80306018;79648254;657764;
09.01.2019;22:20:05;80306086;79648281;657805;
09.01.2019;22:21:05;80306167;79648304;657863;
09.01.2019;22:22:04;80306259;79648333;657926;
09.01.2019;22:23:04;80306332;79648353;657979;
09.01.2019;22:24:04;80306430;79648383;658047;
09.01.2019;22:25:05;80306525;79648410;658115;
09.01.2019;22:26:05;80306583;79648439;658144;
09.01.2019;22:27:05;80306658;79648465;658193;
09.01.2019;22:28:04;80306753;79648484;658269;
09.01.2019;22:29:04;80306856;79648502;658354;
09.01.2019;22:30:17;80306964;79648545;658419;
09.01.2019;22:31:06;80307032;79648574;658458;
09.01.2019;22:32:04;80307098;79648601;658497;
09.01.2019;22:33:06;80307157;79648626;658531;
09.01.2019;22:34:05;80307223;79648648;658575;
09.01.2019;22:35:05;80307321;79648689;658632;
09.01.2019;22:36:04;80307399;79648721;658678;
09.01.2019;22:37:04;80307476;79648738;658738;
09.01.2019;22:38:05;80307586;79648768;658818;
09.01.2019;22:39:05;80307660;79648803;658857;
09.01.2019;22:40:04;80307742;79648824;658918;
09.01.2019;22:41:04;80307827;79648851;658976;
09.01.2019;22:42:04;80307918;79648860;659058;
09.01.2019;22:43:05;80308020;79648895;659125;
09.01.2019;22:44:05;80308121;79648935;659186;
09.01.2019;22:45:04;80308211;79648956;659255;
09.01.2019;22:46:04;80308303;79648977;659326;
09.01.2019;22:47:05;80308393;79648995;659398;
09.01.2019;22:48:04;80308493;79649023;659470;
09.01.2019;22:49:05;80308575;79649053;659522;
09.01.2019;22:50:04;80308664;79649076;659588;
09.01.2019;22:51:04;80308719;79649089;659630;
09.01.2019;22:52:05;80308796;79649123;659673;
09.01.2019;22:53:05;80308887;79649144;659743;
09.01.2019;22:54:04;80308985;79649164;659821;
09.01.2019;22:55:05;80309080;79649183;659897;
09.01.2019;22:56:05;80309163;79649208;659955;
09.01.2019;22:57:05;80309251;79649232;660019;
09.01.2019;22:58:04;80309331;79649257;660074;
09.01.2019;22:59:10;80309417;79649278;660139;
09.01.2019;23:00:05;80309485;79649293;660192;
09.01.2019;23:01:05;80309642;79649314;660328;
09.01.2019;23:02:04;80309788;79649335;660453;
09.01.2019;23:03:05;80309907;79649360;660547;
09.01.2019;23:04:05;80309999;79649387;660612;
09.01.2019;23:05:04;80310091;79649409;660682;
09.01.2019;23:06:04;80310163;79649439;660724;
09.01.2019;23:07:05;80310250;79649463;660787;
09.01.2019;23:08:05;80310354;79649494;660860;
09.01.2019;23:09:04;80310440;79649520;660920;
09.01.2019;23:10:04;80310523;79649541;660982;
09.01.2019;23:11:05;80310604;79649576;661028;
09.01.2019;23:12:06;80310697;79649591;661106;
09.01.2019;23:13:04;80310788;79649614;661174;
09.01.2019;23:14:04;80310884;79649642;661242;
09.01.2019;23:15:05;80310959;79649653;661306;
09.01.2019;23:16:04;80311045;79649674;661371;
09.01.2019;23:17:05;80311138;79649681;661457;
09.01.2019;23:18:05;80311211;79649700;661511;
09.01.2019;23:19:04;80311294;79649723;661571;
09.01.2019;23:20:04;80311386;79649758;661628;
09.01.2019;23:21:05;80311497;79649786;661711;
09.01.2019;23:27:56;80312045;79649930;662115;
09.01.2019;23:28:06;80312066;79649936;662130;
09.01.2019;23:29:07;80312151;79649960;662191;
09.01.2019;23:30:07;80312206;79649978;662228;
09.01.2019;23:31:04;80312266;79649988;662278;
09.01.2019;23:32:05;80312344;79650011;662333;
09.01.2019;23:33:04;80312418;79650044;662374;
09.01.2019;23:34:04;80312486;79650062;662424;
09.01.2019;23:35:05;80312561;79650098;662463;
09.01.2019;23:36:05;80312653;79650121;662532;
09.01.2019;23:37:04;80312738;79650151;662587;
09.01.2019;23:38:05;80312811;79650169;662642;
09.01.2019;23:39:06;80312887;79650192;662695;
09.01.2019;23:40:04;80312952;79650213;662739;
09.01.2019;23:41:05;80313027;79650236;662791;
09.01.2019;23:42:05;80313101;79650255;662846;
09.01.2019;23:43:04;80313187;79650285;662902;
09.01.2019;23:44:04;80313270;79650305;662965;
09.01.2019;23:45:05;80313340;79650325;663015;
09.01.2019;23:46:05;80313401;79650344;663057;
09.01.2019;23:47:05;80313491;79650372;663119;
09.01.2019;23:48:04;80313563;79650395;663168;
09.01.2019;23:49:05;80313637;79650416;663221;
09.01.2019;23:50:05;80313708;79650441;663267;
09.01.2019;23:51:04;80313784;79650460;663324;
09.01.2019;23:52:10;80313854;79650476;663378;
09.01.2019;23:53:05;80313919;79650488;663431;
09.01.2019;23:54:04;80313978;79650511;663467;
09.01.2019;23:55:04;80314041;79650537;663504;
09.01.2019;23:56:05;80314121;79650571;663550;
09.01.2019;23:57:12;80314197;79650600;663597;
09.01.2019;23:58:06;80314258;79650622;663636;
09.01.2019;23:59:04;80314331;79650641;663690;
10.01.2019;00:00:07;80314424;79650667;663757;
10.01.2019;00:01:07;80314527;79650691;663836;
10.01.2019;00:02:08;80314598;79650716;663882;
10.01.2019;00:03:08;80314664;79650741;663923;
10.01.2019;00:04:12;80314725;79650755;663970;
10.01.2019;00:05:12;80314781;79650777;664004;
10.01.2019;00:06:08;80314839;79650789;664050;
10.01.2019;00:07:08;80314907;79650811;664096;
10.01.2019;00:08:07;80314981;79650833;664148;
10.01.2019;00:09:07;80315046;79650836;664210;
10.01.2019;00:10:09;80315094;79650856;664238;
10.01.2019;00:11:07;80315149;79650876;664273;
10.01.2019;00:12:08;80315204;79650885;664319;
10.01.2019;00:13:09;80315269;79650897;664372;
10.01.2019;00:14:08;80315290;79650904;664386;
10.01.2019;00:15:07;80315350;79650922;664428;
10.01.2019;00:18:18;80315565;79650976;664589;
10.01.2019;00:19:13;80315638;79650998;664640;
10.01.2019;00:20:24;80315709;79651009;664700;
10.01.2019;00:21:17;80315779;79651025;664754;
10.01.2019;00:24:19;80315970;79651088;664882;
10.01.2019;00:25:22;80316048;79651120;664928;
10.01.2019;00:26:22;80316112;79651136;664976;
10.01.2019;00:27:21;80316161;79651158;665003;
10.01.2019;00:28:22;80316224;79651183;665041;
10.01.2019;00:29:19;80316282;79651196;665086;
10.01.2019;00:30:19;80316338;79651216;665122;
10.01.2019;00:32:19;80316478;79651260;665218;
10.01.2019;00:33:18;80316541;79651276;665265;
10.01.2019;00:34:16;80316605;79651291;665314;
10.01.2019;00:35:16;80316671;79651316;665355;
10.01.2019;00:36:16;80316737;79651348;665389;
10.01.2019;00:37:17;80316783;79651368;665415;
10.01.2019;00:38:16;80316850;79651392;665458;
10.01.2019;00:39:16;80316924;79651409;665515;
10.01.2019;00:40:16;80316991;79651430;665561;
10.01.2019;00:41:15;80317052;79651454;665598;
10.01.2019;00:42:13;80317102;79651482;665620;
10.01.2019;00:43:13;80317142;79651509;665633;
10.01.2019;00:44:13;80317231;79651538;665693;
10.01.2019;00:45:09;80317281;79651559;665722;
10.01.2019;00:46:10;80317327;79651586;665741;
10.01.2019;00:47:10;80317392;79651597;665795;
10.01.2019;00:48:11;80317402;79651595;665807;
10.01.2019;00:49:10;80317474;79651614;665860;
10.01.2019;00:50:08;80317527;79651638;665889;
10.01.2019;00:51:08;80317585;79651659;665926;
10.01.2019;00:52:07;80317658;79651675;665983;
10.01.2019;00:53:07;80317730;79651705;666025;
10.01.2019;00:54:07;80317804;79651735;666069;
10.01.2019;00:55:07;80317873;79651760;666113;
10.01.2019;00:56:07;80317928;79651787;666141;
10.01.2019;00:57:07;80317995;79651810;666185;
10.01.2019;00:58:08;80318049;79651839;666210;
10.01.2019;00:59:07;80318111;79651861;666250;
10.01.2019;01:00:05;80318179;79651881;666298;
10.01.2019;01:01:04;80318257;79651901;666356;
10.01.2019;01:02:05;80318324;79651926;666398;
10.01.2019;01:03:04;80318398;79651957;666441;
10.01.2019;01:04:04;80318511;79651979;666532;
10.01.2019;01:05:05;80318591;79651993;666598;
10.01.2019;01:06:05;80318688;79652027;666661;
10.01.2019;01:07:04;80318763;79652049;666714;
10.01.2019;01:08:05;80318857;79652071;666786;
10.01.2019;01:09:05;80318921;79652105;666816;
10.01.2019;01:10:04;80319004;79652137;666867;
10.01.2019;01:12:10;80319167;79652201;666966;
10.01.2019;01:13:05;80319235;79652225;667010;
10.01.2019;01:14:04;80319317;79652254;667063;
10.01.2019;01:15:06;80319416;79652277;667139;
10.01.2019;01:16:07;80319496;79652310;667186;
10.01.2019;01:17:08;80319561;79652333;667228;
10.01.2019;01:18:07;80319633;79652361;667272;
10.01.2019;01:20:04;80319795;79652411;667384;
10.01.2019;01:21:04;80319915;79652450;667465;
10.01.2019;01:22:05;80320008;79652480;667528;
10.01.2019;01:23:05;80320096;79652514;667582;
10.01.2019;01:24:04;80320185;79652538;667647;
10.01.2019;01:25:04;80320262;79652568;667694;
10.01.2019;01:26:05;80320344;79652603;667741;
10.01.2019;01:27:04;80320441;79652645;667796;
10.01.2019;01:28:04;80320533;79652672;667861;
10.01.2019;01:29:05;80320611;79652713;667898;
10.01.2019;01:30:04;80320682;79652754;667928;
10.01.2019;01:31:04;80320765;79652782;667983;
10.01.2019;01:32:04;80320868;79652816;668052;
10.01.2019;01:33:05;80320941;79652853;668088;
10.01.2019;01:34:05;80321027;79652882;668145;
10.01.2019;01:35:04;80321109;79652923;668186;
10.01.2019;01:36:04;80321175;79652965;668210;
10.01.2019;01:37:05;80321259;79652993;668266;
10.01.2019;01:38:04;80321358;79653031;668327;
10.01.2019;01:39:04;80321435;79653072;668363;
10.01.2019;01:40:04;80321504;79653109;668395;
10.01.2019;01:41:05;80321581;79653148;668433;
10.01.2019;01:42:04;80321659;79653191;668468;
10.01.2019;01:43:04;80321739;79653216;668523;
10.01.2019;01:44:05;80321840;79653250;668590;
10.01.2019;01:45:04;80321919;79653296;668623;
10.01.2019;01:46:04;80321996;79653336;668660;
10.01.2019;01:47:05;80322070;79653378;668692;
10.01.2019;01:48:04;80322135;79653428;668707;
10.01.2019;01:49:04;80322227;79653463;668764;
10.01.2019;01:50:05;80322336;79653497;668839;
10.01.2019;01:51:04;80322449;79653536;668913;
10.01.2019;01:52:04;80322529;79653585;668944;
10.01.2019;01:53:04;80322615;79653625;668990;
10.01.2019;01:54:04;80322718;79653665;669053;
10.01.2019;01:55:05;80322822;79653700;669122;
10.01.2019;01:56:04;80322899;79653742;669157;
10.01.2019;01:57:04;80322978;79653790;669188;
10.01.2019;01:58:05;80323049;79653834;669215;
10.01.2019;01:59:04;80323167;79653891;669276;
10.01.2019;02:00:05;80323263;79653939;669324;
10.01.2019;02:01:05;80323344;79653991;669353;
10.01.2019;02:02:05;80323446;79654036;669410;
10.01.2019;02:03:05;80323538;79654079;669459;
10.01.2019;02:04:05;80323605;79654127;669478;
10.01.2019;02:05:04;80323661;79654178;669483;
10.01.2019;02:06:05;80323749;79654238;669511;
10.01.2019;02:07:04;80323820;79654269;669551;
10.01.2019;02:08:04;80323893;79654325;669568;
10.01.2019;02:09:05;80323949;79654372;669577;
10.01.2019;02:10:04;80324034;79654417;669617;
10.01.2019;02:11:05;80324125;79654466;669659;
10.01.2019;02:12:04;80324181;79654513;669668;
10.01.2019;02:13:04;80324240;79654552;669688;
10.01.2019;02:14:05;80324311;79654596;669715;
10.01.2019;02:15:05;80324390;79654645;669745;
10.01.2019;02:16:04;80324469;79654704;669765;
10.01.2019;02:17:05;80324543;79654751;669792;
10.01.2019;02:18:04;80324622;79654806;669816;
10.01.2019;02:19:04;80324707;79654854;669853;
10.01.2019;02:20:04;80324795;79654912;669883;
10.01.2019;02:21:04;80324880;79654991;669889;
10.01.2019;02:22:05;80324968;79655052;669916;
10.01.2019;02:23:04;80325052;79655119;669933;
10.01.2019;02:24:05;80325145;79655186;669959;
10.01.2019;02:25:04;80325225;79655247;669978;
10.01.2019;02:26:10;80325310;79655317;669993;
10.01.2019;02:27:05;80325389;79655378;670011;
10.01.2019;02:28:06;80325475;79655430;670045;
10.01.2019;02:29:05;80325556;79655480;670076;
10.01.2019;02:30:05;80325630;79655541;670089;
10.01.2019;02:31:04;80325710;79655598;670112;
10.01.2019;02:32:05;80325797;79655656;670141;
10.01.2019;02:33:04;80325878;79655719;670159;
10.01.2019;02:34:04;80325949;79655787;670162;
10.01.2019;02:35:04;80326033;79655846;670187;
10.01.2019;02:36:04;80326114;79655912;670202;
10.01.2019;02:37:04;80326191;79655987;670204;
10.01.2019;02:38:04;80326291;79656048;670243;
10.01.2019;02:39:04;80326371;79656125;670246;
10.01.2019;02:40:05;80326437;79656195;670242;
10.01.2019;02:41:04;80326500;79656267;670233;
10.01.2019;02:42:04;80326597;79656324;670273;
10.01.2019;02:43:04;80326675;79656391;670284;
10.01.2019;02:44:04;80326759;79656470;670289;
10.01.2019;02:45:04;80326837;79656541;670296;
10.01.2019;02:46:04;80326918;79656608;670310;
10.01.2019;02:47:05;80327013;79656697;670316;
10.01.2019;02:48:04;80327109;79656765;670344;
10.01.2019;02:49:05;80327182;79656835;670347;
10.01.2019;02:50:04;80327273;79656891;670382;
10.01.2019;02:51:04;80327357;79656976;670381;
10.01.2019;02:52:04;80327451;79657066;670385;
10.01.2019;02:53:04;80327535;79657138;670397;
10.01.2019;02:54:05;80327612;79657220;670392;
10.01.2019;02:55:04;80327678;79657303;670375;
10.01.2019;02:56:05;80327752;79657376;670376;
10.01.2019;02:57:04;80327833;79657446;670387;
10.01.2019;02:58:05;80327903;79657531;670372;
10.01.2019;02:59:04;80327986;79657606;670380;
10.01.2019;03:00:04;80328074;79657683;670391;
10.01.2019;03:01:05;80328165;79657764;670401;
10.01.2019;03:02:04;80328259;79657836;670423;
10.01.2019;03:03:05;80328350;79657933;670417;
10.01.2019;03:04:04;80328412;79658010;670402;
10.01.2019;03:05:05;80328476;79658099;670377;
10.01.2019;03:06:04;80328538;79658166;670372;
10.01.2019;03:07:04;80328628;79658252;670376;
10.01.2019;03:08:04;80328715;79658356;670359;
10.01.2019;03:09:04;80328784;79658452;670332;
10.01.2019;03:10:04;80328875;79658555;670320;
10.01.2019;03:11:04;80328963;79658627;670336;
10.01.2019;03:12:04;80329038;79658706;670332;
10.01.2019;03:13:04;80329107;79658783;670324;
10.01.2019;03:14:04;80329184;79658875;670309;
10.01.2019;03:15:05;80329254;79658972;670282;
10.01.2019;03:16:04;80329346;79659073;670273;
10.01.2019;03:17:05;80329431;79659182;670249;
10.01.2019;03:18:04;80329503;79659278;670225;
10.01.2019;03:19:04;80329583;79659378;670205;
10.01.2019;03:20:05;80329656;79659476;670180;
10.01.2019;03:21:04;80329750;79659563;670187;
10.01.2019;03:22:05;80329858;79659675;670183;
10.01.2019;03:23:04;80329934;79659758;670176;
10.01.2019;03:24:05;80330020;79659844;670176;
10.01.2019;03:25:04;80330106;79659967;670139;
10.01.2019;03:26:05;80330183;79660064;670119;
10.01.2019;03:27:04;80330252;79660156;670096;
10.01.2019;03:28:04;80330336;79660260;670076;
10.01.2019;03:29:05;80330423;79660353;670070;
10.01.2019;03:30:04;80330491;79660444;670047;
10.01.2019;03:31:05;80330576;79660530;670046;
10.01.2019;03:32:04;80330648;79660627;670021;
10.01.2019;03:33:04;80330745;79660735;670010;
10.01.2019;03:34:04;80330844;79660837;670007;
10.01.2019;03:35:04;80330932;79660924;670008;
10.01.2019;03:36:04;80331010;79661014;669996;
10.01.2019;03:37:04;80331082;79661111;669971;
10.01.2019;03:38:04;80331155;79661219;669936;
10.01.2019;03:39:05;80331239;79661308;669931;
10.01.2019;03:40:04;80331313;79661404;669909;
10.01.2019;03:41:04;80331383;79661495;669888;
10.01.2019;03:42:05;80331474;79661604;669870;
10.01.2019;03:43:04;80331542;79661701;669841;
10.01.2019;03:44:04;80331629;79661815;669814;
10.01.2019;03:45:05;80331697;79661933;669764;
10.01.2019;03:46:04;80331778;79662036;669742;
10.01.2019;03:47:05;80331903;79662156;669747;
10.01.2019;03:48:04;80331984;79662242;669742;
10.01.2019;03:49:04;80332015;79662311;669704;
10.01.2019;03:50:05;80332099;79662419;669680;
10.01.2019;03:51:04;80332166;79662538;669628;
10.01.2019;03:52:05;80332251;79662630;669621;
10.01.2019;03:53:04;80332324;79662734;669590;
10.01.2019;03:54:04;80332408;79662825;669583;
10.01.2019;03:55:04;80332486;79662953;669533;
10.01.2019;03:56:04;80332571;79663050;669521;
10.01.2019;03:57:05;80332649;79663178;669471;
10.01.2019;03:58:04;80332739;79663280;669459;
10.01.2019;03:59:05;80332803;79663380;669423;
10.01.2019;04:00:04;80332881;79663505;669376;
10.01.2019;04:01:04;80332956;79663611;669345;
10.01.2019;04:02:05;80333043;79663732;669311;
10.01.2019;04:03:04;80333116;79663833;669283;
10.01.2019;04:04:04;80333191;79663925;669266;
10.01.2019;04:05:04;80333266;79664034;669232;
10.01.2019;04:06:04;80333342;79664140;669202;
10.01.2019;04:07:05;80333400;79664237;669163;
10.01.2019;04:08:04;80333474;79664350;669124;
10.01.2019;04:09:05;80333556;79664445;669111;
10.01.2019;04:10:04;80333626;79664550;669076;
10.01.2019;04:11:04;80333686;79664662;669024;
10.01.2019;04:12:04;80333747;79664771;668976;
10.01.2019;04:13:04;80333845;79664877;668968;
10.01.2019;04:14:04;80333913;79665003;668910;
10.01.2019;04:15:04;80333979;79665102;668877;
10.01.2019;04:16:05;80334026;79665168;668858;
10.01.2019;04:17:04;80334078;79665265;668813;
10.01.2019;04:18:04;80334141;79665383;668758;
10.01.2019;04:19:04;80334214;79665479;668735;
10.01.2019;04:20:04;80334297;79665588;668709;
10.01.2019;04:21:05;80334365;79665678;668687;
10.01.2019;04:22:04;80334423;79665797;668626;
10.01.2019;04:23:05;80334498;79665905;668593;
10.01.2019;04:24:04;80334554;79666035;668519;
10.01.2019;04:25:05;80334624;79666157;668467;
10.01.2019;04:26:04;80334697;79666269;668428;
10.01.2019;04:27:05;80334767;79666384;668383;
10.01.2019;04:28:04;80334836;79666510;668326;
10.01.2019;04:29:05;80334906;79666628;668278;
10.01.2019;04:30:04;80334973;79666736;668237;
10.01.2019;04:31:04;80335033;79666860;668173;
10.01.2019;04:32:04;80335109;79666963;668146;
10.01.2019;04:33:04;80335188;79667075;668113;
10.01.2019;04:34:05;80335252;79667185;668067;
10.01.2019;04:35:04;80335304;79667310;667994;
10.01.2019;04:36:05;80335366;79667412;667954;
10.01.2019;04:37:04;80335444;79667518;667926;
10.01.2019;04:38:04;80335507;79667640;667867;
10.01.2019;04:39:05;80335588;79667753;667835;
10.01.2019;04:40:04;80335667;79667846;667821;
10.01.2019;04:41:05;80335749;79667973;667776;
10.01.2019;04:42:04;80335824;79668088;667736;
10.01.2019;04:43:04;80335894;79668200;667694;
10.01.2019;04:44:05;80335960;79668349;667611;
10.01.2019;04:45:04;80336037;79668445;667592;
10.01.2019;04:46:05;80336128;79668572;667556;
10.01.2019;04:47:04;80336217;79668665;667552;
10.01.2019;04:48:05;80336296;79668769;667527;
10.01.2019;04:49:04;80336383;79668883;667500;
10.01.2019;04:50:05;80336461;79668994;667467;
10.01.2019;04:51:04;80336520;79669109;667411;
10.01.2019;04:52:04;80336590;79669217;667373;
10.01.2019;04:53:04;80336668;79669341;667327;
10.01.2019;04:54:04;80336727;79669468;667259;
10.01.2019;04:55:05;80336796;79669588;667208;
10.01.2019;04:56:04;80336854;79669701;667153;
10.01.2019;04:57:05;80336928;79669822;667106;
10.01.2019;04:58:04;80337007;79669972;667035;
10.01.2019;04:59:05;80337064;79670083;666981;
10.01.2019;05:00:04;80337148;79670188;666960;
10.01.2019;05:01:05;80337216;79670289;666927;
10.01.2019;05:02:04;80337283;79670412;666871;
10.01.2019;05:03:05;80337341;79670528;666813;
10.01.2019;05:04:04;80337426;79670658;666768;
10.01.2019;05:05:04;80337509;79670762;666747;
10.01.2019;05:06:04;80337587;79670879;666708;
10.01.2019;05:07:04;80337640;79670983;666657;
10.01.2019;05:08:04;80337719;79671128;666591;
10.01.2019;05:09:04;80337778;79671231;666547;
10.01.2019;05:10:05;80337835;79671361;666474;
10.01.2019;05:11:04;80337892;79671488;666404;
10.01.2019;05:12:05;80337958;79671598;666360;
10.01.2019;05:13:04;80338025;79671714;666311;
10.01.2019;05:14:05;80338094;79671827;666267;
10.01.2019;05:15:04;80338167;79671944;666223;
10.01.2019;05:16:04;80338224;79672085;666139;
10.01.2019;05:17:05;80338294;79672180;666114;
10.01.2019;05:18:04;80338359;79672315;666044;
10.01.2019;05:19:05;80338415;79672416;665999;
10.01.2019;05:20:04;80338474;79672545;665929;
10.01.2019;05:21:04;80338532;79672667;665865;
10.01.2019;05:22:04;80338602;79672800;665802;
10.01.2019;05:23:04;80338661;79672903;665758;
10.01.2019;05:24:04;80338727;79673011;665716;
10.01.2019;05:25:04;80338777;79673140;665637;
10.01.2019;05:26:05;80338840;79673249;665591;
10.01.2019;05:27:04;80338906;79673369;665537;
10.01.2019;05:28:05;80338965;79673497;665468;
10.01.2019;05:29:04;80339041;79673625;665416;
10.01.2019;05:30:05;80339114;79673748;665366;
10.01.2019;05:31:04;80339170;79673867;665303;
10.01.2019;05:32:05;80339233;79674011;665222;
10.01.2019;05:33:04;80339295;79674138;665157;
10.01.2019;05:34:05;80339374;79674260;665114;
10.01.2019;05:35:04;80339430;79674390;665040;
10.01.2019;05:36:04;80339492;79674481;665011;
10.01.2019;05:37:04;80339552;79674604;664948;
10.01.2019;05:38:04;80339598;79674703;664895;
10.01.2019;05:39:05;80339654;79674814;664840;
10.01.2019;05:40:04;80339709;79674935;664774;
10.01.2019;05:41:05;80339772;79675059;664713;
10.01.2019;05:42:04;80339818;79675193;664625;
10.01.2019;05:43:04;80339869;79675301;664568;
10.01.2019;05:44:04;80339922;79675410;664512;
10.01.2019;05:45:04;80339987;79675523;664464;
10.01.2019;05:46:04;80340052;79675660;664392;
10.01.2019;05:47:04;80340111;79675779;664332;
10.01.2019;05:48:05;80340177;79675882;664295;
10.01.2019;05:49:04;80340232;79676000;664232;
10.01.2019;05:50:05;80340307;79676133;664174;
10.01.2019;05:51:04;80340364;79676248;664116;
10.01.2019;05:52:05;80340421;79676361;664060;
10.01.2019;05:53:05;80340489;79676489;664000;
10.01.2019;05:54:04;80340548;79676595;663953;
10.01.2019;05:55:05;80340615;79676707;663908;
10.01.2019;05:56:04;80340664;79676811;663853;
10.01.2019;05:57:05;80340710;79676924;663786;
10.01.2019;05:58:04;80340760;79677032;663728;
10.01.2019;05:59:04;80340790;79677148;663642;
10.01.2019;06:00:04;80340846;79677247;663599;
10.01.2019;06:01:04;80340895;79677362;663533;
10.01.2019;06:02:05;80340968;79677480;663488;
10.01.2019;06:03:04;80341018;79677593;663425;
10.01.2019;06:04:05;80341057;79677708;663349;
10.01.2019;06:05:04;80341114;79677826;663288;
10.01.2019;06:06:05;80341153;79677949;663204;
10.01.2019;06:07:04;80341200;79678063;663137;
10.01.2019;06:08:04;80341244;79678204;663040;
10.01.2019;06:09:04;80341292;79678315;662977;
10.01.2019;06:10:04;80341340;79678439;662901;
10.01.2019;06:11:05;80341397;79678567;662830;
10.01.2019;06:12:04;80341442;79678664;662778;
10.01.2019;06:13:05;80341518;79678795;662723;
10.01.2019;06:14:04;80341557;79678927;662630;
10.01.2019;06:15:05;80341612;79679069;662543;
10.01.2019;06:16:04;80341648;79679189;662459;
10.01.2019;06:17:05;80341698;79679324;662374;
10.01.2019;06:18:05;80341757;79679449;662308;
10.01.2019;06:19:04;80341822;79679584;662238;
10.01.2019;06:20:05;80341887;79679687;662200;
10.01.2019;06:21:04;80341940;79679798;662142;
10.01.2019;06:22:04;80342010;79679923;662087;
10.01.2019;06:23:05;80342051;79680054;661997;
10.01.2019;06:24:04;80342078;79680174;661904;
10.01.2019;06:25:07;80342134;79680312;661822;
10.01.2019;06:26:06;80342198;79680441;661757;
10.01.2019;06:27:04;80342259;79680552;661707;
10.01.2019;06:28:05;80342341;79680689;661652;
10.01.2019;06:29:04;80342397;79680827;661570;
10.01.2019;06:30:05;80342450;79680942;661508;
10.01.2019;06:31:04;80342515;79681051;661464;
10.01.2019;06:32:04;80342574;79681153;661421;
10.01.2019;06:33:04;80342645;79681277;661368;
10.01.2019;06:34:04;80342708;79681380;661328;
10.01.2019;06:35:05;80342766;79681514;661252;
10.01.2019;06:36:04;80342833;79681625;661208;
10.01.2019;06:37:05;80342880;79681765;661115;
10.01.2019;06:38:04;80342935;79681903;661032;
10.01.2019;06:39:10;80342990;79682048;660942;
10.01.2019;06:40:05;80343013;79682120;660893;
10.01.2019;06:41:04;80343036;79682215;660821;
10.01.2019;06:42:05;80343093;79682334;660759;
10.01.2019;06:43:04;80343168;79682450;660718;
10.01.2019;06:44:06;80343220;79682577;660643;
10.01.2019;06:45:05;80343274;79682698;660576;
10.01.2019;06:46:05;80343328;79682826;660502;
10.01.2019;06:47:05;80343389;79682937;660452;
10.01.2019;06:48:10;80343448;79683081;660367;
10.01.2019;06:49:05;80343511;79683189;660322;
10.01.2019;06:50:13;80343582;79683348;660234;
10.01.2019;06:51:11;80343618;79683472;660146;
10.01.2019;06:52:06;80343672;79683598;660074;
10.01.2019;06:53:04;80343727;79683696;660031;
10.01.2019;06:54:11;80343775;79683841;659934;
10.01.2019;06:55:04;80343813;79683961;659852;
10.01.2019;06:56:05;80343856;79684108;659748;
10.01.2019;06:57:07;80343913;79684215;659698;
10.01.2019;06:58:04;80343959;79684331;659628;
10.01.2019;06:59:11;80344007;79684462;659545;
10.01.2019;07:00:04;80344051;79684567;659484;
10.01.2019;07:01:04;80344105;79684692;659413;
10.01.2019;07:02:05;80344165;79684822;659343;
10.01.2019;07:03:04;80344206;79684960;659246;
10.01.2019;07:04:11;80344290;79685065;659225;
10.01.2019;07:05:05;80344335;79685174;659161;
10.01.2019;07:06:05;80344393;79685299;659094;
10.01.2019;07:07:10;80344441;79685437;659004;
10.01.2019;07:08:06;80344510;79685550;658960;
10.01.2019;07:09:05;80344560;79685681;658879;
10.01.2019;07:10:10;80344618;79685807;658811;
10.01.2019;07:11:04;80344667;79685919;658748;
10.01.2019;07:12:10;80344738;79686029;658709;
10.01.2019;07:13:11;80344785;79686157;658628;
10.01.2019;07:14:05;80344847;79686265;658582;
10.01.2019;07:15:04;80344898;79686363;658535;
10.01.2019;07:16:05;80344950;79686500;658450;
10.01.2019;07:17:10;80345003;79686647;658356;
10.01.2019;07:18:10;80345061;79686764;658297;
10.01.2019;07:19:10;80345088;79686893;658195;
10.01.2019;07:20:05;80345149;79687024;658125;
10.01.2019;07:21:04;80345207;79687154;658053;
10.01.2019;07:22:04;80345254;79687276;657978;
10.01.2019;07:23:05;80345309;79687417;657892;
10.01.2019;07:24:04;80345362;79687545;657817;
10.01.2019;07:25:06;80345409;79687671;657738;
10.01.2019;07:26:10;80345460;79687827;657633;
10.01.2019;07:27:05;80345503;79687942;657561;
10.01.2019;07:28:05;80345559;79688072;657487;
10.01.2019;07:29:05;80345604;79688199;657405;
10.01.2019;07:30:04;80345669;79688328;657341;
10.01.2019;07:31:05;80345731;79688448;657283;
10.01.2019;07:32:05;80345774;79688595;657179;
10.01.2019;07:33:04;80345845;79688721;657124;
10.01.2019;07:34:04;80345905;79688845;657060;
10.01.2019;07:35:04;80345957;79688967;656990;
10.01.2019;07:36:04;80346011;79689105;656906;
10.01.2019;07:37:05;80346053;79689254;656799;
10.01.2019;07:38:05;80346107;79689378;656729;
10.01.2019;07:39:05;80346161;79689474;656687;
10.01.2019;07:40:05;80346220;79689591;656629;
10.01.2019;07:41:04;80346281;79689719;656562;
10.01.2019;07:42:05;80346328;79689852;656476;
10.01.2019;07:43:04;80346372;79689983;656389;
10.01.2019;07:44:05;80346439;79690117;656322;
10.01.2019;07:45:05;80346498;79690253;656245;
10.01.2019;07:46:04;80346561;79690375;656186;
10.01.2019;07:47:05;80346623;79690505;656118;
10.01.2019;07:48:11;80346673;79690626;656047;
10.01.2019;07:49:10;80346707;79690752;655955;
10.01.2019;07:50:05;80346752;79690838;655914;
10.01.2019;07:51:06;80346800;79690961;655839;
10.01.2019;07:52:05;80346861;79691079;655782;
10.01.2019;07:53:10;80346935;79691213;655722;
10.01.2019;07:54:04;80346985;79691332;655653;
10.01.2019;07:55:05;80347045;79691449;655596;
10.01.2019;07:56:04;80347111;79691572;655539;
10.01.2019;07:57:04;80347159;79691689;655470;
10.01.2019;07:58:11;80347216;79691814;655402;
10.01.2019;07:59:04;80347265;79691923;655342;
10.01.2019;08:00:05;80347298;79692033;655265;
10.01.2019;08:01:10;80347326;79692126;655200;
10.01.2019;08:02:11;80347369;79692234;655135;
10.01.2019;08:03:04;80347392;79692355;655037;
10.01.2019;08:04:05;80347436;79692485;654951;
10.01.2019;08:05:04;80347468;79692583;654885;
10.01.2019;08:06:04;80347501;79692699;654802;
10.01.2019;08:07:04;80347560;79692803;654757;
10.01.2019;08:08:04;80347603;79692901;654702;
10.01.2019;08:09:05;80347658;79693002;654656;
10.01.2019;08:10:04;80347696;79693099;654597;
10.01.2019;08:11:04;80347752;79693222;654530;
10.01.2019;08:12:04;80347803;79693351;654452;
10.01.2019;08:13:04;80347861;79693458;654403;
10.01.2019;08:14:05;80347904;79693572;654332;
10.01.2019;08:15:04;80347950;79693710;654240;
10.01.2019;08:16:05;80348008;79693840;654168;
10.01.2019;08:17:04;80348056;79693964;654092;
10.01.2019;08:18:04;80348097;79694092;654005;
10.01.2019;08:19:05;80348149;79694205;653944;
10.01.2019;08:20:04;80348200;79694321;653879;
10.01.2019;08:21:05;80348248;79694444;653804;
10.01.2019;08:22:04;80348293;79694554;653739;
10.01.2019;08:23:04;80348335;79694671;653664;
10.01.2019;08:24:05;80348386;79694798;653588;
10.01.2019;08:25:04;80348435;79694932;653503;
10.01.2019;08:26:04;80348482;79695068;653414;
10.01.2019;08:27:05;80348523;79695195;653328;
10.01.2019;08:28:04;80348566;79695336;653230;
10.01.2019;08:29:04;80348612;79695449;653163;
10.01.2019;08:30:11;80348677;79695592;653085;
10.01.2019;08:31:04;80348724;79695712;653012;
10.01.2019;08:32:04;80348768;79695847;652921;
10.01.2019;08:33:04;80348809;79695977;652832;
10.01.2019;08:34:04;80348870;79696101;652769;
10.01.2019;08:35:05;80348930;79696201;652729;
10.01.2019;08:36:04;80348964;79696310;652654;
10.01.2019;08:37:05;80349005;79696454;652551;
10.01.2019;08:38:04;80349067;79696551;652516;
10.01.2019;08:39:04;80349112;79696660;652452;
10.01.2019;08:40:05;80349165;79696794;652371;
10.01.2019;08:41:04;80349214;79696916;652298;
10.01.2019;08:42:04;80349276;79697048;652228;
10.01.2019;08:43:05;80349324;79697185;652139;
10.01.2019;08:44:04;80349386;79697282;652104;
10.01.2019;08:45:05;80349437;79697396;652041;
10.01.2019;08:46:04;80349484;79697531;651953;
10.01.2019;08:47:04;80349539;79697652;651887;
10.01.2019;08:48:04;80349586;79697774;651812;
10.01.2019;08:49:04;80349637;79697901;651736;
10.01.2019;08:50:05;80349683;79698021;651662;
10.01.2019;08:51:04;80349744;79698155;651589;
10.01.2019;08:52:04;80349780;79698274;651506;
10.01.2019;08:53:04;80349834;79698398;651436;
10.01.2019;08:54:04;80349877;79698520;651357;
10.01.2019;08:55:05;80349928;79698643;651285;
10.01.2019;08:56:04;80349972;79698766;651206;
10.01.2019;08:57:05;80350034;79698883;651151;
10.01.2019;08:58:04;80350082;79699005;651077;
10.01.2019;08:59:04;80350129;79699130;650999;
10.01.2019;09:00:05;80350180;79699255;650925;
10.01.2019;09:01:04;80350224;79699401;650823;
10.01.2019;09:02:05;80350265;79699515;650750;
10.01.2019;09:03:04;80350306;79699644;650662;
10.01.2019;09:04:05;80350350;79699788;650562;
10.01.2019;09:05:04;80350405;79699892;650513;
10.01.2019;09:06:04;80350458;79700005;650453;
10.01.2019;09:07:05;80350503;79700135;650368;
10.01.2019;09:08:04;80350566;79700248;650318;
10.01.2019;09:09:05;80350618;79700395;650223;
10.01.2019;09:10:04;80350671;79700511;650160;
10.01.2019;09:11:04;80350715;79700612;650103;
10.01.2019;09:12:05;80350764;79700743;650021;
10.01.2019;09:13:04;80350803;79700893;649910;
10.01.2019;09:14:04;80350850;79701031;649819;
10.01.2019;09:15:05;80350901;79701171;649730;
10.01.2019;09:16:04;80350939;79701319;649620;
10.01.2019;09:17:05;80350995;79701434;649561;
10.01.2019;09:18:04;80351051;79701552;649499;
10.01.2019;09:19:04;80351096;79701672;649424;
10.01.2019;09:20:05;80351132;79701837;649295;
10.01.2019;09:21:04;80351191;79701959;649232;
10.01.2019;09:22:04;80351236;79702085;649151;
10.01.2019;09:23:04;80351284;79702202;649082;
10.01.2019;09:24:04;80351333;79702332;649001;
10.01.2019;09:25:05;80351390;79702478;648912;
10.01.2019;09:26:04;80351434;79702600;648834;
10.01.2019;09:27:05;80351499;79702742;648757;
10.01.2019;09:28:04;80351536;79702876;648660;
10.01.2019;09:29:04;80351584;79703006;648578;
10.01.2019;09:30:04;80351631;79703147;648484;
10.01.2019;09:31:04;80351691;79703280;648411;
10.01.2019;09:32:04;80351743;79703422;648321;
10.01.2019;09:33:04;80351799;79703562;648237;
10.01.2019;09:34:05;80351851;79703683;648168;
10.01.2019;09:35:04;80351902;79703812;648090;
10.01.2019;09:36:04;80351944;79703936;648008;
10.01.2019;09:37:04;80351953;79704000;647953;
10.01.2019;09:38:04;80351991;79704135;647856;
10.01.2019;09:39:05;80352034;79704274;647760;
10.01.2019;09:40:04;80352083;79704414;647669;
10.01.2019;09:41:05;80352127;79704540;647587;
10.01.2019;09:42:04;80352172;79704664;647508;
10.01.2019;09:43:04;80352234;79704783;647451;
10.01.2019;09:44:05;80352288;79704922;647366;
10.01.2019;09:45:04;80352322;79705064;647258;
10.01.2019;09:46:04;80352382;79705220;647162;
10.01.2019;09:47:05;80352419;79705377;647042;
10.01.2019;09:48:04;80352460;79705520;646940;
10.01.2019;09:49:05;80352511;79705652;646859;
10.01.2019;09:50:04;80352530;79705776;646754;
10.01.2019;09:51:04;80352576;79705909;646667;
10.01.2019;09:52:04;80352622;79706045;646577;
10.01.2019;09:53:04;80352684;79706178;646506;
10.01.2019;09:54:04;80352733;79706332;646401;
10.01.2019;09:55:04;80352795;79706476;646319;
10.01.2019;09:56:05;80352841;79706626;646215;
10.01.2019;09:57:04;80352894;79706766;646128;
10.01.2019;09:58:04;80352935;79706912;646023;
10.01.2019;09:59:04;80352989;79707059;645930;
10.01.2019;10:00:04;80353019;79707186;645833;
10.01.2019;10:01:05;80353058;79707319;645739;
10.01.2019;10:02:04;80353102;79707459;645643;
10.01.2019;10:03:04;80353147;79707570;645577;
10.01.2019;10:04:04;80353193;79707688;645505;
10.01.2019;10:05:04;80353226;79707802;645424;
10.01.2019;10:06:04;80353263;79707918;645345;
10.01.2019;10:07:05;80353276;79708031;645245;
10.01.2019;10:08:04;80353322;79708138;645184;
10.01.2019;10:09:05;80353352;79708246;645106;
10.01.2019;10:10:04;80353389;79708375;645014;
10.01.2019;10:11:04;80353431;79708533;644898;
10.01.2019;10:12:05;80353476;79708657;644819;
10.01.2019;10:13:04;80353501;79708759;644742;
10.01.2019;10:14:05;80353544;79708904;644640;
10.01.2019;10:15:04;80353581;79709040;644541;
10.01.2019;10:16:05;80353626;79709169;644457;
10.01.2019;10:17:05;80353658;79709292;644366;
10.01.2019;10:18:04;80353699;79709437;644262;
10.01.2019;10:19:05;80353730;79709593;644137;
10.01.2019;10:20:04;80353788;79709692;644096;
10.01.2019;10:21:05;80353825;79709815;644010;
10.01.2019;10:22:04;80353864;79709960;643904;
10.01.2019;10:23:05;80353913;79710095;643818;
10.01.2019;10:24:04;80353942;79710223;643719;
10.01.2019;10:25:04;80353989;79710334;643655;
10.01.2019;10:26:04;80354036;79710472;643564;
10.01.2019;10:27:04;80354089;79710615;643474;
10.01.2019;10:28:05;80354139;79710729;643410;
10.01.2019;10:29:04;80354171;79710852;643319;
10.01.2019;10:30:04;80354211;79710985;643226;
10.01.2019;10:31:04;80354258;79711108;643150;
10.01.2019;10:32:04;80354319;79711241;643078;
10.01.2019;10:33:04;80354367;79711345;643022;
10.01.2019;10:34:04;80354408;79711424;642984;
10.01.2019;10:35:05;80354458;79711546;642912;
10.01.2019;10:36:04;80354496;79711667;642829;
10.01.2019;10:37:05;80354547;79711781;642766;
10.01.2019;10:38:04;80354588;79711899;642689;
10.01.2019;10:39:04;80354658;79712018;642640;
10.01.2019;10:40:05;80354698;79712163;642535;
10.01.2019;10:41:04;80354751;79712298;642453;
10.01.2019;10:42:04;80354789;79712423;642366;
10.01.2019;10:43:04;80354842;79712547;642295;
10.01.2019;10:44:04;80354893;79712666;642227;
10.01.2019;10:45:04;80354935;79712791;642144;
10.01.2019;10:46:04;80354983;79712937;642046;
10.01.2019;10:47:05;80355026;79713054;641972;
10.01.2019;10:48:04;80355067;79713187;641880;
10.01.2019;10:49:04;80355106;79713272;641834;
10.01.2019;10:50:04;80355153;79713420;641733;
10.01.2019;10:51:04;80355203;79713546;641657;
10.01.2019;10:52:05;80355234;79713691;641543;
10.01.2019;10:53:04;80355299;79713821;641478;
10.01.2019;10:54:05;80355338;79713938;641400;
10.01.2019;10:55:04;80355385;79714075;641310;
10.01.2019;10:56:04;80355443;79714191;641252;
10.01.2019;10:57:04;80355498;79714335;641163;
10.01.2019;10:58:04;80355538;79714466;641072;
10.01.2019;10:59:04;80355576;79714613;640963;
10.01.2019;11:00:04;80355627;79714727;640900;
10.01.2019;11:01:05;80355668;79714867;640801;
10.01.2019;11:02:04;80355699;79715000;640699;
10.01.2019;11:03:05;80355733;79715133;640600;
10.01.2019;11:04:04;80355768;79715276;640492;
10.01.2019;11:05:05;80355816;79715405;640411;
10.01.2019;11:06:04;80355869;79715524;640345;
10.01.2019;11:07:04;80355919;79715667;640252;
10.01.2019;11:08:04;80355967;79715793;640174;
10.01.2019;11:09:04;80356016;79715924;640092;
10.01.2019;11:10:05;80356061;79716018;640043;
10.01.2019;11:11:04;80356110;79716142;639968;
10.01.2019;11:12:05;80356176;79716260;639916;
10.01.2019;11:13:04;80356228;79716403;639825;
10.01.2019;11:14:05;80356284;79716532;639752;
10.01.2019;11:15:04;80356320;79716668;639652;
10.01.2019;11:16:04;80356369;79716800;639569;
10.01.2019;11:17:05;80356401;79716937;639464;
10.01.2019;11:18:04;80356434;79717054;639380;
10.01.2019;11:19:05;80356489;79717192;639297;
10.01.2019;11:20:04;80356527;79717344;639183;
10.01.2019;11:21:04;80356572;79717509;639063;
10.01.2019;11:22:05;80356624;79717634;638990;
10.01.2019;11:23:04;80356664;79717783;638881;
10.01.2019;11:24:04;80356704;79717924;638780;
10.01.2019;11:25:05;80356768;79718045;638723;
10.01.2019;11:26:09;80356833;79718206;638627;
10.01.2019;11:27:05;80356857;79718336;638521;
10.01.2019;11:28:04;80356906;79718458;638448;
10.01.2019;11:29:04;80356944;79718588;638356;
10.01.2019;11:30:06;80356986;79718728;638258;
10.01.2019;11:31:05;80357025;79718850;638175;
10.01.2019;11:32:04;80357067;79718979;638088;
10.01.2019;11:33:05;80357122;79719114;638008;
10.01.2019;11:34:04;80357161;79719285;637876;
10.01.2019;11:35:05;80357206;79719422;637784;
10.01.2019;11:36:04;80357243;79719536;637707;
10.01.2019;11:37:04;80357285;79719696;637589;
10.01.2019;11:38:05;80357320;79719813;637507;
10.01.2019;11:39:04;80357366;79719942;637424;
10.01.2019;11:40:04;80357405;79720081;637324;
10.01.2019;11:41:10;80357458;79720233;637225;
10.01.2019;11:42:05;80357502;79720357;637145;
10.01.2019;11:43:04;80357550;79720483;637067;
10.01.2019;11:44:04;80357599;79720618;636981;
10.01.2019;11:45:05;80357642;79720730;636912;
10.01.2019;11:46:04;80357674;79720873;636801;
10.01.2019;11:47:05;80357722;79720996;636726;
10.01.2019;11:48:04;80357775;79721122;636653;
10.01.2019;11:49:04;80357809;79721265;636544;
10.01.2019;11:50:04;80357878;79721394;636484;
10.01.2019;11:51:04;80357912;79721508;636404;
10.01.2019;11:52:05;80357956;79721665;636291;
10.01.2019;11:53:04;80358000;79721816;636184;
10.01.2019;11:54:04;80358048;79721941;636107;
10.01.2019;11:55:05;80358099;79722075;636024;
10.01.2019;11:56:04;80358152;79722190;635962;
10.01.2019;11:57:05;80358190;79722330;635860;
10.01.2019;11:58:05;80358237;79722466;635771;
10.01.2019;11:59:04;80358274;79722603;635671;
10.01.2019;12:00:04;80358307;79722758;635549;
10.01.2019;12:01:05;80358363;79722868;635495;
10.01.2019;12:02:04;80358397;79723001;635396;
10.01.2019;12:03:04;80358436;79723144;635292;
10.01.2019;12:04:05;80358459;79723266;635193;
10.01.2019;12:05:04;80358483;79723349;635134;
10.01.2019;12:06:04;80358488;79723407;635081;
10.01.2019;12:07:05;80358495;79723482;635013;
10.01.2019;12:08:04;80358530;79723581;634949;
10.01.2019;12:09:04;80358557;79723697;634860;
10.01.2019;12:10:05;80358607;79723814;634793;
10.01.2019;12:11:04;80358650;79723935;634715;
10.01.2019;12:12:04;80358707;79724043;634664;
10.01.2019;12:13:05;80358765;79724164;634601;
10.01.2019;12:14:04;80358821;79724298;634523;
10.01.2019;12:15:04;80358867;79724413;634454;
10.01.2019;12:16:05;80358913;79724562;634351;
10.01.2019;12:17:05;80358966;79724679;634287;
10.01.2019;12:18:04;80359007;79724815;634192;
10.01.2019;12:19:05;80359048;79724943;634105;
10.01.2019;12:20:04;80359095;79725053;634042;
10.01.2019;12:21:04;80359157;79725195;633962;
10.01.2019;12:22:05;80359223;79725347;633876;
10.01.2019;12:23:05;80359287;79725474;633813;
10.01.2019;12:24:04;80359322;79725607;633715;
10.01.2019;12:25:04;80359373;79725730;633643;
10.01.2019;12:26:05;80359416;79725864;633552;
10.01.2019;12:27:05;80359477;79725972;633505;
10.01.2019;12:28:04;80359539;79726095;633444;
10.01.2019;12:29:04;80359591;79726215;633376;
10.01.2019;12:30:05;80359663;79726333;633330;
10.01.2019;12:31:04;80359713;79726420;633293;
10.01.2019;12:32:04;80359758;79726531;633227;
10.01.2019;12:33:04;80359809;79726636;633173;
10.01.2019;12:34:05;80359693;79726593;633100;
10.01.2019;12:35:05;80359431;79726472;632959;
10.01.2019;12:36:05;80359504;79726589;632915;
10.01.2019;12:37:04;80359565;79726712;632853;
10.01.2019;12:38:05;80359631;79726847;632784;
10.01.2019;12:39:05;80359694;79726988;632706;
10.01.2019;12:40:04;80359747;79727146;632601;
10.01.2019;12:41:04;80359802;79727304;632498;
10.01.2019;12:42:05;80359848;79727428;632420;
10.01.2019;12:43:04;80359901;79727557;632344;
10.01.2019;12:44:11;80359963;79727633;632330;
10.01.2019;12:45:05;80360021;79727733;632288;
10.01.2019;12:46:10;80360086;79727831;632255;
10.01.2019;12:47:05;80360132;79727942;632190;
10.01.2019;12:48:04;80360193;79728041;632152;
10.01.2019;12:49:04;80360256;79728150;632106;
10.01.2019;12:50:06;80360323;79728255;632068;
10.01.2019;12:51:05;80360377;79728378;631999;
10.01.2019;12:52:06;80360449;79728484;631965;
10.01.2019;12:53:04;80360501;79728644;631857;
10.01.2019;12:54:05;80360564;79728759;631805;
10.01.2019;12:55:07;80360629;79728866;631763;
10.01.2019;12:56:05;80360693;79728979;631714;
10.01.2019;12:57:04;80360749;79729094;631655;
10.01.2019;12:58:05;80360795;79729217;631578;
10.01.2019;12:59:07;80360850;79729317;631533;
10.01.2019;13:00:06;80360934;79729416;631518;
10.01.2019;13:01:04;80360986;79729519;631467;
10.01.2019;13:02:04;80361045;79729627;631418;
10.01.2019;13:03:05;80361121;79729757;631364;
10.01.2019;13:04:04;80361187;79729880;631307;
10.01.2019;13:05:04;80361238;79730040;631198;
10.01.2019;13:06:05;80361308;79730142;631166;
10.01.2019;13:07:04;80361362;79730262;631100;
10.01.2019;13:08:04;80361440;79730389;631051;
10.01.2019;13:09:05;80361497;79730510;630987;
10.01.2019;13:10:04;80361576;79730640;630936;
10.01.2019;13:11:09;80361644;79730778;630866;
10.01.2019;13:12:05;80361710;79730881;630829;
10.01.2019;13:13:05;80361787;79731027;630760;
10.01.2019;13:14:04;80361847;79731159;630688;
10.01.2019;13:15:04;80361906;79731287;630619;
10.01.2019;13:16:05;80361974;79731427;630547;
10.01.2019;13:17:04;80362049;79731564;630485;
10.01.2019;13:18:04;80362115;79731666;630449;
10.01.2019;13:19:05;80362182;79731814;630368;
10.01.2019;13:20:04;80362249;79731967;630282;
10.01.2019;13:21:04;80362311;79732125;630186;
10.01.2019;13:22:05;80362370;79732244;630126;
10.01.2019;13:23:10;80362451;79732405;630046;
10.01.2019;13:24:04;80362502;79732518;629984;
10.01.2019;13:25:10;80362557;79732680;629877;
10.01.2019;13:26:05;80362615;79732799;629816;
10.01.2019;13:27:04;80362700;79732931;629769;
10.01.2019;13:28:04;80362771;79733070;629701;
10.01.2019;13:29:05;80362846;79733198;629648;
10.01.2019;13:30:05;80362912;79733347;629565;
10.01.2019;13:31:04;80362982;79733478;629504;
10.01.2019;13:32:05;80363042;79733613;629429;
10.01.2019;13:33:05;80363097;79733753;629344;
10.01.2019;13:34:04;80363165;79733892;629273;
10.01.2019;13:35:04;80363228;79734006;629222;
10.01.2019;13:36:05;80363299;79734145;629154;
10.01.2019;13:37:04;80363383;79734278;629105;
10.01.2019;13:38:04;80363456;79734425;629031;
10.01.2019;13:39:05;80363518;79734555;628963;
10.01.2019;13:40:04;80363562;79734700;628862;
10.01.2019;13:41:04;80363634;79734824;628810;
10.01.2019;13:42:05;80363698;79734996;628702;
10.01.2019;13:43:05;80363790;79735140;628650;
10.01.2019;13:44:04;80363878;79735281;628597;
10.01.2019;13:45:05;80363945;79735434;628511;
10.01.2019;13:46:04;80364034;79735581;628453;
10.01.2019;13:47:04;80364103;79735741;628362;
10.01.2019;13:48:05;80364191;79735848;628343;
10.01.2019;13:49:05;80364274;79735998;628276;
10.01.2019;13:50:04;80364357;79736105;628252;
10.01.2019;13:51:05;80364424;79736239;628185;
10.01.2019;13:52:05;80364501;79736385;628116;
10.01.2019;13:53:04;80364581;79736531;628050;
10.01.2019;13:54:04;80364655;79736655;628000;
10.01.2019;13:55:05;80364744;79736804;627940;
10.01.2019;13:56:04;80364800;79736932;627868;
10.01.2019;13:57:05;80364840;79737035;627805;
10.01.2019;13:58:04;80364899;79737178;627721;
10.01.2019;13:59:04;80364951;79737282;627669;
10.01.2019;14:00:05;80365036;79737459;627577;
10.01.2019;14:01:05;80365096;79737587;627509;
10.01.2019;14:02:05;80365180;79737704;627476;
10.01.2019;14:03:06;80365240;79737812;627428;
10.01.2019;14:04:04;80365306;79737985;627321;
10.01.2019;14:05:05;80365381;79738096;627285;
10.01.2019;14:06:05;80365445;79738234;627211;
10.01.2019;14:07:04;80365502;79738385;627117;
10.01.2019;14:08:04;80365556;79738484;627072;
10.01.2019;14:09:05;80365620;79738593;627027;
10.01.2019;14:10:04;80365688;79738740;626948;
10.01.2019;14:11:05;80365761;79738893;626868;
10.01.2019;14:12:04;80365830;79739030;626800;
10.01.2019;14:13:04;80365903;79739182;626721;
10.01.2019;14:14:05;80365980;79739341;626639;
10.01.2019;14:15:04;80366041;79739513;626528;
10.01.2019;14:16:05;80366114;79739677;626437;
10.01.2019;14:17:05;80366187;79739848;626339;
10.01.2019;14:18:04;80366249;79740010;626239;
10.01.2019;14:19:05;80366333;79740169;626164;
10.01.2019;14:20:04;80366407;79740333;626074;
10.01.2019;14:21:04;80366486;79740490;625996;
10.01.2019;14:22:05;80366561;79740616;625945;
10.01.2019;14:23:04;80366613;79740774;625839;
10.01.2019;14:24:05;80366686;79740918;625768;
10.01.2019;14:25:04;80366778;79741075;625703;
10.01.2019;14:26:04;80366840;79741212;625628;
10.01.2019;14:27:05;80366923;79741374;625549;
10.01.2019;14:28:04;80366989;79741526;625463;
10.01.2019;14:29:04;80367078;79741666;625412;
10.01.2019;14:30:05;80367167;79741845;625322;
10.01.2019;14:31:04;80367217;79741995;625222;
10.01.2019;14:32:05;80367303;79742165;625138;
10.01.2019;14:33:04;80367393;79742327;625066;
10.01.2019;14:34:05;80367479;79742486;624993;
10.01.2019;14:35:04;80367539;79742643;624896;
10.01.2019;14:36:04;80367619;79742791;624828;
10.01.2019;14:37:05;80367701;79742936;624765;
10.01.2019;14:38:04;80367784;79743073;624711;
10.01.2019;14:39:05;80367887;79743236;624651;
10.01.2019;14:40:05;80367975;79743425;624550;
10.01.2019;14:41:05;80368054;79743613;624441;
10.01.2019;14:42:04;80368124;79743781;624343;
10.01.2019;14:43:04;80368212;79743921;624291;
10.01.2019;14:44:05;80368309;79744063;624246;
10.01.2019;14:45:04;80368390;79744229;624161;
10.01.2019;14:46:05;80368488;79744360;624128;
10.01.2019;14:47:04;80368584;79744529;624055;
10.01.2019;14:48:04;80368682;79744729;623953;
10.01.2019;14:49:05;80368804;79744896;623908;
10.01.2019;14:50:05;80368912;79745034;623878;
10.01.2019;14:51:05;80368995;79745186;623809;
10.01.2019;14:52:05;80369084;79745350;623734;
10.01.2019;14:53:04;80369194;79745549;623645;
10.01.2019;14:54:05;80369300;79745685;623615;
10.01.2019;14:55:04;80369393;79745833;623560;
10.01.2019;14:56:04;80369490;79745975;623515;
10.01.2019;14:57:05;80369597;79746107;623490;
10.01.2019;14:58:04;80369686;79746278;623408;
10.01.2019;14:59:04;80369795;79746435;623360;
10.01.2019;15:00:07;80369899;79746619;623280;
10.01.2019;15:01:07;80369974;79746747;623227;
10.01.2019;15:02:07;80370078;79746919;623159;
10.01.2019;15:03:07;80370191;79747069;623122;
10.01.2019;15:04:08;80370295;79747249;623046;
10.01.2019;15:05:07;80370382;79747389;622993;
10.01.2019;15:06:08;80370468;79747527;622941;
10.01.2019;15:07:07;80370561;79747693;622868;
10.01.2019;15:08:07;80370661;79747846;622815;
10.01.2019;15:09:12;80370753;79748033;622720;
10.01.2019;15:10:08;80370840;79748188;622652;
10.01.2019;15:11:13;80370959;79748346;622613;
10.01.2019;15:12:09;80371030;79748499;622531;
10.01.2019;15:13:12;80371105;79748693;622412;
10.01.2019;15:14:08;80371207;79748882;622325;
10.01.2019;15:15:07;80371313;79749044;622269;
10.01.2019;15:16:07;80371409;79749227;622182;
10.01.2019;15:17:07;80371500;79749394;622106;
10.01.2019;15:18:07;80371574;79749557;622017;
10.01.2019;15:19:07;80371641;79749732;621909;
10.01.2019;15:20:07;80371732;79749894;621838;
10.01.2019;15:21:07;80371822;79750062;621760;
10.01.2019;15:22:07;80371883;79750234;621649;
10.01.2019;15:23:07;80371981;79750385;621596;
10.01.2019;15:24:12;80372075;79750566;621509;
10.01.2019;15:25:06;80372166;79750748;621418;
10.01.2019;15:26:07;80372256;79750913;621343;
10.01.2019;15:27:07;80372341;79751078;621263;
10.01.2019;15:28:07;80372425;79751237;621188;
10.01.2019;15:29:07;80372540;79751367;621173;
10.01.2019;15:30:07;80372615;79751548;621067;
10.01.2019;15:31:08;80372710;79751705;621005;
10.01.2019;15:32:07;80372801;79751858;620943;
10.01.2019;15:33:07;80372865;79752054;620811;
10.01.2019;15:34:08;80372944;79752221;620723;
10.01.2019;15:35:07;80373029;79752401;620628;
10.01.2019;15:36:07;80373134;79752564;620570;
10.01.2019;15:37:07;80373219;79752722;620497;
10.01.2019;15:38:07;80373325;79752903;620422;
10.01.2019;15:39:08;80373424;79753058;620366;
10.01.2019;15:40:07;80373514;79753219;620295;
10.01.2019;15:41:08;80373603;79753362;620241;
10.01.2019;15:42:12;80373715;79753556;620159;
10.01.2019;15:43:10;80373806;79753704;620102;
10.01.2019;15:44:08;80373903;79753854;620049;
10.01.2019;15:45:07;80374016;79754030;619986;
10.01.2019;15:46:07;80374120;79754220;619900;
10.01.2019;15:47:07;80374208;79754413;619795;
10.01.2019;15:48:07;80374300;79754578;619722;
10.01.2019;15:49:07;80374401;79754742;619659;
10.01.2019;15:50:07;80374477;79754912;619565;
10.01.2019;15:51:07;80374571;79755109;619462;
10.01.2019;15:52:08;80374662;79755294;619368;
10.01.2019;15:53:07;80374752;79755463;619289;
10.01.2019;15:54:08;80374855;79755609;619246;
10.01.2019;15:55:07;80374939;79755817;619122;
10.01.2019;15:56:07;80375045;79756014;619031;
10.01.2019;15:57:07;80375157;79756188;618969;
10.01.2019;15:58:07;80375265;79756393;618872;
10.01.2019;15:59:07;80375328;79756573;618755;
10.01.2019;16:00:05;80375390;79756700;618690;
10.01.2019;16:01:04;80375447;79756846;618601;
10.01.2019;16:02:05;80375502;79756976;618526;
10.01.2019;16:03:04;80375565;79757117;618448;
10.01.2019;16:04:04;80375659;79757264;618395;
10.01.2019;16:05:05;80375720;79757429;618291;
10.01.2019;16:06:04;80375808;79757576;618232;
10.01.2019;16:07:05;80375889;79757762;618127;
10.01.2019;16:08:04;80375952;79757890;618062;
10.01.2019;16:09:04;80376053;79758036;618017;
10.01.2019;16:10:05;80376123;79758210;617913;
10.01.2019;16:11:04;80376220;79758371;617849;
10.01.2019;16:12:05;80376308;79758548;617760;
10.01.2019;16:13:04;80376394;79758699;617695;
10.01.2019;16:14:05;80376473;79758829;617644;
10.01.2019;16:15:04;80376577;79759002;617575;
10.01.2019;16:16:04;80376678;79759170;617508;
10.01.2019;16:17:05;80376747;79759329;617418;
10.01.2019;16:18:04;80376823;79759492;617331;
10.01.2019;16:19:05;80376923;79759685;617238;
10.01.2019;16:20:04;80377014;79759843;617171;
10.01.2019;16:21:10;80377111;79760040;617071;
10.01.2019;16:22:10;80377208;79760213;616995;
10.01.2019;16:23:04;80377306;79760381;616925;
10.01.2019;16:24:04;80377401;79760578;616823;
10.01.2019;16:25:07;80377493;79760732;616761;
10.01.2019;16:26:04;80377577;79760927;616650;
10.01.2019;16:27:05;80377666;79761079;616587;
10.01.2019;16:28:05;80377763;79761236;616527;
10.01.2019;16:29:04;80377844;79761420;616424;
10.01.2019;16:30:04;80377938;79761575;616363;
10.01.2019;16:31:05;80378018;79761736;616282;
10.01.2019;16:32:04;80378117;79761900;616217;
10.01.2019;16:33:05;80378212;79762061;616151;
10.01.2019;16:34:04;80378307;79762229;616078;
10.01.2019;16:35:04;80378421;79762408;616013;
10.01.2019;16:36:05;80378528;79762585;615943;
10.01.2019;16:37:04;80378607;79762739;615868;
10.01.2019;16:38:04;80378694;79762923;615771;
10.01.2019;16:39:05;80378804;79763111;615693;
10.01.2019;16:40:04;80378869;79763275;615594;
10.01.2019;16:41:04;80378956;79763454;615502;
10.01.2019;16:42:04;80379049;79763624;615425;
10.01.2019;16:43:04;80379151;79763796;615355;
10.01.2019;16:44:05;80379248;79763999;615249;
10.01.2019;16:45:04;80379340;79764175;615165;
10.01.2019;16:46:05;80379426;79764329;615097;
10.01.2019;16:47:05;80379508;79764509;614999;
10.01.2019;16:48:04;80379609;79764702;614907;
10.01.2019;16:49:04;80379692;79764836;614856;
10.01.2019;16:50:05;80379777;79765019;614758;
10.01.2019;16:51:05;80379881;79765188;614693;
10.01.2019;16:52:04;80379993;79765357;614636;
10.01.2019;16:53:04;80380074;79765533;614541;
10.01.2019;16:54:05;80380159;79765695;614464;
10.01.2019;16:55:04;80380253;79765845;614408;
10.01.2019;16:56:04;80380349;79766020;614329;
10.01.2019;16:57:05;80380448;79766199;614249;
10.01.2019;16:58:04;80380552;79766378;614174;
10.01.2019;16:59:04;80380648;79766551;614097;
10.01.2019;17:00:05;80380739;79766716;614023;
10.01.2019;17:01:05;80380848;79766879;613969;
10.01.2019;17:02:05;80380954;79767046;613908;
10.01.2019;17:03:04;80381047;79767234;613813;
10.01.2019;17:04:04;80381139;79767440;613699;
10.01.2019;17:05:05;80381230;79767610;613620;
10.01.2019;17:06:05;80381334;79767798;613536;
10.01.2019;17:07:05;80381434;79767946;613488;
10.01.2019;17:08:04;80381523;79768120;613403;
10.01.2019;17:09:11;80381620;79768304;613316;
10.01.2019;17:10:04;80381726;79768460;613266;
10.01.2019;17:11:05;80381821;79768606;613215;
10.01.2019;17:12:05;80381917;79768777;613140;
10.01.2019;17:13:05;80382001;79768924;613077;
10.01.2019;17:14:05;80382099;79769060;613039;
10.01.2019;17:15:04;80382178;79769225;612953;
10.01.2019;17:16:04;80382280;79769393;612887;
10.01.2019;17:17:05;80382360;79769552;612808;
10.01.2019;17:18:05;80382442;79769721;612721;
10.01.2019;17:19:04;80382527;79769890;612637;
10.01.2019;17:20:04;80382619;79770029;612590;
10.01.2019;17:21:05;80382707;79770199;612508;
10.01.2019;17:22:04;80382802;79770379;612423;
10.01.2019;17:23:04;80382906;79770542;612364;
10.01.2019;17:24:04;80383010;79770696;612314;
10.01.2019;17:25:05;80383106;79770853;612253;
10.01.2019;17:26:04;80383204;79771034;612170;
10.01.2019;17:27:04;80383295;79771176;612119;
10.01.2019;17:28:05;80383367;79771343;612024;
10.01.2019;17:29:10;80383462;79771511;611951;
10.01.2019;17:30:04;80383557;79771647;611910;
10.01.2019;17:31:04;80383642;79771802;611840;
10.01.2019;17:32:05;80383719;79771985;611734;
10.01.2019;17:33:05;80383806;79772168;611638;
10.01.2019;17:34:05;80383902;79772333;611569;
10.01.2019;17:35:04;80383999;79772487;611512;
10.01.2019;17:36:05;80384101;79772668;611433;
10.01.2019;17:37:05;80384201;79772824;611377;
10.01.2019;17:38:05;80384305;79772992;611313;
10.01.2019;17:39:05;80384401;79773153;611248;
10.01.2019;17:40:05;80384499;79773304;611195;
10.01.2019;17:41:05;80384596;79773473;611123;
10.01.2019;17:42:05;80384711;79773604;611107;
10.01.2019;17:43:05;80384799;79773758;611041;
10.01.2019;17:44:05;80384893;79773911;610982;
10.01.2019;17:45:04;80384978;79774086;610892;
10.01.2019;17:46:05;80385064;79774225;610839;
10.01.2019;17:47:05;80385156;79774391;610765;
10.01.2019;17:48:06;80385253;79774563;610690;
10.01.2019;17:49:05;80385344;79774726;610618;
10.01.2019;17:50:05;80385438;79774886;610552;
10.01.2019;17:51:05;80385543;79775055;610488;
10.01.2019;17:52:04;80385654;79775212;610442;
10.01.2019;17:53:04;80385753;79775361;610392;
10.01.2019;17:54:04;80385839;79775517;610322;
10.01.2019;17:55:05;80385944;79775680;610264;
10.01.2019;17:56:05;80386022;79775876;610146;
10.01.2019;17:57:05;80386097;79776015;610082;
10.01.2019;17:58:04;80386206;79776183;610023;
10.01.2019;17:59:05;80386328;79776326;610002;
10.01.2019;18:00:05;80386425;79776500;609925;
10.01.2019;18:01:04;80386518;79776653;609865;
10.01.2019;18:02:26;80386642;79776843;609799;
10.01.2019;18:03:04;80386697;79776949;609748;
10.01.2019;18:05:52;80386912;79777308;609604;
10.01.2019;18:06:09;80386929;79777339;609590;
10.01.2019;18:07:10;80387017;79777452;609565;
10.01.2019;18:08:11;80387080;79777559;609521;
10.01.2019;18:09:22;80387166;79777681;609485;
10.01.2019;18:10:12;80387232;79777788;609444;
10.01.2019;18:11:07;80387329;79777922;609407;
10.01.2019;18:12:10;80387380;79778072;609308;
10.01.2019;18:13:09;80387473;79778196;609277;
10.01.2019;18:14:11;80387548;79778321;609227;
10.01.2019;18:15:08;80387626;79778437;609189;
10.01.2019;18:16:10;80387704;79778564;609140;
10.01.2019;18:17:14;80387791;79778687;609104;
10.01.2019;18:18:14;80387850;79778833;609017;
10.01.2019;18:19:09;80387945;79778948;608997;
10.01.2019;18:20:14;80388022;79779089;608933;
10.01.2019;18:21:05;80388085;79779215;608870;
10.01.2019;18:23:11;80388230;79779529;608701;
10.01.2019;18:24:06;80388321;79779663;608658;
10.01.2019;18:25:06;80388420;79779808;608612;
10.01.2019;18:26:04;80388509;79779942;608567;
10.01.2019;18:27:05;80388602;79780095;608507;
10.01.2019;18:28:06;80388692;79780231;608461;
10.01.2019;18:29:05;80388780;79780387;608393;
10.01.2019;18:30:05;80388886;79780522;608364;
10.01.2019;18:31:05;80388995;79780644;608351;
10.01.2019;18:32:05;80389084;79780788;608296;
10.01.2019;18:33:04;80389167;79780933;608234;
10.01.2019;18:34:07;80389273;79781073;608200;
10.01.2019;18:35:06;80389367;79781219;608148;
10.01.2019;18:36:05;80389466;79781363;608103;
10.01.2019;18:37:06;80389560;79781484;608076;
10.01.2019;18:38:05;80389640;79781625;608015;
10.01.2019;18:39:05;80389725;79781755;607970;
10.01.2019;18:40:06;80389812;79781887;607925;
10.01.2019;18:41:05;80389900;79782021;607879;
10.01.2019;18:42:05;80389991;79782163;607828;
10.01.2019;18:43:04;80390090;79782276;607814;
10.01.2019;18:44:13;80390191;79782430;607761;
10.01.2019;18:45:07;80390280;79782558;607722;
10.01.2019;18:46:09;80390378;79782672;607706;
10.01.2019;18:47:05;80390466;79782790;607676;
10.01.2019;18:48:14;80390586;79782931;607655;
10.01.2019;18:49:07;80390670;79783030;607640;
10.01.2019;18:50:05;80390771;79783164;607607;
10.01.2019;18:51:06;80390882;79783276;607606;
10.01.2019;18:52:04;80390880;79783315;607565;
10.01.2019;18:53:05;80390976;79783445;607531;
10.01.2019;18:54:05;80391067;79783578;607489;
10.01.2019;18:55:05;80391149;79783714;607435;
10.01.2019;18:56:05;80391257;79783833;607424;
10.01.2019;18:57:09;80391345;79783957;607388;
10.01.2019;18:58:13;80391451;79784100;607351;
10.01.2019;18:59:09;80391547;79784214;607333;
10.01.2019;19:00:09;80391651;79784325;607326;
10.01.2019;19:01:07;80391743;79784430;607313;
10.01.2019;19:02:07;80391834;79784556;607278;
10.01.2019;19:03:06;80391929;79784669;607260;
10.01.2019;19:04:08;80392039;79784786;607253;
10.01.2019;19:05:08;80392131;79784883;607248;
10.01.2019;19:06:14;80392225;79785001;607224;
10.01.2019;19:07:07;80392299;79785086;607213;
10.01.2019;19:08:07;80392379;79785194;607185;
10.01.2019;19:09:09;80392484;79785296;607188;
10.01.2019;19:10:13;80392575;79785417;607158;
10.01.2019;19:11:16;80392667;79785525;607142;
10.01.2019;19:12:12;80392733;79785604;607129;
10.01.2019;19:13:06;80392832;79785712;607120;
10.01.2019;19:14:09;80392938;79785840;607098;
10.01.2019;19:15:08;80393025;79785947;607078;
10.01.2019;19:16:13;80393128;79786069;607059;
10.01.2019;19:17:13;80393226;79786176;607050;
10.01.2019;19:18:11;80393323;79786278;607045;
10.01.2019;19:19:08;80393399;79786376;607023;
10.01.2019;19:20:08;80393491;79786485;607006;
10.01.2019;19:21:08;80393604;79786582;607022;
10.01.2019;19:22:07;80393692;79786672;607020;
10.01.2019;19:23:08;80393796;79786765;607031;
10.01.2019;19:24:08;80393877;79786865;607012;
10.01.2019;19:25:08;80393954;79786959;606995;
10.01.2019;19:26:14;80394041;79787077;606964;
10.01.2019;19:27:13;80394135;79787156;606979;
10.01.2019;19:28:08;80394221;79787241;606980;
10.01.2019;19:29:08;80394296;79787327;606969;
10.01.2019;19:30:07;80394394;79787408;606986;
10.01.2019;19:31:09;80394486;79787509;606977;
10.01.2019;19:32:15;80394574;79787598;606976;
10.01.2019;19:33:08;80394660;79787694;606966;
10.01.2019;19:34:12;80394750;79787802;606948;
10.01.2019;19:35:06;80394839;79787865;606974;
10.01.2019;19:36:13;80394940;79787946;606994;
10.01.2019;19:37:12;80395048;79788054;606994;
10.01.2019;19:38:05;80395120;79788127;606993;
10.01.2019;19:39:06;80395207;79788228;606979;
10.01.2019;19:40:05;80395280;79788311;606969;
10.01.2019;19:41:05;80395378;79788390;606988;
10.01.2019;19:42:08;80395475;79788499;606976;
10.01.2019;19:43:07;80395558;79788577;606981;
10.01.2019;19:44:07;80395646;79788653;606993;
10.01.2019;19:45:07;80395734;79788727;607007;
10.01.2019;19:46:07;80395825;79788816;607009;
10.01.2019;19:47:07;80395915;79788906;607009;
10.01.2019;19:48:07;80396010;79788989;607021;
10.01.2019;19:49:05;80396093;79789067;607026;
10.01.2019;19:50:06;80396173;79789159;607014;
10.01.2019;19:51:05;80396270;79789234;607036;
10.01.2019;19:52:06;80396366;79789310;607056;
10.01.2019;19:53:05;80396471;79789412;607059;
10.01.2019;19:54:11;80396533;79789494;607039;
10.01.2019;19:55:05;80396620;79789569;607051;
10.01.2019;19:56:12;80396720;79789658;607062;
10.01.2019;19:57:08;80396822;79789737;607085;
10.01.2019;19:58:08;80396813;79789817;606996;
10.01.2019;19:59:05;80396833;79789890;606943;
10.01.2019;20:00:13;80396872;79789961;606911;
10.01.2019;20:01:08;80396900;79789986;606914;
10.01.2019;20:02:13;80396926;79790040;606886;
10.01.2019;20:03:08;80396980;79790062;606918;
10.01.2019;20:04:08;80397038;79790124;606914;
10.01.2019;20:05:08;80397085;79790220;606865;
10.01.2019;20:06:07;80397142;79790263;606879;
10.01.2019;20:07:08;80395893;79790301;605592;
10.01.2019;20:10:11;80396087;79790442;605645;
10.01.2019;20:11:09;80396146;79790504;605642;
10.01.2019;20:12:08;80396210;79790582;605628;
10.01.2019;20:13:12;80396253;79790644;605609;
10.01.2019;20:14:04;80396324;79794627;601697;
10.01.2019;20:15:05;80396395;79794682;601713;
10.01.2019;20:16:04;80396452;79794752;601700;
10.01.2019;20:17:10;80396525;79794836;601689;
10.01.2019;20:18:05;80396605;79794892;601713;
10.01.2019;20:19:05;80396629;79794962;601667;
10.01.2019;20:20:04;80396728;79795041;601687;
10.01.2019;20:21:10;80396801;79795121;601680;
10.01.2019;20:22:06;80396850;79795190;601660;
10.01.2019;20:23:06;80396922;79795242;601680;
10.01.2019;20:24:05;80396991;79795299;601692;
10.01.2019;20:25:05;80397041;79795363;601678;
10.01.2019;20:26:05;80397104;79795436;601668;
10.01.2019;20:36:26;80397898;79796092;601806;
10.01.2019;20:36:27;80397895;79796092;601803;
10.01.2019;20:37:08;80397966;79796126;601840;
10.01.2019;20:38:12;80398052;79796174;601878;
10.01.2019;20:39:06;80398119;79796233;601886;
10.01.2019;20:40:05;80398206;79796309;601897;
10.01.2019;20:41:06;80398275;79796363;601912;
10.01.2019;20:42:05;80398366;79796431;601935;
10.01.2019;20:43:05;80398456;79796484;601972;
10.01.2019;20:44:05;80398531;79796543;601988;
10.01.2019;20:45:05;80398631;79796617;602014;
10.01.2019;20:46:04;80398690;79796679;602011;
10.01.2019;20:47:04;80398774;79796751;602023;
10.01.2019;20:48:04;80398859;79796806;602053;
10.01.2019;20:49:05;80398939;79796876;602063;
10.01.2019;20:50:06;80399034;79796947;602087;
10.01.2019;20:51:05;80399139;79797010;602129;
10.01.2019;20:52:06;80399218;79797079;602139;
10.01.2019;20:53:05;80399315;79797139;602176;
10.01.2019;20:54:05;80399403;79797202;602201;
10.01.2019;20:55:05;80399499;79797247;602252;
10.01.2019;20:56:05;80399554;79797301;602253;
10.01.2019;20:57:05;80399627;79797369;602258;
10.01.2019;20:58:06;80399724;79797440;602284;
10.01.2019;20:59:04;80399806;79797490;602316;
10.01.2019;21:00:11;80399938;79797553;602385;
10.01.2019;21:01:07;80400045;79797601;602444;
10.01.2019;21:02:10;80400137;79797664;602473;
10.01.2019;21:03:07;80400217;79797718;602499;
10.01.2019;21:04:06;80400307;79797777;602530;
10.01.2019;21:05:06;80400397;79797831;602566;
10.01.2019;21:06:06;80400461;79797900;602561;
10.01.2019;21:07:07;80400534;79797950;602584;
10.01.2019;21:08:08;80400617;79798008;602609;
10.01.2019;21:09:14;80400716;79798062;602654;
10.01.2019;21:10:06;80400789;79798109;602680;
10.01.2019;21:11:09;80400890;79798156;602734;
10.01.2019;21:12:07;80400953;79798195;602758;
10.01.2019;21:13:08;80401037;79798239;602798;
10.01.2019;21:14:05;80401123;79798301;602822;
10.01.2019;21:15:04;80401205;79798340;602865;
10.01.2019;21:16:05;80401287;79798376;602911;
10.01.2019;21:17:06;80401375;79798423;602952;
10.01.2019;21:18:06;80401488;79798471;603017;
10.01.2019;21:19:05;80401570;79798520;603050;
10.01.2019;21:20:06;80401675;79798571;603104;
10.01.2019;21:21:06;80401744;79798633;603111;
10.01.2019;21:22:10;80401861;79798684;603177;
10.01.2019;21:23:09;80401950;79798734;603216;
10.01.2019;21:24:07;80402052;79798767;603285;
10.01.2019;21:25:07;80402121;79798831;603290;
10.01.2019;21:26:07;80402219;79798879;603340;
10.01.2019;21:27:13;80402318;79798924;603394;
10.01.2019;21:28:06;80402408;79798968;603440;
10.01.2019;21:29:11;80402482;79799021;603461;
10.01.2019;21:30:05;80402563;79799080;603483;
10.01.2019;21:31:07;80402650;79799130;603520;
10.01.2019;21:32:06;80402750;79799170;603580;
10.01.2019;21:33:17;80402829;79799228;603601;
10.01.2019;21:34:12;80402914;79799271;603643;
10.01.2019;21:35:07;80402973;79799304;603669;
10.01.2019;21:36:07;80403064;79799335;603729;
10.01.2019;21:37:06;80403160;79799376;603784;
10.01.2019;21:38:07;80403257;79799424;603833;
10.01.2019;21:39:06;80403358;79799465;603893;
10.01.2019;21:40:05;80403426;79799508;603918;
10.01.2019;21:41:04;80403516;79799547;603969;
10.01.2019;21:42:09;80403595;79799592;604003;
10.01.2019;21:43:05;80403685;79799639;604046;
10.01.2019;21:44:06;80403769;79799674;604095;
10.01.2019;21:45:05;80403841;79799721;604120;
10.01.2019;21:46:10;80403936;79799763;604173;
10.01.2019;21:47:06;80404041;79799802;604239;
10.01.2019;21:48:13;80404154;79799838;604316;
10.01.2019;21:49:05;80404209;79799884;604325;
10.01.2019;21:50:11;80404296;79799931;604365;
10.01.2019;21:51:12;80404383;79799971;604412;
10.01.2019;21:52:08;80404452;79800011;604441;
10.01.2019;21:53:06;80404553;79800046;604507;
10.01.2019;21:54:06;80404651;79800077;604574;
10.01.2019;21:55:08;80404739;79800107;604632;
10.01.2019;21:56:12;80404851;79800143;604708;
10.01.2019;21:57:11;80404944;79800172;604772;
10.01.2019;21:58:13;80404996;79800206;604790;
10.01.2019;21:59:06;80405047;79800228;604819;
10.01.2019;22:00:06;80405129;79800257;604872;
10.01.2019;22:01:07;80405172;79800238;604934;
10.01.2019;22:02:10;80405237;79800264;604973;
10.01.2019;22:03:06;80405330;79800300;605030;
10.01.2019;22:04:05;80405409;79800319;605090;
10.01.2019;22:05:07;80405484;79800345;605139;
10.01.2019;22:06:04;80405538;79800383;605155;
10.01.2019;22:07:12;80405622;79800418;605204;
10.01.2019;22:08:07;80405689;79800444;605245;
10.01.2019;22:09:06;80405779;79800483;605296;
10.01.2019;22:10:06;80405889;79800516;605373;
10.01.2019;22:11:09;80405969;79800551;605418;
10.01.2019;22:12:06;80406064;79800586;605478;
10.01.2019;22:13:06;80406158;79800619;605539;
10.01.2019;22:14:06;80406248;79800649;605599;
10.01.2019;22:15:06;80406332;79800675;605657;
10.01.2019;22:16:16;80406422;79800704;605718;
10.01.2019;22:17:07;80406500;79800729;605771;
10.01.2019;22:18:06;80406575;79800762;605813;
10.01.2019;22:19:05;80406660;79800793;605867;
10.01.2019;22:20:06;80406736;79800817;605919;
10.01.2019;22:21:07;80406815;79800855;605960;
10.01.2019;22:22:11;80406904;79800892;606012;
10.01.2019;22:23:08;80406969;79800935;606034;
10.01.2019;22:24:10;80407065;79800953;606112;
10.01.2019;22:25:08;80407152;79800980;606172;
10.01.2019;22:26:06;80407248;79800997;606251;
10.01.2019;22:27:05;80407320;79801040;606280;
10.01.2019;22:28:12;80407401;79801062;606339;
10.01.2019;22:29:04;80407468;79801101;606367;
10.01.2019;22:30:06;80407537;79801134;606403;
10.01.2019;22:31:10;80407634;79801184;606450;
10.01.2019;22:32:07;80407707;79801212;606495;
10.01.2019;22:33:06;80407773;79801246;606527;
10.01.2019;22:34:07;80407869;79801280;606589;
10.01.2019;22:35:13;80407948;79801320;606628;
10.01.2019;22:36:06;80408028;79801348;606680;
10.01.2019;22:37:06;80408126;79801383;606743;
10.01.2019;22:38:05;80408194;79801421;606773;
10.01.2019;22:39:05;80408288;79801452;606836;
10.01.2019;22:40:08;80408374;79801474;606900;
10.01.2019;22:41:07;80408454;79801499;606955;
10.01.2019;22:42:11;80408552;79801544;607008;
10.01.2019;22:43:10;80408635;79801580;607055;
10.01.2019;22:44:11;80408710;79801614;607096;
10.01.2019;22:45:11;80408800;79801634;607166;
10.01.2019;22:46:07;80408855;79801648;607207;
10.01.2019;22:47:11;80408940;79801674;607266;
10.01.2019;22:48:06;80409048;79801699;607349;
10.01.2019;22:49:05;80409141;79801727;607414;
10.01.2019;22:50:05;80409213;79801760;607453;
10.01.2019;22:51:06;80409295;79801789;607506;
10.01.2019;22:52:15;80409396;79801818;607578;
10.01.2019;22:53:07;80409473;79801841;607632;
10.01.2019;22:54:06;80409555;79801858;607697;
10.01.2019;22:55:05;80409654;79801884;607770;
10.01.2019;22:56:10;80409752;79801918;607834;
10.01.2019;22:57:08;80409848;79801932;607916;
10.01.2019;22:58:07;80409911;79801956;607955;
10.01.2019;22:59:06;80410015;79801983;608032;
10.01.2019;23:00:07;80410100;79802007;608093;
10.01.2019;23:01:07;80410174;79802030;608144;
10.01.2019;23:02:06;80410275;79802058;608217;
10.01.2019;23:03:16;80410384;79802096;608288;
10.01.2019;23:04:12;80410450;79802117;608333;
10.01.2019;23:05:11;80410520;79802140;608380;
10.01.2019;23:06:12;80410607;79802156;608451;
10.01.2019;23:07:07;80410688;79802198;608490;
10.01.2019;23:08:13;80410782;79802230;608552;
10.01.2019;23:09:10;80410841;79802240;608601;
10.01.2019;23:10:11;80410931;79802276;608655;
10.01.2019;23:11:05;80411008;79802288;608720;
10.01.2019;23:12:06;80411091;79802321;608770;
10.01.2019;23:13:05;80411191;79802357;608834;
10.01.2019;23:14:05;80411268;79802387;608881;
10.01.2019;23:15:06;80411379;79802409;608970;
10.01.2019;23:16:05;80411477;79802442;609035;
10.01.2019;23:17:10;80411582;79802468;609114;
10.01.2019;23:18:05;80411654;79802493;609161;
10.01.2019;23:19:06;80411752;79802516;609236;
10.01.2019;23:20:06;80411824;79802538;609286;
10.01.2019;23:21:05;80411911;79802544;609367;
10.01.2019;23:22:09;80411968;79802576;609392;
10.01.2019;23:23:06;80412047;79802589;609458;
10.01.2019;23:24:06;80412112;79802602;609510;
10.01.2019;23:25:09;80412183;79802629;609554;
10.01.2019;23:26:04;80412241;79802658;609583;
10.01.2019;23:27:06;80412313;79802691;609622;
10.01.2019;23:28:07;80412384;79802713;609671;
10.01.2019;23:29:05;80412485;79802727;609758;
10.01.2019;23:30:10;80412562;79802746;609816;
10.01.2019;23:31:06;80412644;79802766;609878;
10.01.2019;23:32:06;80412697;79802803;609894;
10.01.2019;23:33:07;80412786;79802828;609958;
10.01.2019;23:34:05;80412862;79802848;610014;
10.01.2019;23:35:05;80412952;79802873;610079;
10.01.2019;23:36:11;80413041;79802897;610144;
10.01.2019;23:37:11;80413132;79802929;610203;
10.01.2019;23:38:07;80413206;79802944;610262;
10.01.2019;23:39:12;80413299;79802970;610329;
10.01.2019;23:40:06;80413381;79802997;610384;
10.01.2019;23:41:05;80413460;79803022;610438;
10.01.2019;23:42:05;80413548;79803046;610502;
10.01.2019;23:43:05;80413620;79803071;610549;
10.01.2019;23:44:11;80413710;79803084;610626;
10.01.2019;23:45:12;80413785;79803108;610677;
10.01.2019;23:46:07;80413858;79803129;610729;
10.01.2019;23:47:05;80413958;79803142;610816;
10.01.2019;23:48:10;80414024;79803169;610855;
10.01.2019;23:49:06;80414101;79803191;610910;
10.01.2019;23:50:06;80414186;79803203;610983;
10.01.2019;23:51:12;80414266;79803228;611038;
10.01.2019;23:52:05;80414329;79803248;611081;
10.01.2019;23:53:05;80414400;79803273;611127;
10.01.2019;23:54:05;80414494;79803290;611204;
10.01.2019;23:55:07;80414589;79803310;611279;
10.01.2019;23:56:06;80414669;79803339;611330;
10.01.2019;23:57:06;80414749;79803360;611389;
10.01.2019;23:58:05;80414833;79803390;611443;
11.01.2019;00:00:08;80414996;79803427;611569;
11.01.2019;00:01:09;80415036;79803451;611585;
11.01.2019;00:02:07;80415082;79803474;611608;
11.01.2019;00:03:08;80415165;79803490;611675;
11.01.2019;00:04:07;80415229;79803516;611713;
11.01.2019;00:05:10;80415265;79803530;611735;
11.01.2019;00:06:12;80415324;79803544;611780;
11.01.2019;00:07:07;80415422;79803566;611856;
11.01.2019;00:08:07;80415498;79803576;611922;
11.01.2019;00:09:08;80415582;79803584;611998;
11.01.2019;00:10:08;80415652;79803599;612053;
11.01.2019;00:11:08;80415721;79803626;612095;
11.01.2019;00:12:08;80415787;79803648;612139;
11.01.2019;00:13:07;80415859;79803656;612203;
11.01.2019;00:14:08;80415949;79803669;612280;
11.01.2019;00:15:07;80416016;79803687;612329;
11.01.2019;00:16:07;80416091;79803703;612388;
11.01.2019;00:17:08;80416158;79803726;612432;
11.01.2019;00:18:09;80416227;79803744;612483;
11.01.2019;00:19:08;80416286;79803773;612513;
11.01.2019;00:20:09;80416357;79803800;612557;
11.01.2019;00:21:09;80416426;79803822;612604;
11.01.2019;00:22:08;80416505;79803840;612665;
11.01.2019;00:23:09;80416579;79803860;612719;
11.01.2019;00:24:08;80416661;79803878;612783;
11.01.2019;00:25:08;80416745;79803897;612848;
11.01.2019;00:26:09;80416809;79803924;612885;
11.01.2019;00:27:08;80416865;79803953;612912;
11.01.2019;00:28:13;80416949;79803978;612971;
11.01.2019;00:29:10;80416999;79804004;612995;
11.01.2019;00:30:08;80417096;79804039;613057;
11.01.2019;00:31:19;80417165;79804062;613103;
11.01.2019;00:32:09;80417256;79804089;613167;
11.01.2019;00:33:10;80417338;79804112;613226;
11.01.2019;00:34:08;80417415;79804139;613276;
11.01.2019;00:35:08;80417488;79804167;613321;
11.01.2019;00:36:09;80417553;79804195;613358;
11.01.2019;00:37:08;80417639;79804213;613426;
11.01.2019;00:38:09;80417724;79804234;613490;
11.01.2019;00:39:07;80417799;79804265;613534;
11.01.2019;00:40:07;80417876;79804297;613579;
11.01.2019;00:41:08;80417951;79804324;613627;
11.01.2019;00:42:09;80418027;79804343;613684;
11.01.2019;00:43:13;80418103;79804374;613729;
11.01.2019;00:44:08;80418160;79804386;613774;
11.01.2019;00:45:07;80418234;79804410;613824;
11.01.2019;00:46:10;80418323;79804427;613896;
11.01.2019;00:47:07;80418399;79804452;613947;
11.01.2019;00:48:08;80418457;79804477;613980;
11.01.2019;00:49:08;80418531;79804502;614029;
11.01.2019;00:50:09;80418628;79804530;614098;
11.01.2019;00:51:09;80418698;79804548;614150;
11.01.2019;00:52:08;80418763;79804569;614194;
11.01.2019;00:53:10;80418856;79804601;614255;
11.01.2019;00:54:09;80418916;79804625;614291;
11.01.2019;00:55:09;80418984;79804650;614334;
11.01.2019;00:56:08;80419058;79804665;614393;
11.01.2019;00:57:08;80419137;79804699;614438;
11.01.2019;00:58:07;80419222;79804733;614489;
11.01.2019;00:59:13;80419299;79804768;614531;
11.01.2019;01:00:11;80419379;79804798;614581;
11.01.2019;01:01:05;80419440;79804823;614617;
11.01.2019;01:02:05;80419472;79804818;614654;
11.01.2019;01:03:05;80419556;79804836;614720;
11.01.2019;01:04:04;80419622;79804871;614751;
11.01.2019;01:05:11;80419703;79804910;614793;
11.01.2019;01:06:06;80419768;79804933;614835;
11.01.2019;01:07:11;80419858;79804963;614895;
11.01.2019;01:08:06;80419913;79804999;614914;
11.01.2019;01:09:11;80419990;79805028;614962;
11.01.2019;01:10:05;80420049;79805052;614997;
11.01.2019;01:11:06;80420154;79805086;615068;
11.01.2019;01:12:06;80420227;79805107;615120;
11.01.2019;01:13:04;80420300;79805127;615173;
11.01.2019;01:14:04;80420388;79805162;615226;
11.01.2019;01:15:04;80420466;79805195;615271;
11.01.2019;01:16:05;80420554;79805230;615324;
11.01.2019;01:17:06;80420634;79805255;615379;
11.01.2019;01:18:05;80420716;79805278;615438;
11.01.2019;01:19:05;80420794;79805307;615487;
11.01.2019;01:20:04;80420874;79805340;615534;
11.01.2019;01:21:04;80420962;79805393;615569;
11.01.2019;01:22:05;80421041;79805417;615624;
11.01.2019;01:23:05;80421114;79805447;615667;
11.01.2019;01:24:04;80421180;79805492;615688;
11.01.2019;01:25:05;80421273;79805541;615732;
11.01.2019;01:26:05;80421359;79805579;615780;
11.01.2019;01:27:05;80421424;79805626;615798;
11.01.2019;01:28:05;80421501;79805651;615850;
11.01.2019;01:29:06;80421574;79805689;615885;
11.01.2019;01:30:05;80421641;79805731;615910;
11.01.2019;01:31:04;80421720;79805760;615960;
11.01.2019;01:32:04;80421801;79805784;616017;
11.01.2019;01:33:05;80421896;79805819;616077;
11.01.2019;01:34:05;80421973;79805847;616126;
11.01.2019;01:35:04;80422059;79805878;616181;
11.01.2019;01:36:04;80422107;79805910;616197;
11.01.2019;01:37:06;80422184;79805941;616243;
11.01.2019;01:38:05;80422255;79805984;616271;
11.01.2019;01:39:06;80422333;79806020;616313;
11.01.2019;01:40:06;80422418;79806060;616358;
11.01.2019;01:41:07;80422499;79806097;616402;
11.01.2019;01:42:05;80422564;79806143;616421;
11.01.2019;01:43:11;80422634;79806175;616459;
11.01.2019;01:44:07;80422721;79806209;616512;
11.01.2019;01:45:07;80422781;79806253;616528;
11.01.2019;01:46:07;80422839;79806296;616543;
11.01.2019;01:47:05;80422920;79806328;616592;
11.01.2019;01:48:05;80423006;79806366;616640;
11.01.2019;01:49:05;80423089;79806400;616689;
11.01.2019;01:50:05;80423162;79806447;616715;
11.01.2019;01:51:04;80423248;79806496;616752;
11.01.2019;01:52:05;80423325;79806546;616779;
11.01.2019;01:53:05;80423345;79806602;616743;
11.01.2019;01:54:04;80423450;79806645;616805;
11.01.2019;01:55:05;80423462;79806689;616773;
11.01.2019;01:56:04;80423598;79806730;616868;
11.01.2019;01:57:04;80423684;79806782;616902;
11.01.2019;01:58:05;80423753;79806842;616911;
11.01.2019;01:59:05;80423816;79806894;616922;
11.01.2019;02:00:04;80423879;79806950;616929;
11.01.2019;02:01:05;80423952;79807006;616946;
11.01.2019;02:02:05;80424015;79807048;616967;
11.01.2019;02:03:04;80424087;79807090;616997;
11.01.2019;02:04:04;80424134;79807123;617011;
11.01.2019;02:05:05;80424205;79807164;617041;
11.01.2019;02:06:04;80424287;79807206;617081;
11.01.2019;02:07:04;80424358;79807251;617107;
11.01.2019;02:08:05;80424418;79807304;617114;
11.01.2019;02:09:04;80424473;79807351;617122;
11.01.2019;02:10:04;80424522;79807395;617127;
11.01.2019;02:11:05;80424581;79807443;617138;
11.01.2019;02:12:04;80424644;79807487;617157;
11.01.2019;02:13:05;80424692;79807538;617154;
11.01.2019;02:14:04;80424738;79807591;617147;
11.01.2019;02:15:04;80424807;79807647;617160;
11.01.2019;02:16:05;80424880;79807708;617172;
11.01.2019;02:17:04;80424933;79807770;617163;
11.01.2019;02:18:04;80425016;79807828;617188;
11.01.2019;02:19:05;80425098;79807885;617213;
11.01.2019;02:20:04;80425155;79807924;617231;
11.01.2019;02:21:04;80425227;79807991;617236;
11.01.2019;02:22:04;80425310;79808054;617256;
11.01.2019;02:23:06;80425365;79808112;617253;
11.01.2019;02:24:05;80425434;79808172;617262;
11.01.2019;02:25:04;80425522;79808232;617290;
11.01.2019;02:26:06;80425598;79808306;617292;
11.01.2019;02:27:06;80425670;79808389;617281;
11.01.2019;02:28:04;80425755;79808449;617306;
11.01.2019;02:29:05;80425835;79808525;617310;
11.01.2019;02:30:04;80425917;79808596;617321;
11.01.2019;02:31:04;80426000;79808652;617348;
11.01.2019;02:32:05;80426060;79808701;617359;
11.01.2019;02:33:04;80426124;79808771;617353;
11.01.2019;02:34:04;80426184;79808840;617344;
11.01.2019;02:35:05;80426247;79808906;617341;
11.01.2019;02:36:05;80426339;79808987;617352;
11.01.2019;02:37:05;80426431;79809064;617367;
11.01.2019;02:38:05;80426522;79809142;617380;
11.01.2019;02:39:06;80426595;79809204;617391;
11.01.2019;02:40:04;80426665;79809296;617369;
11.01.2019;02:41:04;80426737;79809378;617359;
11.01.2019;02:42:06;80426818;79809454;617364;
11.01.2019;02:43:05;80426891;79809527;617364;
11.01.2019;02:44:06;80426956;79809602;617354;
11.01.2019;02:45:05;80427030;79809670;617360;
11.01.2019;02:46:05;80427107;79809743;617364;
11.01.2019;02:47:04;80427174;79809821;617353;
11.01.2019;02:48:05;80427258;79809882;617376;
11.01.2019;02:49:04;80427343;79809949;617394;
11.01.2019;02:50:05;80427403;79810018;617385;
11.01.2019;02:51:04;80427467;79810103;617364;
11.01.2019;02:52:05;80427551;79810170;617381;
11.01.2019;02:53:04;80427628;79810232;617396;
11.01.2019;02:54:04;80427719;79810308;617411;
11.01.2019;02:55:05;80427815;79810382;617433;
11.01.2019;02:56:04;80427914;79810480;617434;
11.01.2019;02:57:04;80427976;79810571;617405;
11.01.2019;02:58:05;80428065;79810650;617415;
11.01.2019;02:59:04;80428154;79810736;617418;
11.01.2019;03:00:04;80428204;79810829;617375;
11.01.2019;03:01:05;80428273;79810926;617347;
11.01.2019;03:02:05;80428351;79811013;617338;
11.01.2019;03:03:04;80428403;79811111;617292;
11.01.2019;03:04:05;80428486;79811186;617300;
11.01.2019;03:05:05;80428553;79811273;617280;
11.01.2019;03:06:04;80428627;79811363;617264;
11.01.2019;03:07:04;80428702;79811441;617261;
11.01.2019;03:08:05;80428798;79811518;617280;
11.01.2019;03:09:04;80428884;79811606;617278;
11.01.2019;03:10:04;80428965;79811690;617275;
11.01.2019;03:11:05;80429046;79811780;617266;
11.01.2019;03:12:04;80429115;79811876;617239;
11.01.2019;03:13:04;80429191;79811954;617237;
11.01.2019;03:14:07;80429257;79812061;617196;
11.01.2019;03:15:05;80429342;79812150;617192;
11.01.2019;03:16:04;80429431;79812228;617203;
11.01.2019;03:17:04;80429490;79812310;617180;
11.01.2019;03:18:04;80429568;79812389;617179;
11.01.2019;03:19:05;80429645;79812506;617139;
11.01.2019;03:20:04;80429729;79812607;617122;
11.01.2019;03:21:04;80429797;79812696;617101;
11.01.2019;03:22:06;80429861;79812793;617068;
11.01.2019;03:23:05;80429951;79812870;617081;
11.01.2019;03:24:04;80430017;79812986;617031;
11.01.2019;03:25:04;80430089;79813106;616983;
11.01.2019;03:26:05;80430173;79813218;616955;
11.01.2019;03:27:04;80430244;79813352;616892;
11.01.2019;03:28:04;80430311;79813476;616835;
11.01.2019;03:29:05;80430391;79813577;616814;
11.01.2019;03:30:04;80430492;79813677;616815;
11.01.2019;03:31:04;80430569;79813771;616798;
11.01.2019;03:32:05;80430654;79813887;616767;
11.01.2019;03:33:06;80430742;79814003;616739;
11.01.2019;03:34:04;80430825;79814099;616726;
11.01.2019;03:35:04;80430892;79814188;616704;
11.01.2019;03:36:05;80430972;79814269;616703;
11.01.2019;03:37:04;80431043;79814365;616678;
11.01.2019;03:38:04;80431130;79814495;616635;
11.01.2019;03:39:05;80431207;79814594;616613;
11.01.2019;03:40:04;80431279;79814712;616567;
11.01.2019;03:41:04;80431352;79814818;616534;
11.01.2019;03:42:05;80431436;79814911;616525;
11.01.2019;03:43:05;80431505;79815006;616499;
11.01.2019;03:44:04;80431588;79815115;616473;
11.01.2019;03:45:06;80431654;79815228;616426;
11.01.2019;03:46:05;80431727;79815328;616399;
11.01.2019;03:47:04;80431797;79815447;616350;
11.01.2019;03:48:04;80431872;79815548;616324;
11.01.2019;03:49:05;80431954;79815668;616286;
11.01.2019;03:50:04;80432020;79815764;616256;
11.01.2019;03:51:04;80432076;79815890;616186;
11.01.2019;03:52:05;80432144;79816019;616125;
11.01.2019;03:53:04;80432217;79816133;616084;
11.01.2019;03:54:05;80432298;79816232;616066;
11.01.2019;03:55:04;80432376;79816346;616030;
11.01.2019;03:56:04;80432442;79816463;615979;
11.01.2019;03:57:05;80432523;79816561;615962;
11.01.2019;03:58:05;80432604;79816683;615921;
11.01.2019;03:59:04;80432669;79816779;615890;
11.01.2019;04:00:04;80432740;79816877;615863;
11.01.2019;04:01:05;80432833;79816994;615839;
11.01.2019;04:02:04;80432903;79817087;615816;
11.01.2019;04:03:05;80432908;79817170;615738;
11.01.2019;04:04:05;80432984;79817307;615677;
11.01.2019;04:05:04;80433060;79817429;615631;
11.01.2019;04:06:04;80433132;79817534;615598;
11.01.2019;04:07:05;80433208;79817672;615536;
11.01.2019;04:08:04;80433270;79817790;615480;
11.01.2019;04:09:04;80433351;79817907;615444;
11.01.2019;04:10:05;80433432;79818042;615390;
11.01.2019;04:11:04;80433496;79818146;615350;
11.01.2019;04:12:04;80433549;79818232;615317;
11.01.2019;04:13:05;80433615;79818349;615266;
11.01.2019;04:14:04;80433689;79818459;615230;
11.01.2019;04:15:04;80433776;79818581;615195;
11.01.2019;04:16:05;80433841;79818682;615159;
11.01.2019;04:17:04;80433900;79818792;615108;
11.01.2019;04:18:04;80433949;79818881;615068;
11.01.2019;04:19:05;80434015;79818980;615035;
11.01.2019;04:20:04;80434064;79819089;614975;
11.01.2019;04:21:05;80434133;79819187;614946;
11.01.2019;04:22:04;80434209;79819297;614912;
11.01.2019;04:23:04;80434303;79819423;614880;
11.01.2019;04:24:05;80434384;79819519;614865;
11.01.2019;04:25:04;80434460;79819610;614850;
11.01.2019;04:26:04;80434528;79819712;614816;
11.01.2019;04:27:05;80434602;79819844;614758;
11.01.2019;04:28:05;80434667;79819961;614706;
11.01.2019;04:29:04;80434743;79820066;614677;
11.01.2019;04:30:04;80434821;79820195;614626;
11.01.2019;04:31:05;80434878;79820331;614547;
11.01.2019;04:32:04;80434945;79820455;614490;
11.01.2019;04:33:04;80435000;79820573;614427;
11.01.2019;04:34:05;80435054;79820714;614340;
11.01.2019;04:35:04;80435130;79820820;614310;
11.01.2019;04:36:04;80435207;79820937;614270;
11.01.2019;04:37:05;80435289;79821045;614244;
11.01.2019;04:38:04;80435362;79821183;614179;
11.01.2019;04:39:04;80435424;79821311;614113;
11.01.2019;04:40:05;80435494;79821410;614084;
11.01.2019;04:41:05;80435563;79821539;614024;
11.01.2019;04:42:04;80435627;79821674;613953;
11.01.2019;04:43:05;80435701;79821807;613894;
11.01.2019;04:44:06;80435776;79821930;613846;
11.01.2019;04:45:04;80435845;79822050;613795;
11.01.2019;04:46:04;80435906;79822194;613712;
11.01.2019;04:47:04;80435963;79822298;613665;
11.01.2019;04:48:05;80436035;79822436;613599;
11.01.2019;04:49:05;80436100;79822565;613535;
11.01.2019;04:50:04;80436169;79822678;613491;
11.01.2019;04:51:05;80436243;79822809;613434;
11.01.2019;04:52:04;80436308;79822948;613360;
11.01.2019;04:53:04;80436354;79823063;613291;
11.01.2019;04:54:05;80436417;79823169;613248;
11.01.2019;04:55:04;80436508;79823277;613231;
11.01.2019;04:56:04;80436568;79823395;613173;
11.01.2019;04:57:05;80436621;79823508;613113;
11.01.2019;04:58:05;80436700;79823627;613073;
11.01.2019;04:59:04;80436779;79823731;613048;
11.01.2019;05:00:05;80436849;79823840;613009;
11.01.2019;05:01:05;80436938;79823984;612954;
11.01.2019;05:02:04;80437024;79824093;612931;
11.01.2019;05:03:05;80437102;79824219;612883;
11.01.2019;05:04:04;80437172;79824346;612826;
11.01.2019;05:05:04;80437253;79824479;612774;
11.01.2019;05:06:05;80437307;79824609;612698;
11.01.2019;05:07:04;80437374;79824744;612630;
11.01.2019;05:08:04;80437446;79824863;612583;
11.01.2019;05:09:05;80437516;79824990;612526;
11.01.2019;05:10:05;80437578;79825104;612474;
11.01.2019;05:11:04;80437655;79825225;612430;
11.01.2019;05:12:05;80437725;79825351;612374;
11.01.2019;05:13:05;80437786;79825445;612341;
11.01.2019;05:14:04;80437850;79825555;612295;
11.01.2019;05:15:04;80437899;79825661;612238;
11.01.2019;05:16:05;80437979;79825802;612177;
11.01.2019;05:17:04;80438054;79825949;612105;
11.01.2019;05:18:04;80438135;79826076;612059;
11.01.2019;05:19:05;80438199;79826209;611990;
11.01.2019;05:20:04;80438278;79826326;611952;
11.01.2019;05:21:04;80438347;79826443;611904;
11.01.2019;05:22:05;80438406;79826551;611855;
11.01.2019;05:23:04;80438469;79826679;611790;
11.01.2019;05:24:05;80438523;79826814;611709;
11.01.2019;05:25:05;80438590;79826922;611668;
11.01.2019;05:26:04;80438631;79827029;611602;
11.01.2019;05:27:05;80438697;79827149;611548;
11.01.2019;05:28:04;80438766;79827265;611501;
11.01.2019;05:29:04;80438826;79827377;611449;
11.01.2019;05:30:05;80438908;79827506;611402;
11.01.2019;05:31:04;80438964;79827619;611345;
11.01.2019;05:32:04;80439037;79827761;611276;
11.01.2019;05:33:04;80439110;79827875;611235;
11.01.2019;05:34:05;80439165;79828001;611164;
11.01.2019;05:35:04;80439227;79828124;611103;
11.01.2019;05:36:05;80439286;79828261;611025;
11.01.2019;05:37:05;80439341;79828389;610952;
11.01.2019;05:38:04;80439404;79828527;610877;
11.01.2019;05:39:05;80439471;79828658;610813;
11.01.2019;05:40:05;80439544;79828755;610789;
11.01.2019;05:41:04;80439611;79828903;610708;
11.01.2019;05:42:04;80439691;79829035;610656;
11.01.2019;05:43:05;80439762;79829135;610627;
11.01.2019;05:44:04;80439828;79829270;610558;
11.01.2019;05:45:05;80439883;79829403;610480;
11.01.2019;05:46:04;80439944;79829536;610408;
11.01.2019;05:47:04;80440006;79829663;610343;
11.01.2019;05:48:05;80440083;79829782;610301;
11.01.2019;05:49:04;80440163;79829904;610259;
11.01.2019;05:50:04;80440214;79830043;610171;
11.01.2019;05:51:05;80440273;79830171;610102;
11.01.2019;05:52:04;80440334;79830280;610054;
11.01.2019;05:53:05;80440390;79830404;609986;
11.01.2019;05:54:05;80440445;79830534;609911;
11.01.2019;05:55:04;80440503;79830631;609872;
11.01.2019;05:56:04;80440568;79830753;609815;
11.01.2019;05:57:05;80440633;79830889;609744;
11.01.2019;05:58:04;80440697;79831027;609670;
11.01.2019;05:59:05;80440765;79831170;609595;
11.01.2019;06:00:05;80440818;79831290;609528;
11.01.2019;06:01:04;80440880;79831412;609468;
11.01.2019;06:02:05;80440937;79831542;609395;
11.01.2019;06:03:04;80440989;79831660;609329;
11.01.2019;06:04:04;80441049;79831774;609275;
11.01.2019;06:05:04;80441125;79831902;609223;
11.01.2019;06:06:04;80441172;79832038;609134;
11.01.2019;06:07:05;80441234;79832156;609078;
11.01.2019;06:08:04;80441306;79832257;609049;
11.01.2019;06:09:05;80441370;79832369;609001;
11.01.2019;06:10:05;80441428;79832471;608957;
11.01.2019;06:11:05;80441491;79832579;608912;
11.01.2019;06:12:04;80441538;79832667;608871;
11.01.2019;06:13:05;80441587;79832766;608821;
11.01.2019;06:14:04;80441634;79832875;608759;
11.01.2019;06:15:04;80441676;79832986;608690;
11.01.2019;06:16:05;80441725;79833090;608635;
11.01.2019;06:17:04;80441775;79833193;608582;
11.01.2019;06:18:04;80441837;79833300;608537;
11.01.2019;06:19:05;80441901;79833408;608493;
11.01.2019;06:20:04;80441963;79833530;608433;
11.01.2019;06:21:05;80442032;79833659;608373;
11.01.2019;06:22:04;80442093;79833751;608342;
11.01.2019;06:23:04;80442149;79833831;608318;
11.01.2019;06:24:05;80442211;79833961;608250;
11.01.2019;06:25:07;80442293;79834103;608190;
11.01.2019;06:26:04;80442351;79834211;608140;
11.01.2019;06:27:05;80442408;79834332;608076;
11.01.2019;06:28:04;80442474;79834447;608027;
11.01.2019;06:29:05;80442520;79834558;607962;
11.01.2019;06:30:04;80442584;79834682;607902;
11.01.2019;06:31:04;80442650;79834811;607839;
11.01.2019;06:32:05;80442713;79834927;607786;
11.01.2019;06:33:06;80442787;79835029;607758;
11.01.2019;06:34:04;80442840;79835144;607696;
11.01.2019;06:35:05;80442909;79835265;607644;
11.01.2019;06:36:04;80442975;79835417;607558;
11.01.2019;06:37:04;80443028;79835556;607472;
11.01.2019;06:38:05;80443086;79835676;607410;
11.01.2019;06:39:04;80443147;79835819;607328;
11.01.2019;06:40:04;80443212;79835955;607257;
11.01.2019;06:41:05;80443283;79836063;607220;
11.01.2019;06:42:04;80443341;79836198;607143;
11.01.2019;06:43:04;80443401;79836330;607071;
11.01.2019;06:44:05;80443463;79836484;606979;
11.01.2019;06:45:04;80443545;79836603;606942;
11.01.2019;06:46:04;80443603;79836754;606849;
11.01.2019;06:47:05;80443641;79836884;606757;
11.01.2019;06:48:04;80443702;79836990;606712;
11.01.2019;06:49:05;80443755;79837105;606650;
11.01.2019;06:50:04;80443814;79837243;606571;
11.01.2019;06:51:04;80443891;79837377;606514;
11.01.2019;06:52:05;80443962;79837521;606441;
11.01.2019;06:53:04;80444010;79837649;606361;
11.01.2019;06:54:04;80444062;79837774;606288;
11.01.2019;06:55:05;80444126;79837882;606244;
11.01.2019;06:56:04;80444137;79837982;606155;
11.01.2019;06:57:04;80444194;79838100;606094;
11.01.2019;06:58:05;80444260;79838227;606033;
11.01.2019;06:59:04;80444309;79838345;605964;
11.01.2019;07:00:04;80444366;79838476;605890;
11.01.2019;07:01:05;80444422;79838601;605821;
11.01.2019;07:02:04;80444481;79838738;605743;
11.01.2019;07:03:05;80444533;79838864;605669;
11.01.2019;07:04:04;80444591;79838968;605623;
11.01.2019;07:05:05;80444646;79839086;605560;
11.01.2019;07:06:05;80444687;79839192;605495;
11.01.2019;07:07:04;80444748;79839302;605446;
11.01.2019;07:08:05;80444810;79839410;605400;
11.01.2019;07:09:05;80444877;79839525;605352;
11.01.2019;07:10:04;80444934;79839646;605288;
11.01.2019;07:11:04;80444979;79839773;605206;
11.01.2019;07:12:04;80445023;79839903;605120;
11.01.2019;07:13:04;80445074;79840024;605050;
11.01.2019;07:14:05;80445114;79840142;604972;
11.01.2019;07:15:04;80445168;79840259;604909;
11.01.2019;07:16:04;80445222;79840418;604804;
11.01.2019;07:17:05;80445269;79840537;604732;
11.01.2019;07:18:04;80445323;79840659;604664;
11.01.2019;07:19:04;80445367;79840790;604577;
11.01.2019;07:20:05;80445407;79840920;604487;
11.01.2019;07:21:04;80445461;79841043;604418;
11.01.2019;07:22:04;80445523;79841195;604328;
11.01.2019;07:23:05;80445552;79841307;604245;
11.01.2019;07:24:04;80445599;79841420;604179;
11.01.2019;07:25:04;80445642;79841530;604112;
11.01.2019;07:26:05;80445680;79841662;604018;
11.01.2019;07:27:04;80445721;79841788;603933;
11.01.2019;07:28:04;80445778;79841927;603851;
11.01.2019;07:29:05;80445833;79842065;603768;
11.01.2019;07:30:04;80445893;79842182;603711;
11.01.2019;07:31:04;80445940;79842310;603630;
11.01.2019;07:32:05;80445991;79842440;603551;
11.01.2019;07:33:04;80446041;79842553;603488;
11.01.2019;07:34:05;80446090;79842670;603420;
11.01.2019;07:35:05;80446155;79842782;603373;
11.01.2019;07:36:04;80446222;79842881;603341;
11.01.2019;07:37:05;80446284;79843003;603281;
11.01.2019;07:38:04;80446336;79843108;603228;
11.01.2019;07:39:04;80446383;79843242;603141;
11.01.2019;07:40:04;80446437;79843364;603073;
11.01.2019;07:41:05;80446490;79843489;603001;
11.01.2019;07:42:04;80446546;79843617;602929;
11.01.2019;07:43:04;80446587;79843725;602862;
11.01.2019;07:44:05;80446644;79843882;602762;
11.01.2019;07:45:04;80446694;79843982;602712;
11.01.2019;07:46:04;80446759;79844128;602631;
11.01.2019;07:47:05;80446808;79844235;602573;
11.01.2019;07:48:04;80446852;79844382;602470;
11.01.2019;07:49:04;80446897;79844491;602406;
11.01.2019;07:50:05;80446953;79844621;602332;
11.01.2019;07:51:04;80446992;79844732;602260;
11.01.2019;07:52:04;80447027;79844862;602165;
11.01.2019;07:53:05;80447078;79844974;602104;
11.01.2019;07:54:04;80447132;79845111;602021;
11.01.2019;07:55:04;80447174;79845193;601981;
11.01.2019;07:56:05;80447236;79845324;601912;
11.01.2019;07:57:04;80447276;79845455;601821;
11.01.2019;07:58:04;80447328;79845594;601734;
11.01.2019;07:59:05;80447384;79845697;601687;
11.01.2019;08:00:04;80447452;79845807;601645;
11.01.2019;08:01:04;80447501;79845938;601563;
11.01.2019;08:02:05;80447559;79846070;601489;
11.01.2019;08:03:05;80447609;79846186;601423;
11.01.2019;08:04:04;80447655;79846307;601348;
11.01.2019;08:05:05;80447710;79846438;601272;
11.01.2019;08:06:04;80447760;79846553;601207;
11.01.2019;08:07:04;80447807;79846645;601162;
11.01.2019;08:08:05;80447836;79846755;601081;
11.01.2019;08:09:04;80447863;79846867;600996;
11.01.2019;08:10:04;80447900;79846965;600935;
11.01.2019;08:11:05;80447935;79847056;600879;
11.01.2019;08:12:05;80447980;79847166;600814;
11.01.2019;08:13:04;80448040;79847259;600781;
11.01.2019;08:14:05;80448092;79847354;600738;
11.01.2019;08:15:04;80448133;79847486;600647;
11.01.2019;08:16:04;80448161;79847578;600583;
11.01.2019;08:17:05;80448195;79847688;600507;
11.01.2019;08:18:05;80448222;79847795;600427;
11.01.2019;08:19:04;80448265;79847913;600352;
11.01.2019;08:20:04;80448306;79848031;600275;
11.01.2019;08:21:05;80448365;79848146;600219;
11.01.2019;08:22:04;80448397;79848281;600116;
11.01.2019;08:23:04;80448449;79848375;600074;
11.01.2019;08:24:05;80448494;79848509;599985;
11.01.2019;08:25:04;80448539;79848633;599906;
11.01.2019;08:26:04;80448583;79848755;599828;
11.01.2019;08:27:05;80448632;79848861;599771;
11.01.2019;08:28:04;80448673;79848974;599699;
11.01.2019;08:29:04;80448726;79849101;599625;
11.01.2019;08:30:05;80448774;79849229;599545;
11.01.2019;08:31:04;80448832;79849335;599497;
11.01.2019;08:32:05;80448880;79849437;599443;
11.01.2019;08:33:05;80448922;79849571;599351;
11.01.2019;08:34:05;80448978;79849724;599254;
11.01.2019;08:35:05;80449022;79849832;599190;
11.01.2019;08:36:04;80449063;79849960;599103;
11.01.2019;08:37:05;80449108;79850098;599010;
11.01.2019;08:38:05;80449173;79850226;598947;
11.01.2019;08:39:04;80449228;79850337;598891;
11.01.2019;08:40:04;80449287;79850467;598820;
11.01.2019;08:41:05;80449351;79850615;598736;
11.01.2019;08:42:04;80449391;79850731;598660;
11.01.2019;08:43:05;80449422;79850873;598549;
11.01.2019;08:44:04;80449463;79850999;598464;
11.01.2019;08:45:04;80449516;79851130;598386;
11.01.2019;08:46:13;80449569;79851288;598281;
11.01.2019;08:47:05;80449609;79851400;598209;
11.01.2019;08:48:04;80449644;79851511;598133;
11.01.2019;08:49:04;80449704;79851664;598040;
11.01.2019;08:50:04;80449759;79851776;597983;
11.01.2019;08:51:04;80449804;79851909;597895;
11.01.2019;08:52:05;80449853;79852023;597830;
11.01.2019;08:53:05;80449898;79852164;597734;
11.01.2019;08:54:10;80449944;79852298;597646;
11.01.2019;08:55:05;80450008;79852422;597586;
11.01.2019;08:56:04;80450051;79852543;597508;
11.01.2019;08:57:05;80450084;79852666;597418;
11.01.2019;08:58:05;80450140;79852798;597342;
11.01.2019;08:59:04;80450190;79852940;597250;
11.01.2019;09:00:04;80450237;79853064;597173;
11.01.2019;09:01:05;80450267;79853181;597086;
11.01.2019;09:02:04;80450318;79853338;596980;
11.01.2019;09:03:04;80450368;79853454;596914;
11.01.2019;09:04:05;80450428;79853604;596824;
11.01.2019;09:05:04;80450475;79853737;596738;
11.01.2019;09:06:04;80450520;79853864;596656;
11.01.2019;09:07:05;80450577;79854007;596570;
11.01.2019;09:08:04;80450617;79854112;596505;
11.01.2019;09:09:04;80450660;79854276;596384;
11.01.2019;09:10:05;80450715;79854381;596334;
11.01.2019;09:11:04;80450758;79854519;596239;
11.01.2019;09:12:04;80450793;79854656;596137;
11.01.2019;09:13:05;80450854;79854767;596087;
11.01.2019;09:14:04;80450891;79854905;595986;
11.01.2019;09:15:04;80450942;79855010;595932;
11.01.2019;09:16:05;80450995;79855139;595856;
11.01.2019;09:17:04;80451053;79855236;595817;
11.01.2019;09:18:04;80451107;79855351;595756;
11.01.2019;09:19:05;80451147;79855474;595673;
11.01.2019;09:20:04;80451194;79855606;595588;
11.01.2019;09:21:04;80451235;79855749;595486;
11.01.2019;09:22:05;80451292;79855851;595441;
11.01.2019;09:23:04;80451352;79855993;595359;
11.01.2019;09:24:04;80451402;79856114;595288;
11.01.2019;09:25:05;80451454;79856258;595196;
11.01.2019;09:26:05;80451510;79856393;595117;
11.01.2019;09:27:05;80451550;79856531;595019;
11.01.2019;09:28:04;80451600;79856651;594949;
11.01.2019;09:29:05;80451642;79856782;594860;
11.01.2019;09:30:04;80451688;79856911;594777;
11.01.2019;09:31:04;80451729;79857036;594693;
11.01.2019;09:32:05;80451779;79857180;594599;
11.01.2019;09:33:04;80451817;79857321;594496;
11.01.2019;09:34:04;80451862;79857417;594445;
11.01.2019;09:35:05;80451908;79857554;594354;
11.01.2019;09:36:06;80451952;79857692;594260;
11.01.2019;09:37:04;80451991;79857801;594190;
11.01.2019;09:38:04;80452025;79857947;594078;
11.01.2019;09:39:05;80452071;79858066;594005;
11.01.2019;09:40:05;80452120;79858208;593912;
11.01.2019;09:41:05;80452168;79858334;593834;
11.01.2019;09:42:04;80452200;79858483;593717;
11.01.2019;09:43:05;80452249;79858629;593620;
11.01.2019;09:44:06;80452286;79858767;593519;
11.01.2019;09:45:05;80452324;79858911;593413;
11.01.2019;09:46:04;80452366;79859039;593327;
11.01.2019;09:47:04;80452406;79859168;593238;
11.01.2019;09:48:05;80452450;79859305;593145;
11.01.2019;09:49:04;80452502;79859429;593073;
11.01.2019;09:50:05;80452560;79859565;592995;
11.01.2019;09:51:04;80452588;79859676;592912;
11.01.2019;09:52:04;80452622;79859812;592810;
11.01.2019;09:53:05;80452676;79859955;592721;
11.01.2019;09:54:05;80452721;79860084;592637;
11.01.2019;09:55:04;80452774;79860241;592533;
11.01.2019;09:56:05;80452824;79860380;592444;
11.01.2019;09:57:04;80452858;79860503;592355;
11.01.2019;09:58:04;80452909;79860632;592277;
11.01.2019;09:59:10;80452944;79860799;592145;
11.01.2019;10:00:04;80452994;79860909;592085;
11.01.2019;10:01:05;80453028;79861055;591973;
11.01.2019;10:02:04;80453072;79861178;591894;
11.01.2019;10:03:04;80453121;79861301;591820;
11.01.2019;10:04:05;80453181;79861415;591766;
11.01.2019;10:05:04;80453215;79861540;591675;
11.01.2019;10:06:04;80453252;79861670;591582;
11.01.2019;10:07:05;80453307;79861784;591523;
11.01.2019;10:08:04;80453350;79861916;591434;
11.01.2019;10:09:05;80453397;79862040;591357;
11.01.2019;10:10:05;80453438;79862170;591268;
11.01.2019;10:11:04;80453483;79862307;591176;
11.01.2019;10:12:05;80453504;79862438;591066;
11.01.2019;10:13:05;80453525;79862558;590967;
11.01.2019;10:14:04;80453542;79862700;590842;
11.01.2019;10:15:05;80453586;79862825;590761;
11.01.2019;10:16:05;80453617;79862958;590659;
11.01.2019;10:17:05;80453630;79863066;590564;
11.01.2019;10:18:04;80453655;79863205;590450;
11.01.2019;10:19:05;80453683;79863354;590329;
11.01.2019;10:20:05;80453738;79863478;590260;
11.01.2019;10:21:05;80453784;79863612;590172;
11.01.2019;10:22:04;80453820;79863726;590094;
11.01.2019;10:23:05;80453868;79863855;590013;
11.01.2019;10:24:05;80453898;79863987;589911;
11.01.2019;10:25:04;80453946;79864132;589814;
11.01.2019;10:26:04;80453986;79864265;589721;
11.01.2019;10:27:05;80454021;79864415;589606;
11.01.2019;10:28:04;80454060;79864554;589506;
11.01.2019;10:29:04;80454112;79864669;589443;
11.01.2019;10:30:05;80454152;79864840;589312;
11.01.2019;10:31:04;80454193;79864975;589218;
11.01.2019;10:32:04;80454225;79865102;589123;
11.01.2019;10:33:06;80454270;79865186;589084;
11.01.2019;10:34:06;80454301;79865358;588943;
11.01.2019;10:35:05;80454343;79865478;588865;
11.01.2019;10:36:04;80454400;79865626;588774;
11.01.2019;10:37:05;80454435;79865778;588657;
11.01.2019;10:38:06;80454485;79865932;588553;
11.01.2019;10:39:06;80454543;79866063;588480;
11.01.2019;10:40:04;80454602;79866171;588431;
11.01.2019;10:41:05;80454641;79866296;588345;
11.01.2019;10:42:04;80454676;79866448;588228;
11.01.2019;10:43:04;80454722;79866563;588159;
11.01.2019;10:44:06;80454771;79866701;588070;
11.01.2019;10:45:04;80454808;79866850;587958;
11.01.2019;10:46:04;80454849;79866978;587871;
11.01.2019;10:47:05;80454902;79867131;587771;
11.01.2019;10:48:05;80454965;79867267;587698;
11.01.2019;10:49:04;80455009;79867405;587604;
11.01.2019;10:50:04;80455056;79867537;587519;
11.01.2019;10:51:05;80455103;79867682;587421;
11.01.2019;10:52:05;80455166;79867822;587344;
11.01.2019;10:53:05;80455215;79867958;587257;
11.01.2019;10:54:05;80455258;79868078;587180;
11.01.2019;10:55:06;80455297;79868230;587067;
11.01.2019;10:56:06;80455339;79868372;586967;
11.01.2019;10:57:05;80455381;79868489;586892;
11.01.2019;10:58:05;80455436;79868630;586806;
11.01.2019;10:59:05;80455486;79868787;586699;
11.01.2019;11:00:04;80455537;79868915;586622;
11.01.2019;11:01:07;80455590;79869035;586555;
11.01.2019;11:02:07;80455639;79869212;586427;
11.01.2019;11:03:06;80455685;79869331;586354;
11.01.2019;11:04:06;80455734;79869451;586283;
11.01.2019;11:05:06;80455781;79869594;586187;
11.01.2019;11:06:06;80455826;79869729;586097;
11.01.2019;11:07:05;80455864;79869863;586001;
11.01.2019;11:08:05;80455903;79870000;585903;
11.01.2019;11:09:05;80455964;79870169;585795;
11.01.2019;11:10:05;80456010;79870338;585672;
11.01.2019;11:11:05;80456072;79870492;585580;
11.01.2019;11:12:04;80456126;79870637;585489;
11.01.2019;11:13:05;80456179;79870778;585401;
11.01.2019;11:14:05;80456238;79870930;585308;
11.01.2019;11:15:05;80456274;79871082;585192;
11.01.2019;11:16:05;80456312;79871234;585078;
11.01.2019;11:17:04;80456368;79871368;585000;
11.01.2019;11:18:04;80456411;79871512;584899;
11.01.2019;11:19:04;80456453;79871634;584819;
11.01.2019;11:20:06;80456492;79871784;584708;
11.01.2019;11:21:06;80456544;79871929;584615;
11.01.2019;11:23:05;80456635;79872232;584403;
11.01.2019;11:24:05;80456676;79872361;584315;
11.01.2019;11:25:05;80456719;79872503;584216;
11.01.2019;11:26:04;80456753;79872640;584113;
11.01.2019;11:27:05;80456806;79872780;584026;
11.01.2019;11:28:05;80456841;79872920;583921;
11.01.2019;11:29:04;80456877;79873066;583811;
11.01.2019;11:30:04;80456916;79873195;583721;
11.01.2019;11:31:05;80456973;79873348;583625;
11.01.2019;11:32:06;80457020;79873482;583538;
11.01.2019;11:33:04;80457082;79873617;583465;
11.01.2019;11:34:06;80457126;79873760;583366;
11.01.2019;11:35:06;80457172;79873898;583274;
11.01.2019;11:36:06;80457212;79874059;583153;
11.01.2019;11:37:06;80457259;79874203;583056;
11.01.2019;11:38:09;80457299;79874370;582929;
11.01.2019;11:39:06;80457332;79874528;582804;
11.01.2019;11:40:06;80457387;79874669;582718;
11.01.2019;11:41:07;80457442;79874820;582622;
11.01.2019;11:42:06;80457479;79874948;582531;
11.01.2019;11:43:06;80457533;79875079;582454;
11.01.2019;11:44:04;80457581;79875178;582403;
11.01.2019;11:45:10;80457636;79875343;582293;
11.01.2019;11:46:05;80457667;79875474;582193;
11.01.2019;11:47:04;80457713;79875614;582099;
11.01.2019;11:48:04;80457754;79875711;582043;
11.01.2019;11:49:04;80457799;79875831;581968;
11.01.2019;11:50:04;80457837;79875992;581845;
11.01.2019;11:51:05;80457867;79876109;581758;
11.01.2019;11:52:05;80457936;79876254;581682;
11.01.2019;11:53:04;80457974;79876401;581573;
11.01.2019;11:54:04;80458020;79876546;581474;
11.01.2019;11:55:04;80458082;79876679;581403;
11.01.2019;11:56:05;80458138;79876826;581312;
11.01.2019;11:57:04;80458176;79876966;581210;
11.01.2019;11:58:04;80458225;79877106;581119;
11.01.2019;11:59:04;80458267;79877237;581030;
11.01.2019;12:00:05;80458307;79877378;580929;
11.01.2019;12:01:05;80458345;79877523;580822;
11.01.2019;12:02:05;80458383;79877656;580727;
11.01.2019;12:03:04;80458426;79877794;580632;
11.01.2019;12:04:04;80458492;79877934;580558;
11.01.2019;12:05:05;80458552;79878064;580488;
11.01.2019;12:06:05;80458613;79878199;580414;
11.01.2019;12:07:04;80458640;79878313;580327;
11.01.2019;12:08:04;80458702;79878447;580255;
11.01.2019;12:09:05;80458745;79878592;580153;
11.01.2019;12:10:05;80458772;79878689;580083;
11.01.2019;12:11:05;80458782;79878760;580022;
11.01.2019;12:12:04;80458786;79878848;579938;
11.01.2019;12:13:05;80458802;79878973;579829;
11.01.2019;12:14:05;80458858;79879108;579750;
11.01.2019;12:15:04;80458900;79879222;579678;
11.01.2019;12:16:04;80458946;79879343;579603;
11.01.2019;12:17:05;80458985;79879496;579489;
11.01.2019;12:18:05;80459048;79879631;579417;
11.01.2019;12:19:04;80459101;79879753;579348;
11.01.2019;12:20:04;80459154;79879896;579258;
11.01.2019;12:21:04;80459192;79880042;579150;
11.01.2019;12:22:05;80459246;79880172;579074;
11.01.2019;12:23:05;80459302;79880297;579005;
11.01.2019;12:24:05;80459355;79880446;578909;
11.01.2019;12:25:06;80459399;79880576;578823;
11.01.2019;12:26:10;80459447;79880697;578750;
11.01.2019;12:27:07;80459479;79880837;578642;
11.01.2019;12:28:05;80459526;79880966;578560;
11.01.2019;12:29:06;80459582;79881117;578465;
11.01.2019;12:30:06;80459637;79881260;578377;
11.01.2019;12:31:10;80459679;79881409;578270;
11.01.2019;12:32:06;80459716;79881544;578172;
11.01.2019;12:33:05;80459765;79881695;578070;
11.01.2019;12:34:11;80459826;79881846;577980;
11.01.2019;12:35:05;80459888;79881969;577919;
11.01.2019;12:36:04;80459960;79882087;577873;
11.01.2019;12:37:05;80460009;79882195;577814;
11.01.2019;12:38:05;80460067;79882302;577765;
11.01.2019;12:39:05;80460129;79882424;577705;
11.01.2019;12:40:04;80460178;79882538;577640;
11.01.2019;12:41:05;80460233;79882676;577557;
11.01.2019;12:42:06;80460286;79882787;577499;
11.01.2019;12:43:05;80460339;79882905;577434;
11.01.2019;12:44:09;80460167;79882856;577311;
11.01.2019;12:45:05;80459815;79882706;577109;
11.01.2019;12:46:04;80459853;79882825;577028;
11.01.2019;12:47:12;80459898;79882954;576944;
11.01.2019;12:48:09;80459954;79883061;576893;
11.01.2019;12:49:07;80460007;79883197;576810;
11.01.2019;12:50:07;80460059;79883335;576724;
11.01.2019;12:51:07;80460109;79883475;576634;
11.01.2019;12:52:04;80460160;79883612;576548;
11.01.2019;12:53:05;80460217;79883751;576466;
11.01.2019;12:54:05;80460261;79883894;576367;
11.01.2019;12:55:12;80460339;79884026;576313;
11.01.2019;12:56:06;80460397;79884150;576247;
11.01.2019;12:57:12;80460470;79884281;576189;
11.01.2019;12:58:12;80460508;79884412;576096;
11.01.2019;12:59:06;80460560;79884535;576025;
11.01.2019;13:00:06;80460621;79884662;575959;
11.01.2019;13:01:06;80460681;79884823;575858;
11.01.2019;13:02:05;80460734;79884975;575759;
11.01.2019;13:03:06;80460809;79885119;575690;
11.01.2019;13:04:05;80460871;79885243;575628;
11.01.2019;13:05:06;80460916;79885379;575537;
11.01.2019;13:06:11;80460962;79885518;575444;
11.01.2019;13:07:07;80461039;79885657;575382;
11.01.2019;13:08:10;80461103;79885808;575295;
11.01.2019;13:09:10;80461168;79885948;575220;
11.01.2019;13:10:10;80461250;79886087;575163;
11.01.2019;13:11:10;80461302;79886240;575062;
11.01.2019;13:12:06;80461345;79886366;574979;
11.01.2019;13:13:04;80461407;79886536;574871;
11.01.2019;13:14:05;80461486;79886672;574814;
11.01.2019;13:15:04;80461552;79886819;574733;
11.01.2019;13:16:07;80461628;79886972;574656;
11.01.2019;13:17:05;80461676;79887096;574580;
11.01.2019;13:18:05;80461777;79887216;574561;
11.01.2019;13:19:06;80461861;79887368;574493;
11.01.2019;13:20:12;80461944;79887525;574419;
11.01.2019;13:21:04;80461999;79887626;574373;
11.01.2019;13:22:04;80462074;79887756;574318;
11.01.2019;13:23:04;80462142;79887894;574248;
11.01.2019;13:24:04;80462198;79888028;574170;
11.01.2019;13:25:04;80462264;79888192;574072;
11.01.2019;13:31:39;80462744;79889133;573611;
11.01.2019;13:32:07;80462771;79889204;573567;
11.01.2019;13:36:05;80463119;79889777;573342;
11.01.2019;13:36:09;80463119;79889788;573331;
11.01.2019;13:37:08;80463217;79889944;573273;
11.01.2019;13:38:07;80463301;79890072;573229;
11.01.2019;13:39:05;80463379;79890239;573140;
11.01.2019;13:40:05;80463468;79890379;573089;
11.01.2019;13:41:07;80463564;79890515;573049;
11.01.2019;13:42:12;80463654;79890673;572981;
11.01.2019;13:43:05;80463729;79890812;572917;
11.01.2019;13:44:08;80463811;79890987;572824;
11.01.2019;13:45:08;80463903;79891121;572782;
11.01.2019;13:46:08;80463988;79891263;572725;
11.01.2019;13:47:05;80464075;79891392;572683;
11.01.2019;13:48:05;80464151;79891530;572621;
11.01.2019;13:49:05;80464233;79891671;572562;
11.01.2019;13:50:06;80464334;79891839;572495;
11.01.2019;13:51:05;80464430;79891991;572439;
11.01.2019;13:52:12;80464504;79892147;572357;
11.01.2019;13:53:05;80464589;79892287;572302;
11.01.2019;13:54:10;80464691;79892462;572229;
11.01.2019;13:55:08;80464794;79892631;572163;
11.01.2019;13:56:07;80464896;79892793;572103;
11.01.2019;13:57:11;80464978;79892962;572016;
11.01.2019;13:58:05;80465082;79893102;571980;
11.01.2019;13:59:05;80465159;79893256;571903;
11.01.2019;14:00:05;80465243;79893430;571813;
11.01.2019;14:01:05;80465314;79893571;571743;
11.01.2019;14:02:11;80465411;79893735;571676;
11.01.2019;14:03:10;80465512;79893889;571623;
11.01.2019;14:04:06;80465589;79894043;571546;
11.01.2019;14:05:05;80465681;79894235;571446;
11.01.2019;14:06:16;80465805;79894407;571398;
11.01.2019;14:20:20;80467003;79896479;570524;
11.01.2019;14:20:24;80467009;79896483;570526;
11.01.2019;14:21:18;80467083;79896633;570450;
11.01.2019;14:22:07;80467153;79896760;570393;
11.01.2019;14:23:06;80467239;79896937;570302;
11.01.2019;14:24:05;80467346;79897081;570265;
11.01.2019;14:25:06;80467440;79897264;570176;
11.01.2019;14:26:04;80467553;79897428;570125;
11.01.2019;14:27:10;80467664;79897625;570039;
11.01.2019;14:28:04;80467749;79897782;569967;
11.01.2019;14:29:04;80467843;79897963;569880;
11.01.2019;14:30:05;80467943;79898126;569817;
11.01.2019;14:31:04;80468046;79898278;569768;
11.01.2019;14:32:07;80468144;79898456;569688;
11.01.2019;14:33:05;80468224;79898599;569625;
11.01.2019;14:34:07;80468327;79898766;569561;
11.01.2019;14:35:08;80468420;79898931;569489;
11.01.2019;14:36:08;80468489;79899057;569432;
11.01.2019;14:37:05;80468596;79899222;569374;
11.01.2019;14:38:06;80468681;79899393;569288;
11.01.2019;14:39:06;80468767;79899543;569224;
11.01.2019;14:40:04;80468853;79899701;569152;
11.01.2019;14:41:05;80468945;79899850;569095;
11.01.2019;14:42:04;80469057;79900015;569042;
11.01.2019;14:43:04;80469149;79900156;568993;
11.01.2019;14:44:05;80469236;79900313;568923;
11.01.2019;14:45:04;80469318;79900479;568839;
11.01.2019;14:46:04;80469414;79900631;568783;
11.01.2019;14:47:06;80469512;79900798;568714;
11.01.2019;14:48:08;80469619;79900951;568668;
11.01.2019;14:49:09;80469686;79901133;568553;
11.01.2019;14:50:10;80469782;79901317;568465;
11.01.2019;14:51:08;80469871;79901469;568402;
11.01.2019;14:52:05;80469962;79901635;568327;
11.01.2019;14:53:05;80470035;79901777;568258;
11.01.2019;14:54:05;80470138;79901986;568152;
11.01.2019;14:55:10;80470256;79902139;568117;
11.01.2019;14:56:05;80470331;79902286;568045;
11.01.2019;14:57:06;80470417;79902450;567967;
11.01.2019;14:58:11;80470521;79902624;567897;
11.01.2019;14:59:08;80470603;79902803;567800;
11.01.2019;15:00:09;80470698;79902987;567711;
11.01.2019;15:01:13;80470776;79903178;567598;
11.01.2019;15:02:09;80470882;79903324;567558;
11.01.2019;15:03:13;80470987;79903486;567501;
11.01.2019;15:04:14;80471086;79903673;567413;
11.01.2019;15:05:14;80471197;79903815;567382;
11.01.2019;15:06:14;80471271;79903994;567277;
11.01.2019;15:07:13;80471344;79904162;567182;
11.01.2019;15:08:15;80471448;79904354;567094;
11.01.2019;15:09:18;80471530;79904490;567040;
11.01.2019;15:10:16;80471612;79904683;566929;
11.01.2019;15:11:16;80471704;79904848;566856;
11.01.2019;15:12:15;80471795;79905033;566762;
11.01.2019;15:13:20;80471911;79905220;566691;
11.01.2019;15:14:19;80472018;79905376;566642;
11.01.2019;15:15:20;80472113;79905533;566580;
11.01.2019;15:16:24;80472213;79905707;566506;
11.01.2019;15:17:26;80472321;79905887;566434;
11.01.2019;15:18:24;80472419;79906072;566347;
11.01.2019;15:19:23;80472507;79906243;566264;
11.01.2019;15:20:29;80472625;79906416;566209;
11.01.2019;15:21:28;80472709;79906597;566112;
11.01.2019;15:22:29;80472799;79906757;566042;
11.01.2019;15:23:31;80472902;79906926;565976;
11.01.2019;15:24:32;80472998;79907111;565887;
11.01.2019;15:25:32;80473093;79907326;565767;
11.01.2019;15:26:34;80473195;79907488;565707;
11.01.2019;15:27:34;80473288;79907673;565615;
11.01.2019;15:28:37;80473381;79907848;565533;
11.01.2019;15:29:36;80473480;79908008;565472;
11.01.2019;15:30:40;80473566;79908225;565341;
11.01.2019;15:31:37;80473651;79908396;565255;
11.01.2019;15:32:37;80473774;79908600;565174;
11.01.2019;15:33:35;80473866;79908759;565107;
11.01.2019;15:34:36;80473951;79908936;565015;
11.01.2019;15:35:36;80474055;79909100;564955;
11.01.2019;15:36:36;80474140;79909283;564857;
11.01.2019;15:37:37;80474230;79909468;564762;
11.01.2019;15:38:37;80474328;79909641;564687;
11.01.2019;15:39:39;80474449;79909838;564611;
11.01.2019;15:40:34;80474533;79909992;564541;
11.01.2019;15:41:37;80474649;79910142;564507;
11.01.2019;15:42:36;80474735;79910302;564433;
11.01.2019;15:43:36;80474821;79910505;564316;
11.01.2019;15:44:37;80474931;79910687;564244;
11.01.2019;15:45:39;80475035;79910886;564149;
11.01.2019;15:46:34;80475116;79911050;564066;
11.01.2019;15:47:36;80475207;79911213;563994;
11.01.2019;15:48:37;80475304;79911375;563929;
11.01.2019;15:49:37;80475393;79911518;563875;
11.01.2019;15:50:37;80475491;79911698;563793;
11.01.2019;15:51:35;80475594;79911880;563714;
11.01.2019;15:52:37;80475694;79912079;563615;
11.01.2019;15:53:37;80475793;79912275;563518;
11.01.2019;15:54:37;80475893;79912447;563446;
11.01.2019;15:55:35;80476007;79912620;563387;
11.01.2019;15:56:36;80476121;79912791;563330;
11.01.2019;15:57:38;80476221;79913003;563218;
11.01.2019;15:58:38;80476317;79913178;563139;
11.01.2019;15:59:40;80476397;79913371;563026;
11.01.2019;16:00:32;80476473;79913530;562943;
11.01.2019;16:01:29;80476565;79913707;562858;
11.01.2019;16:02:27;80476660;79913889;562771;
11.01.2019;16:03:22;80476728;79914066;562662;
11.01.2019;16:04:18;80476832;79914229;562603;
11.01.2019;16:05:07;80476903;79914377;562526;
11.01.2019;16:06:08;80476999;79914559;562440;
11.01.2019;16:07:08;80477124;79914722;562402;
11.01.2019;16:08:09;80477223;79914909;562314;
11.01.2019;16:09:10;80477339;79915105;562234;
11.01.2019;16:10:08;80477440;79915292;562148;
11.01.2019;16:11:08;80477541;79915466;562075;
11.01.2019;16:12:08;80477613;79915656;561957;
11.01.2019;16:13:08;80477703;79915808;561895;
11.01.2019;16:14:05;80477783;79915934;561849;
11.01.2019;16:15:05;80477841;79916050;561791;
11.01.2019;16:16:05;80477932;79916202;561730;
11.01.2019;16:17:06;80478020;79916342;561678;
11.01.2019;16:18:08;80478100;79916523;561577;
11.01.2019;16:19:05;80478202;79916657;561545;
11.01.2019;16:20:05;80478241;79916821;561420;
11.01.2019;16:21:05;80478339;79916978;561361;
11.01.2019;16:22:05;80478424;79917137;561287;
11.01.2019;16:23:04;80478528;79917282;561246;
11.01.2019;16:24:04;80478611;79917466;561145;
11.01.2019;16:25:05;80478700;79917608;561092;
11.01.2019;16:26:05;80478793;79917773;561020;
11.01.2019;16:27:05;80478888;79917964;560924;
11.01.2019;16:28:05;80478998;79918163;560835;
11.01.2019;16:29:05;80479123;79918332;560791;
11.01.2019;16:30:05;80479230;79918493;560737;
11.01.2019;16:31:04;80479327;79918680;560647;
11.01.2019;16:32:04;80479429;79918855;560574;
11.01.2019;16:33:05;80479516;79919035;560481;
11.01.2019;16:34:05;80479609;79919197;560412;
11.01.2019;16:35:04;80479704;79919387;560317;
11.01.2019;16:36:04;80479798;79919589;560209;
11.01.2019;16:37:05;80479902;79919770;560132;
11.01.2019;16:38:05;80480017;79919952;560065;
11.01.2019;16:39:07;80480112;79920136;559976;
11.01.2019;16:40:04;80480207;79920315;559892;
11.01.2019;16:41:04;80480319;79920491;559828;
11.01.2019;16:42:05;80480445;79920676;559769;
11.01.2019;16:43:06;80480553;79920870;559683;
11.01.2019;16:44:04;80480655;79921070;559585;
11.01.2019;16:45:04;80480768;79921253;559515;
11.01.2019;16:46:05;80480871;79921435;559436;
11.01.2019;16:47:05;80480981;79921645;559336;
11.01.2019;16:48:05;80481091;79921840;559251;
11.01.2019;16:49:04;80481196;79922017;559179;
11.01.2019;16:50:04;80481298;79922194;559104;
11.01.2019;16:51:05;80481388;79922387;559001;
11.01.2019;16:52:04;80481499;79922542;558957;
11.01.2019;16:53:05;80481605;79922732;558873;
11.01.2019;16:54:06;80481695;79922878;558817;
11.01.2019;16:55:05;80481782;79923036;558746;
11.01.2019;16:56:05;80481896;79923228;558668;
11.01.2019;16:57:04;80482004;79923400;558604;
11.01.2019;16:58:04;80482115;79923575;558540;
11.01.2019;16:59:05;80482225;79923751;558474;
11.01.2019;17:00:05;80482317;79923936;558381;
11.01.2019;17:01:05;80482386;79924128;558258;
11.01.2019;17:02:04;80482480;79924302;558178;
11.01.2019;17:03:04;80482578;79924500;558078;
11.01.2019;17:04:04;80482679;79924697;557982;
11.01.2019;17:05:04;80482775;79924876;557899;
11.01.2019;17:06:09;80482878;79925076;557802;
11.01.2019;17:07:11;80482978;79925282;557696;
11.01.2019;17:08:13;80483095;79925478;557617;
11.01.2019;17:09:07;80483213;79925636;557577;
11.01.2019;17:10:05;80483316;79925824;557492;
11.01.2019;17:11:04;80483420;79925987;557433;
11.01.2019;17:12:05;80483546;79926128;557418;
11.01.2019;17:13:04;80483634;79926283;557351;
11.01.2019;17:14:05;80483746;79926450;557296;
11.01.2019;17:15:05;80483857;79926626;557231;
11.01.2019;17:16:04;80483943;79926778;557165;
11.01.2019;17:17:05;80484045;79926950;557095;
11.01.2019;17:18:04;80484184;79927135;557049;
11.01.2019;17:19:04;80484290;79927319;556971;
11.01.2019;17:20:05;80484398;79927504;556894;
11.01.2019;17:21:06;80484509;79927697;556812;
11.01.2019;17:22:05;80484612;79927878;556734;
11.01.2019;17:23:05;80484695;79928063;556632;
11.01.2019;17:24:05;80484798;79928251;556547;
11.01.2019;17:25:07;80484896;79928452;556444;
11.01.2019;17:26:12;80485000;79928666;556334;
11.01.2019;17:27:08;80485135;79928823;556312;
11.01.2019;17:28:05;80485234;79929006;556228;
11.01.2019;17:29:05;80485347;79929185;556162;
11.01.2019;17:30:05;80485453;79929353;556100;
11.01.2019;17:31:05;80485565;79929518;556047;
11.01.2019;17:32:04;80485668;79929661;556007;
11.01.2019;17:33:04;80485787;79929827;555960;
11.01.2019;17:34:05;80485886;79930021;555865;
11.01.2019;17:35:05;80485994;79930177;555817;
11.01.2019;17:36:04;80486092;79930339;555753;
11.01.2019;17:37:04;80486193;79930515;555678;
11.01.2019;17:38:05;80486300;79930642;555658;
11.01.2019;17:39:05;80486409;79930828;555581;
11.01.2019;17:40:05;80486528;79931011;555517;
11.01.2019;17:41:05;80486634;79931134;555500;
11.01.2019;17:42:04;80486734;79931300;555434;
11.01.2019;17:43:04;80486839;79931465;555374;
11.01.2019;17:44:04;80486953;79931637;555316;
11.01.2019;17:45:05;80487060;79931827;555233;
11.01.2019;17:46:04;80487167;79931992;555175;
11.01.2019;17:47:04;80487251;79932159;555092;
11.01.2019;17:48:04;80487354;79932324;555030;
11.01.2019;17:49:05;80487454;79932480;554974;
11.01.2019;17:50:05;80487573;79932659;554914;
11.01.2019;17:51:04;80487691;79932837;554854;
11.01.2019;17:52:04;80487814;79932991;554823;
11.01.2019;17:53:05;80487926;79933156;554770;
11.01.2019;17:54:06;80488030;79933303;554727;
11.01.2019;17:55:04;80488148;79933456;554692;
11.01.2019;17:56:05;80488274;79933647;554627;
11.01.2019;17:57:05;80488375;79933816;554559;
11.01.2019;17:58:04;80488493;79933964;554529;
11.01.2019;17:59:05;80488582;79934126;554456;
11.01.2019;18:00:05;80488674;79934271;554403;
11.01.2019;18:01:04;80488779;79934437;554342;
11.01.2019;18:02:04;80488872;79934573;554299;
11.01.2019;18:03:05;80488961;79934744;554217;
11.01.2019;18:04:05;80489052;79934905;554147;
11.01.2019;18:05:05;80489158;79935055;554103;
11.01.2019;18:06:05;80489276;79935213;554063;
11.01.2019;18:07:05;80489396;79935348;554048;
11.01.2019;18:08:05;80489505;79935524;553981;
11.01.2019;18:09:06;80489617;79935679;553938;
11.01.2019;18:10:04;80489717;79935836;553881;
11.01.2019;18:11:05;80489828;79935977;553851;
11.01.2019;18:12:05;80489942;79936127;553815;
11.01.2019;18:13:05;80490062;79936287;553775;
11.01.2019;18:14:05;80490143;79936425;553718;
11.01.2019;18:15:06;80490248;79936569;553679;
11.01.2019;18:16:05;80490348;79936697;553651;
11.01.2019;18:17:05;80490423;79936828;553595;
11.01.2019;18:18:04;80490521;79936959;553562;
11.01.2019;18:19:04;80490590;79937049;553541;
11.01.2019;18:20:05;80490636;79937142;553494;
11.01.2019;18:21:05;80490693;79937243;553450;
11.01.2019;18:22:04;80490769;79937395;553374;
11.01.2019;18:23:04;80490853;79937548;553305;
11.01.2019;18:24:05;80490944;79937689;553255;
11.01.2019;18:25:05;80491046;79937824;553222;
11.01.2019;18:26:06;80491139;79937965;553174;
11.01.2019;18:27:04;80491218;79938098;553120;
11.01.2019;18:28:04;80491300;79938197;553103;
11.01.2019;18:29:05;80491386;79938348;553038;
11.01.2019;18:30:05;80491482;79938478;553004;
11.01.2019;18:31:04;80491594;79938608;552986;
11.01.2019;18:32:04;80491688;79938748;552940;
11.01.2019;18:33:05;80491803;79938871;552932;
11.01.2019;18:34:05;80491876;79938985;552891;
11.01.2019;18:35:04;80491980;79939133;552847;
11.01.2019;18:36:05;80492108;79939260;552848;
11.01.2019;18:37:05;80492225;79939396;552829;
11.01.2019;18:38:05;80492330;79939518;552812;
11.01.2019;18:39:06;80492458;79939651;552807;
11.01.2019;18:40:04;80492555;79939794;552761;
11.01.2019;18:41:05;80492664;79939924;552740;
11.01.2019;18:42:05;80492765;79940081;552684;
11.01.2019;18:43:04;80492843;79940211;552632;
11.01.2019;18:44:05;80492949;79940317;552632;
11.01.2019;18:45:05;80493075;79940449;552626;
11.01.2019;18:46:04;80493142;79940549;552593;
11.01.2019;18:47:04;80493177;79940698;552479;
11.01.2019;18:48:05;80493220;79940821;552399;
11.01.2019;18:49:05;80493243;79940955;552288;
11.01.2019;18:50:05;80493295;79941093;552202;
11.01.2019;18:51:05;80493365;79941227;552138;
11.01.2019;18:52:05;80493446;79941345;552101;
11.01.2019;18:53:05;80493509;79941482;552027;
11.01.2019;18:54:05;80493582;79941606;551976;
11.01.2019;18:55:04;80493654;79941734;551920;
11.01.2019;18:57:05;80493809;79941968;551841;
11.01.2019;18:58:04;80493910;79942093;551817;
11.01.2019;18:59:04;80493985;79942225;551760;
11.01.2019;19:00:05;80494071;79942348;551723;
11.01.2019;19:01:04;80494132;79942477;551655;
11.01.2019;19:02:04;80494201;79942624;551577;
11.01.2019;19:03:05;80494275;79942751;551524;
11.01.2019;19:04:05;80494363;79942870;551493;
11.01.2019;19:05:04;80494466;79942981;551485;
11.01.2019;19:06:04;80494545;79943103;551442;
11.01.2019;19:07:05;80494648;79943231;551417;
11.01.2019;19:08:05;80494733;79943344;551389;
11.01.2019;19:09:06;80494822;79943448;551374;
11.01.2019;19:10:04;80494901;79943572;551329;
11.01.2019;19:11:05;80494960;79943664;551296;
11.01.2019;19:12:05;80495022;79943776;551246;
11.01.2019;19:13:05;80495085;79943900;551185;
11.01.2019;19:14:04;80495161;79944003;551158;
11.01.2019;19:15:04;80495249;79944113;551136;
11.01.2019;19:16:05;80495321;79944224;551097;
11.01.2019;19:17:05;80495392;79944333;551059;
11.01.2019;19:18:05;80495488;79944439;551049;
11.01.2019;19:19:05;80495556;79944531;551025;
11.01.2019;19:20:04;80495642;79944623;551019;
11.01.2019;19:21:04;80495714;79944727;550987;
11.01.2019;19:22:07;80495812;79944842;550970;
11.01.2019;19:23:08;80495912;79944961;550951;
11.01.2019;19:24:04;80495980;79945058;550922;
11.01.2019;19:25:05;80496086;79945160;550926;
11.01.2019;19:26:05;80496176;79945254;550922;
11.01.2019;19:27:05;80496270;79945361;550909;
11.01.2019;19:28:04;80496374;79945447;550927;
11.01.2019;19:29:04;80496444;79945551;550893;
11.01.2019;19:30:05;80496551;79945663;550888;
11.01.2019;19:31:05;80496615;79945754;550861;
11.01.2019;19:32:05;80496623;79945774;550849;
11.01.2019;19:33:06;80496690;79945862;550828;
11.01.2019;19:34:04;80496773;79945941;550832;
11.01.2019;19:35:04;80496852;79946045;550807;
11.01.2019;19:36:05;80496957;79946143;550814;
11.01.2019;19:37:05;80497035;79946212;550823;
11.01.2019;19:38:05;80497113;79946302;550811;
11.01.2019;19:39:05;80497193;79946393;550800;
11.01.2019;19:40:04;80497281;79946475;550806;
11.01.2019;19:41:04;80497366;79946547;550819;
11.01.2019;19:42:04;80497454;79946621;550833;
11.01.2019;19:43:05;80497542;79946721;550821;
11.01.2019;19:44:05;80497636;79946787;550849;
11.01.2019;19:45:06;80497733;79946865;550868;
11.01.2019;19:46:05;80497825;79946940;550885;
11.01.2019;19:47:04;80497918;79947020;550898;
11.01.2019;19:48:04;80497991;79947106;550885;
11.01.2019;19:49:05;80498077;79947196;550881;
11.01.2019;19:50:05;80498174;79947290;550884;
11.01.2019;19:51:05;80498263;79947363;550900;
11.01.2019;19:52:05;80498349;79947467;550882;
11.01.2019;19:53:05;80498428;79947571;550857;
11.01.2019;19:54:04;80498503;79947660;550843;
11.01.2019;19:55:04;80497872;79947724;550148;
11.01.2019;19:56:05;80497979;79947797;550182;
11.01.2019;19:57:05;80498061;79947885;550176;
11.01.2019;19:58:04;80498159;79947962;550197;
11.01.2019;19:59:04;80498269;79948057;550212;
11.01.2019;20:00:04;80498384;79948152;550232;
11.01.2019;20:01:05;80498475;79948232;550243;
11.01.2019;20:02:05;80498564;79948304;550260;
11.01.2019;20:03:05;80498637;79954332;544305;
11.01.2019;20:04:06;80498694;79954403;544291;
11.01.2019;20:05:05;80498775;79954488;544287;
11.01.2019;20:06:05;80498863;79954580;544283;
11.01.2019;20:07:04;80498948;79954650;544298;
11.01.2019;20:08:04;80499024;79954735;544289;
11.01.2019;20:09:06;80499116;79954804;544312;
11.01.2019;20:10:06;80499220;79954863;544357;
11.01.2019;20:11:04;80499309;79954919;544390;
11.01.2019;20:12:06;80499394;79954976;544418;
11.01.2019;20:13:04;80499501;79955044;544457;
11.01.2019;20:14:04;80499614;79955124;544490;
11.01.2019;20:15:05;80499722;79955193;544529;
11.01.2019;20:16:06;80499807;79955278;544529;
11.01.2019;20:17:05;80499918;79955352;544566;
11.01.2019;20:18:05;80500014;79955425;544589;
11.01.2019;20:19:05;80500097;79955490;544607;
11.01.2019;20:20:06;80500167;79955538;544629;
11.01.2019;20:21:05;80500203;79955521;544682;
11.01.2019;20:22:04;80500297;79955593;544704;
11.01.2019;20:23:08;80500387;79955646;544741;
11.01.2019;20:24:06;80500490;79955716;544774;
11.01.2019;20:25:05;80500568;79955768;544800;
11.01.2019;20:26:05;80500619;79955796;544823;
11.01.2019;20:27:04;80500695;79955849;544846;
11.01.2019;20:28:05;80500738;79955890;544848;
11.01.2019;20:29:05;80500829;79955939;544890;
11.01.2019;20:30:05;80500922;79955975;544947;
11.01.2019;20:31:05;80501005;79956033;544972;
11.01.2019;20:32:05;80501089;79956093;544996;
11.01.2019;20:33:04;80501173;79956154;545019;
11.01.2019;20:34:05;80501269;79956223;545046;
11.01.2019;20:35:05;80501382;79956307;545075;
11.01.2019;20:36:05;80501498;79956371;545127;
11.01.2019;20:37:04;80501595;79956435;545160;
11.01.2019;20:38:04;80501703;79956507;545196;
11.01.2019;20:39:08;80501785;79956582;545203;
11.01.2019;20:40:05;80501877;79956636;545241;
11.01.2019;20:41:04;80501980;79956692;545288;
11.01.2019;20:42:06;80502081;79956759;545322;
11.01.2019;20:43:04;80502186;79956818;545368;
11.01.2019;20:44:10;80502283;79956880;545403;
11.01.2019;20:45:05;80502354;79956934;545420;
11.01.2019;20:46:04;80502428;79957010;545418;
11.01.2019;20:47:05;80502516;79957075;545441;
11.01.2019;20:48:05;80502610;79957129;545481;
11.01.2019;20:49:05;80502718;79957191;545527;
11.01.2019;20:50:08;80502807;79957243;545564;
11.01.2019;20:51:06;80502894;79957303;545591;
11.01.2019;20:52:05;80502995;79957367;545628;
11.01.2019;20:53:05;80503122;79957428;545694;
11.01.2019;20:54:05;80503221;79957511;545710;
11.01.2019;20:55:07;80503318;79957577;545741;
11.01.2019;20:56:04;80503414;79957629;545785;
11.01.2019;20:57:04;80503527;79957682;545845;
11.01.2019;20:58:06;80503626;79957736;545890;
11.01.2019;20:59:10;80503704;79957782;545922;
11.01.2019;21:00:06;80503798;79957842;545956;
11.01.2019;21:01:04;80503883;79957882;546001;
11.01.2019;21:02:05;80503970;79957942;546028;
11.01.2019;21:03:06;80504079;79957986;546093;
11.01.2019;21:04:04;80504179;79958047;546132;
11.01.2019;21:05:06;80504274;79958106;546168;
11.01.2019;21:06:06;80504382;79958160;546222;
11.01.2019;21:07:05;80504464;79958216;546248;
11.01.2019;21:08:06;80504550;79958277;546273;
11.01.2019;21:09:06;80504643;79958326;546317;
11.01.2019;21:10:06;80504759;79958368;546391;
11.01.2019;21:11:05;80504845;79958433;546412;
11.01.2019;21:12:05;80504947;79958492;546455;
11.01.2019;21:13:07;80505054;79958528;546526;
11.01.2019;21:14:05;80505134;79958566;546568;
11.01.2019;21:15:05;80505233;79958615;546618;
11.01.2019;21:16:06;80505328;79958642;546686;
11.01.2019;21:17:05;80505423;79958694;546729;
11.01.2019;21:18:06;80505534;79958750;546784;
11.01.2019;21:19:06;80505635;79958820;546815;
11.01.2019;21:20:04;80505739;79958872;546867;
11.01.2019;21:21:05;80505822;79958927;546895;
11.01.2019;21:22:08;80505949;79958974;546975;
11.01.2019;21:23:04;80506037;79959015;547022;
11.01.2019;21:24:08;80506136;79959053;547083;
11.01.2019;21:25:04;80506252;79959094;547158;
11.01.2019;21:26:04;80506356;79959136;547220;
11.01.2019;21:27:05;80506457;79959188;547269;
11.01.2019;21:28:05;80506554;79959241;547313;
11.01.2019;21:29:04;80506640;79959287;547353;
11.01.2019;21:30:06;80506738;79959328;547410;
11.01.2019;21:31:11;80506832;79959394;547438;
11.01.2019;21:32:07;80506917;79959431;547486;
11.01.2019;21:33:05;80506983;79959487;547496;
11.01.2019;21:34:12;80507062;79959545;547517;
11.01.2019;21:35:12;80507174;79959594;547580;
11.01.2019;21:36:05;80507261;79959625;547636;
11.01.2019;21:37:10;80507363;79959666;547697;
11.01.2019;21:38:04;80507432;79959709;547723;
11.01.2019;21:39:13;80507536;79959762;547774;
11.01.2019;21:40:12;80507606;79959798;547808;
11.01.2019;21:41:05;80507712;79959842;547870;
11.01.2019;21:42:06;80507816;79959882;547934;
11.01.2019;21:43:05;80507918;79959931;547987;
11.01.2019;21:44:10;80508015;79959965;548050;
11.01.2019;21:45:05;80508097;79959998;548099;
11.01.2019;21:46:06;80508182;79960050;548132;
11.01.2019;21:47:10;80508291;79960087;548204;
11.01.2019;21:48:04;80508372;79960112;548260;
11.01.2019;21:49:05;80508472;79960151;548321;
11.01.2019;21:50:05;80508574;79960206;548368;
11.01.2019;21:51:05;80508673;79960254;548419;
11.01.2019;21:52:04;80508794;79960296;548498;
11.01.2019;21:53:04;80508869;79960348;548521;
11.01.2019;21:54:04;80508960;79960405;548555;
11.01.2019;21:55:05;80509058;79960485;548573;
11.01.2019;21:56:05;80509158;79960542;548616;
11.01.2019;21:57:05;80509238;79960590;548648;
11.01.2019;21:58:04;80509326;79960627;548699;
11.01.2019;21:59:05;80509419;79960657;548762;
11.01.2019;22:00:05;80509531;79960697;548834;
11.01.2019;22:01:06;80509633;79960750;548883;
11.01.2019;22:02:11;80509715;79960816;548899;
11.01.2019;22:03:05;80509808;79960864;548944;
11.01.2019;22:04:04;80509863;79960875;548988;
11.01.2019;22:05:04;80509937;79960918;549019;
11.01.2019;22:06:11;80510048;79960965;549083;
11.01.2019;22:07:07;80510102;79960993;549109;
11.01.2019;22:08:04;80510181;79961039;549142;
11.01.2019;22:09:06;80510282;79961087;549195;
11.01.2019;22:10:11;80510370;79961118;549252;
11.01.2019;22:11:05;80510453;79961160;549293;
11.01.2019;22:12:10;80510515;79961193;549322;
11.01.2019;22:13:06;80510597;79961238;549359;
11.01.2019;22:14:05;80510676;79961279;549397;
11.01.2019;22:15:05;80510739;79961305;549434;
11.01.2019;22:16:05;80510796;79961339;549457;
11.01.2019;22:17:05;80510854;79961361;549493;
11.01.2019;22:18:13;80510949;79961398;549551;
11.01.2019;22:19:06;80511009;79961443;549566;
11.01.2019;22:20:05;80511076;79961487;549589;
11.01.2019;22:21:06;80511145;79961545;549600;
11.01.2019;22:22:04;80511206;79961585;549621;
11.01.2019;22:23:04;80511306;79961629;549677;
11.01.2019;22:24:05;80511388;79961665;549723;
11.01.2019;22:25:05;80511463;79961715;549748;
11.01.2019;22:26:06;80511545;79961753;549792;
11.01.2019;22:27:04;80511634;79961818;549816;
11.01.2019;22:28:04;80511725;79961877;549848;
11.01.2019;22:29:05;80511819;79961944;549875;
11.01.2019;22:30:04;80511930;79961993;549937;
11.01.2019;22:31:04;80512041;79962024;550017;
11.01.2019;22:32:05;80512139;79962091;550048;
11.01.2019;22:33:04;80512237;79962144;550093;
11.01.2019;22:34:04;80512340;79962183;550157;
11.01.2019;22:35:05;80512437;79962218;550219;
11.01.2019;22:36:05;80512518;79962260;550258;
11.01.2019;22:37:06;80512618;79962311;550307;
11.01.2019;22:38:04;80512672;79962346;550326;
11.01.2019;22:39:06;80512768;79962390;550378;
11.01.2019;22:40:05;80512865;79962424;550441;
11.01.2019;22:41:04;80512957;79962456;550501;
11.01.2019;22:42:05;80513051;79962493;550558;
11.01.2019;22:43:05;80513166;79962541;550625;
11.01.2019;22:44:04;80513258;79962575;550683;
11.01.2019;22:45:05;80513348;79962600;550748;
11.01.2019;22:46:05;80513449;79962652;550797;
11.01.2019;22:47:04;80513530;79962685;550845;
11.01.2019;22:48:04;80513613;79962718;550895;
11.01.2019;22:49:05;80513712;79962773;550939;
11.01.2019;22:50:05;80513806;79962844;550962;
11.01.2019;22:51:04;80513882;79962916;550966;
11.01.2019;22:52:04;80513963;79962960;551003;
11.01.2019;22:53:05;80514052;79963003;551049;
11.01.2019;22:54:05;80514144;79963045;551099;
11.01.2019;22:55:04;80514226;79963088;551138;
11.01.2019;22:56:05;80514288;79963128;551160;
11.01.2019;22:57:05;80514377;79963181;551196;
11.01.2019;22:58:04;80514483;79963220;551263;
11.01.2019;22:59:04;80514566;79963267;551299;
11.01.2019;23:00:06;80514647;79963308;551339;
11.01.2019;23:01:05;80514734;79963347;551387;
11.01.2019;23:02:04;80514805;79963374;551431;
11.01.2019;23:03:04;80514864;79963416;551448;
11.01.2019;23:04:06;80514944;79963455;551489;
11.01.2019;23:05:05;80515046;79963496;551550;
11.01.2019;23:06:04;80515124;79963534;551590;
11.01.2019;23:07:04;80515204;79963571;551633;
11.01.2019;23:08:05;80515273;79963620;551653;
11.01.2019;23:09:05;80515383;79963667;551716;
11.01.2019;23:10:04;80515454;79963715;551739;
11.01.2019;23:11:05;80515568;79963761;551807;
11.01.2019;23:12:05;80515653;79963802;551851;
11.01.2019;23:13:04;80515739;79963843;551896;
11.01.2019;23:14:04;80515821;79963875;551946;
11.01.2019;23:15:05;80515899;79963908;551991;
11.01.2019;23:16:05;80515994;79963943;552051;
11.01.2019;23:17:04;80516089;79963975;552114;
11.01.2019;23:18:04;80516177;79964025;552152;
11.01.2019;23:19:05;80516279;79964061;552218;
11.01.2019;23:20:04;80516363;79964083;552280;
11.01.2019;23:21:09;80516441;79964126;552315;
11.01.2019;23:22:04;80516531;79964167;552364;
11.01.2019;23:23:05;80516625;79964214;552411;
11.01.2019;23:24:04;80516710;79964245;552465;
11.01.2019;23:25:04;80516814;79964288;552526;
11.01.2019;23:26:05;80516920;79964347;552573;
11.01.2019;23:27:05;80517041;79964386;552655;
11.01.2019;23:28:04;80517129;79964422;552707;
11.01.2019;23:29:05;80517195;79964459;552736;
11.01.2019;23:30:05;80517287;79964488;552799;
11.01.2019;23:31:04;80517376;79964528;552848;
11.01.2019;23:32:04;80517464;79964560;552904;
11.01.2019;23:33:05;80517525;79964597;552928;
11.01.2019;23:34:04;80517592;79964636;552956;
11.01.2019;23:35:04;80517681;79964670;553011;
11.01.2019;23:36:05;80517772;79964707;553065;
11.01.2019;23:37:04;80517842;79964749;553093;
11.01.2019;23:38:04;80517927;79964775;553152;
11.01.2019;23:39:07;80518014;79964808;553206;
11.01.2019;23:40:04;80518088;79964833;553255;
11.01.2019;23:41:05;80518169;79964871;553298;
11.01.2019;23:42:05;80518266;79964917;553349;
11.01.2019;23:43:05;80518363;79964938;553425;
11.01.2019;23:44:04;80518450;79964972;553478;
11.01.2019;23:45:04;80518532;79965003;553529;
11.01.2019;23:46:05;80518623;79965043;553580;
11.01.2019;23:47:04;80518701;79965078;553623;
11.01.2019;23:48:04;80518781;79965114;553667;
11.01.2019;23:49:05;80518887;79965146;553741;
11.01.2019;23:50:04;80518982;79965183;553799;
11.01.2019;23:51:11;80519061;79965224;553837;
11.01.2019;23:52:06;80519153;79965248;553905;
11.01.2019;23:53:04;80519238;79965290;553948;
11.01.2019;23:54:04;80519328;79965316;554012;
11.01.2019;23:55:04;80519412;79965338;554074;
11.01.2019;23:56:11;80519500;79965376;554124;
11.01.2019;23:57:05;80519578;79965399;554179;
11.01.2019;23:58:06;80519663;79965423;554240;
11.01.2019;23:59:13;80519758;79965456;554302;
12.01.2019;00:00:07;80519854;79965481;554373;
12.01.2019;00:01:08;80519951;79965510;554441;
12.01.2019;00:02:14;80520055;79965544;554511;
12.01.2019;00:03:12;80520125;79965563;554562;
12.01.2019;00:04:09;80520181;79965585;554596;
12.01.2019;00:05:07;80520248;79965598;554650;
12.01.2019;00:06:13;80520316;79965632;554684;
12.01.2019;00:07:07;80520357;79965639;554718;
12.01.2019;00:08:07;80520435;79965656;554779;
12.01.2019;00:09:07;80520517;79965676;554841;
12.01.2019;00:10:13;80520583;79965701;554882;
12.01.2019;00:11:07;80520621;79965728;554893;
12.01.2019;00:12:08;80520676;79965755;554921;
12.01.2019;00:13:07;80520747;79965786;554961;
12.01.2019;00:14:10;80520827;79965804;555023;
12.01.2019;00:15:07;80520890;79965827;555063;
12.01.2019;00:16:07;80520967;79965862;555105;
12.01.2019;00:17:10;80521037;79965900;555137;
12.01.2019;00:18:08;80521108;79965918;555190;
12.01.2019;00:19:07;80521164;79965954;555210;
12.01.2019;00:20:09;80521214;79965980;555234;
12.01.2019;00:21:07;80521284;79966014;555270;
12.01.2019;00:22:07;80521365;79966039;555326;
12.01.2019;00:23:07;80521462;79966070;555392;
12.01.2019;00:24:09;80521542;79966095;555447;
12.01.2019;00:25:07;80521638;79966137;555501;
12.01.2019;00:26:08;80521726;79966161;555565;
12.01.2019;00:27:07;80521799;79966192;555607;
12.01.2019;00:28:08;80521868;79966225;555643;
12.01.2019;00:29:12;80521946;79966255;555691;
12.01.2019;00:30:06;80522026;79966280;555746;
12.01.2019;00:31:10;80522111;79966318;555793;
12.01.2019;00:32:12;80522172;79966354;555818;
12.01.2019;00:33:13;80522256;79966381;555875;
12.01.2019;00:34:07;80522336;79966410;555926;
12.01.2019;00:35:08;80522414;79966436;555978;
12.01.2019;00:36:08;80522490;79966480;556010;
12.01.2019;00:37:09;80522557;79966512;556045;
12.01.2019;00:38:13;80522645;79966533;556112;
12.01.2019;00:39:10;80522739;79966557;556182;
12.01.2019;00:40:08;80522812;79966588;556224;
12.01.2019;00:41:07;80522872;79966615;556257;
12.01.2019;00:42:12;80522933;79966658;556275;
12.01.2019;00:43:08;80523003;79966684;556319;
12.01.2019;00:44:07;80523074;79966710;556364;
12.01.2019;00:45:09;80523163;79966738;556425;
12.01.2019;00:46:07;80523260;79966771;556489;
12.01.2019;00:47:08;80523343;79966797;556546;
12.01.2019;00:48:07;80523432;79966837;556595;
12.01.2019;00:49:08;80523508;79966862;556646;
12.01.2019;00:50:08;80523579;79966900;556679;
12.01.2019;00:51:12;80523641;79966929;556712;
12.01.2019;00:52:08;80523715;79966960;556755;
12.01.2019;00:53:08;80523796;79966987;556809;
12.01.2019;00:54:07;80523867;79967015;556852;
12.01.2019;00:55:09;80523947;79967040;556907;
12.01.2019;00:56:08;80524016;79967076;556940;
12.01.2019;00:57:08;80524099;79967098;557001;
12.01.2019;00:58:07;80524197;79967119;557078;
12.01.2019;00:59:08;80524268;79967150;557118;
12.01.2019;01:00:06;80524335;79967170;557165;
12.01.2019;01:01:10;80524407;79967207;557200;
12.01.2019;01:02:11;80524475;79967243;557232;
12.01.2019;01:03:10;80524537;79967274;557263;
12.01.2019;01:04:05;80524618;79967302;557316;
12.01.2019;01:05:05;80524684;79967341;557343;
12.01.2019;01:06:04;80524746;79967376;557370;
12.01.2019;01:07:11;80524826;79967401;557425;
12.01.2019;01:08:11;80524890;79967429;557461;
12.01.2019;01:09:06;80524952;79967451;557501;
12.01.2019;01:10:04;80525021;79967488;557533;
12.01.2019;01:11:04;80525107;79967520;557587;
12.01.2019;01:12:06;80525197;79967545;557652;
12.01.2019;01:13:06;80525220;79967556;557664;
12.01.2019;01:14:04;80525294;79967572;557722;
12.01.2019;01:15:04;80525356;79967613;557743;
12.01.2019;01:16:05;80525426;79967643;557783;
12.01.2019;01:17:06;80525479;79967682;557797;
12.01.2019;01:18:04;80525562;79967711;557851;
12.01.2019;01:19:05;80525645;79967750;557895;
12.01.2019;01:20:06;80525728;79967787;557941;
12.01.2019;01:21:11;80525802;79967820;557982;
12.01.2019;01:22:06;80525877;79967852;558025;
12.01.2019;01:23:04;80525948;79967886;558062;
12.01.2019;01:24:05;80526023;79967925;558098;
12.01.2019;01:25:11;80526093;79967962;558131;
12.01.2019;01:26:05;80526174;79967993;558181;
12.01.2019;01:27:04;80526253;79968033;558220;
12.01.2019;01:28:07;80526329;79968059;558270;
12.01.2019;01:29:14;80526413;79968099;558314;
12.01.2019;01:30:10;80526491;79968131;558360;
12.01.2019;01:31:10;80526563;79968176;558387;
12.01.2019;01:32:05;80526634;79968227;558407;
12.01.2019;01:33:10;80526692;79968267;558425;
12.01.2019;01:34:04;80526767;79968297;558470;
12.01.2019;01:35:06;80526835;79968344;558491;
12.01.2019;01:36:04;80526911;79968372;558539;
12.01.2019;01:37:04;80526983;79968413;558570;
12.01.2019;01:38:06;80527052;79968458;558594;
12.01.2019;01:39:07;80527127;79968506;558621;
12.01.2019;01:40:11;80527188;79968549;558639;
12.01.2019;01:41:05;80527254;79968601;558653;
12.01.2019;01:42:05;80527318;79968645;558673;
12.01.2019;01:43:10;80527387;79968694;558693;
12.01.2019;01:44:06;80527451;79968724;558727;
12.01.2019;01:45:10;80527536;79968764;558772;
12.01.2019;01:46:05;80527596;79968804;558792;
12.01.2019;01:47:06;80527673;79968842;558831;
12.01.2019;01:48:12;80527738;79968883;558855;
12.01.2019;01:49:05;80527813;79968925;558888;
12.01.2019;01:50:06;80527910;79968978;558932;
12.01.2019;01:51:05;80527983;79969025;558958;
12.01.2019;01:52:05;80528062;79969076;558986;
12.01.2019;01:53:06;80528144;79969134;559010;
12.01.2019;01:54:10;80528221;79969181;559040;
12.01.2019;01:55:07;80528298;79969223;559075;
12.01.2019;01:56:06;80528366;79969277;559089;
12.01.2019;01:57:10;80528475;79969348;559127;
12.01.2019;01:58:05;80528553;79969394;559159;
12.01.2019;01:59:05;80528609;79969448;559161;
12.01.2019;02:00:06;80528684;79969499;559185;
12.01.2019;02:01:04;80528752;79969556;559196;
12.01.2019;02:02:11;80528843;79969624;559219;
12.01.2019;02:03:06;80528904;79969675;559229;
12.01.2019;02:04:05;80528967;79969719;559248;
12.01.2019;02:05:06;80529028;79969782;559246;
12.01.2019;02:06:04;80529125;79969837;559288;
12.01.2019;02:07:06;80529194;79969888;559306;
12.01.2019;02:08:05;80529265;79969945;559320;
12.01.2019;02:09:07;80529340;79969995;559345;
12.01.2019;02:10:12;80529406;79970049;559357;
12.01.2019;02:11:10;80529447;79970083;559364;
12.01.2019;02:12:10;80529501;79970133;559368;
12.01.2019;02:13:11;80529552;79970202;559350;
12.01.2019;02:14:10;80529616;79970268;559348;
12.01.2019;02:15:05;80529674;79970328;559346;
12.01.2019;02:16:05;80529745;79970366;559379;
12.01.2019;02:17:05;80529805;79970434;559371;
12.01.2019;02:18:04;80529849;79970485;559364;
12.01.2019;02:19:05;80529915;79970552;559363;
12.01.2019;02:20:12;80529989;79970615;559374;
12.01.2019;02:21:06;80530041;79970686;559355;
12.01.2019;02:22:05;80530111;79970749;559362;
12.01.2019;02:23:05;80530186;79970809;559377;
12.01.2019;02:24:05;80530277;79970889;559388;
12.01.2019;02:25:06;80530348;79970942;559406;
12.01.2019;02:26:04;80530422;79971010;559412;
12.01.2019;02:27:05;80530494;79971064;559430;
12.01.2019;02:28:06;80530563;79971136;559427;
12.01.2019;02:29:06;80530644;79971216;559428;
12.01.2019;02:30:11;80530731;79971293;559438;
12.01.2019;02:31:04;80530797;79971354;559443;
12.01.2019;02:32:11;80530884;79971412;559472;
12.01.2019;02:33:05;80530975;79971478;559497;
12.01.2019;02:34:10;80531057;79971568;559489;
12.01.2019;02:35:05;80531119;79971626;559493;
12.01.2019;02:36:05;80531195;79971711;559484;
12.01.2019;02:37:10;80531284;79971802;559482;
12.01.2019;02:38:06;80531342;79971881;559461;
12.01.2019;02:39:06;80531400;79971951;559449;
12.01.2019;02:40:05;80531476;79972029;559447;
12.01.2019;02:41:06;80531550;79972099;559451;
12.01.2019;02:42:11;80531627;79972191;559436;
12.01.2019;02:43:05;80531699;79972260;559439;
12.01.2019;02:44:12;80531782;79972346;559436;
12.01.2019;02:45:05;80531854;79972416;559438;
12.01.2019;02:46:11;80531935;79972518;559417;
12.01.2019;02:47:11;80532016;79972586;559430;
12.01.2019;02:48:06;80532090;79972655;559435;
12.01.2019;02:49:12;80532160;79972777;559383;
12.01.2019;02:50:11;80532254;79972859;559395;
12.01.2019;02:51:06;80532320;79972942;559378;
12.01.2019;02:52:06;80532399;79973027;559372;
12.01.2019;02:53:06;80532478;79973128;559350;
12.01.2019;02:54:05;80532567;79973219;559348;
12.01.2019;02:55:04;80532654;79973311;559343;
12.01.2019;02:56:12;80532706;79973406;559300;
12.01.2019;02:57:05;80532774;79973491;559283;
12.01.2019;02:58:05;80532855;79973578;559277;
12.01.2019;02:59:05;80532919;79973658;559261;
12.01.2019;03:00:12;80532991;79973751;559240;
12.01.2019;03:01:11;80533061;79973830;559231;
12.01.2019;03:02:10;80533122;79973920;559202;
12.01.2019;03:03:10;80533187;79974017;559170;
12.01.2019;03:04:05;80533254;79974092;559162;
12.01.2019;03:05:10;80533353;79974206;559147;
12.01.2019;03:06:12;80533423;79974292;559131;
12.01.2019;03:07:06;80533516;79974375;559141;
12.01.2019;03:08:06;80533599;79974455;559144;
12.01.2019;03:09:07;80533693;79974528;559165;
12.01.2019;03:10:09;80533765;79974627;559138;
12.01.2019;03:11:06;80533840;79974718;559122;
12.01.2019;03:12:10;80533925;79974851;559074;
12.01.2019;03:13:10;80533975;79974951;559024;
12.01.2019;03:14:07;80534050;79975029;559021;
12.01.2019;03:15:12;80534134;79975137;558997;
12.01.2019;03:16:06;80534188;79975223;558965;
12.01.2019;03:17:05;80534291;79975331;558960;
12.01.2019;03:18:09;80534363;79975434;558929;
12.01.2019;03:19:06;80534433;79975524;558909;
12.01.2019;03:20:06;80534515;79975614;558901;
12.01.2019;03:21:05;80534610;79975711;558899;
12.01.2019;03:22:06;80534684;79975806;558878;
12.01.2019;03:23:06;80534785;79975887;558898;
12.01.2019;03:24:05;80534860;79975986;558874;
12.01.2019;03:25:04;80534954;79976067;558887;
12.01.2019;03:26:10;80535060;79976165;558895;
12.01.2019;03:27:05;80535152;79976260;558892;
12.01.2019;03:28:06;80535214;79976353;558861;
12.01.2019;03:29:06;80535286;79976466;558820;
12.01.2019;03:30:06;80535373;79976576;558797;
12.01.2019;03:31:10;80535451;79976687;558764;
12.01.2019;03:32:07;80535512;79976805;558707;
12.01.2019;03:33:09;80535598;79976931;558667;
12.01.2019;03:34:09;80535682;79977049;558633;
12.01.2019;03:35:07;80535767;79977156;558611;
12.01.2019;03:36:06;80535852;79977254;558598;
12.01.2019;03:37:10;80535922;79977365;558557;
12.01.2019;03:38:05;80535987;79977462;558525;
12.01.2019;03:39:08;80536064;79977576;558488;
12.01.2019;03:40:10;80536140;79977695;558445;
12.01.2019;03:41:05;80536229;79977798;558431;
12.01.2019;03:42:05;80536305;79977922;558383;
12.01.2019;03:43:05;80536401;79978048;558353;
12.01.2019;03:44:05;80536484;79978153;558331;
12.01.2019;03:45:12;80536552;79978264;558288;
12.01.2019;03:46:06;80536653;79978370;558283;
12.01.2019;03:47:06;80536725;79978475;558250;
12.01.2019;03:48:05;80536806;79978590;558216;
12.01.2019;03:49:04;80536875;79978680;558195;
12.01.2019;03:50:06;80536952;79978780;558172;
12.01.2019;03:51:06;80537038;79978896;558142;
12.01.2019;03:52:10;80537113;79979014;558099;
12.01.2019;03:53:11;80537209;79979129;558080;
12.01.2019;03:54:06;80537275;79979206;558069;
12.01.2019;03:55:06;80537350;79979314;558036;
12.01.2019;03:56:06;80537443;79979421;558022;
12.01.2019;03:57:10;80537518;79979531;557987;
12.01.2019;03:58:11;80537583;79979663;557920;
12.01.2019;03:59:06;80537659;79979766;557893;
12.01.2019;04:00:12;80537756;79979889;557867;
12.01.2019;04:01:07;80537824;79980000;557824;
12.01.2019;04:02:07;80537919;79980104;557815;
12.01.2019;04:03:06;80538006;79980229;557777;
12.01.2019;04:04:08;80538074;79980344;557730;
12.01.2019;04:05:07;80538142;79980461;557681;
12.01.2019;04:06:11;80538204;79980592;557612;
12.01.2019;04:07:05;80538272;79980716;557556;
12.01.2019;04:08:05;80538359;79980838;557521;
12.01.2019;04:09:04;80538424;79980960;557464;
12.01.2019;04:10:06;80538473;79981085;557388;
12.01.2019;04:11:11;80538558;79981222;557336;
12.01.2019;04:12:12;80538637;79981363;557274;
12.01.2019;04:13:10;80538705;79981462;557243;
12.01.2019;04:14:11;80538756;79981583;557173;
12.01.2019;04:15:08;80538762;79981655;557107;
12.01.2019;04:16:05;80538831;79981750;557081;
12.01.2019;04:17:12;80538889;79981882;557007;
12.01.2019;04:18:06;80538955;79981993;556962;
12.01.2019;04:19:06;80539034;79982112;556922;
12.01.2019;04:20:05;80539102;79982232;556870;
12.01.2019;04:21:05;80539183;79982348;556835;
12.01.2019;04:22:05;80539252;79982467;556785;
12.01.2019;04:23:06;80539339;79982577;556762;
12.01.2019;04:24:11;80539397;79982697;556700;
12.01.2019;04:25:07;80539467;79982816;556651;
12.01.2019;04:26:10;80539535;79982972;556563;
12.01.2019;04:27:06;80539616;79983082;556534;
12.01.2019;04:28:05;80539698;79983204;556494;
12.01.2019;04:29:06;80539795;79983323;556472;
12.01.2019;04:30:05;80539886;79983457;556429;
12.01.2019;04:31:06;80539959;79983580;556379;
12.01.2019;04:32:04;80540068;79983689;556379;
12.01.2019;04:33:05;80540144;79983803;556341;
12.01.2019;04:34:04;80540234;79983924;556310;
12.01.2019;04:35:06;80540319;79984054;556265;
12.01.2019;04:36:06;80540411;79984196;556215;
12.01.2019;04:37:11;80540488;79984318;556170;
12.01.2019;04:38:04;80540583;79984429;556154;
12.01.2019;04:39:07;80540668;79984548;556120;
12.01.2019;04:40:05;80540747;79984680;556067;
12.01.2019;04:41:11;80540834;79984826;556008;
12.01.2019;04:42:06;80540918;79984935;555983;
12.01.2019;04:43:05;80540982;79985080;555902;
12.01.2019;04:44:05;80541068;79985230;555838;
12.01.2019;04:45:05;80541156;79985368;555788;
12.01.2019;04:46:05;80541232;79985485;555747;
12.01.2019;04:47:10;80541338;79985639;555699;
12.01.2019;04:48:06;80541398;79985767;555631;
12.01.2019;04:49:12;80541502;79985893;555609;
12.01.2019;04:50:05;80541572;79986011;555561;
12.01.2019;04:51:11;80541661;79986136;555525;
12.01.2019;04:52:05;80541725;79986262;555463;
12.01.2019;04:53:10;80541797;79986390;555407;
12.01.2019;04:54:06;80541874;79986516;555358;
12.01.2019;04:55:06;80541938;79986651;555287;
12.01.2019;04:56:06;80542018;79986773;555245;
12.01.2019;04:57:10;80542072;79986935;555137;
12.01.2019;04:58:06;80542137;79987041;555096;
12.01.2019;04:59:06;80542212;79987187;555025;
12.01.2019;05:00:10;80542281;79987314;554967;
12.01.2019;05:01:12;80542386;79987443;554943;
12.01.2019;05:02:05;80542440;79987554;554886;
12.01.2019;05:03:05;80542496;79987695;554801;
12.01.2019;05:04:04;80542574;79987826;554748;
12.01.2019;05:05:06;80542664;79987942;554722;
12.01.2019;05:06:07;80542724;79988052;554672;
12.01.2019;05:07:04;80542811;79988183;554628;
12.01.2019;05:08:11;80542878;79988329;554549;
12.01.2019;05:09:13;80542968;79988471;554497;
12.01.2019;05:10:13;80543043;79988631;554412;
12.01.2019;05:11:10;80543114;79988767;554347;
12.01.2019;05:12:07;80543183;79988879;554304;
12.01.2019;05:13:05;80543254;79989002;554252;
12.01.2019;05:14:11;80543340;79989132;554208;
12.01.2019;05:15:10;80543413;79989283;554130;
12.01.2019;05:16:10;80543491;79989421;554070;
12.01.2019;05:17:05;80543561;79989520;554041;
12.01.2019;05:18:05;80543644;79989661;553983;
12.01.2019;05:19:06;80543721;79989807;553914;
12.01.2019;05:20:06;80543780;79989922;553858;
12.01.2019;05:21:06;80543861;79990057;553804;
12.01.2019;05:22:10;80543924;79990202;553722;
12.01.2019;05:23:05;80544029;79990341;553688;
12.01.2019;05:24:05;80544104;79990462;553642;
12.01.2019;05:25:10;80544187;79990619;553568;
12.01.2019;05:26:11;80544269;79990747;553522;
12.01.2019;05:27:11;80544346;79990865;553481;
12.01.2019;05:28:04;80544423;79990981;553442;
12.01.2019;05:29:12;80544512;79991128;553384;
12.01.2019;05:30:06;80544591;79991237;553354;
12.01.2019;05:31:07;80544681;79991358;553323;
12.01.2019;05:32:06;80544773;79991494;553279;
12.01.2019;05:33:04;80544838;79991627;553211;
12.01.2019;05:34:05;80544918;79991763;553155;
12.01.2019;05:35:11;80544996;79991909;553087;
12.01.2019;05:36:11;80545091;79992035;553056;
12.01.2019;05:37:05;80545168;79992172;552996;
12.01.2019;05:38:10;80545240;79992300;552940;
12.01.2019;05:39:06;80545323;79992415;552908;
12.01.2019;05:40:07;80545400;79992567;552833;
12.01.2019;05:41:05;80545494;79992685;552809;
12.01.2019;05:42:10;80545575;79992824;552751;
12.01.2019;05:43:07;80545634;79992940;552694;
12.01.2019;05:44:06;80545716;79993087;552629;
12.01.2019;05:45:06;80545772;79993224;552548;
12.01.2019;05:46:07;80545853;79993382;552471;
12.01.2019;05:47:11;80545919;79993547;552372;
12.01.2019;05:48:06;80545980;79993676;552304;
12.01.2019;05:49:10;80546073;79993837;552236;
12.01.2019;05:50:06;80546143;79993956;552187;
12.01.2019;05:51:06;80546218;79994105;552113;
12.01.2019;05:52:11;80546284;79994276;552008;
12.01.2019;05:53:04;80546370;79994419;551951;
12.01.2019;05:54:10;80546460;79994539;551921;
12.01.2019;05:55:06;80546527;79994672;551855;
12.01.2019;05:56:06;80546596;79994821;551775;
12.01.2019;05:57:11;80546659;79994970;551689;
12.01.2019;05:58:05;80546726;79995115;551611;
12.01.2019;05:59:07;80546783;79995268;551515;
12.01.2019;06:00:05;80546846;79995416;551430;
12.01.2019;06:01:05;80546906;79995532;551374;
12.01.2019;06:02:04;80546964;79995670;551294;
12.01.2019;06:03:04;80547037;79995823;551214;
12.01.2019;06:04:06;80547109;79995975;551134;
12.01.2019;06:05:06;80547169;79996116;551053;
12.01.2019;06:06:06;80547218;79996236;550982;
12.01.2019;06:07:06;80547276;79996364;550912;
12.01.2019;06:08:07;80547334;79996523;550811;
12.01.2019;06:09:09;80547427;79996670;550757;
12.01.2019;06:10:06;80547497;79996788;550709;
12.01.2019;06:11:05;80547538;79996922;550616;
12.01.2019;06:12:04;80547575;79997051;550524;
12.01.2019;06:13:07;80547639;79997178;550461;
12.01.2019;06:14:06;80547671;79997298;550373;
12.01.2019;06:15:06;80547749;79997437;550312;
12.01.2019;06:16:06;80547820;79997559;550261;
12.01.2019;06:17:06;80547876;79997704;550172;
12.01.2019;06:18:06;80547958;79997819;550139;
12.01.2019;06:19:04;80548006;79997945;550061;
12.01.2019;06:20:05;80548077;79998087;549990;
12.01.2019;06:21:05;80548142;79998216;549926;
12.01.2019;06:22:04;80548207;79998349;549858;
12.01.2019;06:23:06;80548279;79998529;549750;
12.01.2019;06:24:06;80548345;79998638;549707;
12.01.2019;06:25:15;80548411;79998836;549575;
12.01.2019;06:26:05;80548467;79998957;549510;
12.01.2019;06:27:06;80548528;79999097;549431;
12.01.2019;06:28:12;80548634;79999247;549387;
12.01.2019;06:29:10;80548702;79999381;549321;
12.01.2019;06:30:11;80548776;79999542;549234;
12.01.2019;06:31:05;80548832;79999683;549149;
12.01.2019;06:32:09;80548897;79999833;549064;
12.01.2019;06:33:06;80548976;79999993;548983;
12.01.2019;06:34:11;80549035;80000176;548859;
12.01.2019;06:35:05;80549102;80000309;548793;
12.01.2019;06:36:10;80549158;80000481;548677;
12.01.2019;06:37:07;80549231;80000618;548613;
12.01.2019;06:38:07;80549297;80000748;548549;
12.01.2019;06:39:08;80549375;80000900;548475;
12.01.2019;06:40:07;80549455;80001021;548434;
12.01.2019;06:41:05;80549516;80001167;548349;
12.01.2019;06:42:06;80549599;80001316;548283;
12.01.2019;06:43:07;80549669;80001447;548222;
12.01.2019;06:44:06;80549741;80001589;548152;
12.01.2019;06:45:07;80549821;80001704;548117;
12.01.2019;06:46:06;80549867;80001823;548044;
12.01.2019;06:47:07;80549940;80001957;547983;
12.01.2019;06:48:12;80550028;80002101;547927;
12.01.2019;06:49:05;80550081;80002245;547836;
12.01.2019;06:50:07;80550145;80002428;547717;
12.01.2019;06:51:06;80550198;80002567;547631;
12.01.2019;06:52:06;80550272;80002727;547545;
12.01.2019;06:53:10;80550341;80002878;547463;
12.01.2019;06:54:09;80550403;80003009;547394;
12.01.2019;06:55:06;80550460;80003120;547340;
12.01.2019;06:56:06;80550522;80003264;547258;
12.01.2019;06:57:05;80550597;80003402;547195;
12.01.2019;06:58:06;80550652;80003528;547124;
12.01.2019;06:59:11;80550735;80003683;547052;
12.01.2019;07:00:10;80550793;80003812;546981;
12.01.2019;07:01:12;80550845;80003950;546895;
12.01.2019;07:02:07;80550906;80004096;546810;
12.01.2019;07:03:06;80550969;80004225;546744;
12.01.2019;07:04:06;80551032;80004370;546662;
12.01.2019;07:05:06;80551111;80004488;546623;
12.01.2019;07:06:06;80551197;80004629;546568;
12.01.2019;07:07:12;80551270;80004796;546474;
12.01.2019;07:08:10;80551347;80004918;546429;
12.01.2019;07:09:10;80551415;80005033;546382;
12.01.2019;07:10:06;80551425;80005116;546309;
12.01.2019;07:11:05;80551494;80005269;546225;
12.01.2019;07:12:06;80551556;80005394;546162;
12.01.2019;07:13:05;80551624;80005522;546102;
12.01.2019;07:14:05;80551668;80005671;545997;
12.01.2019;07:15:10;80551749;80005817;545932;
12.01.2019;07:16:06;80551825;80005943;545882;
12.01.2019;07:17:12;80551880;80006107;545773;
12.01.2019;07:18:05;80551944;80006247;545697;
12.01.2019;07:19:06;80552022;80006383;545639;
12.01.2019;07:20:11;80552086;80006514;545572;
12.01.2019;07:21:06;80552168;80006640;545528;
12.01.2019;07:22:06;80552238;80006791;545447;
12.01.2019;07:23:07;80552311;80006955;545356;
12.01.2019;07:24:12;80552392;80007142;545250;
12.01.2019;07:25:06;80552431;80007271;545160;
12.01.2019;07:26:04;80552505;80007421;545084;
12.01.2019;07:27:05;80552569;80007549;545020;
12.01.2019;07:28:06;80552632;80007694;544938;
12.01.2019;07:29:06;80552708;80007828;544880;
12.01.2019;07:30:07;80552783;80007967;544816;
12.01.2019;07:31:05;80552854;80008100;544754;
12.01.2019;07:32:06;80552917;80008258;544659;
12.01.2019;07:33:05;80552972;80008402;544570;
12.01.2019;07:34:05;80553046;80008526;544520;
12.01.2019;07:35:04;80553109;80008638;544471;
12.01.2019;07:36:07;80553186;80008760;544426;
12.01.2019;07:37:04;80553246;80008867;544379;
12.01.2019;07:38:04;80553327;80008997;544330;
12.01.2019;07:39:07;80553388;80009117;544271;
12.01.2019;07:40:04;80553457;80009215;544242;
12.01.2019;07:41:09;80553519;80009364;544155;
12.01.2019;07:42:05;80553581;80009487;544094;
12.01.2019;07:43:04;80553638;80009618;544020;
12.01.2019;07:44:05;80553678;80009749;543929;
12.01.2019;07:45:04;80553751;80009879;543872;
12.01.2019;07:46:05;80553822;80010012;543810;
12.01.2019;07:47:06;80553872;80010137;543735;
12.01.2019;07:48:06;80553936;80010290;543646;
12.01.2019;07:49:05;80554001;80010422;543579;
12.01.2019;07:50:04;80554063;80010553;543510;
12.01.2019;07:51:05;80554134;80010703;543431;
12.01.2019;07:52:05;80554209;80010850;543359;
12.01.2019;07:53:04;80554272;80010986;543286;
12.01.2019;07:54:04;80554323;80011108;543215;
12.01.2019;07:55:05;80554396;80011255;543141;
12.01.2019;07:56:04;80554450;80011408;543042;
12.01.2019;07:57:05;80554513;80011557;542956;
12.01.2019;07:58:04;80554589;80011705;542884;
12.01.2019;07:59:04;80554659;80011860;542799;
12.01.2019;08:00:05;80554723;80012013;542710;
12.01.2019;08:01:06;80554796;80012118;542678;
12.01.2019;08:02:04;80554850;80012252;542598;
12.01.2019;08:03:05;80554890;80012348;542542;
12.01.2019;08:04:05;80554941;80012485;542456;
12.01.2019;08:05:04;80555002;80012597;542405;
12.01.2019;08:06:04;80555061;80012740;542321;
12.01.2019;08:07:05;80555119;80012885;542234;
12.01.2019;08:08:04;80555199;80013041;542158;
12.01.2019;08:09:06;80555275;80013175;542100;
12.01.2019;08:10:04;80555325;80013298;542027;
12.01.2019;08:11:04;80555371;80013428;541943;
12.01.2019;08:12:05;80555419;80013547;541872;
12.01.2019;08:13:04;80555481;80013684;541797;
12.01.2019;08:14:04;80555541;80013813;541728;
12.01.2019;08:15:05;80555602;80013951;541651;
12.01.2019;08:16:04;80555672;80014079;541593;
12.01.2019;08:17:04;80555728;80014215;541513;
12.01.2019;08:18:10;80555801;80014348;541453;
12.01.2019;08:19:10;80555854;80014462;541392;
12.01.2019;08:20:04;80555916;80014601;541315;
12.01.2019;08:21:04;80555971;80014734;541237;
12.01.2019;08:22:05;80556046;80014881;541165;
12.01.2019;08:23:04;80556132;80015030;541102;
12.01.2019;08:24:04;80556205;80015173;541032;
12.01.2019;08:25:06;80556274;80015343;540931;
12.01.2019;08:26:07;80556336;80015478;540858;
12.01.2019;08:27:12;80556417;80015638;540779;
12.01.2019;08:28:06;80556463;80015764;540699;
12.01.2019;08:29:06;80556527;80015897;540630;
12.01.2019;08:30:06;80556588;80016035;540553;
12.01.2019;08:31:04;80556646;80016173;540473;
12.01.2019;08:32:06;80556709;80016308;540401;
12.01.2019;08:33:06;80556778;80016463;540315;
12.01.2019;08:34:06;80556831;80016608;540223;
12.01.2019;08:35:05;80556891;80016735;540156;
12.01.2019;08:36:08;80556956;80016877;540079;
12.01.2019;08:37:06;80557030;80017015;540015;
12.01.2019;08:38:06;80557087;80017141;539946;
12.01.2019;08:39:06;80557165;80017284;539881;
12.01.2019;08:40:04;80557217;80017421;539796;
12.01.2019;08:41:06;80557275;80017512;539763;
12.01.2019;08:42:05;80557331;80017629;539702;
12.01.2019;08:43:06;80557394;80017724;539670;
12.01.2019;08:44:06;80557468;80017849;539619;
12.01.2019;08:45:05;80557546;80017974;539572;
12.01.2019;08:46:06;80557612;80018105;539507;
12.01.2019;08:47:05;80557679;80018254;539425;
12.01.2019;08:48:05;80557729;80018349;539380;
12.01.2019;08:49:04;80557769;80018497;539272;
12.01.2019;08:50:05;80557849;80018618;539231;
12.01.2019;08:51:04;80557920;80018753;539167;
12.01.2019;08:52:05;80557990;80018901;539089;
12.01.2019;08:53:12;80558057;80019037;539020;
12.01.2019;08:54:06;80558105;80019162;538943;
12.01.2019;08:55:06;80558156;80019314;538842;
12.01.2019;08:56:06;80558226;80019445;538781;
12.01.2019;08:57:06;80558292;80019588;538704;
12.01.2019;08:58:04;80558368;80019717;538651;
12.01.2019;08:59:10;80558441;80019859;538582;
12.01.2019;09:00:10;80558500;80020000;538500;
12.01.2019;09:01:10;80558569;80020162;538407;
12.01.2019;09:02:12;80558622;80020291;538331;
12.01.2019;09:03:06;80558689;80020399;538290;
12.01.2019;09:04:10;80558742;80020564;538178;
12.01.2019;09:05:05;80558807;80020699;538108;
12.01.2019;09:06:12;80558876;80020857;538019;
12.01.2019;09:07:06;80558929;80020975;537954;
12.01.2019;09:08:06;80558982;80021125;537857;
12.01.2019;09:09:08;80559044;80021284;537760;
12.01.2019;09:10:06;80559106;80021409;537697;
12.01.2019;09:11:05;80559168;80021553;537615;
12.01.2019;09:12:05;80559238;80021673;537565;
12.01.2019;09:13:05;80559287;80021816;537471;
12.01.2019;09:14:05;80559348;80021952;537396;
12.01.2019;09:15:07;80559398;80022078;537320;
12.01.2019;09:16:07;80559453;80022207;537246;
12.01.2019;09:17:05;80559519;80022335;537184;
12.01.2019;09:18:05;80559586;80022504;537082;
12.01.2019;09:19:05;80559655;80022631;537024;
12.01.2019;09:20:04;80559724;80022776;536948;
12.01.2019;09:21:05;80559785;80022926;536859;
12.01.2019;09:22:06;80559838;80023058;536780;
12.01.2019;09:23:07;80559886;80023204;536682;
12.01.2019;09:24:07;80559949;80023345;536604;
12.01.2019;09:25:06;80560011;80023472;536539;
12.01.2019;09:26:06;80560076;80023621;536455;
12.01.2019;09:27:05;80560135;80023759;536376;
12.01.2019;09:28:04;80560201;80023909;536292;
12.01.2019;09:29:04;80560270;80024051;536219;
12.01.2019;09:30:05;80560323;80024168;536155;
12.01.2019;09:31:04;80560381;80024315;536066;
12.01.2019;09:32:04;80560438;80024455;535983;
12.01.2019;09:33:05;80560498;80024576;535922;
12.01.2019;09:34:04;80560582;80024709;535873;
12.01.2019;09:35:05;80560639;80024870;535769;
12.01.2019;09:36:05;80560697;80025033;535664;
12.01.2019;09:37:04;80560756;80025181;535575;
12.01.2019;09:38:05;80560821;80025328;535493;
12.01.2019;09:39:06;80560888;80025497;535391;
12.01.2019;09:40:04;80560938;80025634;535304;
12.01.2019;09:41:05;80561004;80025777;535227;
12.01.2019;09:42:04;80561071;80025906;535165;
12.01.2019;09:43:04;80561113;80026032;535081;
12.01.2019;09:44:05;80561167;80026170;534997;
12.01.2019;09:45:05;80561253;80026293;534960;
12.01.2019;09:46:04;80561310;80026437;534873;
12.01.2019;09:47:04;80561357;80026580;534777;
12.01.2019;09:48:05;80561423;80026723;534700;
12.01.2019;09:49:06;80561493;80026876;534617;
12.01.2019;09:50:04;80561545;80027014;534531;
12.01.2019;09:51:06;80561609;80027173;534436;
12.01.2019;09:52:07;80561658;80027307;534351;
12.01.2019;09:53:05;80561718;80027454;534264;
12.01.2019;09:54:05;80561786;80027605;534181;
12.01.2019;09:55:06;80561844;80027759;534085;
12.01.2019;09:56:04;80561910;80027902;534008;
12.01.2019;09:57:04;80561977;80028049;533928;
12.01.2019;09:58:06;80562038;80028212;533826;
12.01.2019;09:59:11;80562108;80028362;533746;
12.01.2019;10:00:05;80562163;80028480;533683;
12.01.2019;10:01:04;80562183;80028602;533581;
12.01.2019;10:02:05;80562208;80028755;533453;
12.01.2019;10:03:04;80562282;80028892;533390;
12.01.2019;10:04:04;80562343;80029031;533312;
12.01.2019;10:05:05;80562415;80029191;533224;
12.01.2019;10:06:04;80562478;80029313;533165;
12.01.2019;10:07:04;80562517;80029442;533075;
12.01.2019;10:08:11;80562565;80029581;532984;
12.01.2019;10:09:07;80562610;80029702;532908;
12.01.2019;10:10:05;80562650;80029820;532830;
12.01.2019;10:11:04;80562682;80029923;532759;
12.01.2019;10:12:05;80562740;80030042;532698;
12.01.2019;10:13:05;80562787;80030200;532587;
12.01.2019;10:14:04;80562845;80030361;532484;
12.01.2019;10:15:04;80562898;80030518;532380;
12.01.2019;10:16:05;80562957;80030670;532287;
12.01.2019;10:17:05;80563017;80030838;532179;
12.01.2019;10:18:04;80563085;80030987;532098;
12.01.2019;10:19:05;80563139;80031129;532010;
12.01.2019;10:20:04;80563196;80031284;531912;
12.01.2019;10:21:05;80563234;80031412;531822;
12.01.2019;10:22:04;80563290;80031524;531766;
12.01.2019;10:23:04;80563344;80031680;531664;
12.01.2019;10:24:05;80563392;80031834;531558;
12.01.2019;10:25:05;80563453;80031973;531480;
12.01.2019;10:26:04;80563517;80032117;531400;
12.01.2019;10:27:04;80563586;80032258;531328;
12.01.2019;10:28:05;80563634;80032422;531212;
12.01.2019;10:29:05;80563687;80032543;531144;
12.01.2019;10:30:04;80563743;80032700;531043;
12.01.2019;10:31:04;80563815;80032826;530989;
12.01.2019;10:32:05;80563880;80032996;530884;
12.01.2019;10:33:05;80563930;80033159;530771;
12.01.2019;10:34:04;80563984;80033296;530688;
12.01.2019;10:35:05;80564038;80033446;530592;
12.01.2019;10:36:04;80564093;80033587;530506;
12.01.2019;10:37:05;80564140;80033748;530392;
12.01.2019;10:38:04;80564216;80033894;530322;
12.01.2019;10:39:04;80564290;80034041;530249;
12.01.2019;10:40:04;80564348;80034196;530152;
12.01.2019;10:41:05;80564412;80034365;530047;
12.01.2019;10:42:05;80564475;80034503;529972;
12.01.2019;10:43:04;80564528;80034653;529875;
12.01.2019;10:44:04;80564573;80034782;529791;
12.01.2019;10:45:04;80564628;80034931;529697;
12.01.2019;10:46:05;80564674;80035078;529596;
12.01.2019;10:47:05;80564751;80035231;529520;
12.01.2019;10:48:04;80564810;80035367;529443;
12.01.2019;10:49:05;80564879;80035494;529385;
12.01.2019;10:50:05;80564949;80035632;529317;
12.01.2019;10:51:05;80565012;80035735;529277;
12.01.2019;10:52:04;80565075;80035859;529216;
12.01.2019;10:53:04;80565124;80035978;529146;
12.01.2019;10:54:05;80565180;80036119;529061;
12.01.2019;10:55:05;80565243;80036261;528982;
12.01.2019;10:56:04;80565309;80036395;528914;
12.01.2019;10:57:04;80565366;80036532;528834;
12.01.2019;10:58:05;80565427;80036686;528741;
12.01.2019;10:59:05;80565492;80036834;528658;
12.01.2019;11:00:04;80565567;80036956;528611;
12.01.2019;11:01:04;80565615;80037108;528507;
12.01.2019;11:02:05;80565675;80037256;528419;
12.01.2019;11:03:05;80565740;80037409;528331;
12.01.2019;11:04:04;80565803;80037546;528257;
12.01.2019;11:05:10;80565847;80037669;528178;
12.01.2019;11:06:05;80565921;80037804;528117;
12.01.2019;11:07:04;80565969;80037946;528023;
12.01.2019;11:08:04;80566027;80038087;527940;
12.01.2019;11:09:07;80566082;80038247;527835;
12.01.2019;11:10:05;80566146;80038395;527751;
12.01.2019;11:11:06;80566203;80038522;527681;
12.01.2019;11:12:04;80566270;80038677;527593;
12.01.2019;11:13:04;80566326;80038806;527520;
12.01.2019;11:14:04;80566381;80038931;527450;
12.01.2019;11:15:05;80566457;80039078;527379;
12.01.2019;11:16:05;80566531;80039208;527323;
12.01.2019;11:17:05;80566598;80039373;527225;
12.01.2019;11:18:05;80566664;80039498;527166;
12.01.2019;11:19:05;80566727;80039641;527086;
12.01.2019;11:20:05;80566791;80039763;527028;
12.01.2019;11:21:04;80566867;80039905;526962;
12.01.2019;11:22:04;80566930;80040028;526902;
12.01.2019;11:23:05;80566985;80040169;526816;
12.01.2019;11:24:04;80567047;80040334;526713;
12.01.2019;11:25:04;80567115;80040477;526638;
12.01.2019;11:26:05;80567187;80040643;526544;
12.01.2019;11:27:05;80567265;80040801;526464;
12.01.2019;11:28:05;80567328;80040957;526371;
12.01.2019;11:29:05;80567397;80041116;526281;
12.01.2019;11:30:05;80567465;80041271;526194;
12.01.2019;11:31:04;80567521;80041435;526086;
12.01.2019;11:32:04;80567581;80041581;526000;
12.01.2019;11:33:05;80567647;80041753;525894;
12.01.2019;11:34:05;80567720;80041873;525847;
12.01.2019;11:35:04;80567795;80042023;525772;
12.01.2019;11:36:04;80567856;80042189;525667;
12.01.2019;11:37:05;80567921;80042347;525574;
12.01.2019;11:38:07;80567968;80042517;525451;
12.01.2019;11:39:06;80568057;80042669;525388;
12.01.2019;11:40:04;80568107;80042784;525323;
12.01.2019;11:41:05;80568192;80042932;525260;
12.01.2019;11:42:05;80568257;80043067;525190;
12.01.2019;11:43:04;80568306;80043195;525111;
12.01.2019;11:44:04;80568368;80043335;525033;
12.01.2019;11:45:04;80568418;80043475;524943;
12.01.2019;11:46:05;80568489;80043638;524851;
12.01.2019;11:47:05;80568564;80043776;524788;
12.01.2019;11:48:04;80568612;80043930;524682;
12.01.2019;11:49:09;80568669;80044068;524601;
12.01.2019;11:50:05;80568748;80044209;524539;
12.01.2019;11:51:05;80568810;80044364;524446;
12.01.2019;11:52:05;80568871;80044501;524370;
12.01.2019;11:53:05;80568937;80044639;524298;
12.01.2019;11:54:04;80569014;80044803;524211;
12.01.2019;11:55:05;80569079;80044955;524124;
12.01.2019;11:56:05;80569144;80045093;524051;
12.01.2019;11:57:06;80569199;80045259;523940;
12.01.2019;11:58:05;80569271;80045390;523881;
12.01.2019;11:59:05;80569327;80045532;523795;
12.01.2019;12:00:05;80569378;80045699;523679;
12.01.2019;12:01:04;80569453;80045857;523596;
12.01.2019;12:02:04;80569505;80046020;523485;
12.01.2019;12:03:09;80569545;80046153;523392;
12.01.2019;12:04:06;80569592;80046259;523333;
12.01.2019;12:05:05;80569627;80046371;523256;
12.01.2019;12:06:04;80569661;80046462;523199;
12.01.2019;12:07:05;80569697;80046572;523125;
12.01.2019;12:08:05;80569740;80046676;523064;
12.01.2019;12:09:07;80569811;80046815;522996;
12.01.2019;12:10:05;80569866;80046959;522907;
12.01.2019;12:11:05;80569907;80047095;522812;
12.01.2019;12:12:05;80569968;80047250;522718;
12.01.2019;12:13:04;80570016;80047387;522629;
12.01.2019;12:14:04;80570088;80047501;522587;
12.01.2019;12:15:05;80570148;80047674;522474;
12.01.2019;12:16:05;80570223;80047824;522399;
12.01.2019;12:17:05;80570291;80047995;522296;
12.01.2019;12:18:05;80570345;80048157;522188;
12.01.2019;12:19:04;80570396;80048315;522081;
12.01.2019;12:20:05;80570460;80048470;521990;
12.01.2019;12:21:05;80570526;80048611;521915;
12.01.2019;12:22:05;80570592;80048758;521834;
12.01.2019;12:23:06;80570661;80048896;521765;
12.01.2019;12:24:04;80570716;80049049;521667;
12.01.2019;12:25:04;80570777;80049188;521589;
12.01.2019;12:26:06;80570834;80049340;521494;
12.01.2019;12:27:05;80570881;80049497;521384;
12.01.2019;12:28:04;80570943;80049645;521298;
12.01.2019;12:29:05;80571006;80049800;521206;
12.01.2019;12:30:05;80571076;80049963;521113;
12.01.2019;12:31:04;80571152;80050114;521038;
12.01.2019;12:32:04;80571205;80050244;520961;
12.01.2019;12:33:04;80571272;80050395;520877;
12.01.2019;12:34:05;80571348;80050534;520814;
12.01.2019;12:35:05;80571413;80050719;520694;
12.01.2019;12:36:04;80571488;80050863;520625;
12.01.2019;12:37:04;80571565;80050998;520567;
12.01.2019;12:38:04;80571640;80051160;520480;
12.01.2019;12:39:05;80571695;80051322;520373;
12.01.2019;12:40:04;80571759;80051472;520287;
12.01.2019;12:41:05;80571838;80051637;520201;
12.01.2019;12:42:05;80571908;80051790;520118;
12.01.2019;12:43:05;80571978;80051928;520050;
12.01.2019;12:44:04;80572048;80052055;519993;
12.01.2019;12:45:04;80572108;80052213;519895;
12.01.2019;12:46:04;80572190;80052370;519820;
12.01.2019;12:47:05;80572264;80052547;519717;
12.01.2019;12:48:05;80572321;80052727;519594;
12.01.2019;12:49:05;80572383;80052913;519470;
12.01.2019;12:50:05;80572447;80053079;519368;
12.01.2019;12:51:05;80572288;80053007;519281;
12.01.2019;12:52:14;80572015;80052937;519078;
12.01.2019;12:53:04;80572056;80053067;518989;
12.01.2019;12:54:05;80572153;80053210;518943;
12.01.2019;12:55:05;80572246;80053350;518896;
12.01.2019;12:56:05;80572318;80053477;518841;
12.01.2019;12:57:05;80572376;80053627;518749;
12.01.2019;12:58:05;80572444;80053808;518636;
12.01.2019;12:59:04;80572521;80053970;518551;
12.01.2019;13:00:04;80572581;80054145;518436;
12.01.2019;13:01:05;80572648;80054321;518327;
12.01.2019;13:02:05;80572727;80054486;518241;
12.01.2019;13:03:05;80572801;80054640;518161;
12.01.2019;13:04:05;80572858;80054797;518061;
12.01.2019;13:05:15;80572930;80054963;517967;
12.01.2019;13:06:05;80572992;80055105;517887;
12.01.2019;13:07:05;80573065;80055269;517796;
12.01.2019;13:08:05;80573134;80055435;517699;
12.01.2019;13:09:06;80573222;80055588;517634;
12.01.2019;13:10:04;80573299;80055771;517528;
12.01.2019;13:11:05;80573371;80055901;517470;
12.01.2019;13:12:05;80573428;80056060;517368;
12.01.2019;13:13:05;80573499;80056196;517303;
12.01.2019;13:14:04;80573568;80056354;517214;
12.01.2019;13:15:04;80573639;80056498;517141;
12.01.2019;13:16:04;80573712;80056655;517057;
12.01.2019;13:17:05;80573772;80056811;516961;
12.01.2019;13:18:05;80573838;80056982;516856;
12.01.2019;13:19:06;80573933;80057132;516801;
12.01.2019;13:20:05;80574002;80057280;516722;
12.01.2019;13:21:05;80574083;80057413;516670;
12.01.2019;13:22:04;80574156;80057563;516593;
12.01.2019;13:23:04;80574213;80057708;516505;
12.01.2019;13:24:05;80574287;80057858;516429;
12.01.2019;13:25:05;80574362;80058007;516355;
12.01.2019;13:26:04;80574449;80058154;516295;
12.01.2019;13:27:04;80574519;80058295;516224;
12.01.2019;13:28:05;80574593;80058443;516150;
12.01.2019;13:29:05;80574665;80058592;516073;
12.01.2019;13:30:04;80574744;80058752;515992;
12.01.2019;13:31:05;80574805;80058885;515920;
12.01.2019;13:32:05;80574891;80059014;515877;
12.01.2019;13:33:05;80574967;80059126;515841;
12.01.2019;13:34:05;80575045;80059271;515774;
12.01.2019;13:35:05;80575120;80059413;515707;
12.01.2019;13:36:04;80575207;80059574;515633;
12.01.2019;13:37:04;80575298;80059707;515591;
12.01.2019;13:38:04;80575375;80059855;515520;
12.01.2019;13:39:07;80575477;80060010;515467;
12.01.2019;13:40:05;80575546;80060167;515379;
12.01.2019;13:41:05;80575609;80060292;515317;
12.01.2019;13:42:04;80575685;80060432;515253;
12.01.2019;13:43:09;80575791;80060609;515182;
12.01.2019;13:44:04;80575861;80060763;515098;
12.01.2019;13:45:04;80575933;80060934;514999;
12.01.2019;13:46:04;80576020;80061088;514932;
12.01.2019;13:47:05;80576103;80061225;514878;
12.01.2019;13:48:05;80576188;80061360;514828;
12.01.2019;13:49:05;80576278;80061500;514778;
12.01.2019;13:50:04;80576346;80061644;514702;
12.01.2019;13:51:04;80576418;80061779;514639;
12.01.2019;13:52:04;80576498;80061929;514569;
12.01.2019;13:53:04;80576590;80062065;514525;
12.01.2019;13:54:05;80576672;80062222;514450;
12.01.2019;13:55:05;80576736;80062336;514400;
12.01.2019;13:56:05;80576814;80062519;514295;
12.01.2019;13:57:04;80576888;80062667;514221;
12.01.2019;13:58:04;80576966;80062816;514150;
12.01.2019;13:59:21;80577057;80062995;514062;
12.01.2019;14:00:04;80577116;80063100;514016;
12.01.2019;14:01:05;80577176;80063254;513922;
12.01.2019;14:02:05;80577245;80063422;513823;
12.01.2019;14:03:04;80577339;80063552;513787;
12.01.2019;14:04:04;80577418;80063702;513716;
12.01.2019;14:05:05;80577485;80063874;513611;
12.01.2019;14:06:05;80577573;80064050;513523;
12.01.2019;14:07:05;80577639;80064209;513430;
12.01.2019;14:08:05;80577694;80064349;513345;
12.01.2019;14:09:06;80577774;80064505;513269;
12.01.2019;14:10:05;80577845;80064624;513221;
12.01.2019;14:11:10;80577916;80064728;513188;
12.01.2019;14:12:04;80577977;80064867;513110;
12.01.2019;14:13:05;80578051;80065003;513048;
12.01.2019;14:14:05;80578114;80065168;512946;
12.01.2019;14:15:06;80578197;80065331;512866;
12.01.2019;14:16:06;80578255;80065518;512737;
12.01.2019;14:17:06;80578305;80065664;512641;
12.01.2019;14:18:05;80578356;80065800;512556;
12.01.2019;14:19:06;80578415;80065915;512500;
12.01.2019;14:20:07;80578462;80066065;512397;
12.01.2019;14:21:11;80578533;80066234;512299;
12.01.2019;14:22:04;80578621;80066389;512232;
12.01.2019;14:23:05;80578736;80066584;512152;
12.01.2019;14:24:06;80578807;80066742;512065;
12.01.2019;14:25:10;80578884;80066915;511969;
12.01.2019;14:26:06;80578940;80067040;511900;
12.01.2019;14:27:11;80579019;80067202;511817;
12.01.2019;14:28:06;80579091;80067345;511746;
12.01.2019;14:29:06;80579160;80067527;511633;
12.01.2019;14:30:05;80579249;80067703;511546;
12.01.2019;14:31:10;80579325;80067893;511432;
12.01.2019;14:32:11;80579399;80068068;511331;
12.01.2019;14:33:07;80579507;80068204;511303;
12.01.2019;14:34:06;80579566;80068380;511186;
12.01.2019;14:35:06;80579647;80068535;511112;
12.01.2019;14:36:11;80579738;80068691;511047;
12.01.2019;14:37:04;80579805;80068840;510965;
12.01.2019;14:38:04;80579890;80069012;510878;
12.01.2019;14:39:10;80579985;80069190;510795;
12.01.2019;14:40:09;80580048;80069351;510697;
12.01.2019;14:41:04;80580126;80069496;510630;
12.01.2019;14:42:05;80580243;80069634;510609;
12.01.2019;14:43:05;80580313;80069793;510520;
12.01.2019;14:44:04;80580396;80069932;510464;
12.01.2019;14:45:04;80580481;80070091;510390;
12.01.2019;14:46:05;80580578;80070263;510315;
12.01.2019;14:47:04;80580682;80070446;510236;
12.01.2019;14:48:04;80580753;80070615;510138;
12.01.2019;14:49:04;80580835;80070773;510062;
12.01.2019;14:50:05;80580919;80070944;509975;
12.01.2019;14:51:04;80581028;80071090;509938;
12.01.2019;14:52:04;80581132;80071253;509879;
12.01.2019;14:53:05;80581215;80071438;509777;
12.01.2019;14:54:05;80581292;80071609;509683;
12.01.2019;14:55:04;80581384;80071780;509604;
12.01.2019;14:56:04;80581471;80071950;509521;
12.01.2019;14:57:05;80581558;80072115;509443;
12.01.2019;14:58:05;80581631;80072291;509340;
12.01.2019;14:59:04;80581729;80072462;509267;
12.01.2019;15:00:08;80581835;80072641;509194;
12.01.2019;15:01:07;80581930;80072803;509127;
12.01.2019;15:02:08;80582010;80072969;509041;
12.01.2019;15:03:07;80582093;80073159;508934;
12.01.2019;15:04:07;80582175;80073341;508834;
12.01.2019;15:05:09;80582258;80073500;508758;
12.01.2019;15:06:07;80582347;80073645;508702;
12.01.2019;15:07:08;80582444;80073816;508628;
12.01.2019;15:08:09;80582552;80073999;508553;
12.01.2019;15:09:08;80582640;80074201;508439;
12.01.2019;15:10:07;80582728;80074370;508358;
12.01.2019;15:11:08;80582818;80074539;508279;
12.01.2019;15:12:09;80582897;80074713;508184;
12.01.2019;15:13:08;80582978;80074883;508095;
12.01.2019;15:14:09;80583074;80075044;508030;
12.01.2019;15:15:08;80583156;80075192;507964;
12.01.2019;15:16:09;80583255;80075351;507904;
12.01.2019;15:17:09;80583349;80075535;507814;
12.01.2019;15:18:07;80583436;80075691;507745;
12.01.2019;15:19:07;80583530;80075866;507664;
12.01.2019;15:20:08;80583623;80076037;507586;
12.01.2019;15:21:07;80583722;80076205;507517;
12.01.2019;15:22:09;80583817;80076408;507409;
12.01.2019;15:23:07;80583904;80076567;507337;
12.01.2019;15:24:07;80583991;80076739;507252;
12.01.2019;15:25:08;80584080;80076937;507143;
12.01.2019;15:26:09;80584178;80077135;507043;
12.01.2019;15:27:08;80584263;80077310;506953;
12.01.2019;15:28:07;80584361;80077490;506871;
12.01.2019;15:29:08;80584445;80077659;506786;
12.01.2019;15:30:09;80584528;80077881;506647;
12.01.2019;15:31:13;80584634;80078039;506595;
12.01.2019;15:32:12;80584719;80078231;506488;
12.01.2019;15:33:08;80584813;80078405;506408;
12.01.2019;15:34:08;80584910;80078549;506361;
12.01.2019;15:35:08;80585003;80078702;506301;
12.01.2019;15:36:09;80585114;80078842;506272;
12.01.2019;15:37:12;80585242;80079003;506239;
12.01.2019;15:38:09;80585327;80079205;506122;
12.01.2019;15:39:09;80585427;80079356;506071;
12.01.2019;15:40:08;80585532;80079520;506012;
12.01.2019;15:41:07;80585609;80079711;505898;
12.01.2019;15:42:09;80585695;80079900;505795;
12.01.2019;15:43:08;80585791;80080103;505688;
12.01.2019;15:44:13;80585905;80080276;505629;
12.01.2019;15:45:08;80585993;80080437;505556;
12.01.2019;15:46:09;80586093;80080622;505471;
12.01.2019;15:47:13;80586202;80080821;505381;
12.01.2019;15:48:13;80586310;80080968;505342;
12.01.2019;15:49:13;80586408;80081161;505247;
12.01.2019;15:50:09;80586485;80081322;505163;
12.01.2019;15:51:09;80586582;80081464;505118;
12.01.2019;15:52:12;80586696;80081635;505061;
12.01.2019;15:53:08;80586792;80081816;504976;
12.01.2019;15:54:07;80586906;80081997;504909;
12.01.2019;15:55:07;80587005;80082174;504831;
12.01.2019;15:56:09;80587114;80082366;504748;
12.01.2019;15:57:08;80587236;80082550;504686;
12.01.2019;15:58:07;80587338;80082690;504648;
12.01.2019;15:59:07;80587473;80082881;504592;
12.01.2019;16:00:04;80587585;80083058;504527;
12.01.2019;16:01:04;80587673;80083223;504450;
12.01.2019;16:02:05;80587774;80083399;504375;
12.01.2019;16:03:05;80587884;80083576;504308;
12.01.2019;16:04:04;80587989;80083723;504266;
12.01.2019;16:05:05;80588083;80083891;504192;
12.01.2019;16:06:05;80588181;80084054;504127;
12.01.2019;16:07:04;80588258;80084249;504009;
12.01.2019;16:08:04;80588345;80084415;503930;
12.01.2019;16:09:06;80588457;80084592;503865;
12.01.2019;16:10:05;80588536;80084799;503737;
12.01.2019;16:11:04;80588630;80084992;503638;
12.01.2019;16:12:04;80588710;80085168;503542;
12.01.2019;16:13:05;80588813;80085323;503490;
12.01.2019;16:14:04;80588906;80085502;503404;
12.01.2019;16:15:04;80588985;80085651;503334;
12.01.2019;16:16:10;80589043;80085779;503264;
12.01.2019;16:17:05;80589110;80085895;503215;
12.01.2019;16:18:04;80589202;80086031;503171;
12.01.2019;16:19:04;80589279;80086229;503050;
12.01.2019;16:20:05;80589365;80086397;502968;
12.01.2019;16:21:04;80589471;80086571;502900;
12.01.2019;16:22:04;80589555;80086744;502811;
12.01.2019;16:23:04;80589630;80086909;502721;
12.01.2019;16:24:05;80589717;80087044;502673;
12.01.2019;16:25:04;80589800;80087200;502600;
12.01.2019;16:26:04;80589874;80087377;502497;
12.01.2019;16:27:05;80589947;80087519;502428;
12.01.2019;16:28:04;80590050;80087685;502365;
12.01.2019;16:29:05;80590147;80087868;502279;
12.01.2019;16:30:05;80590218;80088050;502168;
12.01.2019;16:31:05;80590316;80088204;502112;
12.01.2019;16:32:04;80590416;80088403;502013;
12.01.2019;16:33:04;80590526;80088562;501964;
12.01.2019;16:34:05;80590632;80088753;501879;
12.01.2019;16:35:05;80590720;80088917;501803;
12.01.2019;16:36:04;80590831;80089090;501741;
12.01.2019;16:37:04;80590940;80089271;501669;
12.01.2019;16:38:05;80591051;80089460;501591;
12.01.2019;16:39:06;80591151;80089613;501538;
12.01.2019;16:40:04;80591256;80089779;501477;
12.01.2019;16:41:05;80591364;80089934;501430;
12.01.2019;16:42:04;80591476;80090098;501378;
12.01.2019;16:43:04;80591549;80090297;501252;
12.01.2019;16:44:05;80591671;80090461;501210;
12.01.2019;16:45:05;80591770;80090628;501142;
12.01.2019;16:46:05;80591889;80090813;501076;
12.01.2019;16:47:04;80591996;80090977;501019;
12.01.2019;16:48:05;80592129;80091147;500982;
12.01.2019;16:49:05;80592224;80091278;500946;
12.01.2019;16:50:05;80592334;80091460;500874;
12.01.2019;16:51:04;80592423;80091632;500791;
12.01.2019;16:52:04;80592509;80091803;500706;
12.01.2019;16:53:05;80592630;80091976;500654;
12.01.2019;16:54:05;80592762;80092144;500618;
12.01.2019;16:55:05;80592854;80092331;500523;
12.01.2019;16:56:05;80592960;80092507;500453;
12.01.2019;16:57:04;80593056;80092675;500381;
12.01.2019;16:58:04;80593143;80092848;500295;
12.01.2019;16:59:05;80593255;80093000;500255;
12.01.2019;17:00:05;80593354;80093172;500182;
12.01.2019;17:01:04;80593465;80093353;500112;
12.01.2019;17:02:04;80593530;80093525;500005;
12.01.2019;17:03:05;80593633;80093686;499947;
12.01.2019;17:04:05;80593737;80093878;499859;
12.01.2019;17:05:04;80593831;80094084;499747;
12.01.2019;17:06:04;80593927;80094264;499663;
12.01.2019;17:07:05;80594021;80094417;499604;
12.01.2019;17:08:05;80594130;80094575;499555;
12.01.2019;17:09:06;80594253;80094741;499512;
12.01.2019;17:10:05;80594352;80094921;499431;
12.01.2019;17:11:04;80594469;80095081;499388;
12.01.2019;17:12:04;80594565;80095247;499318;
12.01.2019;17:13:05;80594673;80095408;499265;
12.01.2019;17:14:05;80594773;80095587;499186;
12.01.2019;17:15:05;80594859;80095767;499092;
12.01.2019;17:16:05;80594950;80095938;499012;
12.01.2019;17:17:05;80595056;80096104;498952;
12.01.2019;17:18:04;80595160;80096285;498875;
12.01.2019;17:19:04;80595263;80096463;498800;
12.01.2019;17:20:04;80595364;80096637;498727;
12.01.2019;17:21:05;80595478;80096803;498675;
12.01.2019;17:22:05;80595600;80096937;498663;
12.01.2019;17:23:04;80595740;80097136;498604;
12.01.2019;17:24:04;80595847;80097325;498522;
12.01.2019;17:25:05;80595952;80097505;498447;
12.01.2019;17:26:05;80596061;80097688;498373;
12.01.2019;17:27:04;80596153;80097865;498288;
12.01.2019;17:28:04;80596277;80098034;498243;
12.01.2019;17:29:05;80596390;80098198;498192;
12.01.2019;17:30:05;80596477;80098371;498106;
12.01.2019;17:31:05;80596573;80098510;498063;
12.01.2019;17:32:05;80596673;80098670;498003;
12.01.2019;17:33:04;80596788;80098811;497977;
12.01.2019;17:34:04;80596893;80099004;497889;
12.01.2019;17:35:05;80596987;80099182;497805;
12.01.2019;17:36:05;80597100;80099321;497779;
12.01.2019;17:37:05;80597200;80099499;497701;
12.01.2019;17:38:04;80597303;80099686;497617;
12.01.2019;17:39:06;80597413;80099853;497560;
12.01.2019;17:40:05;80597502;80100017;497485;
12.01.2019;17:41:04;80597597;80100200;497397;
12.01.2019;17:42:04;80597698;80100384;497314;
12.01.2019;17:43:04;80597788;80100537;497251;
12.01.2019;17:44:04;80597892;80100688;497204;
12.01.2019;17:45:05;80598005;80100844;497161;
12.01.2019;17:46:05;80598121;80100987;497134;
12.01.2019;17:47:05;80598231;80101165;497066;
12.01.2019;17:48:04;80598340;80101320;497020;
12.01.2019;17:49:04;80598446;80101479;496967;
12.01.2019;17:50:05;80598543;80101643;496900;
12.01.2019;17:51:05;80598653;80101776;496877;
12.01.2019;17:52:04;80598776;80101941;496835;
12.01.2019;17:53:04;80598864;80102104;496760;
12.01.2019;17:54:05;80598968;80102277;496691;
12.01.2019;17:55:05;80599060;80102448;496612;
12.01.2019;17:56:05;80599148;80102605;496543;
12.01.2019;17:57:05;80599240;80102775;496465;
12.01.2019;17:58:04;80599346;80102909;496437;
12.01.2019;17:59:04;80599453;80103063;496390;
12.01.2019;18:00:04;80599550;80103208;496342;
12.01.2019;18:01:05;80599640;80103404;496236;
12.01.2019;18:02:05;80599733;80103552;496181;
12.01.2019;18:03:05;80599829;80103698;496131;
12.01.2019;18:04:05;80599968;80103840;496128;
12.01.2019;18:05:04;80600078;80104000;496078;
12.01.2019;18:06:04;80600217;80104160;496057;
12.01.2019;18:07:05;80600317;80104330;495987;
12.01.2019;18:08:05;80600440;80104460;495980;
12.01.2019;18:09:05;80600539;80104633;495906;
12.01.2019;18:10:05;80600647;80104769;495878;
12.01.2019;18:11:05;80600741;80104942;495799;
12.01.2019;18:12:05;80600841;80105077;495764;
12.01.2019;18:13:05;80600936;80105213;495723;
12.01.2019;18:14:05;80601025;80105381;495644;
12.01.2019;18:15:05;80601115;80105517;495598;
12.01.2019;18:16:04;80601205;80105688;495517;
12.01.2019;18:17:15;80601320;80105842;495478;
12.01.2019;18:18:04;80601413;80105933;495480;
12.01.2019;18:19:04;80601513;80106024;495489;
12.01.2019;18:20:05;80601600;80106120;495480;
12.01.2019;18:21:05;80601676;80106256;495420;
12.01.2019;18:22:06;80601688;80106366;495322;
12.01.2019;18:23:05;80601776;80106532;495244;
12.01.2019;18:24:05;80601867;80106691;495176;
12.01.2019;18:25:11;80601964;80106849;495115;
12.01.2019;18:26:05;80602060;80106982;495078;
12.01.2019;18:27:10;80602158;80107139;495019;
12.01.2019;18:28:05;80602250;80107251;494999;
12.01.2019;18:29:06;80602360;80107380;494980;
12.01.2019;18:30:12;80602491;80107558;494933;
12.01.2019;18:31:06;80602596;80107670;494926;
12.01.2019;18:32:11;80602715;80107830;494885;
12.01.2019;18:33:06;80602829;80107943;494886;
12.01.2019;18:34:04;80602929;80108081;494848;
12.01.2019;18:35:06;80603037;80108237;494800;
12.01.2019;18:36:06;80603136;80108368;494768;
12.01.2019;18:37:07;80603257;80108498;494759;
12.01.2019;18:38:06;80603347;80108636;494711;
12.01.2019;18:39:08;80603455;80108779;494676;
12.01.2019;18:40:06;80603488;80108851;494637;
12.01.2019;18:41:05;80603597;80108960;494637;
12.01.2019;18:42:06;80603714;80109083;494631;
12.01.2019;18:43:05;80603808;80109203;494605;
12.01.2019;18:44:04;80603912;80109343;494569;
12.01.2019;18:45:10;80604024;80109492;494532;
12.01.2019;18:46:05;80604129;80109625;494504;
12.01.2019;18:47:05;80604215;80109779;494436;
12.01.2019;18:48:05;80604353;80109927;494426;
12.01.2019;18:49:04;80604459;80110040;494419;
12.01.2019;18:50:05;80604562;80110182;494380;
12.01.2019;18:51:05;80604677;80110311;494366;
12.01.2019;18:52:05;80604784;80110430;494354;
12.01.2019;18:53:04;80604880;80110554;494326;
12.01.2019;18:54:12;80604986;80110701;494285;
12.01.2019;18:55:06;80605076;80110863;494213;
12.01.2019;18:56:06;80605185;80111003;494182;
12.01.2019;18:57:07;80605265;80111127;494138;
12.01.2019;18:58:11;80605354;80111254;494100;
12.01.2019;18:59:06;80605437;80111374;494063;
12.01.2019;19:00:06;80605520;80111510;494010;
12.01.2019;19:01:06;80605624;80111619;494005;
12.01.2019;19:02:04;80605712;80111774;493938;
12.01.2019;19:03:04;80605796;80111919;493877;
12.01.2019;19:04:06;80605904;80112070;493834;
12.01.2019;19:05:06;80606015;80112160;493855;
12.01.2019;19:06:05;80606096;80112267;493829;
12.01.2019;19:07:05;80606199;80112355;493844;
12.01.2019;19:08:04;80606282;80112476;493806;
12.01.2019;19:09:07;80606373;80112595;493778;
12.01.2019;19:10:05;80606458;80112695;493763;
12.01.2019;19:11:05;80606554;80112819;493735;
12.01.2019;19:12:05;80606652;80112923;493729;
12.01.2019;19:13:06;80606767;80113028;493739;
12.01.2019;19:14:06;80606865;80113107;493758;
12.01.2019;19:15:06;80606951;80113212;493739;
12.01.2019;19:16:06;80607037;80113326;493711;
12.01.2019;19:17:06;80607128;80113427;493701;
12.01.2019;19:18:05;80607250;80113533;493717;
12.01.2019;19:19:06;80607341;80113647;493694;
12.01.2019;19:20:06;80607442;80113739;493703;
12.01.2019;19:21:06;80607535;80113873;493662;
12.01.2019;19:22:04;80607649;80114000;493649;
12.01.2019;19:23:06;80607747;80114106;493641;
12.01.2019;19:24:06;80607861;80114222;493639;
12.01.2019;19:25:05;80607996;80114306;493690;
12.01.2019;19:26:08;80608117;80114432;493685;
12.01.2019;19:27:05;80608218;80114522;493696;
12.01.2019;19:28:06;80608316;80114640;493676;
12.01.2019;19:29:05;80608435;80114758;493677;
12.01.2019;19:30:04;80608547;80114867;493680;
12.01.2019;19:31:05;80608643;80114953;493690;
12.01.2019;19:32:05;80608750;80115075;493675;
12.01.2019;19:33:05;80608862;80115194;493668;
12.01.2019;19:34:06;80608952;80115297;493655;
12.01.2019;19:35:06;80609065;80115411;493654;
12.01.2019;19:36:05;80609153;80115513;493640;
12.01.2019;19:37:05;80609264;80115604;493660;
12.01.2019;19:38:05;80609365;80115697;493668;
12.01.2019;19:39:07;80609461;80115796;493665;
12.01.2019;19:40:05;80609546;80115876;493670;
12.01.2019;19:41:04;80609654;80115966;493688;
12.01.2019;19:42:05;80609736;80116066;493670;
12.01.2019;19:43:04;80609842;80116159;493683;
12.01.2019;19:44:04;80609940;80116237;493703;
12.01.2019;19:45:05;80610039;80116324;493715;
12.01.2019;19:46:05;80610138;80116416;493722;
12.01.2019;19:47:04;80610241;80116503;493738;
12.01.2019;19:48:06;80610344;80116609;493735;
12.01.2019;19:49:06;80610450;80116723;493727;
12.01.2019;19:50:06;80610531;80116806;493725;
12.01.2019;19:51:06;80610659;80116895;493764;
12.01.2019;19:52:05;80610767;80116981;493786;
12.01.2019;19:53:05;80610868;80117073;493795;
12.01.2019;19:54:05;80610989;80117153;493836;
12.01.2019;19:55:05;80611101;80117245;493856;
12.01.2019;19:56:05;80611202;80117335;493867;
12.01.2019;19:57:04;80611306;80117422;493884;
12.01.2019;19:58:04;80611383;80117505;493878;
12.01.2019;19:59:05;80611481;80117592;493889;
12.01.2019;20:00:05;80611579;80117681;493898;
12.01.2019;20:01:06;80611662;80117763;493899;
12.01.2019;20:02:06;80611765;80117856;493909;
12.01.2019;20:03:05;80611860;80117933;493927;
12.01.2019;20:04:05;80611954;80118017;493937;
12.01.2019;20:05:04;80612064;80118099;493965;
12.01.2019;20:06:04;80612160;80118185;493975;
12.01.2019;20:07:04;80610121;80118259;491862;
12.01.2019;20:08:05;80610236;80118346;491890;
12.01.2019;20:09:05;80610351;80118423;491928;
12.01.2019;20:10:05;80610439;80118504;491935;
12.01.2019;20:11:05;80610523;80124699;485824;
12.01.2019;20:12:05;80610617;80124764;485853;
12.01.2019;20:13:04;80610696;80124838;485858;
12.01.2019;20:14:05;80610762;80124899;485863;
12.01.2019;20:15:04;80610839;80124953;485886;
12.01.2019;20:16:05;80610920;80125006;485914;
12.01.2019;20:17:05;80611002;80125067;485935;
12.01.2019;20:18:05;80611073;80125122;485951;
12.01.2019;20:19:05;80611135;80125162;485973;
12.01.2019;20:20:11;80611203;80125240;485963;
12.01.2019;20:21:04;80611287;80125285;486002;
12.01.2019;20:22:04;80611367;80125347;486020;
12.01.2019;20:23:04;80611450;80125419;486031;
12.01.2019;20:24:05;80611535;80125452;486083;
12.01.2019;20:25:05;80611617;80125521;486096;
12.01.2019;20:26:05;80611724;80125579;486145;
12.01.2019;20:27:05;80611827;80125647;486180;
12.01.2019;20:28:04;80611924;80125711;486213;
12.01.2019;20:29:04;80612032;80125782;486250;
12.01.2019;20:30:04;80612132;80125849;486283;
12.01.2019;20:31:05;80612226;80125901;486325;
12.01.2019;20:32:05;80612316;80125973;486343;
12.01.2019;20:33:05;80612414;80126037;486377;
12.01.2019;20:34:05;80612512;80126103;486409;
12.01.2019;20:35:06;80612607;80126173;486434;
12.01.2019;20:36:05;80612707;80126243;486464;
12.01.2019;20:37:05;80612808;80126314;486494;
12.01.2019;20:38:05;80612912;80126370;486542;
12.01.2019;20:39:08;80613006;80126435;486571;
12.01.2019;20:40:05;80613095;80126506;486589;
12.01.2019;20:41:05;80613188;80126568;486620;
12.01.2019;20:42:04;80613287;80126634;486653;
12.01.2019;20:43:04;80613383;80126683;486700;
12.01.2019;20:44:05;80613463;80126741;486722;
12.01.2019;20:45:05;80613555;80126798;486757;
12.01.2019;20:46:04;80613666;80126854;486812;
12.01.2019;20:47:04;80613766;80126920;486846;
12.01.2019;20:48:04;80613863;80126984;486879;
12.01.2019;20:49:06;80613978;80127041;486937;
12.01.2019;20:50:04;80614084;80127092;486992;
12.01.2019;20:51:05;80614178;80127174;487004;
12.01.2019;20:52:06;80614283;80127244;487039;
12.01.2019;20:53:06;80614386;80127296;487090;
12.01.2019;20:54:05;80614492;80127358;487134;
12.01.2019;20:55:05;80614592;80127410;487182;
12.01.2019;20:56:06;80614706;80127483;487223;
12.01.2019;20:57:05;80614819;80127564;487255;
12.01.2019;20:58:05;80614924;80127622;487302;
12.01.2019;20:59:04;80614990;80127682;487308;
12.01.2019;21:00:04;80615102;80127738;487364;
12.01.2019;21:01:05;80615196;80127799;487397;
12.01.2019;21:02:04;80615286;80127869;487417;
12.01.2019;21:03:04;80615397;80127919;487478;
12.01.2019;21:04:05;80615507;80127989;487518;
12.01.2019;21:05:05;80615596;80128043;487553;
12.01.2019;21:06:04;80615676;80128087;487589;
12.01.2019;21:07:04;80615788;80128150;487638;
12.01.2019;21:08:04;80615873;80128209;487664;
12.01.2019;21:09:07;80615984;80128269;487715;
12.01.2019;21:10:05;80616083;80128312;487771;
12.01.2019;21:11:05;80616160;80128354;487806;
12.01.2019;21:12:05;80616260;80128419;487841;
12.01.2019;21:13:04;80616359;80128475;487884;
12.01.2019;21:14:05;80616462;80128519;487943;
12.01.2019;21:15:04;80616556;80128565;487991;
12.01.2019;21:16:05;80616660;80128616;488044;
12.01.2019;21:17:05;80616752;80128689;488063;
12.01.2019;21:18:05;80616836;80128749;488087;
12.01.2019;21:19:05;80616952;80128810;488142;
12.01.2019;21:20:04;80617018;80128875;488143;
12.01.2019;21:21:04;80617095;80128942;488153;
12.01.2019;21:22:06;80617208;80128994;488214;
12.01.2019;21:23:06;80617295;80129051;488244;
12.01.2019;21:24:06;80617404;80129089;488315;
12.01.2019;21:25:06;80617509;80129138;488371;
12.01.2019;21:26:04;80617596;80129195;488401;
12.01.2019;21:27:12;80617719;80129246;488473;
12.01.2019;21:28:05;80617810;80129288;488522;
12.01.2019;21:29:07;80617922;80129344;488578;
12.01.2019;21:30:11;80617938;80129401;488537;
12.01.2019;21:31:06;80617970;80129441;488529;
12.01.2019;21:32:05;80618023;80129485;488538;
12.01.2019;21:33:11;80618086;80129548;488538;
12.01.2019;21:34:06;80618138;80129593;488545;
12.01.2019;21:35:06;80618218;80129644;488574;
12.01.2019;21:36:11;80618314;80129707;488607;
12.01.2019;21:37:11;80618377;80129748;488629;
12.01.2019;21:38:06;80618450;80129798;488652;
12.01.2019;21:39:08;80618520;80129857;488663;
12.01.2019;21:40:12;80618589;80129881;488708;
12.01.2019;21:41:06;80618597;80129864;488733;
12.01.2019;21:42:05;80618668;80129906;488762;
12.01.2019;21:43:05;80618744;80129949;488795;
12.01.2019;21:44:05;80618836;80129988;488848;
12.01.2019;21:45:05;80618936;80130035;488901;
12.01.2019;21:46:12;80619019;80130095;488924;
12.01.2019;21:47:11;80619112;80130154;488958;
12.01.2019;21:48:06;80619205;80130204;489001;
12.01.2019;21:49:06;80619278;80130263;489015;
12.01.2019;21:50:06;80619355;80130313;489042;
12.01.2019;21:51:06;80619441;80130365;489076;
12.01.2019;21:52:11;80619537;80130416;489121;
12.01.2019;21:53:12;80619641;80130454;489187;
12.01.2019;21:54:05;80619715;80130492;489223;
12.01.2019;21:55:05;80619805;80130533;489272;
12.01.2019;21:56:04;80619879;80130566;489313;
12.01.2019;21:57:04;80619976;80130617;489359;
12.01.2019;21:58:11;80620077;80130672;489405;
12.01.2019;21:59:11;80620196;80130720;489476;
12.01.2019;22:00:06;80620270;80130761;489509;
12.01.2019;22:01:06;80620361;80130796;489565;
12.01.2019;22:02:04;80620428;80130835;489593;
12.01.2019;22:03:06;80620494;80130870;489624;
12.01.2019;22:04:08;80620574;80130906;489668;
12.01.2019;22:05:08;80620648;80130939;489709;
12.01.2019;22:06:11;80620737;80130989;489748;
12.01.2019;22:07:05;80620841;80131031;489810;
12.01.2019;22:08:05;80620926;80131075;489851;
12.01.2019;22:09:05;80620978;80131115;489863;
12.01.2019;22:10:05;80621030;80131136;489894;
12.01.2019;22:11:06;80621076;80131145;489931;
12.01.2019;22:12:05;80621126;80131165;489961;
12.01.2019;22:13:06;80621175;80131203;489972;
12.01.2019;22:14:05;80621210;80131227;489983;
12.01.2019;22:15:07;80621303;80131243;490060;
12.01.2019;22:16:05;80621374;80131278;490096;
12.01.2019;22:17:06;80621452;80131299;490153;
12.01.2019;22:18:04;80621530;80131316;490214;
12.01.2019;22:19:13;80621609;80131356;490253;
12.01.2019;22:20:06;80621666;80131391;490275;
12.01.2019;22:21:05;80621749;80131414;490335;
12.01.2019;22:22:05;80621866;80131452;490414;
12.01.2019;22:23:05;80621965;80131500;490465;
12.01.2019;22:24:07;80622067;80131537;490530;
12.01.2019;22:25:07;80622162;80131581;490581;
12.01.2019;22:26:06;80622233;80131614;490619;
12.01.2019;22:27:05;80622312;80131654;490658;
12.01.2019;22:28:05;80622410;80131686;490724;
12.01.2019;22:29:11;80622503;80131727;490776;
12.01.2019;22:30:06;80622597;80131766;490831;
12.01.2019;22:31:06;80622696;80131808;490888;
12.01.2019;22:32:06;80622793;80131849;490944;
12.01.2019;22:33:05;80622883;80131879;491004;
12.01.2019;22:34:06;80622956;80131918;491038;
12.01.2019;22:35:06;80623044;80131958;491086;
12.01.2019;22:36:05;80623142;80131990;491152;
12.01.2019;22:37:10;80623232;80132025;491207;
12.01.2019;22:38:16;80623336;80132077;491259;
12.01.2019;22:39:19;80623416;80132118;491298;
12.01.2019;22:40:07;80623489;80132134;491355;
12.01.2019;22:41:07;80623577;80132160;491417;
12.01.2019;22:42:06;80623648;80132185;491463;
12.01.2019;22:43:06;80623719;80132211;491508;
12.01.2019;22:44:08;80623802;80132247;491555;
12.01.2019;22:45:05;80623874;80132264;491610;
12.01.2019;22:46:06;80623958;80132288;491670;
12.01.2019;22:47:10;80624049;80132342;491707;
12.01.2019;22:48:11;80624143;80132390;491753;
12.01.2019;22:49:09;80624249;80132420;491829;
12.01.2019;22:50:09;80624352;80132448;491904;
12.01.2019;22:51:04;80624436;80132488;491948;
12.01.2019;22:52:06;80624535;80132534;492001;
12.01.2019;22:53:12;80624615;80132584;492031;
12.01.2019;22:54:12;80624691;80132622;492069;
12.01.2019;22:55:08;80624782;80132648;492134;
12.01.2019;22:56:04;80624855;80132680;492175;
12.01.2019;22:57:04;80624968;80132719;492249;
12.01.2019;22:58:10;80625048;80132760;492288;
12.01.2019;22:59:07;80625114;80132796;492318;
12.01.2019;23:00:06;80625199;80132823;492376;
12.01.2019;23:01:04;80625287;80132858;492429;
12.01.2019;23:02:05;80625379;80132885;492494;
12.01.2019;23:03:05;80625451;80132908;492543;
12.01.2019;23:04:05;80625519;80132943;492576;
12.01.2019;23:05:06;80625613;80132964;492649;
12.01.2019;23:06:11;80625680;80132998;492682;
12.01.2019;23:07:11;80625767;80133033;492734;
12.01.2019;23:08:13;80625842;80133071;492771;
12.01.2019;23:09:08;80625903;80133095;492808;
12.01.2019;23:10:06;80625984;80133116;492868;
12.01.2019;23:11:12;80626075;80133152;492923;
12.01.2019;23:12:08;80626146;80133165;492981;
12.01.2019;23:13:06;80626234;80133202;493032;
12.01.2019;23:14:07;80626308;80133229;493079;
12.01.2019;23:15:08;80626396;80133269;493127;
12.01.2019;23:16:07;80626470;80133291;493179;
12.01.2019;23:17:07;80626560;80133314;493246;
12.01.2019;23:18:11;80626634;80133350;493284;
12.01.2019;23:19:07;80626711;80133386;493325;
12.01.2019;23:20:06;80626810;80133420;493390;
12.01.2019;23:21:11;80626888;80133463;493425;
12.01.2019;23:22:11;80626979;80133477;493502;
12.01.2019;23:23:05;80627061;80133497;493564;
12.01.2019;23:24:05;80627138;80133532;493606;
12.01.2019;23:25:07;80627217;80133565;493652;
12.01.2019;23:26:06;80627285;80133588;493697;
12.01.2019;23:27:06;80627364;80133621;493743;
12.01.2019;23:28:06;80627425;80133652;493773;
12.01.2019;23:29:06;80627508;80133685;493823;
12.01.2019;23:30:07;80627590;80133722;493868;
12.01.2019;23:31:05;80627668;80133764;493904;
12.01.2019;23:32:05;80627746;80133797;493949;
12.01.2019;23:33:12;80627829;80133835;493994;
12.01.2019;23:34:10;80627885;80133866;494019;
12.01.2019;23:35:10;80627985;80133899;494086;
12.01.2019;23:36:06;80628064;80133916;494148;
12.01.2019;23:37:10;80628127;80133940;494187;
12.01.2019;23:38:06;80628193;80133966;494227;
12.01.2019;23:39:09;80628307;80133981;494326;
12.01.2019;23:40:07;80628401;80133992;494409;
12.01.2019;23:41:06;80628493;80134012;494481;
12.01.2019;23:42:10;80628589;80134037;494552;
12.01.2019;23:43:06;80628672;80134063;494609;
12.01.2019;23:44:06;80628758;80134088;494670;
12.01.2019;23:45:06;80628836;80134124;494712;
12.01.2019;23:46:04;80628929;80134138;494791;
12.01.2019;23:47:04;80629003;80134157;494846;
12.01.2019;23:48:06;80629079;80134185;494894;
12.01.2019;23:51:06;80629367;80134273;495094;
12.01.2019;23:52:11;80629457;80134296;495161;
12.01.2019;23:53:06;80629515;80134315;495200;
12.01.2019;23:54:04;80629587;80134338;495249;
12.01.2019;23:55:04;80629664;80134364;495300;
12.01.2019;23:56:05;80629749;80134387;495362;
12.01.2019;23:57:04;80629825;80134416;495409;
12.01.2019;23:58:04;80629901;80134437;495464;
12.01.2019;23:59:05;80629975;80134460;495515;
13.01.2019;00:00:07;80630064;80134502;495562;
13.01.2019;00:01:07;80630127;80134532;495595;
13.01.2019;00:02:07;80630195;80134553;495642;
13.01.2019;00:03:07;80630266;80134585;495681;
13.01.2019;00:04:07;80630335;80134609;495726;
13.01.2019;00:05:08;80630392;80134634;495758;
13.01.2019;00:06:08;80630452;80134657;495795;
13.01.2019;00:07:07;80630515;80134679;495836;
13.01.2019;00:08:08;80630587;80134689;495898;
13.01.2019;00:09:07;80630635;80134699;495936;
13.01.2019;00:10:07;80630703;80134714;495989;
13.01.2019;00:11:08;80630776;80134733;496043;
13.01.2019;00:12:08;80630822;80134748;496074;
13.01.2019;00:13:08;80630901;80134755;496146;
13.01.2019;00:14:08;80630973;80134770;496203;
13.01.2019;00:15:07;80631050;80134796;496254;
13.01.2019;00:16:07;80631095;80134820;496275;
13.01.2019;00:17:07;80631174;80134849;496325;
13.01.2019;00:18:08;80631245;80134864;496381;
13.01.2019;00:19:07;80631317;80134889;496428;
13.01.2019;00:20:07;80631377;80134920;496457;
13.01.2019;00:21:08;80631476;80134947;496529;
13.01.2019;00:22:08;80631533;80134977;496556;
13.01.2019;00:23:08;80631611;80135002;496609;
13.01.2019;00:24:07;80631696;80135035;496661;
13.01.2019;00:25:08;80631777;80135044;496733;
13.01.2019;00:26:07;80631863;80135067;496796;
13.01.2019;00:27:08;80631947;80135086;496861;
13.01.2019;00:28:07;80632027;80135108;496919;
13.01.2019;00:29:12;80632117;80135129;496988;
13.01.2019;00:30:08;80632200;80135153;497047;
13.01.2019;00:31:07;80632273;80135177;497096;
13.01.2019;00:32:08;80632365;80135201;497164;
13.01.2019;00:33:07;80632436;80135226;497210;
13.01.2019;00:34:08;80632512;80135263;497249;
13.01.2019;00:35:07;80632578;80135291;497287;
13.01.2019;00:36:07;80632646;80135320;497326;
13.01.2019;00:37:07;80632718;80135339;497379;
13.01.2019;00:38:07;80632791;80135360;497431;
13.01.2019;00:39:08;80632802;80135342;497460;
13.01.2019;00:40:08;80632884;80135373;497511;
13.01.2019;00:41:08;80632969;80135403;497566;
13.01.2019;00:42:08;80633036;80135439;497597;
13.01.2019;00:43:08;80633105;80135467;497638;
13.01.2019;00:44:08;80633163;80135483;497680;
13.01.2019;00:45:08;80633227;80135512;497715;
13.01.2019;00:46:08;80633304;80135543;497761;
13.01.2019;00:47:08;80633366;80135579;497787;
13.01.2019;00:48:28;80633458;80135614;497844;
13.01.2019;00:49:08;80633517;80135627;497890;
13.01.2019;00:50:12;80633585;80135659;497926;
13.01.2019;00:51:07;80633651;80135671;497980;
13.01.2019;00:52:08;80633740;80135702;498038;
13.01.2019;00:53:07;80633813;80135714;498099;
13.01.2019;00:54:07;80633886;80135740;498146;
13.01.2019;00:55:07;80633968;80135767;498201;
13.01.2019;00:56:07;80634037;80135809;498228;
13.01.2019;00:57:07;80634093;80135827;498266;
13.01.2019;00:58:07;80634189;80135855;498334;
13.01.2019;00:59:07;80634276;80135884;498392;
13.01.2019;01:00:05;80634346;80135910;498436;
13.01.2019;01:01:04;80634441;80135939;498502;
13.01.2019;01:02:04;80634528;80135967;498561;
13.01.2019;01:03:04;80634608;80135999;498609;
13.01.2019;01:04:04;80634681;80136026;498655;
13.01.2019;01:05:05;80634758;80136052;498706;
13.01.2019;01:06:06;80634832;80136080;498752;
13.01.2019;01:07:05;80634916;80136118;498798;
13.01.2019;01:08:05;80634981;80136147;498834;
13.01.2019;01:09:06;80635055;80136177;498878;
13.01.2019;01:10:04;80635137;80136211;498926;
13.01.2019;01:11:04;80635219;80136242;498977;
13.01.2019;01:12:05;80635298;80136277;499021;
13.01.2019;01:13:04;80635362;80136313;499049;
13.01.2019;01:14:04;80635442;80136331;499111;
13.01.2019;01:15:05;80635513;80136363;499150;
13.01.2019;01:16:04;80635586;80136397;499189;
13.01.2019;01:17:04;80635666;80136438;499228;
13.01.2019;01:18:04;80635734;80136468;499266;
13.01.2019;01:19:05;80635810;80136506;499304;
13.01.2019;01:20:04;80635893;80136537;499356;
13.01.2019;01:21:04;80635981;80136571;499410;
13.01.2019;01:22:05;80636048;80136596;499452;
13.01.2019;01:23:05;80636126;80136629;499497;
13.01.2019;01:24:04;80636197;80136666;499531;
13.01.2019;01:25:04;80636261;80136688;499573;
13.01.2019;01:26:05;80636345;80136720;499625;
13.01.2019;01:27:04;80636409;80136761;499648;
13.01.2019;01:28:05;80636502;80136802;499700;
13.01.2019;01:29:05;80636569;80136834;499735;
13.01.2019;01:30:04;80636639;80136879;499760;
13.01.2019;01:31:04;80636706;80136918;499788;
13.01.2019;01:32:05;80636771;80136952;499819;
13.01.2019;01:33:04;80636837;80136982;499855;
13.01.2019;01:34:04;80636909;80137015;499894;
13.01.2019;01:35:05;80636989;80137041;499948;
13.01.2019;01:36:04;80637055;80137097;499958;
13.01.2019;01:37:05;80637128;80137142;499986;
13.01.2019;01:38:05;80637191;80137175;500016;
13.01.2019;01:39:04;80637251;80137216;500035;
13.01.2019;01:40:04;80637315;80137247;500068;
13.01.2019;01:41:05;80637385;80137292;500093;
13.01.2019;01:42:05;80637462;80137335;500127;
13.01.2019;01:43:09;80637527;80137370;500157;
13.01.2019;01:44:04;80637585;80137398;500187;
13.01.2019;01:45:04;80637654;80137451;500203;
13.01.2019;01:46:04;80637739;80137483;500256;
13.01.2019;01:47:05;80637818;80137533;500285;
13.01.2019;01:48:08;80637881;80137577;500304;
13.01.2019;01:49:04;80637938;80137629;500309;
13.01.2019;01:50:05;80638030;80137681;500349;
13.01.2019;01:51:04;80638096;80137732;500364;
13.01.2019;01:52:05;80638159;80137783;500376;
13.01.2019;01:53:04;80638232;80137829;500403;
13.01.2019;01:54:04;80638295;80137872;500423;
13.01.2019;01:55:04;80638397;80137918;500479;
13.01.2019;01:56:05;80638464;80137962;500502;
13.01.2019;01:57:04;80638539;80138010;500529;
13.01.2019;01:58:05;80638632;80138047;500585;
13.01.2019;01:59:05;80638715;80138094;500621;
13.01.2019;02:00:04;80638769;80138147;500622;
13.01.2019;02:01:04;80638826;80138207;500619;
13.01.2019;02:02:05;80638894;80138264;500630;
13.01.2019;02:03:04;80638966;80138310;500656;
13.01.2019;02:04:04;80639029;80138353;500676;
13.01.2019;02:05:05;80639111;80138395;500716;
13.01.2019;02:06:05;80639165;80138452;500713;
13.01.2019;02:07:04;80639234;80138507;500727;
13.01.2019;02:08:04;80639299;80138564;500735;
13.01.2019;02:09:06;80639373;80138624;500749;
13.01.2019;02:10:04;80639435;80138668;500767;
13.01.2019;02:11:05;80639468;80138719;500749;
13.01.2019;02:12:05;80639533;80138755;500778;
13.01.2019;02:13:04;80639583;80138809;500774;
13.01.2019;02:14:05;80639627;80138855;500772;
13.01.2019;02:15:05;80639688;80138912;500776;
13.01.2019;02:16:04;80639741;80138968;500773;
13.01.2019;02:17:04;80639786;80139017;500769;
13.01.2019;02:18:05;80639867;80139075;500792;
13.01.2019;02:19:04;80639908;80139128;500780;
13.01.2019;02:20:05;80639965;80139175;500790;
13.01.2019;02:21:04;80640017;80139211;500806;
13.01.2019;02:22:04;80640070;80139271;500799;
13.01.2019;02:23:05;80640123;80139320;500803;
13.01.2019;02:24:04;80640185;80139378;500807;
13.01.2019;02:25:04;80640252;80139446;500806;
13.01.2019;02:26:05;80640309;80139502;500807;
13.01.2019;02:27:04;80640375;80139586;500789;
13.01.2019;02:28:04;80640443;80139649;500794;
13.01.2019;02:29:05;80640507;80139710;500797;
13.01.2019;02:30:04;80640573;80139789;500784;
13.01.2019;02:31:04;80640618;80139837;500781;
13.01.2019;02:32:04;80640696;80139912;500784;
13.01.2019;02:33:05;80640757;80139962;500795;
13.01.2019;02:34:05;80640836;80140026;500810;
13.01.2019;02:35:04;80640896;80140108;500788;
13.01.2019;02:36:04;80640978;80140194;500784;
13.01.2019;02:37:04;80641046;80140280;500766;
13.01.2019;02:38:04;80641095;80140351;500744;
13.01.2019;02:39:07;80641167;80140430;500737;
13.01.2019;02:40:04;80641239;80140511;500728;
13.01.2019;02:41:05;80641311;80140580;500731;
13.01.2019;02:42:05;80641395;80140646;500749;
13.01.2019;02:43:04;80641456;80140716;500740;
13.01.2019;02:44:04;80641539;80140803;500736;
13.01.2019;02:45:05;80641599;80140899;500700;
13.01.2019;02:46:05;80641673;80140967;500706;
13.01.2019;02:47:04;80641760;80141046;500714;
13.01.2019;02:48:04;80641859;80141115;500744;
13.01.2019;02:49:05;80641928;80141191;500737;
13.01.2019;02:50:04;80641988;80141277;500711;
13.01.2019;02:51:04;80642070;80141349;500721;
13.01.2019;02:52:05;80642143;80141444;500699;
13.01.2019;02:53:05;80642199;80141499;500700;
13.01.2019;02:54:05;80642273;80141582;500691;
13.01.2019;02:55:04;80642331;80141650;500681;
13.01.2019;02:56:04;80642406;80141721;500685;
13.01.2019;02:57:05;80642470;80141815;500655;
13.01.2019;02:58:05;80642544;80141896;500648;
13.01.2019;02:59:04;80642620;80141967;500653;
13.01.2019;03:00:06;80642680;80142061;500619;
13.01.2019;03:01:05;80642741;80142153;500588;
13.01.2019;03:02:06;80642818;80142248;500570;
13.01.2019;03:03:04;80642886;80142319;500567;
13.01.2019;03:04:04;80642957;80142400;500557;
13.01.2019;03:05:05;80643030;80142502;500528;
13.01.2019;03:06:04;80643095;80142579;500516;
13.01.2019;03:07:04;80643189;80142681;500508;
13.01.2019;03:08:05;80643258;80142781;500477;
13.01.2019;03:09:10;80643332;80142887;500445;
13.01.2019;03:10:04;80643422;80142964;500458;
13.01.2019;03:11:04;80643481;80143040;500441;
13.01.2019;03:12:05;80643565;80143125;500440;
13.01.2019;03:13:04;80643629;80143221;500408;
13.01.2019;03:14:04;80643708;80143322;500386;
13.01.2019;03:15:05;80643784;80143408;500376;
13.01.2019;03:16:05;80643847;80143507;500340;
13.01.2019;03:17:04;80643918;80143613;500305;
13.01.2019;03:18:05;80643999;80143701;500298;
13.01.2019;03:19:04;80644077;80143802;500275;
13.01.2019;03:20:04;80644154;80143907;500247;
13.01.2019;03:21:05;80644228;80144002;500226;
13.01.2019;03:22:04;80644304;80144111;500193;
13.01.2019;03:23:04;80644373;80144194;500179;
13.01.2019;03:24:05;80644450;80144291;500159;
13.01.2019;03:25:04;80644502;80144411;500091;
13.01.2019;03:26:05;80644601;80144524;500077;
13.01.2019;03:27:05;80644679;80144616;500063;
13.01.2019;03:28:04;80644744;80144712;500032;
13.01.2019;03:29:04;80644832;80144818;500014;
13.01.2019;03:30:05;80644944;80144931;500013;
13.01.2019;03:31:04;80645034;80145025;500009;
13.01.2019;03:32:05;80645118;80145144;499974;
13.01.2019;03:33:04;80645184;80145270;499914;
13.01.2019;03:34:04;80645263;80145377;499886;
13.01.2019;03:35:05;80645330;80145502;499828;
13.01.2019;03:36:05;80645398;80145614;499784;
13.01.2019;03:37:04;80645452;80145728;499724;
13.01.2019;03:38:10;80645549;80145854;499695;
13.01.2019;03:39:07;80645604;80145968;499636;
13.01.2019;03:40:04;80645696;80146066;499630;
13.01.2019;03:41:04;80645776;80146180;499596;
13.01.2019;03:42:05;80645859;80146288;499571;
13.01.2019;03:43:04;80645936;80146408;499528;
13.01.2019;03:44:04;80646012;80146528;499484;
13.01.2019;03:45:05;80646077;80146660;499417;
13.01.2019;03:46:04;80646071;80146734;499337;
13.01.2019;03:47:04;80646150;80146839;499311;
13.01.2019;03:48:05;80646227;80146975;499252;
13.01.2019;03:49:04;80646302;80147105;499197;
13.01.2019;03:50:04;80646361;80147222;499139;
13.01.2019;03:51:05;80646452;80147349;499103;
13.01.2019;03:52:04;80646525;80147464;499061;
13.01.2019;03:53:04;80646616;80147590;499026;
13.01.2019;03:54:05;80646672;80147705;498967;
13.01.2019;03:55:04;80646730;80147810;498920;
13.01.2019;03:56:05;80646800;80147940;498860;
13.01.2019;03:57:05;80646883;80148079;498804;
13.01.2019;03:58:04;80646968;80148204;498764;
13.01.2019;03:59:05;80647047;80148344;498703;
13.01.2019;04:00:04;80647110;80148463;498647;
13.01.2019;04:01:04;80647180;80148582;498598;
13.01.2019;04:02:05;80647260;80148712;498548;
13.01.2019;04:03:04;80647342;80148831;498511;
13.01.2019;04:04:04;80647425;80148948;498477;
13.01.2019;04:05:05;80647497;80149066;498431;
13.01.2019;04:06:04;80647565;80149197;498368;
13.01.2019;04:07:04;80647635;80149324;498311;
13.01.2019;04:08:05;80647724;80149452;498272;
13.01.2019;04:09:06;80647799;80149562;498237;
13.01.2019;04:10:05;80647850;80149681;498169;
13.01.2019;04:11:05;80647908;80149794;498114;
13.01.2019;04:12:04;80647946;80149916;498030;
13.01.2019;04:13:05;80647976;80150054;497922;
13.01.2019;04:14:05;80648023;80150200;497823;
13.01.2019;04:15:04;80648095;80150321;497774;
13.01.2019;04:16:05;80648161;80150449;497712;
13.01.2019;04:17:05;80648231;80150596;497635;
13.01.2019;04:18:05;80648297;80150720;497577;
13.01.2019;04:19:04;80648338;80150867;497471;
13.01.2019;04:20:05;80648382;80151015;497367;
13.01.2019;04:21:05;80648447;80151151;497296;
13.01.2019;04:22:04;80648507;80151283;497224;
13.01.2019;04:23:04;80648564;80151395;497169;
13.01.2019;04:24:05;80648609;80151527;497082;
13.01.2019;04:25:04;80648671;80151665;497006;
13.01.2019;04:26:05;80648743;80151822;496921;
13.01.2019;04:27:04;80648819;80151949;496870;
13.01.2019;04:28:05;80648892;80152086;496806;
13.01.2019;04:29:05;80648967;80152249;496718;
13.01.2019;04:30:04;80649028;80152392;496636;
13.01.2019;04:31:04;80649130;80152524;496606;
13.01.2019;04:32:05;80649198;80152643;496555;
13.01.2019;04:33:05;80649274;80152764;496510;
13.01.2019;04:34:04;80649355;80152888;496467;
13.01.2019;04:35:05;80649446;80153029;496417;
13.01.2019;04:36:04;80649527;80153180;496347;
13.01.2019;04:37:05;80649588;80153317;496271;
13.01.2019;04:38:04;80649667;80153443;496224;
13.01.2019;04:39:06;80649761;80153575;496186;
13.01.2019;04:40:04;80649850;80153698;496152;
13.01.2019;04:41:05;80649924;80153861;496063;
13.01.2019;04:42:04;80649979;80153996;495983;
13.01.2019;04:43:04;80650069;80154128;495941;
13.01.2019;04:44:05;80650140;80154252;495888;
13.01.2019;04:45:04;80650216;80154386;495830;
13.01.2019;04:46:04;80650286;80154549;495737;
13.01.2019;04:47:04;80650337;80154690;495647;
13.01.2019;04:48:04;80650425;80154843;495582;
13.01.2019;04:49:05;80650505;80154970;495535;
13.01.2019;04:50:04;80650568;80155125;495443;
13.01.2019;04:51:04;80650648;80155255;495393;
13.01.2019;04:52:05;80650714;80155414;495300;
13.01.2019;04:53:04;80650782;80155572;495210;
13.01.2019;04:54:05;80650857;80155717;495140;
13.01.2019;04:55:04;80650920;80155872;495048;
13.01.2019;04:56:04;80650986;80156032;494954;
13.01.2019;04:57:05;80651057;80156175;494882;
13.01.2019;04:58:06;80651116;80156342;494774;
13.01.2019;04:59:04;80651193;80156485;494708;
13.01.2019;05:00:04;80651281;80156616;494665;
13.01.2019;05:01:05;80651357;80156753;494604;
13.01.2019;05:02:05;80651433;80156900;494533;
13.01.2019;05:03:04;80651490;80157058;494432;
13.01.2019;05:04:05;80651580;80157222;494358;
13.01.2019;05:05:04;80651653;80157384;494269;
13.01.2019;05:06:04;80651732;80157517;494215;
13.01.2019;05:07:05;80651808;80157666;494142;
13.01.2019;05:08:04;80651872;80157822;494050;
13.01.2019;05:09:07;80651954;80157982;493972;
13.01.2019;05:10:04;80652018;80158129;493889;
13.01.2019;05:11:04;80652075;80158279;493796;
13.01.2019;05:12:05;80652125;80158438;493687;
13.01.2019;05:13:04;80652193;80158590;493603;
13.01.2019;05:14:05;80652272;80158739;493533;
13.01.2019;05:15:06;80652331;80158868;493463;
13.01.2019;05:16:04;80652388;80158988;493400;
13.01.2019;05:17:04;80652483;80159125;493358;
13.01.2019;05:18:05;80652560;80159258;493302;
13.01.2019;05:19:04;80652638;80159442;493196;
13.01.2019;05:20:04;80652702;80159593;493109;
13.01.2019;05:21:05;80652794;80159756;493038;
13.01.2019;05:22:04;80652865;80159893;492972;
13.01.2019;05:23:04;80652931;80160046;492885;
13.01.2019;05:24:05;80653009;80160216;492793;
13.01.2019;05:25:04;80653060;80160376;492684;
13.01.2019;05:26:04;80653130;80160542;492588;
13.01.2019;05:27:05;80653203;80160686;492517;
13.01.2019;05:28:04;80653269;80160857;492412;
13.01.2019;05:29:04;80653356;80160993;492363;
13.01.2019;05:31:04;80653490;80161313;492177;
13.01.2019;05:32:05;80653552;80161472;492080;
13.01.2019;05:33:05;80653630;80161626;492004;
13.01.2019;05:34:04;80653702;80161794;491908;
13.01.2019;05:35:10;80653757;80161948;491809;
13.01.2019;05:36:04;80653827;80162075;491752;
13.01.2019;05:37:05;80653893;80162247;491646;
13.01.2019;05:38:04;80653987;80162396;491591;
13.01.2019;05:39:06;80654069;80162550;491519;
13.01.2019;05:40:05;80654157;80162687;491470;
13.01.2019;05:41:04;80654237;80162816;491421;
13.01.2019;05:42:05;80654320;80162989;491331;
13.01.2019;05:43:04;80654392;80163160;491232;
13.01.2019;05:44:04;80654461;80163318;491143;
13.01.2019;05:45:04;80654532;80163473;491059;
13.01.2019;05:46:04;80654622;80163617;491005;
13.01.2019;05:47:05;80654682;80163768;490914;
13.01.2019;05:48:06;80654745;80163922;490823;
13.01.2019;05:49:06;80654837;80164102;490735;
13.01.2019;05:50:04;80654906;80164239;490667;
13.01.2019;05:51:05;80654994;80164417;490577;
13.01.2019;05:52:06;80655049;80164593;490456;
13.01.2019;05:53:04;80655124;80164723;490401;
13.01.2019;05:54:06;80655194;80164904;490290;
13.01.2019;05:55:05;80655258;80165057;490201;
13.01.2019;05:56:04;80655328;80165226;490102;
13.01.2019;05:57:04;80655403;80165405;489998;
13.01.2019;05:58:05;80655470;80165587;489883;
13.01.2019;05:59:05;80655531;80165719;489812;
13.01.2019;06:00:04;80655599;80165866;489733;
13.01.2019;06:01:05;80655689;80166029;489660;
13.01.2019;06:02:04;80655765;80166155;489610;
13.01.2019;06:03:04;80655825;80166324;489501;
13.01.2019;06:04:05;80655897;80166476;489421;
13.01.2019;06:05:05;80655968;80166642;489326;
13.01.2019;06:06:04;80656054;80166796;489258;
13.01.2019;06:07:06;80656127;80166929;489198;
13.01.2019;06:08:05;80656150;80167043;489107;
13.01.2019;06:09:06;80656202;80167187;489015;
13.01.2019;06:10:05;80656248;80167328;488920;
13.01.2019;06:11:05;80656291;80167470;488821;
13.01.2019;06:12:05;80656352;80167631;488721;
13.01.2019;06:13:05;80656418;80167773;488645;
13.01.2019;06:14:05;80656492;80167919;488573;
13.01.2019;06:15:05;80656565;80168100;488465;
13.01.2019;06:16:04;80656629;80168238;488391;
13.01.2019;06:17:04;80656683;80168401;488282;
13.01.2019;06:18:05;80656731;80168556;488175;
13.01.2019;06:19:04;80656786;80168731;488055;
13.01.2019;06:20:04;80656835;80168880;487955;
13.01.2019;06:21:06;80656910;80169021;487889;
13.01.2019;06:22:05;80656965;80169169;487796;
13.01.2019;06:23:04;80657019;80169344;487675;
13.01.2019;06:24:05;80657077;80169502;487575;
13.01.2019;06:25:07;80657161;80169686;487475;
13.01.2019;06:26:05;80657228;80169866;487362;
13.01.2019;06:27:11;80657297;80170010;487287;
13.01.2019;06:28:12;80657362;80170178;487184;
13.01.2019;06:29:04;80657416;80170334;487082;
13.01.2019;06:30:05;80657477;80170508;486969;
13.01.2019;06:31:04;80657528;80170670;486858;
13.01.2019;06:32:05;80657597;80170851;486746;
13.01.2019;06:33:04;80657656;80171027;486629;
13.01.2019;06:34:04;80657725;80171182;486543;
13.01.2019;06:35:06;80657791;80171332;486459;
13.01.2019;06:36:05;80657862;80171498;486364;
13.01.2019;06:37:04;80657857;80171593;486264;
13.01.2019;06:38:05;80657927;80171745;486182;
13.01.2019;06:39:05;80657968;80171919;486049;
13.01.2019;06:40:05;80658029;80172081;485948;
13.01.2019;06:41:04;80658086;80172247;485839;
13.01.2019;06:42:05;80658143;80172434;485709;
13.01.2019;06:43:04;80658197;80172599;485598;
13.01.2019;06:44:05;80658255;80172765;485490;
13.01.2019;06:45:04;80658321;80172936;485385;
13.01.2019;06:46:04;80658381;80173095;485286;
13.01.2019;06:47:08;80658455;80173273;485182;
13.01.2019;06:48:06;80658519;80173473;485046;
13.01.2019;06:49:06;80658591;80173630;484961;
13.01.2019;06:50:06;80658650;80173791;484859;
13.01.2019;06:51:10;80658715;80173994;484721;
13.01.2019;06:52:05;80658790;80174153;484637;
13.01.2019;06:53:05;80658859;80174343;484516;
13.01.2019;06:54:04;80658917;80174486;484431;
13.01.2019;06:55:04;80658972;80174650;484322;
13.01.2019;06:56:05;80659040;80174839;484201;
13.01.2019;06:57:04;80659109;80175016;484093;
13.01.2019;06:58:04;80659165;80175188;483977;
13.01.2019;06:59:06;80659226;80175372;483854;
13.01.2019;07:00:05;80659305;80175537;483768;
13.01.2019;07:01:04;80659365;80175712;483653;
13.01.2019;07:02:06;80659441;80175889;483552;
13.01.2019;07:03:10;80659501;80176071;483430;
13.01.2019;07:04:04;80659580;80176255;483325;
13.01.2019;07:05:05;80659639;80176380;483259;
13.01.2019;07:06:05;80659689;80176535;483154;
13.01.2019;07:07:06;80659759;80176700;483059;
13.01.2019;07:08:04;80659838;80176842;482996;
13.01.2019;07:09:06;80659908;80177032;482876;
13.01.2019;07:10:06;80659994;80177207;482787;
13.01.2019;07:11:04;80660084;80177350;482734;
13.01.2019;07:12:04;80660148;80177521;482627;
13.01.2019;07:13:05;80660201;80177693;482508;
13.01.2019;07:14:06;80660271;80177857;482414;
13.01.2019;07:15:06;80660329;80178003;482326;
13.01.2019;07:16:04;80660381;80178168;482213;
13.01.2019;07:17:05;80660443;80178335;482108;
13.01.2019;07:18:05;80660522;80178512;482010;
13.01.2019;07:19:06;80660592;80178685;481907;
13.01.2019;07:20:04;80660651;80178859;481792;
13.01.2019;07:21:05;80660725;80179042;481683;
13.01.2019;07:22:05;80660799;80179212;481587;
13.01.2019;07:23:04;80660874;80179373;481501;
13.01.2019;07:24:04;80660957;80179540;481417;
13.01.2019;07:25:06;80661017;80179719;481298;
13.01.2019;07:26:05;80661083;80179896;481187;
13.01.2019;07:27:10;80661140;80180065;481075;
13.01.2019;07:28:04;80661206;80180208;480998;
13.01.2019;07:29:06;80661268;80180400;480868;
13.01.2019;07:30:04;80661331;80180580;480751;
13.01.2019;07:31:06;80661395;80180784;480611;
13.01.2019;07:32:06;80661461;80180960;480501;
13.01.2019;07:33:04;80661511;80181109;480402;
13.01.2019;07:34:04;80661567;80181266;480301;
13.01.2019;07:35:06;80661622;80181426;480196;
13.01.2019;07:36:06;80661691;80181607;480084;
13.01.2019;07:37:06;80661762;80181786;479976;
13.01.2019;07:38:05;80661837;80181948;479889;
13.01.2019;07:39:07;80661909;80182106;479803;
13.01.2019;07:40:05;80661970;80182277;479693;
13.01.2019;07:41:05;80662041;80182441;479600;
13.01.2019;07:42:06;80662110;80182623;479487;
13.01.2019;07:43:04;80662160;80182795;479365;
13.01.2019;07:44:05;80662214;80182980;479234;
13.01.2019;07:45:05;80662291;80183137;479154;
13.01.2019;07:46:05;80662345;80183278;479067;
13.01.2019;07:47:04;80662408;80183404;479004;
13.01.2019;07:48:05;80662482;80183529;478953;
13.01.2019;07:49:05;80662520;80183699;478821;
13.01.2019;07:50:13;80662587;80183865;478722;
13.01.2019;07:51:05;80662657;80184021;478636;
13.01.2019;07:52:07;80662729;80184169;478560;
13.01.2019;07:53:05;80662796;80184322;478474;
13.01.2019;07:54:06;80662866;80184488;478378;
13.01.2019;07:55:04;80662933;80184653;478280;
13.01.2019;07:56:05;80663013;80184778;478235;
13.01.2019;07:57:04;80663079;80184916;478163;
13.01.2019;07:58:05;80663146;80185057;478089;
13.01.2019;07:59:11;80663213;80185232;477981;
13.01.2019;08:00:05;80663277;80185364;477913;
13.01.2019;08:01:05;80663329;80185514;477815;
13.01.2019;08:02:09;80663396;80185680;477716;
13.01.2019;08:03:06;80663475;80185841;477634;
13.01.2019;08:04:13;80663521;80185998;477523;
13.01.2019;08:05:04;80663591;80186135;477456;
13.01.2019;08:06:05;80663678;80186298;477380;
13.01.2019;08:07:05;80663716;80186450;477266;
13.01.2019;08:08:06;80663759;80186624;477135;
13.01.2019;08:09:06;80663787;80186733;477054;
13.01.2019;08:10:04;80663833;80186851;476982;
13.01.2019;08:11:05;80663878;80186982;476896;
13.01.2019;08:12:04;80663907;80187140;476767;
13.01.2019;08:13:04;80663930;80187289;476641;
13.01.2019;08:14:06;80663967;80187418;476549;
13.01.2019;08:15:06;80664034;80187575;476459;
13.01.2019;08:16:11;80664086;80187734;476352;
13.01.2019;08:17:12;80664142;80187894;476248;
13.01.2019;08:18:12;80664205;80188047;476158;
13.01.2019;08:19:06;80664246;80188144;476102;
13.01.2019;08:20:12;80664315;80188316;475999;
13.01.2019;08:21:05;80664376;80188455;475921;
13.01.2019;08:22:07;80664430;80188607;475823;
13.01.2019;08:23:05;80664502;80188773;475729;
13.01.2019;08:24:10;80664577;80188946;475631;
13.01.2019;08:25:11;80664619;80189097;475522;
13.01.2019;08:26:04;80664697;80189217;475480;
13.01.2019;08:27:05;80664754;80189370;475384;
13.01.2019;08:28:06;80664831;80189553;475278;
13.01.2019;08:29:14;80664922;80189705;475217;
13.01.2019;08:30:06;80664977;80189828;475149;
13.01.2019;08:31:05;80665041;80190002;475039;
13.01.2019;08:32:04;80665091;80190175;474916;
13.01.2019;08:33:06;80665133;80190344;474789;
13.01.2019;08:34:07;80665195;80190503;474692;
13.01.2019;08:35:09;80665277;80190676;474601;
13.01.2019;08:36:05;80665322;80190819;474503;
13.01.2019;08:37:05;80665389;80190970;474419;
13.01.2019;08:38:07;80665445;80191152;474293;
13.01.2019;08:39:08;80665507;80191330;474177;
13.01.2019;08:40:07;80665573;80191512;474061;
13.01.2019;08:41:06;80665624;80191660;473964;
13.01.2019;08:42:06;80665690;80191827;473863;
13.01.2019;08:43:04;80665770;80191968;473802;
13.01.2019;08:44:12;80665845;80192189;473656;
13.01.2019;08:45:11;80665912;80192314;473598;
13.01.2019;08:46:10;80665991;80192492;473499;
13.01.2019;08:47:10;80666060;80192663;473397;
13.01.2019;08:48:12;80666157;80192832;473325;
13.01.2019;08:49:04;80666216;80192963;473253;
13.01.2019;08:50:05;80666285;80193110;473175;
13.01.2019;08:51:05;80666345;80193269;473076;
13.01.2019;08:52:11;80666415;80193434;472981;
13.01.2019;08:53:06;80666479;80193563;472916;
13.01.2019;08:54:10;80666552;80193742;472810;
13.01.2019;08:55:11;80666609;80193902;472707;
13.01.2019;08:56:17;80666692;80194085;472607;
13.01.2019;08:57:04;80666752;80194212;472540;
13.01.2019;08:58:05;80666815;80194422;472393;
13.01.2019;08:59:05;80666883;80194604;472279;
13.01.2019;09:00:06;80666941;80194755;472186;
13.01.2019;09:01:05;80667007;80194926;472081;
13.01.2019;09:02:05;80667070;80195099;471971;
13.01.2019;09:03:10;80667143;80195274;471869;
13.01.2019;09:04:05;80667208;80195423;471785;
13.01.2019;09:05:10;80667281;80195628;471653;
13.01.2019;09:06:06;80667358;80195777;471581;
13.01.2019;09:07:12;80667433;80195963;471470;
13.01.2019;09:08:10;80667503;80196126;471377;
13.01.2019;09:09:07;80667563;80196303;471260;
13.01.2019;09:10:11;80667633;80196486;471147;
13.01.2019;09:11:04;80667702;80196622;471080;
13.01.2019;09:12:11;80667758;80196805;470953;
13.01.2019;09:13:10;80667823;80196987;470836;
13.01.2019;09:14:10;80667875;80197152;470723;
13.01.2019;09:15:06;80667937;80197328;470609;
13.01.2019;09:16:04;80668005;80197494;470511;
13.01.2019;09:17:06;80668078;80197664;470414;
13.01.2019;09:18:07;80668118;80197828;470290;
13.01.2019;09:19:05;80668198;80197975;470223;
13.01.2019;09:20:10;80668291;80198156;470135;
13.01.2019;09:21:06;80668365;80198306;470059;
13.01.2019;09:22:05;80668428;80198484;469944;
13.01.2019;09:23:05;80668498;80198662;469836;
13.01.2019;09:24:05;80668557;80198824;469733;
13.01.2019;09:25:05;80668627;80199009;469618;
13.01.2019;09:26:04;80668679;80199188;469491;
13.01.2019;09:27:05;80668742;80199347;469395;
13.01.2019;09:28:05;80668805;80199515;469290;
13.01.2019;09:29:04;80668871;80199668;469203;
13.01.2019;09:30:05;80668929;80199840;469089;
13.01.2019;09:31:04;80668988;80199989;468999;
13.01.2019;09:32:06;80669045;80200171;468874;
13.01.2019;09:33:09;80669100;80200377;468723;
13.01.2019;09:34:07;80669165;80200536;468629;
13.01.2019;09:35:05;80669256;80200682;468574;
13.01.2019;09:36:12;80669298;80200833;468465;
13.01.2019;09:37:05;80669297;80200957;468340;
13.01.2019;09:38:04;80669348;80201116;468232;
13.01.2019;09:39:13;80669419;80201327;468092;
13.01.2019;09:40:12;80669489;80201480;468009;
13.01.2019;09:41:06;80669556;80201632;467924;
13.01.2019;09:42:06;80669613;80201792;467821;
13.01.2019;09:43:11;80669690;80201965;467725;
13.01.2019;09:44:06;80669742;80202142;467600;
13.01.2019;09:45:05;80669812;80202294;467518;
13.01.2019;09:46:11;80669880;80202475;467405;
13.01.2019;09:47:06;80669942;80202652;467290;
13.01.2019;09:48:04;80670007;80202832;467175;
13.01.2019;09:49:04;80670063;80203013;467050;
13.01.2019;09:50:06;80670142;80203170;466972;
13.01.2019;09:51:06;80670208;80203323;466885;
13.01.2019;09:52:04;80670261;80203476;466785;
13.01.2019;09:53:12;80670322;80203645;466677;
13.01.2019;09:54:07;80670375;80203782;466593;
13.01.2019;09:55:06;80670448;80203929;466519;
13.01.2019;09:56:05;80670511;80204072;466439;
13.01.2019;09:57:04;80670552;80204235;466317;
13.01.2019;09:58:11;80670638;80204426;466212;
13.01.2019;09:59:05;80670705;80204547;466158;
13.01.2019;10:00:05;80670762;80204675;466087;
13.01.2019;10:01:06;80670812;80204845;465967;
13.01.2019;10:02:04;80670868;80204990;465878;
13.01.2019;10:03:06;80670935;80205167;465768;
13.01.2019;10:04:11;80670988;80205336;465652;
13.01.2019;10:05:05;80671042;80205474;465568;
13.01.2019;10:06:04;80671113;80205636;465477;
13.01.2019;10:07:05;80671162;80205789;465373;
13.01.2019;10:08:04;80671220;80205970;465250;
13.01.2019;10:09:10;80671308;80206164;465144;
13.01.2019;10:10:10;80671361;80206317;465044;
13.01.2019;10:11:10;80671402;80206480;464922;
13.01.2019;10:12:05;80671406;80206616;464790;
13.01.2019;10:13:07;80671448;80206751;464697;
13.01.2019;10:14:04;80671486;80206873;464613;
13.01.2019;10:15:05;80671545;80207045;464500;
13.01.2019;10:16:08;80671592;80207211;464381;
13.01.2019;10:17:10;80671627;80207330;464297;
13.01.2019;10:18:04;80671669;80207484;464185;
13.01.2019;10:19:04;80671717;80207615;464102;
13.01.2019;10:20:05;80671787;80207763;464024;
13.01.2019;10:21:07;80671848;80207932;463916;
13.01.2019;10:22:06;80671907;80208105;463802;
13.01.2019;10:23:06;80671945;80208252;463693;
13.01.2019;10:24:05;80671989;80208420;463569;
13.01.2019;10:25:05;80672045;80208581;463464;
13.01.2019;10:26:06;80672099;80208747;463352;
13.01.2019;10:27:04;80672153;80208893;463260;
13.01.2019;10:28:04;80672223;80209067;463156;
13.01.2019;10:29:06;80672290;80209206;463084;
13.01.2019;10:30:04;80672337;80209379;462958;
13.01.2019;10:31:04;80672409;80209547;462862;
13.01.2019;10:32:06;80672465;80209680;462785;
13.01.2019;10:33:10;80672515;80209844;462671;
13.01.2019;10:34:05;80672559;80209970;462589;
13.01.2019;10:35:05;80672620;80210101;462519;
13.01.2019;10:36:10;80672692;80210286;462406;
13.01.2019;10:37:06;80672737;80210449;462288;
13.01.2019;10:38:05;80672795;80210619;462176;
13.01.2019;10:39:07;80672875;80210769;462106;
13.01.2019;10:40:11;80672966;80210982;461984;
13.01.2019;10:41:05;80672999;80211110;461889;
13.01.2019;10:42:12;80673076;80211293;461783;
13.01.2019;10:43:06;80673131;80211469;461662;
13.01.2019;10:44:06;80673189;80211644;461545;
13.01.2019;10:45:09;80673235;80211837;461398;
13.01.2019;10:46:07;80673297;80211991;461306;
13.01.2019;10:47:04;80673359;80212135;461224;
13.01.2019;10:48:08;80673408;80212304;461104;
13.01.2019;10:49:12;80673479;80212483;460996;
13.01.2019;10:50:07;80673548;80212634;460914;
13.01.2019;10:51:11;80673605;80212785;460820;
13.01.2019;10:52:10;80673659;80212930;460729;
13.01.2019;10:53:04;80673728;80213076;460652;
13.01.2019;10:54:10;80673798;80213232;460566;
13.01.2019;10:55:06;80673852;80213412;460440;
13.01.2019;10:56:05;80673905;80213553;460352;
13.01.2019;10:57:07;80673956;80213722;460234;
13.01.2019;10:58:06;80674004;80213911;460093;
13.01.2019;10:59:08;80674061;80214085;459976;
13.01.2019;11:00:13;80674138;80214255;459883;
13.01.2019;11:01:06;80674194;80214375;459819;
13.01.2019;11:02:04;80674240;80214546;459694;
13.01.2019;11:03:12;80674301;80214766;459535;
13.01.2019;11:04:07;80674346;80214902;459444;
13.01.2019;11:05:04;80674408;80215078;459330;
13.01.2019;11:06:04;80674473;80215266;459207;
13.01.2019;11:07:05;80674529;80215427;459102;
13.01.2019;11:08:06;80674595;80215593;459002;
13.01.2019;11:09:06;80674668;80215761;458907;
13.01.2019;11:10:05;80674733;80215918;458815;
13.01.2019;11:11:05;80674786;80216089;458697;
13.01.2019;11:12:06;80674849;80216243;458606;
13.01.2019;11:13:12;80674905;80216397;458508;
13.01.2019;11:14:10;80674980;80216557;458423;
13.01.2019;11:15:06;80675040;80216697;458343;
13.01.2019;11:16:05;80675096;80216852;458244;
13.01.2019;11:17:04;80675157;80217029;458128;
13.01.2019;11:18:10;80675233;80217219;458014;
13.01.2019;11:19:07;80675295;80217362;457933;
13.01.2019;11:20:06;80675343;80217491;457852;
13.01.2019;11:21:06;80675403;80217668;457735;
13.01.2019;11:22:09;80675456;80217872;457584;
13.01.2019;11:23:05;80675527;80218015;457512;
13.01.2019;11:24:06;80675604;80218167;457437;
13.01.2019;11:25:05;80675659;80218334;457325;
13.01.2019;11:26:06;80675723;80218501;457222;
13.01.2019;11:27:15;80675786;80218679;457107;
13.01.2019;11:28:08;80675834;80218815;457019;
13.01.2019;11:29:13;80675885;80218998;456887;
13.01.2019;11:30:15;80675952;80219176;456776;
13.01.2019;11:32:07;80676074;80219471;456603;
13.01.2019;11:33:11;80676135;80219647;456488;
13.01.2019;11:34:08;80676198;80219814;456384;
13.01.2019;11:35:11;80676264;80220002;456262;
13.01.2019;11:36:13;80676321;80220164;456157;
13.01.2019;11:37:06;80676371;80220315;456056;
13.01.2019;11:38:09;80676435;80220483;455952;
13.01.2019;11:39:30;80676494;80220682;455812;
13.01.2019;11:40:15;80676542;80220783;455759;
13.01.2019;11:41:07;80676592;80220907;455685;
13.01.2019;11:42:07;80676646;80221058;455588;
13.01.2019;11:43:07;80676720;80221213;455507;
13.01.2019;11:44:11;80676784;80221388;455396;
13.01.2019;11:45:06;80676843;80221534;455309;
13.01.2019;11:46:07;80676909;80221709;455200;
13.01.2019;11:47:10;80676967;80221869;455098;
13.01.2019;11:48:07;80677025;80221997;455028;
13.01.2019;11:51:09;80677201;80222438;454763;
13.01.2019;11:52:10;80677264;80222597;454667;
13.01.2019;11:53:27;80677330;80222771;454559;
13.01.2019;11:54:06;80677402;80222882;454520;
13.01.2019;11:55:07;80677453;80223048;454405;
13.01.2019;11:56:12;80677509;80223204;454305;
13.01.2019;11:57:08;80677560;80223341;454219;
13.01.2019;11:58:09;80677634;80223491;454143;
13.01.2019;11:59:08;80677687;80223642;454045;
13.01.2019;12:00:06;80677740;80223785;453955;
13.01.2019;12:01:09;80677801;80223936;453865;
13.01.2019;12:02:08;80677856;80224098;453758;
13.01.2019;12:03:07;80677916;80224233;453683;
13.01.2019;12:04:11;80677995;80224408;453587;
13.01.2019;12:05:12;80678055;80224544;453511;
13.01.2019;12:06:10;80678105;80224703;453402;
13.01.2019;12:07:13;80678166;80224840;453326;
13.01.2019;12:08:19;80678219;80225018;453201;
13.01.2019;12:09:16;80678298;80225175;453123;
13.01.2019;12:10:31;80678329;80225319;453010;
13.01.2019;12:11:08;80678340;80225375;452965;
13.01.2019;12:12:19;80678357;80225544;452813;
13.01.2019;12:13:09;80678348;80225601;452747;
13.01.2019;12:14:09;80678380;80225742;452638;
13.01.2019;12:15:12;80678419;80225867;452552;
13.01.2019;12:16:07;80678497;80225982;452515;
13.01.2019;12:17:12;80678547;80226130;452417;
13.01.2019;12:18:13;80678599;80226304;452295;
13.01.2019;12:19:08;80678657;80226443;452214;
13.01.2019;12:20:06;80678718;80226580;452138;
13.01.2019;12:21:10;80678777;80226755;452022;
13.01.2019;12:22:05;80678833;80226902;451931;
13.01.2019;12:23:06;80678903;80227044;451859;
13.01.2019;12:24:06;80678965;80227210;451755;
13.01.2019;12:25:06;80679019;80227382;451637;
13.01.2019;12:26:10;80679059;80227529;451530;
13.01.2019;12:27:05;80679106;80227673;451433;
13.01.2019;12:28:06;80679170;80227844;451326;
13.01.2019;12:29:04;80679228;80228009;451219;
13.01.2019;12:30:05;80679281;80228155;451126;
13.01.2019;12:31:06;80679325;80228317;451008;
13.01.2019;12:32:12;80679387;80228494;450893;
13.01.2019;12:33:05;80679448;80228615;450833;
13.01.2019;12:34:04;80679516;80228771;450745;
13.01.2019;12:35:06;80679499;80228872;450627;
13.01.2019;12:36:04;80679370;80228880;450490;
13.01.2019;12:37:11;80679431;80229043;450388;
13.01.2019;12:38:07;80679489;80229172;450317;
13.01.2019;12:39:09;80679551;80229341;450210;
13.01.2019;12:40:05;80679604;80229478;450126;
13.01.2019;12:41:06;80679661;80229626;450035;
13.01.2019;12:42:06;80679708;80229785;449923;
13.01.2019;12:43:06;80679761;80229945;449816;
13.01.2019;12:44:06;80679808;80230117;449691;
13.01.2019;12:45:05;80679876;80230283;449593;
13.01.2019;12:46:05;80679948;80230423;449525;
13.01.2019;12:47:05;80680003;80230565;449438;
13.01.2019;12:48:06;80680058;80230730;449328;
13.01.2019;12:49:06;80680128;80230884;449244;
13.01.2019;12:50:06;80680187;80231044;449143;
13.01.2019;12:51:06;80680243;80231175;449068;
13.01.2019;12:52:06;80680313;80231352;448961;
13.01.2019;12:53:06;80680377;80231487;448890;
13.01.2019;12:54:07;80680443;80231660;448783;
13.01.2019;12:55:06;80680510;80231824;448686;
13.01.2019;12:56:07;80680572;80231999;448573;
13.01.2019;12:57:10;80680633;80232152;448481;
13.01.2019;12:58:05;80680695;80232295;448400;
13.01.2019;12:59:05;80680753;80232439;448314;
13.01.2019;13:00:04;80680810;80232590;448220;
13.01.2019;13:01:12;80680864;80232794;448070;
13.01.2019;13:02:04;80680917;80232918;447999;
13.01.2019;13:03:06;80680981;80233068;447913;
13.01.2019;13:04:11;80681043;80233238;447805;
13.01.2019;13:05:10;80681110;80233388;447722;
13.01.2019;13:06:05;80681168;80233529;447639;
13.01.2019;13:07:05;80681255;80233693;447562;
13.01.2019;13:08:04;80681327;80233848;447479;
13.01.2019;13:09:07;80681389;80234030;447359;
13.01.2019;13:10:10;80681452;80234207;447245;
13.01.2019;13:11:12;80681540;80234407;447133;
13.01.2019;13:12:11;80681615;80234567;447048;
13.01.2019;13:13:05;80681667;80234724;446943;
13.01.2019;13:14:06;80681745;80234888;446857;
13.01.2019;13:16:05;80681875;80235215;446660;
13.01.2019;13:17:05;80681932;80235366;446566;
13.01.2019;13:18:04;80681997;80235521;446476;
13.01.2019;13:19:05;80682062;80235691;446371;
13.01.2019;13:20:05;80682137;80235851;446286;
13.01.2019;13:21:05;80682216;80236009;446207;
13.01.2019;13:22:04;80682289;80236158;446131;
13.01.2019;13:23:04;80682384;80236311;446073;
13.01.2019;13:24:04;80682443;80236502;445941;
13.01.2019;13:25:04;80682506;80236669;445837;
13.01.2019;13:26:05;80682564;80236818;445746;
13.01.2019;13:27:05;80682631;80236976;445655;
13.01.2019;13:28:05;80682698;80237116;445582;
13.01.2019;13:29:21;80682791;80237313;445478;
13.01.2019;13:31:06;80682924;80237573;445351;
13.01.2019;13:32:04;80682994;80237703;445291;
13.01.2019;13:32:22;80682859;80237750;445109;
13.01.2019;13:33:05;80683069;80237868;445201;
13.01.2019;13:34:04;80683146;80238027;445119;
13.01.2019;13:35:05;80683209;80238195;445014;
13.01.2019;13:36:05;80683289;80238358;444931;
13.01.2019;13:37:05;80683350;80238524;444826;
13.01.2019;13:38:05;80683417;80238661;444756;
13.01.2019;13:39:08;80683490;80238810;444680;
13.01.2019;13:40:06;80683549;80238977;444572;
13.01.2019;13:41:52;80683630;80239275;444355;
13.01.2019;13:42:05;80683709;80239307;444402;
13.01.2019;13:45:04;80683891;80239813;444078;
13.01.2019;13:46:04;80683936;80239976;443960;
13.01.2019;13:47:05;80684018;80240143;443875;
13.01.2019;13:48:05;80684101;80240288;443813;
13.01.2019;13:49:06;80684187;80240452;443735;
13.01.2019;13:50:04;80684254;80240593;443661;
13.01.2019;13:51:05;80684321;80240751;443570;
13.01.2019;13:52:04;80684383;80240913;443470;
13.01.2019;13:53:06;80684430;80241071;443359;
13.01.2019;13:54:15;80684501;80241239;443262;
13.01.2019;14:00:38;80684930;80242314;442616;
13.01.2019;14:01:10;80684984;80242413;442571;
13.01.2019;14:02:08;80685047;80242561;442486;
13.01.2019;14:03:13;80685119;80242752;442367;
13.01.2019;14:04:26;80685177;80242937;442240;
13.01.2019;14:06:07;80685318;80243225;442093;
13.01.2019;14:08:09;80685424;80243587;441837;
13.01.2019;14:08:31;80685442;80243640;441802;
13.01.2019;14:09:25;80685478;80243784;441694;
13.01.2019;14:10:07;80685508;80243881;441627;
13.01.2019;14:11:04;80685559;80244023;441536;
13.01.2019;14:12:05;80685626;80244176;441450;
13.01.2019;14:13:06;80685677;80244305;441372;
13.01.2019;14:14:06;80685726;80244442;441284;
13.01.2019;14:15:07;80685774;80244571;441203;
13.01.2019;14:16:58;80685879;80244858;441021;
13.01.2019;14:17:15;80685882;80244891;440991;
13.01.2019;14:18:24;80685946;80245051;440895;
13.01.2019;14:19:08;80685985;80245151;440834;
13.01.2019;14:20:13;80686046;80245305;440741;
13.01.2019;14:21:05;80686102;80245460;440642;
13.01.2019;14:22:04;80686165;80245619;440546;
13.01.2019;14:23:15;80686247;80245812;440435;
13.01.2019;14:24:17;80686323;80246006;440317;
13.01.2019;14:27:06;80686522;80246487;440035;
13.01.2019;14:28:04;80686599;80246628;439971;
13.01.2019;14:29:05;80686666;80246801;439865;
13.01.2019;14:30:05;80686733;80246944;439789;
13.01.2019;14:31:04;80686818;80247096;439722;
13.01.2019;14:34:08;80687042;80247590;439452;
13.01.2019;14:34:09;80687044;80247592;439452;
13.01.2019;14:34:18;80687059;80247613;439446;
13.01.2019;14:35:06;80687121;80247751;439370;
13.01.2019;14:36:05;80687204;80247929;439275;
13.01.2019;14:38:04;80687343;80248285;439058;
13.01.2019;14:40:24;80687538;80248694;438844;
13.01.2019;14:41:07;80687604;80248837;438767;
13.01.2019;14:41:19;80687622;80248868;438754;
13.01.2019;14:42:30;80687693;80249032;438661;
13.01.2019;14:43:06;80687747;80249145;438602;
13.01.2019;14:44:06;80687829;80249322;438507;
13.01.2019;14:48:07;80688162;80250030;438132;
13.01.2019;14:51:06;80688403;80250523;437880;
13.01.2019;14:51:09;80688408;80250528;437880;
13.01.2019;14:51:17;80688416;80250546;437870;
13.01.2019;14:52:06;80688481;80250707;437774;
13.01.2019;14:53:06;80688563;80250879;437684;
13.01.2019;14:54:06;80688652;80251037;437615;
13.01.2019;14:56:09;80688822;80251397;437425;
13.01.2019;14:57:06;80688896;80251582;437314;
13.01.2019;14:58:06;80688975;80251751;437224;
13.01.2019;14:59:06;80689051;80251924;437127;
13.01.2019;15:00:09;80689153;80252093;437060;
13.01.2019;15:01:07;80689244;80252284;436960;
13.01.2019;15:02:11;80689328;80252470;436858;
13.01.2019;15:03:14;80689417;80252647;436770;
13.01.2019;15:04:08;80689481;80252793;436688;
13.01.2019;15:05:08;80689565;80252943;436622;
13.01.2019;15:06:08;80689653;80253096;436557;
13.01.2019;15:07:10;80689721;80253236;436485;
13.01.2019;15:08:08;80689823;80253397;436426;
13.01.2019;15:09:14;80689914;80253606;436308;
13.01.2019;15:10:14;80689997;80253761;436236;
13.01.2019;15:11:08;80690082;80253902;436180;
13.01.2019;15:12:09;80690171;80254075;436096;
13.01.2019;15:13:09;80690236;80254277;435959;
13.01.2019;15:14:08;80690312;80254471;435841;
13.01.2019;15:15:09;80690394;80254638;435756;
13.01.2019;15:16:12;80690465;80254839;435626;
13.01.2019;15:17:08;80690537;80255010;435527;
13.01.2019;15:18:11;80690619;80255187;435432;
13.01.2019;15:19:13;80690707;80255359;435348;
13.01.2019;15:20:12;80690801;80255523;435278;
13.01.2019;15:21:07;80690867;80255681;435186;
13.01.2019;15:22:08;80690950;80255894;435056;
13.01.2019;15:23:07;80691033;80256091;434942;
13.01.2019;15:24:08;80691123;80256270;434853;
13.01.2019;15:25:09;80691192;80256448;434744;
13.01.2019;15:26:08;80691271;80256602;434669;
13.01.2019;15:27:08;80691382;80256773;434609;
13.01.2019;15:28:08;80691463;80256969;434494;
13.01.2019;15:29:09;80691544;80257151;434393;
13.01.2019;15:30:08;80691628;80257321;434307;
13.01.2019;15:31:14;80691727;80257548;434179;
13.01.2019;15:32:07;80691801;80257719;434082;
13.01.2019;15:33:07;80691877;80257876;434001;
13.01.2019;15:34:07;80691976;80258032;433944;
13.01.2019;15:35:09;80692062;80258196;433866;
13.01.2019;15:36:07;80692123;80258352;433771;
13.01.2019;15:37:07;80692201;80258548;433653;
13.01.2019;15:38:08;80692290;80258726;433564;
13.01.2019;15:39:08;80692376;80258899;433477;
13.01.2019;15:40:08;80692435;80259048;433387;
13.01.2019;15:41:07;80692347;80259060;433287;
13.01.2019;15:42:10;80692242;80259071;433171;
13.01.2019;15:43:08;80692335;80259230;433105;
13.01.2019;15:44:09;80692405;80259416;432989;
13.01.2019;15:45:12;80692498;80259603;432895;
13.01.2019;15:46:07;80692568;80259768;432800;
13.01.2019;15:47:07;80692644;80259941;432703;
13.01.2019;15:48:13;80692751;80260149;432602;
13.01.2019;15:49:08;80692832;80260312;432520;
13.01.2019;15:50:08;80692923;80260469;432454;
13.01.2019;15:51:08;80693011;80260636;432375;
13.01.2019;15:52:12;80693131;80260827;432304;
13.01.2019;15:53:09;80693231;80260996;432235;
13.01.2019;15:54:13;80693313;80261160;432153;
13.01.2019;15:55:07;80693395;80261312;432083;
13.01.2019;15:56:08;80693485;80261471;432014;
13.01.2019;15:57:07;80693582;80261660;431922;
13.01.2019;15:58:08;80693665;80261857;431808;
13.01.2019;15:59:09;80693780;80262060;431720;
13.01.2019;16:00:05;80693860;80262233;431627;
13.01.2019;16:01:11;80693955;80262449;431506;
13.01.2019;16:02:12;80694038;80262625;431413;
13.01.2019;16:03:05;80694105;80262785;431320;
13.01.2019;16:04:07;80694185;80262955;431230;
13.01.2019;16:05:05;80694264;80263126;431138;
13.01.2019;16:06:06;80694342;80263321;431021;
13.01.2019;16:07:11;80694436;80263506;430930;
13.01.2019;16:08:06;80694522;80263692;430830;
13.01.2019;16:09:07;80694629;80263881;430748;
13.01.2019;16:10:12;80694752;80264074;430678;
13.01.2019;16:11:05;80694837;80264210;430627;
13.01.2019;16:12:04;80694872;80264345;430527;
13.01.2019;16:13:04;80694912;80264463;430449;
13.01.2019;16:14:05;80694993;80264633;430360;
13.01.2019;16:15:11;80695098;80264849;430249;
13.01.2019;16:16:08;80695183;80265017;430166;
13.01.2019;16:17:11;80695248;80265176;430072;
13.01.2019;16:18:05;80695300;80265307;429993;
13.01.2019;16:19:05;80695399;80265450;429949;
13.01.2019;16:20:07;80695466;80265639;429827;
13.01.2019;16:21:12;80695533;80265803;429730;
13.01.2019;16:22:06;80695615;80265937;429678;
13.01.2019;16:23:13;80695726;80266115;429611;
13.01.2019;16:24:05;80695791;80266276;429515;
13.01.2019;16:25:05;80695884;80266469;429415;
13.01.2019;16:26:13;80695973;80266649;429324;
13.01.2019;16:27:12;80696053;80266823;429230;
13.01.2019;16:28:11;80696118;80267009;429109;
13.01.2019;16:29:06;80696205;80267206;428999;
13.01.2019;16:30:06;80696290;80267375;428915;
13.01.2019;16:31:11;80696394;80267566;428828;
13.01.2019;16:32:12;80696481;80267713;428768;
13.01.2019;16:33:10;80696559;80267886;428673;
13.01.2019;16:34:04;80696664;80268056;428608;
13.01.2019;16:35:07;80696784;80268242;428542;
13.01.2019;16:36:07;80696853;80268441;428412;
13.01.2019;16:37:06;80696942;80268599;428343;
13.01.2019;16:38:06;80697030;80268787;428243;
13.01.2019;16:39:07;80697106;80268982;428124;
13.01.2019;16:40:04;80697186;80269164;428022;
13.01.2019;16:41:04;80697291;80269349;427942;
13.01.2019;16:42:10;80697391;80269551;427840;
13.01.2019;16:43:05;80697476;80269719;427757;
13.01.2019;16:44:06;80697571;80269891;427680;
13.01.2019;16:45:05;80697671;80270088;427583;
13.01.2019;16:46:05;80697750;80270261;427489;
13.01.2019;16:47:06;80697849;80270432;427417;
13.01.2019;16:48:11;80697931;80270612;427319;
13.01.2019;16:49:08;80698027;80270779;427248;
13.01.2019;16:50:11;80698128;80270963;427165;
13.01.2019;16:51:06;80698209;80271117;427092;
13.01.2019;16:52:07;80698295;80271307;426988;
13.01.2019;16:53:10;80698405;80271488;426917;
13.01.2019;16:54:05;80698496;80271652;426844;
13.01.2019;16:55:06;80698583;80271838;426745;
13.01.2019;16:56:06;80698672;80272020;426652;
13.01.2019;16:57:11;80698753;80272208;426545;
13.01.2019;16:58:12;80698862;80272400;426462;
13.01.2019;16:59:11;80698945;80272566;426379;
13.01.2019;17:00:07;80699033;80272730;426303;
13.01.2019;17:01:06;80699143;80272865;426278;
13.01.2019;17:02:06;80699250;80273039;426211;
13.01.2019;17:03:05;80699357;80273196;426161;
13.01.2019;17:04:05;80699448;80273392;426056;
13.01.2019;17:05:05;80699536;80273576;425960;
13.01.2019;17:06:06;80699644;80273769;425875;
13.01.2019;17:07:05;80699726;80273912;425814;
13.01.2019;17:08:07;80699812;80274073;425739;
13.01.2019;17:09:09;80699928;80274265;425663;
13.01.2019;17:10:06;80700028;80274441;425587;
13.01.2019;17:11:08;80700111;80274604;425507;
13.01.2019;17:12:06;80700221;80274754;425467;
13.01.2019;17:13:11;80700316;80274958;425358;
13.01.2019;17:14:07;80700401;80275103;425298;
13.01.2019;17:15:05;80700508;80275272;425236;
13.01.2019;17:16:11;80700600;80275471;425129;
13.01.2019;17:17:07;80700690;80275632;425058;
13.01.2019;17:18:07;80700770;80275813;424957;
13.01.2019;17:19:05;80700863;80275970;424893;
13.01.2019;17:20:06;80700972;80276124;424848;
13.01.2019;17:21:06;80701076;80276277;424799;
13.01.2019;17:22:06;80701176;80276435;424741;
13.01.2019;17:23:06;80701270;80276598;424672;
13.01.2019;17:24:05;80701347;80276762;424585;
13.01.2019;17:25:05;80701435;80276942;424493;
13.01.2019;17:26:05;80701541;80277116;424425;
13.01.2019;17:27:05;80701635;80277277;424358;
13.01.2019;17:28:05;80701742;80277424;424318;
13.01.2019;17:29:05;80701841;80277578;424263;
13.01.2019;17:30:05;80701920;80277752;424168;
13.01.2019;17:31:05;80702029;80277922;424107;
13.01.2019;17:32:05;80702101;80278079;424022;
13.01.2019;17:33:06;80702208;80278242;423966;
13.01.2019;17:34:13;80702328;80278431;423897;
13.01.2019;17:35:05;80702418;80278555;423863;
13.01.2019;17:36:04;80702519;80278691;423828;
13.01.2019;17:37:06;80702617;80278869;423748;
13.01.2019;17:38:06;80702704;80279028;423676;
13.01.2019;17:39:13;80702799;80279214;423585;
13.01.2019;17:40:11;80702879;80279361;423518;
13.01.2019;17:41:05;80702983;80279475;423508;
13.01.2019;17:42:05;80703098;80279652;423446;
13.01.2019;17:43:06;80703190;80279811;423379;
13.01.2019;17:44:06;80703273;80279960;423313;
13.01.2019;17:45:14;80703386;80280119;423267;
13.01.2019;17:46:06;80703467;80280267;423200;
13.01.2019;17:47:06;80703559;80280413;423146;
13.01.2019;17:48:05;80703675;80280573;423102;
13.01.2019;17:49:05;80703761;80280741;423020;
13.01.2019;17:50:07;80703860;80280911;422949;
13.01.2019;17:51:05;80703963;80281074;422889;
13.01.2019;17:52:05;80704048;80281235;422813;
13.01.2019;17:53:06;80704131;80281409;422722;
13.01.2019;17:54:05;80704228;80281556;422672;
13.01.2019;17:55:04;80704318;80281701;422617;
13.01.2019;17:56:04;80704412;80281868;422544;
13.01.2019;17:57:09;80704492;80282046;422446;
13.01.2019;17:58:06;80704581;80282182;422399;
13.01.2019;17:59:05;80704678;80282370;422308;
13.01.2019;18:00:04;80704780;80282505;422275;
13.01.2019;18:01:06;80704865;80282666;422199;
13.01.2019;18:02:11;80704963;80282847;422116;
13.01.2019;18:03:10;80705049;80282979;422070;
13.01.2019;18:04:05;80705130;80283123;422007;
13.01.2019;18:05:12;80705220;80283297;421923;
13.01.2019;18:06:04;80705282;80283409;421873;
13.01.2019;18:07:13;80705386;80283604;421782;
13.01.2019;18:08:07;80705490;80283718;421772;
13.01.2019;18:09:05;80705589;80283878;421711;
13.01.2019;18:10:12;80705673;80284048;421625;
13.01.2019;18:11:04;80705773;80284219;421554;
13.01.2019;18:12:05;80705848;80284342;421506;
13.01.2019;18:13:07;80705940;80284474;421466;
13.01.2019;18:14:11;80706030;80284621;421409;
13.01.2019;18:15:14;80706161;80284734;421427;
13.01.2019;18:16:07;80706211;80284851;421360;
13.01.2019;18:17:07;80706268;80284968;421300;
13.01.2019;18:18:12;80706345;80285110;421235;
13.01.2019;18:19:09;80706419;80285223;421196;
13.01.2019;18:20:07;80706483;80285344;421139;
13.01.2019;18:21:09;80706560;80285468;421092;
13.01.2019;18:22:06;80706642;80285579;421063;
13.01.2019;18:23:06;80706712;80285711;421001;
13.01.2019;18:24:05;80706784;80285852;420932;
13.01.2019;18:25:10;80706847;80285988;420859;
13.01.2019;18:26:05;80706946;80286135;420811;
13.01.2019;18:27:06;80707050;80286261;420789;
13.01.2019;18:28:05;80707146;80286405;420741;
13.01.2019;18:29:16;80707236;80286558;420678;
13.01.2019;18:30:07;80707335;80286681;420654;
13.01.2019;18:31:04;80707419;80286817;420602;
13.01.2019;18:32:06;80707482;80286952;420530;
13.01.2019;18:33:04;80707580;80287089;420491;
13.01.2019;18:34:05;80707667;80287237;420430;
13.01.2019;18:35:05;80707769;80287381;420388;
13.01.2019;18:36:06;80707866;80287499;420367;
13.01.2019;18:37:05;80707968;80287616;420352;
13.01.2019;18:38:11;80708070;80287752;420318;
13.01.2019;18:39:08;80708171;80287885;420286;
13.01.2019;18:40:11;80708251;80288010;420241;
13.01.2019;18:41:08;80708262;80288036;420226;
13.01.2019;18:42:11;80708324;80288189;420135;
13.01.2019;18:43:05;80708414;80288317;420097;
13.01.2019;18:44:05;80708519;80288447;420072;
13.01.2019;18:45:05;80708617;80288569;420048;
13.01.2019;18:46:05;80708698;80288694;420004;
13.01.2019;18:47:06;80708663;80288857;419806;
13.01.2019;18:48:05;80708700;80288986;419714;
13.01.2019;18:49:04;80708745;80289112;419633;
13.01.2019;18:50:04;80708773;80289193;419580;
13.01.2019;18:51:07;80708828;80289338;419490;
13.01.2019;18:52:04;80708886;80289485;419401;
13.01.2019;18:53:05;80708938;80289629;419309;
13.01.2019;18:54:04;80708994;80289763;419231;
13.01.2019;18:55:11;80709039;80289902;419137;
13.01.2019;18:56:05;80709112;80290010;419102;
13.01.2019;18:57:06;80709157;80290128;419029;
13.01.2019;18:58:06;80709215;80290265;418950;
13.01.2019;18:59:06;80709290;80290405;418885;
13.01.2019;19:00:04;80709333;80290526;418807;
13.01.2019;19:01:05;80709404;80290652;418752;
13.01.2019;19:02:04;80709483;80290772;418711;
13.01.2019;19:03:06;80709545;80290901;418644;
13.01.2019;19:04:06;80709626;80291022;418604;
13.01.2019;19:05:05;80709692;80291121;418571;
13.01.2019;19:06:13;80709778;80291239;418539;
13.01.2019;19:07:05;80709843;80291325;418518;
13.01.2019;19:08:06;80709935;80291468;418467;
13.01.2019;19:09:06;80710032;80291611;418421;
13.01.2019;19:10:05;80710086;80291723;418363;
13.01.2019;19:11:06;80710151;80291826;418325;
13.01.2019;19:12:05;80710219;80291933;418286;
13.01.2019;19:13:05;80710296;80292039;418257;
13.01.2019;19:14:06;80710379;80292158;418221;
13.01.2019;19:15:07;80710435;80292259;418176;
13.01.2019;19:16:04;80710495;80292376;418119;
13.01.2019;19:17:06;80710569;80292469;418100;
13.01.2019;19:18:06;80710619;80292600;418019;
13.01.2019;19:19:04;80710689;80292705;417984;
13.01.2019;19:20:04;80710748;80292791;417957;
13.01.2019;19:21:04;80710829;80292897;417932;
13.01.2019;19:22:05;80710913;80293010;417903;
13.01.2019;19:23:05;80710986;80293098;417888;
13.01.2019;19:24:07;80711061;80293206;417855;
13.01.2019;19:25:05;80711126;80293301;417825;
13.01.2019;19:26:12;80711224;80293415;417809;
13.01.2019;19:27:06;80711296;80293530;417766;
13.01.2019;19:28:08;80711369;80293616;417753;
13.01.2019;19:29:07;80711447;80293724;417723;
13.01.2019;19:30:05;80711502;80293813;417689;
13.01.2019;19:31:07;80711567;80293924;417643;
13.01.2019;19:32:24;80711686;80294038;417648;
13.01.2019;19:34:05;80711821;80294202;417619;
13.01.2019;19:35:10;80711921;80294288;417633;
13.01.2019;19:36:12;80711991;80294381;417610;
13.01.2019;19:37:07;80712059;80294463;417596;
13.01.2019;19:38:04;80712142;80294534;417608;
13.01.2019;19:39:06;80712198;80294631;417567;
13.01.2019;19:40:06;80712293;80294728;417565;
13.01.2019;19:41:05;80712369;80294811;417558;
13.01.2019;19:42:11;80712474;80294900;417574;
13.01.2019;19:43:05;80712565;80294985;417580;
13.01.2019;19:44:06;80712652;80295068;417584;
13.01.2019;19:45:11;80712736;80295166;417570;
13.01.2019;19:46:06;80712816;80295266;417550;
13.01.2019;19:47:06;80712879;80295363;417516;
13.01.2019;19:48:06;80712956;80295458;417498;
13.01.2019;19:49:06;80713034;80295560;417474;
13.01.2019;19:50:05;80713112;80295644;417468;
13.01.2019;19:51:06;80713195;80295725;417470;
13.01.2019;19:52:06;80713259;80295804;417455;
13.01.2019;19:53:06;80713359;80295892;417467;
13.01.2019;19:54:06;80713441;80295967;417474;
13.01.2019;19:55:12;80713515;80296048;417467;
13.01.2019;19:56:05;80713596;80296116;417480;
13.01.2019;19:57:07;80713672;80296181;417491;
13.01.2019;19:58:08;80713750;80296250;417500;
13.01.2019;19:59:10;80713843;80296338;417505;
13.01.2019;20:00:05;80713921;80296396;417525;
13.01.2019;20:01:06;80714022;80296486;417536;
13.01.2019;20:02:05;80714094;80296575;417519;
13.01.2019;20:03:07;80714190;80296657;417533;
13.01.2019;20:04:05;80714258;80296734;417524;
13.01.2019;20:05:06;80714324;80296799;417525;
13.01.2019;20:06:05;80714397;80296873;417524;
13.01.2019;20:07:11;80714489;80296950;417539;
13.01.2019;20:08:06;80714548;80297033;417515;
13.01.2019;20:09:08;80714623;80297081;417542;
13.01.2019;20:10:07;80714689;80297146;417543;
13.01.2019;20:11:07;80715027;80297188;417839;
13.01.2019;20:12:04;80715069;80304741;410328;
13.01.2019;20:13:05;80715128;80304798;410330;
13.01.2019;20:14:05;80715199;80304847;410352;
13.01.2019;20:15:05;80715285;80304918;410367;
13.01.2019;20:16:05;80715329;80304939;410390;
13.01.2019;20:17:07;80715420;80304974;410446;
13.01.2019;20:18:05;80715493;80305028;410465;
13.01.2019;20:19:06;80715572;80305093;410479;
13.01.2019;20:20:10;80715640;80305150;410490;
13.01.2019;20:21:06;80715727;80305210;410517;
13.01.2019;20:22:13;80715821;80305253;410568;
13.01.2019;20:23:07;80715911;80305315;410596;
13.01.2019;20:24:06;80715999;80305365;410634;
13.01.2019;20:25:11;80716070;80305430;410640;
13.01.2019;20:26:08;80716148;80305495;410653;
13.01.2019;20:27:05;80716239;80305533;410706;
13.01.2019;20:28:05;80716335;80305586;410749;
13.01.2019;20:29:07;80716439;80305650;410789;
13.01.2019;20:30:06;80716513;80305723;410790;
13.01.2019;20:31:05;80716598;80305777;410821;
13.01.2019;20:32:11;80716709;80305851;410858;
13.01.2019;20:33:06;80716787;80305897;410890;
13.01.2019;20:34:06;80716879;80305958;410921;
13.01.2019;20:35:05;80716963;80306023;410940;
13.01.2019;20:36:05;80717063;80306098;410965;
13.01.2019;20:37:10;80717153;80306164;410989;
13.01.2019;20:38:05;80717238;80306234;411004;
13.01.2019;20:39:06;80717322;80306299;411023;
13.01.2019;20:40:04;80717377;80306354;411023;
13.01.2019;20:41:04;80717445;80306412;411033;
13.01.2019;20:42:07;80717539;80306476;411063;
13.01.2019;20:43:10;80717601;80306536;411065;
13.01.2019;20:44:09;80717696;80306607;411089;
13.01.2019;20:45:05;80717802;80306662;411140;
13.01.2019;20:46:06;80717863;80306713;411150;
13.01.2019;20:47:11;80717950;80306775;411175;
13.01.2019;20:48:11;80718049;80306842;411207;
13.01.2019;20:49:11;80718155;80306911;411244;
13.01.2019;20:50:05;80718241;80306969;411272;
13.01.2019;20:51:06;80718324;80307037;411287;
13.01.2019;20:52:06;80718429;80307096;411333;
13.01.2019;20:53:06;80718526;80307154;411372;
13.01.2019;20:54:12;80718597;80307240;411357;
13.01.2019;20:55:06;80718654;80307303;411351;
13.01.2019;20:56:06;80718724;80307353;411371;
13.01.2019;20:57:11;80718829;80307417;411412;
13.01.2019;20:58:11;80718908;80307484;411424;
13.01.2019;20:59:07;80718997;80307521;411476;
13.01.2019;21:00:05;80719076;80307577;411499;
13.01.2019;21:01:10;80719175;80307635;411540;
13.01.2019;21:02:06;80719260;80307674;411586;
13.01.2019;21:03:10;80719343;80307719;411624;
13.01.2019;21:04:11;80719410;80307778;411632;
13.01.2019;21:05:10;80719528;80307827;411701;
13.01.2019;21:06:10;80719614;80307874;411740;
13.01.2019;21:07:11;80719723;80307933;411790;
13.01.2019;21:08:05;80719790;80307975;411815;
13.01.2019;21:09:08;80719866;80308032;411834;
13.01.2019;21:10:06;80719933;80308080;411853;
13.01.2019;21:11:12;80720007;80308131;411876;
13.01.2019;21:12:06;80720074;80308167;411907;
13.01.2019;21:13:05;80720165;80308204;411961;
13.01.2019;21:14:05;80720255;80308255;412000;
13.01.2019;21:15:11;80720339;80308312;412027;
13.01.2019;21:16:10;80720406;80308366;412040;
13.01.2019;21:17:12;80720489;80308414;412075;
13.01.2019;21:18:06;80720566;80308453;412113;
13.01.2019;21:19:11;80720667;80308496;412171;
13.01.2019;21:20:06;80720725;80308538;412187;
13.01.2019;21:21:05;80720826;80308577;412249;
13.01.2019;21:22:06;80720937;80308632;412305;
13.01.2019;21:23:06;80721034;80308673;412361;
13.01.2019;21:24:06;80721099;80308734;412365;
13.01.2019;21:25:10;80721195;80308782;412413;
13.01.2019;21:26:06;80721257;80308837;412420;
13.01.2019;21:27:06;80721334;80308882;412452;
13.01.2019;21:28:05;80721426;80308936;412490;
13.01.2019;21:29:06;80721533;80308995;412538;
13.01.2019;21:30:05;80721616;80309033;412583;
13.01.2019;21:31:12;80721675;80309085;412590;
13.01.2019;21:32:05;80721743;80309120;412623;
13.01.2019;21:33:05;80721838;80309165;412673;
13.01.2019;21:34:10;80721928;80309206;412722;
13.01.2019;21:35:05;80721986;80309245;412741;
13.01.2019;21:36:06;80722089;80309290;412799;
13.01.2019;21:37:06;80722167;80309327;412840;
13.01.2019;21:38:06;80722234;80309361;412873;
13.01.2019;21:39:08;80722321;80309418;412903;
13.01.2019;21:40:11;80722406;80309458;412948;
13.01.2019;21:41:05;80722480;80309486;412994;
13.01.2019;21:42:11;80722567;80309525;413042;
13.01.2019;21:43:04;80722648;80309564;413084;
13.01.2019;21:44:10;80722666;80309539;413127;
13.01.2019;21:45:06;80722735;80309584;413151;
13.01.2019;21:46:05;80722829;80309612;413217;
13.01.2019;21:47:04;80722921;80309658;413263;
13.01.2019;21:48:06;80723008;80309699;413309;
13.01.2019;21:49:05;80723100;80309735;413365;
13.01.2019;21:50:11;80723200;80309779;413421;
13.01.2019;21:51:05;80723281;80309822;413459;
13.01.2019;21:52:11;80723387;80309863;413524;
13.01.2019;21:53:10;80723474;80309900;413574;
13.01.2019;21:54:06;80723536;80309942;413594;
13.01.2019;21:55:07;80723634;80309986;413648;
13.01.2019;21:56:05;80723719;80310020;413699;
13.01.2019;21:57:06;80723826;80310047;413779;
13.01.2019;21:58:07;80723913;80310084;413829;
13.01.2019;21:59:11;80724001;80310117;413884;
13.01.2019;22:00:11;80724082;80310165;413917;
13.01.2019;22:01:04;80724161;80310199;413962;
13.01.2019;22:02:06;80724251;80310247;414004;
13.01.2019;22:03:12;80724352;80310275;414077;
13.01.2019;22:04:05;80724439;80310303;414136;
13.01.2019;22:05:11;80724526;80310334;414192;
13.01.2019;22:06:11;80724613;80310369;414244;
13.01.2019;22:07:06;80724681;80310397;414284;
13.01.2019;22:08:11;80724773;80310426;414347;
13.01.2019;22:09:08;80724854;80310465;414389;
13.01.2019;22:10:09;80724919;80310503;414416;
13.01.2019;22:11:10;80725036;80310542;414494;
13.01.2019;22:12:06;80725132;80310569;414563;
13.01.2019;22:13:05;80725210;80310597;414613;
13.01.2019;22:14:14;80725278;80310626;414652;
13.01.2019;22:15:10;80725326;80310643;414683;
13.01.2019;22:16:07;80725378;80310653;414725;
13.01.2019;22:17:06;80725442;80310655;414787;
13.01.2019;22:18:06;80725501;80310680;414821;
13.01.2019;22:19:07;80725569;80310710;414859;
13.01.2019;22:20:16;80725638;80310736;414902;
13.01.2019;22:21:12;80725727;80310764;414963;
13.01.2019;22:22:07;80725798;80310786;415012;
13.01.2019;22:23:06;80725870;80310807;415063;
13.01.2019;22:24:08;80725946;80310833;415113;
13.01.2019;22:25:08;80726005;80310856;415149;
13.01.2019;22:26:06;80726049;80310887;415162;
13.01.2019;22:27:07;80726117;80310927;415190;
13.01.2019;22:28:06;80726187;80310957;415230;
13.01.2019;22:29:06;80726273;80310981;415292;
13.01.2019;22:31:11;80726437;80311028;415409;
13.01.2019;22:32:07;80726505;80311055;415450;
13.01.2019;22:33:08;80726566;80311079;415487;
13.01.2019;22:34:05;80726635;80311104;415531;
13.01.2019;22:35:06;80726709;80311143;415566;
13.01.2019;22:36:06;80726791;80311183;415608;
13.01.2019;22:37:11;80726887;80311207;415680;
13.01.2019;22:38:08;80726961;80311222;415739;
13.01.2019;22:39:08;80727038;80311259;415779;
13.01.2019;22:41:04;80727194;80311321;415873;
13.01.2019;22:42:04;80727296;80311340;415956;
13.01.2019;22:43:09;80727375;80311371;416004;
13.01.2019;22:44:05;80727441;80311393;416048;
13.01.2019;22:45:06;80727527;80311428;416099;
13.01.2019;22:46:06;80727602;80311458;416144;
13.01.2019;22:47:06;80727674;80311484;416190;
13.01.2019;22:48:09;80727747;80311523;416224;
13.01.2019;22:49:11;80727814;80311551;416263;
13.01.2019;22:50:15;80727898;80311581;416317;
13.01.2019;22:51:06;80727997;80311603;416394;
13.01.2019;22:52:12;80728097;80311640;416457;
13.01.2019;22:53:06;80728153;80311674;416479;
13.01.2019;22:54:05;80728229;80311699;416530;
13.01.2019;22:55:06;80728297;80311743;416554;
13.01.2019;22:56:09;80728382;80311768;416614;
13.01.2019;22:57:07;80728449;80311808;416641;
13.01.2019;22:58:07;80728523;80311834;416689;
13.01.2019;22:59:06;80728617;80311862;416755;
13.01.2019;23:00:04;80728682;80311893;416789;
13.01.2019;23:01:12;80728749;80311931;416818;
13.01.2019;23:02:10;80728825;80311961;416864;
13.01.2019;23:03:07;80728896;80311984;416912;
13.01.2019;23:04:06;80728987;80312020;416967;
13.01.2019;23:06:16;80729162;80312074;417088;
13.01.2019;23:07:11;80729268;80312103;417165;
13.01.2019;23:08:06;80729338;80312131;417207;
13.01.2019;23:09:06;80729407;80312150;417257;
13.01.2019;23:10:06;80729494;80312169;417325;
13.01.2019;23:11:06;80729585;80312193;417392;
13.01.2019;23:12:06;80729663;80312213;417450;
13.01.2019;23:13:07;80729736;80312243;417493;
13.01.2019;23:14:05;80729810;80312266;417544;
13.01.2019;23:15:06;80729904;80312312;417592;
13.01.2019;23:16:06;80729972;80312331;417641;
13.01.2019;23:17:06;80730049;80312357;417692;
13.01.2019;23:18:05;80730127;80312386;417741;
13.01.2019;23:19:06;80730180;80312407;417773;
13.01.2019;23:20:06;80730255;80312446;417809;
13.01.2019;23:21:05;80730340;80312477;417863;
13.01.2019;23:22:13;80730414;80312514;417900;
13.01.2019;23:23:06;80730485;80312535;417950;
13.01.2019;23:24:06;80730555;80312554;418001;
13.01.2019;23:25:05;80730641;80312576;418065;
13.01.2019;23:26:05;80730725;80312599;418126;
13.01.2019;23:27:07;80730798;80312623;418175;
13.01.2019;23:28:11;80730874;80312649;418225;
13.01.2019;23:29:06;80730935;80312677;418258;
13.01.2019;23:30:04;80731015;80312705;418310;
13.01.2019;23:31:10;80731087;80312721;418366;
13.01.2019;23:32:05;80731124;80312746;418378;
13.01.2019;23:33:06;80731214;80312765;418449;
13.01.2019;23:34:07;80731285;80312787;418498;
13.01.2019;23:35:11;80731360;80312809;418551;
13.01.2019;23:36:10;80731427;80312822;418605;
13.01.2019;23:37:05;80731488;80312839;418649;
13.01.2019;23:39:34;80731628;80312906;418722;
13.01.2019;23:40:10;80731670;80312922;418748;
13.01.2019;23:41:05;80731740;80312939;418801;
13.01.2019;23:42:06;80731809;80312965;418844;
13.01.2019;23:43:12;80731894;80312984;418910;
13.01.2019;23:44:06;80731954;80313007;418947;
13.01.2019;23:45:07;80732032;80313030;419002;
13.01.2019;23:46:06;80732118;80313049;419069;
13.01.2019;23:47:07;80732188;80313081;419107;
13.01.2019;23:48:07;80732270;80313091;419179;
13.01.2019;23:49:05;80732344;80313124;419220;
13.01.2019;23:50:05;80732424;80313143;419281;
13.01.2019;23:51:06;80732494;80313168;419326;
13.01.2019;23:52:06;80732571;80313191;419380;
13.01.2019;23:53:05;80732641;80313218;419423;
13.01.2019;23:54:10;80732710;80313236;419474;
13.01.2019;23:55:10;80732804;80313257;419547;
13.01.2019;23:56:06;80732869;80313268;419601;
13.01.2019;23:57:05;80732949;80313289;419660;
13.01.2019;23:58:06;80733040;80313317;419723;
13.01.2019;23:59:07;80733106;80313345;419761;
14.01.2019;00:00:12;80733184;80313366;419818;
14.01.2019;00:01:07;80733237;80313392;419845;
14.01.2019;00:02:13;80733299;80313417;419882;
14.01.2019;00:03:13;80733363;80313431;419932;
14.01.2019;00:04:06;80733432;80313440;419992;
14.01.2019;00:05:08;80733486;80313463;420023;
14.01.2019;00:06:13;80733579;80313480;420099;
14.01.2019;00:07:09;80733633;80313503;420130;
14.01.2019;00:08:08;80733684;80313511;420173;
14.01.2019;00:09:09;80733707;80313520;420187;
14.01.2019;00:10:15;80733732;80313519;420213;
14.01.2019;00:11:06;80733771;80313526;420245;
14.01.2019;00:12:07;80733799;80313535;420264;
14.01.2019;00:13:09;80733840;80313549;420291;
14.01.2019;00:14:11;80733865;80313561;420304;
14.01.2019;00:15:13;80733899;80313573;420326;
14.01.2019;00:16:14;80733939;80313581;420358;
14.01.2019;00:17:09;80733998;80313595;420403;
14.01.2019;00:18:09;80734062;80313624;420438;
14.01.2019;00:19:08;80734125;80313644;420481;
14.01.2019;00:20:09;80734178;80313664;420514;
14.01.2019;00:21:07;80734239;80313685;420554;
14.01.2019;00:22:08;80734317;80313705;420612;
14.01.2019;00:23:13;80734396;80313713;420683;
14.01.2019;00:24:08;80734461;80313731;420730;
14.01.2019;00:25:09;80734514;80313764;420750;
14.01.2019;00:26:09;80734582;80313783;420799;
14.01.2019;00:27:08;80734661;80313808;420853;
14.01.2019;00:28:08;80734733;80313838;420895;
14.01.2019;00:29:10;80734791;80313860;420931;
14.01.2019;00:30:08;80734858;80313876;420982;
14.01.2019;00:31:08;80734918;80313912;421006;
14.01.2019;00:32:09;80734995;80313936;421059;
14.01.2019;00:33:11;80735074;80313951;421123;
14.01.2019;00:34:09;80735152;80313968;421184;
14.01.2019;00:35:14;80735225;80314000;421225;
14.01.2019;00:36:08;80735277;80314018;421259;
14.01.2019;00:37:09;80735328;80314041;421287;
14.01.2019;00:38:09;80735386;80314053;421333;
14.01.2019;00:39:09;80735448;80314076;421372;
14.01.2019;00:40:12;80735507;80314103;421404;
14.01.2019;00:41:07;80735529;80314094;421435;
14.01.2019;00:42:07;80735594;80314127;421467;
14.01.2019;00:43:08;80735651;80314149;421502;
14.01.2019;00:44:08;80735728;80314165;421563;
14.01.2019;00:45:10;80735793;80314181;421612;
14.01.2019;00:46:14;80735868;80314211;421657;
14.01.2019;00:47:08;80735925;80314237;421688;
14.01.2019;00:48:10;80735984;80314258;421726;
14.01.2019;00:49:09;80736067;80314284;421783;
14.01.2019;00:50:09;80736139;80314308;421831;
14.01.2019;00:51:10;80736199;80314344;421855;
14.01.2019;00:52:09;80736249;80314361;421888;
14.01.2019;00:53:13;80736305;80314396;421909;
14.01.2019;00:54:07;80736385;80314428;421957;
14.01.2019;00:55:07;80736460;80314444;422016;
14.01.2019;00:56:09;80736514;80314459;422055;
14.01.2019;00:57:08;80736565;80314485;422080;
14.01.2019;00:58:09;80736610;80314502;422108;
14.01.2019;00:59:09;80736684;80314520;422164;
14.01.2019;01:00:06;80736749;80314553;422196;
14.01.2019;01:01:05;80736810;80314583;422227;
14.01.2019;01:02:06;80736854;80314612;422242;
14.01.2019;01:03:06;80736937;80314644;422293;
14.01.2019;01:04:06;80737005;80314671;422334;
14.01.2019;01:05:05;80737078;80314697;422381;
14.01.2019;01:06:06;80737130;80314728;422402;
14.01.2019;01:07:06;80737204;80314763;422441;
14.01.2019;01:08:04;80737278;80314791;422487;
14.01.2019;01:09:09;80737352;80314825;422527;
14.01.2019;01:10:06;80737411;80314850;422561;
14.01.2019;01:11:06;80737473;80314874;422599;
14.01.2019;01:12:06;80737540;80314908;422632;
14.01.2019;01:14:04;80737660;80314958;422702;
14.01.2019;01:15:07;80737719;80314986;422733;
14.01.2019;01:16:12;80737787;80315020;422767;
14.01.2019;01:17:06;80737861;80315060;422801;
14.01.2019;01:18:05;80737925;80315083;422842;
14.01.2019;01:19:06;80737989;80315110;422879;
14.01.2019;01:20:07;80738067;80315143;422924;
14.01.2019;01:21:06;80738126;80315171;422955;
14.01.2019;01:22:05;80738187;80315207;422980;
14.01.2019;01:23:06;80738257;80315246;423011;
14.01.2019;01:24:06;80738322;80315289;423033;
14.01.2019;01:25:06;80738408;80315319;423089;
14.01.2019;01:26:05;80738470;80315339;423131;
14.01.2019;01:27:11;80738538;80315377;423161;
14.01.2019;01:28:06;80738595;80315409;423186;
14.01.2019;01:29:10;80738655;80315445;423210;
14.01.2019;01:30:05;80738699;80315482;423217;
14.01.2019;01:31:06;80738756;80315524;423232;
14.01.2019;01:32:05;80738839;80315557;423282;
14.01.2019;01:33:04;80738906;80315586;423320;
14.01.2019;01:34:04;80738991;80315613;423378;
14.01.2019;01:35:04;80739068;80315644;423424;
14.01.2019;01:36:09;80739133;80315686;423447;
14.01.2019;01:37:05;80739210;80315724;423486;
14.01.2019;01:38:11;80739280;80315755;423525;
14.01.2019;01:39:09;80739359;80315788;423571;
14.01.2019;01:40:06;80739414;80315827;423587;
14.01.2019;01:41:04;80739479;80315853;423626;
14.01.2019;01:42:07;80739540;80315895;423645;
14.01.2019;01:43:07;80739606;80315936;423670;
14.01.2019;01:44:05;80739690;80315971;423719;
14.01.2019;01:45:06;80739758;80316012;423746;
14.01.2019;01:46:06;80739819;80316035;423784;
14.01.2019;01:47:05;80739872;80316086;423786;
14.01.2019;01:48:05;80739941;80316121;423820;
14.01.2019;01:49:06;80740001;80316166;423835;
14.01.2019;01:50:05;80740060;80316200;423860;
14.01.2019;01:51:06;80740117;80316243;423874;
14.01.2019;01:52:06;80740177;80316285;423892;
14.01.2019;01:53:05;80740231;80316312;423919;
14.01.2019;01:54:06;80740293;80316351;423942;
14.01.2019;01:55:18;80740357;80316399;423958;
14.01.2019;01:56:06;80740429;80316435;423994;
14.01.2019;01:57:12;80740484;80316477;424007;
14.01.2019;01:58:06;80740545;80316530;424015;
14.01.2019;01:59:07;80740615;80316591;424024;
14.01.2019;02:00:13;80740687;80316649;424038;
14.01.2019;02:02:12;80740814;80316758;424056;
14.01.2019;02:03:06;80740870;80316803;424067;
14.01.2019;02:04:13;80740920;80316857;424063;
14.01.2019;02:05:06;80740969;80316898;424071;
14.01.2019;02:06:08;80741030;80316935;424095;
14.01.2019;02:07:05;80741056;80316973;424083;
14.01.2019;02:08:05;80741095;80317012;424083;
14.01.2019;02:09:09;80741144;80317068;424076;
14.01.2019;02:10:06;80741180;80317121;424059;
14.01.2019;02:11:05;80741232;80317169;424063;
14.01.2019;02:12:06;80741298;80317224;424074;
14.01.2019;02:13:07;80741359;80317287;424072;
14.01.2019;02:14:05;80741414;80317333;424081;
14.01.2019;02:15:06;80741474;80317369;424105;
14.01.2019;02:16:05;80741537;80317426;424111;
14.01.2019;02:17:12;80741602;80317484;424118;
14.01.2019;02:18:04;80741659;80317526;424133;
14.01.2019;02:19:10;80741733;80317593;424140;
14.01.2019;02:20:05;80741792;80317659;424133;
14.01.2019;02:21:05;80741874;80317703;424171;
14.01.2019;02:22:07;80741932;80317769;424163;
14.01.2019;02:23:06;80742002;80317844;424158;
14.01.2019;02:24:06;80742058;80317897;424161;
14.01.2019;02:25:07;80742128;80317960;424168;
14.01.2019;02:26:06;80742189;80318019;424170;
14.01.2019;02:27:10;80742272;80318072;424200;
14.01.2019;02:28:12;80742344;80318131;424213;
14.01.2019;02:29:11;80742416;80318207;424209;
14.01.2019;02:30:05;80742465;80318262;424203;
14.01.2019;02:31:07;80742538;80318322;424216;
14.01.2019;02:32:11;80742593;80318396;424197;
14.01.2019;02:33:05;80742646;80318448;424198;
14.01.2019;02:34:07;80742713;80318503;424210;
14.01.2019;02:35:06;80742788;80318581;424207;
14.01.2019;02:36:07;80742847;80318641;424206;
14.01.2019;02:37:04;80742915;80318717;424198;
14.01.2019;02:38:10;80742989;80318800;424189;
14.01.2019;02:39:13;80743071;80318858;424213;
14.01.2019;02:40:05;80743112;80318924;424188;
14.01.2019;02:41:04;80743188;80319004;424184;
14.01.2019;02:42:06;80743265;80319078;424187;
14.01.2019;02:43:06;80743339;80319147;424192;
14.01.2019;02:44:06;80743415;80319223;424192;
14.01.2019;02:45:05;80743484;80319303;424181;
14.01.2019;02:46:09;80743548;80319373;424175;
14.01.2019;02:47:05;80743620;80319450;424170;
14.01.2019;02:48:05;80743690;80319516;424174;
14.01.2019;02:49:05;80743751;80319591;424160;
14.01.2019;02:50:05;80743841;80319657;424184;
14.01.2019;02:51:06;80743921;80319723;424198;
14.01.2019;02:52:06;80744005;80319820;424185;
14.01.2019;02:53:07;80744078;80319929;424149;
14.01.2019;02:54:05;80744140;80320007;424133;
14.01.2019;02:55:05;80744215;80320105;424110;
14.01.2019;02:56:06;80744277;80320187;424090;
14.01.2019;02:57:06;80744348;80320280;424068;
14.01.2019;02:58:08;80744412;80320353;424059;
14.01.2019;02:59:06;80744510;80320418;424092;
14.01.2019;03:00:06;80744565;80320528;424037;
14.01.2019;03:01:04;80744625;80320607;424018;
14.01.2019;03:02:04;80744709;80320702;424007;
14.01.2019;03:03:06;80744799;80320796;424003;
14.01.2019;03:04:10;80744874;80320874;424000;
14.01.2019;03:05:12;80744944;80320963;423981;
14.01.2019;03:06:05;80744999;80321042;423957;
14.01.2019;03:07:05;80745085;80321130;423955;
14.01.2019;03:08:06;80745165;80321228;423937;
14.01.2019;03:09:12;80745233;80321316;423917;
14.01.2019;03:10:10;80745302;80321394;423908;
14.01.2019;03:11:05;80745348;80321488;423860;
14.01.2019;03:12:04;80745413;80321581;423832;
14.01.2019;03:13:06;80745489;80321676;423813;
14.01.2019;03:14:17;80745562;80321784;423778;
14.01.2019;03:15:06;80745627;80321853;423774;
14.01.2019;03:16:05;80745697;80321922;423775;
14.01.2019;03:17:06;80745762;80322028;423734;
14.01.2019;03:18:10;80745856;80322128;423728;
14.01.2019;03:19:06;80745928;80322209;423719;
14.01.2019;03:20:04;80745999;80322294;423705;
14.01.2019;03:21:05;80746070;80322382;423688;
14.01.2019;03:22:06;80746154;80322475;423679;
14.01.2019;03:23:06;80746226;80322553;423673;
14.01.2019;03:24:06;80746308;80322643;423665;
14.01.2019;03:25:04;80746363;80322728;423635;
14.01.2019;03:26:04;80746444;80322833;423611;
14.01.2019;03:27:05;80746499;80322924;423575;
14.01.2019;03:28:04;80746563;80323018;423545;
14.01.2019;03:29:04;80746643;80323108;423535;
14.01.2019;03:30:08;80746711;80323196;423515;
14.01.2019;03:31:06;80746772;80323283;423489;
14.01.2019;03:32:05;80746827;80323378;423449;
14.01.2019;03:33:06;80746894;80323487;423407;
14.01.2019;03:34:05;80746966;80323583;423383;
14.01.2019;03:35:04;80747043;80323697;423346;
14.01.2019;03:36:05;80747126;80323800;423326;
14.01.2019;03:37:10;80747200;80323921;423279;
14.01.2019;03:38:07;80747263;80324018;423245;
14.01.2019;03:39:11;80747367;80324129;423238;
14.01.2019;03:40:05;80747440;80324234;423206;
14.01.2019;03:41:09;80747537;80324339;423198;
14.01.2019;03:42:11;80747627;80324463;423164;
14.01.2019;03:43:09;80747673;80324537;423136;
14.01.2019;03:44:06;80747724;80324640;423084;
14.01.2019;03:45:12;80747797;80324752;423045;
14.01.2019;03:46:05;80747846;80324848;422998;
14.01.2019;03:47:08;80747935;80324939;422996;
14.01.2019;03:48:13;80748024;80325053;422971;
14.01.2019;03:49:06;80748109;80325157;422952;
14.01.2019;03:50:12;80748191;80325275;422916;
14.01.2019;03:51:13;80748261;80325377;422884;
14.01.2019;03:52:07;80748330;80325476;422854;
14.01.2019;03:53:05;80748395;80325592;422803;
14.01.2019;03:54:08;80748445;80325698;422747;
14.01.2019;03:55:05;80748514;80325805;422709;
14.01.2019;03:56:05;80748573;80325929;422644;
14.01.2019;03:57:10;80748663;80326064;422599;
14.01.2019;03:58:11;80748746;80326172;422574;
14.01.2019;03:59:06;80748807;80326284;422523;
14.01.2019;04:00:05;80748877;80326389;422488;
14.01.2019;04:01:05;80748948;80326508;422440;
14.01.2019;04:02:06;80749015;80326616;422399;
14.01.2019;04:03:04;80749057;80326700;422357;
14.01.2019;04:04:06;80749122;80326779;422343;
14.01.2019;04:05:06;80749177;80326895;422282;
14.01.2019;04:06:12;80749252;80327009;422243;
14.01.2019;04:07:05;80749306;80327106;422200;
14.01.2019;04:08:04;80749328;80327228;422100;
14.01.2019;04:09:08;80749390;80327349;422041;
14.01.2019;04:10:11;80749441;80327476;421965;
14.01.2019;04:11:06;80749482;80327557;421925;
14.01.2019;04:12:07;80749530;80327641;421889;
14.01.2019;04:13:06;80749592;80327732;421860;
14.01.2019;04:14:05;80749671;80327842;421829;
14.01.2019;04:15:06;80749719;80327958;421761;
14.01.2019;04:16:11;80749790;80328068;421722;
14.01.2019;04:17:11;80749871;80328174;421697;
14.01.2019;04:18:07;80749943;80328303;421640;
14.01.2019;04:19:05;80750012;80328421;421591;
14.01.2019;04:20:06;80750075;80328555;421520;
14.01.2019;04:21:07;80750149;80328681;421468;
14.01.2019;04:22:05;80750246;80328796;421450;
14.01.2019;04:23:05;80750312;80328914;421398;
14.01.2019;04:24:04;80750392;80329028;421364;
14.01.2019;04:25:11;80750474;80329157;421317;
14.01.2019;04:26:11;80750542;80329277;421265;
14.01.2019;04:27:07;80750605;80329399;421206;
14.01.2019;04:28:11;80750673;80329524;421149;
14.01.2019;04:29:05;80750744;80329654;421090;
14.01.2019;04:30:06;80750837;80329781;421056;
14.01.2019;04:31:07;80750925;80329908;421017;
14.01.2019;04:32:04;80751001;80330024;420977;
14.01.2019;04:33:11;80751091;80330142;420949;
14.01.2019;04:34:07;80751156;80330272;420884;
14.01.2019;04:35:04;80751228;80330386;420842;
14.01.2019;04:36:05;80751306;80330513;420793;
14.01.2019;04:37:07;80751392;80330650;420742;
14.01.2019;04:38:07;80751460;80330781;420679;
14.01.2019;04:39:12;80751555;80330914;420641;
14.01.2019;04:40:06;80751624;80331012;420612;
14.01.2019;04:41:07;80751698;80331133;420565;
14.01.2019;04:42:06;80751776;80331242;420534;
14.01.2019;04:43:05;80751849;80331360;420489;
14.01.2019;04:44:06;80751912;80331492;420420;
14.01.2019;04:45:10;80751976;80331616;420360;
14.01.2019;04:46:06;80752047;80331706;420341;
14.01.2019;04:47:06;80752120;80331834;420286;
14.01.2019;04:48:06;80752185;80331957;420228;
14.01.2019;04:49:10;80752260;80332081;420179;
14.01.2019;04:50:12;80752341;80332207;420134;
14.01.2019;04:51:13;80752430;80332311;420119;
14.01.2019;04:52:08;80752503;80332421;420082;
14.01.2019;04:53:06;80752593;80332527;420066;
14.01.2019;04:54:06;80752656;80332665;419991;
14.01.2019;04:55:06;80752711;80332794;419917;
14.01.2019;04:56:06;80752783;80332913;419870;
14.01.2019;04:57:05;80752851;80333024;419827;
14.01.2019;04:58:10;80752932;80333171;419761;
14.01.2019;04:59:12;80752994;80333281;419713;
14.01.2019;05:00:04;80753050;80333410;419640;
14.01.2019;05:01:06;80753122;80333539;419583;
14.01.2019;05:02:05;80753190;80333660;419530;
14.01.2019;05:03:05;80753266;80333810;419456;
14.01.2019;05:04:07;80753358;80333969;419389;
14.01.2019;05:05:11;80753439;80334097;419342;
14.01.2019;05:06:06;80753509;80334206;419303;
14.01.2019;05:07:10;80753580;80334352;419228;
14.01.2019;05:08:10;80753650;80334501;419149;
14.01.2019;05:09:09;80753728;80334618;419110;
14.01.2019;05:10:04;80753810;80334736;419074;
14.01.2019;05:11:17;80753903;80334907;418996;
14.01.2019;05:12:05;80753966;80335024;418942;
14.01.2019;05:13:05;80754028;80335157;418871;
14.01.2019;05:14:05;80754093;80335275;418818;
14.01.2019;05:15:07;80754164;80335391;418773;
14.01.2019;05:16:05;80754226;80335505;418721;
14.01.2019;05:17:05;80754311;80335624;418687;
14.01.2019;05:18:05;80754396;80335765;418631;
14.01.2019;05:19:10;80754465;80335881;418584;
14.01.2019;05:20:06;80754532;80336003;418529;
14.01.2019;05:21:11;80754608;80336154;418454;
14.01.2019;05:22:11;80754668;80336302;418366;
14.01.2019;05:23:10;80754735;80336462;418273;
14.01.2019;05:24:11;80754822;80336604;418218;
14.01.2019;05:25:06;80754883;80336719;418164;
14.01.2019;05:26:06;80754953;80336852;418101;
14.01.2019;05:27:06;80755024;80336980;418044;
14.01.2019;05:28:11;80755095;80337127;417968;
14.01.2019;05:29:06;80755152;80337239;417913;
14.01.2019;05:30:05;80755217;80337381;417836;
14.01.2019;05:31:05;80755280;80337534;417746;
14.01.2019;05:32:05;80755346;80337668;417678;
14.01.2019;05:33:10;80755421;80337825;417596;
14.01.2019;05:34:05;80755487;80337955;417532;
14.01.2019;05:35:05;80755548;80338088;417460;
14.01.2019;05:36:12;80755631;80338227;417404;
14.01.2019;05:37:06;80755697;80338342;417355;
14.01.2019;05:38:05;80755788;80338481;417307;
14.01.2019;05:39:12;80755853;80338633;417220;
14.01.2019;05:40:06;80755923;80338751;417172;
14.01.2019;05:41:06;80755983;80338912;417071;
14.01.2019;05:42:11;80756073;80339057;417016;
14.01.2019;05:43:12;80756135;80339219;416916;
14.01.2019;05:44:04;80756192;80339342;416850;
14.01.2019;05:45:05;80756259;80339492;416767;
14.01.2019;05:46:11;80756327;80339635;416692;
14.01.2019;05:47:05;80756389;80339758;416631;
14.01.2019;05:48:05;80756467;80339911;416556;
14.01.2019;05:49:05;80756516;80340044;416472;
14.01.2019;05:50:04;80756585;80340185;416400;
14.01.2019;05:51:10;80756642;80340352;416290;
14.01.2019;05:52:08;80756701;80340480;416221;
14.01.2019;05:53:06;80756765;80340606;416159;
14.01.2019;05:54:06;80756838;80340715;416123;
14.01.2019;05:55:05;80756906;80340858;416048;
14.01.2019;05:56:10;80756961;80341042;415919;
14.01.2019;05:57:06;80757024;80341159;415865;
14.01.2019;05:58:12;80757081;80341345;415736;
14.01.2019;05:59:05;80757141;80341486;415655;
14.01.2019;06:00:11;80757200;80341624;415576;
14.01.2019;06:01:04;80757253;80341761;415492;
14.01.2019;06:02:06;80757313;80341898;415415;
14.01.2019;06:03:05;80757387;80342066;415321;
14.01.2019;06:04:09;80757437;80342202;415235;
14.01.2019;06:05:05;80757493;80342319;415174;
14.01.2019;06:06:14;80757547;80342482;415065;
14.01.2019;06:07:05;80757617;80342595;415022;
14.01.2019;06:08:10;80757662;80342740;414922;
14.01.2019;06:09:08;80757717;80342854;414863;
14.01.2019;06:10:12;80757736;80343002;414734;
14.01.2019;06:11:12;80757771;80343110;414661;
14.01.2019;06:12:09;80757819;80343234;414585;
14.01.2019;06:13:12;80757862;80343369;414493;
14.01.2019;06:14:07;80757897;80343479;414418;
14.01.2019;06:15:10;80757952;80343606;414346;
14.01.2019;06:16:08;80758007;80343719;414288;
14.01.2019;06:17:06;80758070;80343868;414202;
14.01.2019;06:18:07;80758114;80343991;414123;
14.01.2019;06:19:05;80758178;80344146;414032;
14.01.2019;06:20:05;80758246;80344305;413941;
14.01.2019;06:21:10;80758295;80344431;413864;
14.01.2019;06:22:06;80758332;80344563;413769;
14.01.2019;06:23:06;80758391;80344719;413672;
14.01.2019;06:24:06;80758451;80344858;413593;
14.01.2019;06:25:09;80758503;80345003;413500;
14.01.2019;06:26:05;80758550;80345137;413413;
14.01.2019;06:27:06;80758616;80345291;413325;
14.01.2019;06:28:11;80758682;80345442;413240;
14.01.2019;06:29:12;80758748;80345598;413150;
14.01.2019;06:30:10;80758802;80345735;413067;
14.01.2019;06:31:05;80758880;80345869;413011;
14.01.2019;06:32:05;80758913;80345988;412925;
14.01.2019;06:33:05;80758995;80346125;412870;
14.01.2019;06:34:06;80759054;80346265;412789;
14.01.2019;06:35:06;80759127;80346421;412706;
14.01.2019;06:36:05;80759189;80346540;412649;
14.01.2019;06:37:06;80759237;80346703;412534;
14.01.2019;06:38:06;80759300;80346841;412459;
14.01.2019;06:39:08;80759355;80346996;412359;
14.01.2019;06:41:06;80759407;80347216;412191;
14.01.2019;06:42:05;80759463;80347326;412137;
14.01.2019;06:43:04;80759521;80347463;412058;
14.01.2019;06:44:05;80759578;80347592;411986;
14.01.2019;06:45:06;80759640;80347744;411896;
14.01.2019;06:46:06;80759706;80347870;411836;
14.01.2019;06:47:06;80759768;80348012;411756;
14.01.2019;06:48:06;80759831;80348142;411689;
14.01.2019;06:49:11;80759892;80348280;411612;
14.01.2019;06:50:12;80759942;80348428;411514;
14.01.2019;06:51:06;80759996;80348550;411446;
14.01.2019;06:52:06;80760065;80348708;411357;
14.01.2019;06:53:06;80760136;80348851;411285;
14.01.2019;06:54:11;80760203;80348995;411208;
14.01.2019;06:55:06;80760253;80349155;411098;
14.01.2019;06:56:06;80760315;80349287;411028;
14.01.2019;06:57:06;80760366;80349442;410924;
14.01.2019;06:58:11;80760420;80349576;410844;
14.01.2019;06:59:05;80760464;80349716;410748;
14.01.2019;07:00:06;80760527;80349841;410686;
14.01.2019;07:01:06;80760574;80350006;410568;
14.01.2019;07:02:12;80760644;80350158;410486;
14.01.2019;07:03:06;80760687;80350300;410387;
14.01.2019;07:04:05;80760732;80350445;410287;
14.01.2019;07:05:05;80760780;80350595;410185;
14.01.2019;07:06:06;80760835;80350762;410073;
14.01.2019;07:07:07;80760886;80350903;409983;
14.01.2019;07:08:10;80760939;80351073;409866;
14.01.2019;07:09:05;80760985;80351194;409791;
14.01.2019;07:10:13;80761040;80351377;409663;
14.01.2019;07:11:05;80761084;80351492;409592;
14.01.2019;07:12:06;80761135;80351638;409497;
14.01.2019;07:18:06;80761466;80352457;409009;
14.01.2019;07:19:11;80761532;80352589;408943;
14.01.2019;07:20:06;80761579;80352747;408832;
14.01.2019;07:21:10;80761614;80352901;408713;
14.01.2019;07:22:12;80761672;80353063;408609;
14.01.2019;07:23:07;80761726;80353209;408517;
14.01.2019;07:24:11;80761789;80353363;408426;
14.01.2019;07:25:07;80761831;80353491;408340;
14.01.2019;07:26:06;80761895;80353637;408258;
14.01.2019;07:27:05;80761941;80353823;408118;
14.01.2019;07:28:04;80761985;80353950;408035;
14.01.2019;07:29:10;80762036;80354115;407921;
14.01.2019;07:30:04;80762106;80354239;407867;
14.01.2019;07:31:05;80762144;80354371;407773;
14.01.2019;07:32:11;80762210;80354560;407650;
14.01.2019;07:33:04;80762246;80354668;407578;
14.01.2019;07:34:05;80762276;80354801;407475;
14.01.2019;07:35:05;80762319;80354927;407392;
14.01.2019;07:36:11;80762369;80355092;407277;
14.01.2019;07:37:05;80762418;80355201;407217;
14.01.2019;07:38:05;80762497;80355360;407137;
14.01.2019;07:39:07;80762561;80355491;407070;
14.01.2019;07:40:10;80762589;80355647;406942;
14.01.2019;07:41:05;80762628;80355770;406858;
14.01.2019;07:42:06;80762670;80355929;406741;
14.01.2019;07:43:05;80762710;80356072;406638;
14.01.2019;07:44:11;80762763;80356263;406500;
14.01.2019;07:45:05;80762816;80356403;406413;
14.01.2019;07:46:05;80762864;80356531;406333;
14.01.2019;07:47:10;80762917;80356693;406224;
14.01.2019;07:48:10;80762985;80356841;406144;
14.01.2019;07:49:10;80763021;80357002;406019;
14.01.2019;07:50:05;80763081;80357150;405931;
14.01.2019;07:51:06;80763143;80357331;405812;
14.01.2019;07:52:05;80763191;80357465;405726;
14.01.2019;07:53:10;80763264;80357628;405636;
14.01.2019;07:54:10;80763307;80357754;405553;
14.01.2019;07:55:06;80763353;80357868;405485;
14.01.2019;07:56:04;80763401;80358013;405388;
14.01.2019;07:57:04;80763455;80358162;405293;
14.01.2019;07:58:12;80763500;80358352;405148;
14.01.2019;07:59:10;80763564;80358499;405065;
14.01.2019;08:00:06;80763616;80358644;404972;
14.01.2019;08:01:06;80763672;80358788;404884;
14.01.2019;08:02:05;80763720;80358952;404768;
14.01.2019;08:03:11;80763745;80359088;404657;
14.01.2019;08:04:06;80763764;80359206;404558;
14.01.2019;08:05:05;80763783;80359339;404444;
14.01.2019;08:06:11;80763802;80359475;404327;
14.01.2019;08:07:04;80763843;80359584;404259;
14.01.2019;08:08:05;80763873;80359719;404154;
14.01.2019;08:09:07;80763896;80359882;404014;
14.01.2019;08:10:11;80763936;80360020;403916;
14.01.2019;08:11:12;80763979;80360169;403810;
14.01.2019;08:12:06;80764019;80360305;403714;
14.01.2019;08:13:04;80764038;80360468;403570;
14.01.2019;08:14:11;80764068;80360618;403450;
14.01.2019;08:15:04;80764116;80360736;403380;
14.01.2019;08:16:05;80764171;80360869;403302;
14.01.2019;08:17:11;80764230;80361038;403192;
14.01.2019;08:18:04;80764263;80361144;403119;
14.01.2019;08:19:09;80764310;80361338;402972;
14.01.2019;08:20:06;80764356;80361499;402857;
14.01.2019;08:21:04;80764399;80361668;402731;
14.01.2019;08:22:05;80764453;80361799;402654;
14.01.2019;08:23:05;80764497;80361965;402532;
14.01.2019;08:24:10;80764521;80362133;402388;
14.01.2019;08:25:10;80764554;80362276;402278;
14.01.2019;08:26:04;80764603;80362424;402179;
14.01.2019;08:27:05;80764636;80362593;402043;
14.01.2019;08:28:05;80764683;80362746;401937;
14.01.2019;08:29:05;80764743;80362884;401859;
14.01.2019;08:30:04;80764790;80363083;401707;
14.01.2019;08:31:10;80764836;80363234;401602;
14.01.2019;08:32:05;80764883;80363376;401507;
14.01.2019;08:33:04;80764923;80363523;401400;
14.01.2019;08:34:04;80764964;80363664;401300;
14.01.2019;08:35:05;80764997;80363828;401169;
14.01.2019;08:36:04;80765044;80363964;401080;
14.01.2019;08:37:04;80765077;80364107;400970;
14.01.2019;08:38:04;80765128;80364253;400875;
14.01.2019;08:39:06;80765161;80364401;400760;
14.01.2019;08:40:05;80765200;80364544;400656;
14.01.2019;08:41:10;80765261;80364698;400563;
14.01.2019;08:42:05;80765297;80364826;400471;
14.01.2019;08:43:11;80765346;80364985;400361;
14.01.2019;08:44:10;80765395;80365125;400270;
14.01.2019;08:45:05;80765427;80365247;400180;
14.01.2019;08:46:05;80765470;80365395;400075;
14.01.2019;08:47:05;80765515;80365549;399966;
14.01.2019;08:48:06;80765563;80365725;399838;
14.01.2019;08:49:06;80765622;80365901;399721;
14.01.2019;08:50:05;80765674;80366040;399634;
14.01.2019;08:51:04;80765731;80366184;399547;
14.01.2019;08:52:05;80765767;80366341;399426;
14.01.2019;08:53:10;80765818;80366513;399305;
14.01.2019;08:54:10;80765860;80366628;399232;
14.01.2019;08:55:05;80765901;80366767;399134;
14.01.2019;08:56:06;80765959;80366938;399021;
14.01.2019;08:57:04;80766001;80367091;398910;
14.01.2019;08:58:10;80766056;80367268;398788;
14.01.2019;08:59:11;80766105;80367417;398688;
14.01.2019;09:00:04;80766162;80367556;398606;
14.01.2019;09:01:04;80766222;80367690;398532;
14.01.2019;09:02:11;80766271;80367874;398397;
14.01.2019;09:03:05;80766315;80367997;398318;
14.01.2019;09:04:10;80766356;80368184;398172;
14.01.2019;09:05:06;80766413;80368324;398089;
14.01.2019;09:06:04;80766442;80368484;397958;
14.01.2019;09:07:12;80766497;80368673;397824;
14.01.2019;09:08:04;80766542;80368811;397731;
14.01.2019;09:09:08;80766600;80368966;397634;
14.01.2019;09:10:06;80766654;80369114;397540;
14.01.2019;09:11:05;80766699;80369273;397426;
14.01.2019;09:12:10;80766747;80369453;397294;
14.01.2019;09:13:04;80766783;80369600;397183;
14.01.2019;09:14:11;80766840;80369762;397078;
14.01.2019;09:15:10;80766886;80369901;396985;
14.01.2019;09:16:12;80766925;80370053;396872;
14.01.2019;09:17:06;80766993;80370186;396807;
14.01.2019;09:18:11;80767039;80370367;396672;
14.01.2019;09:19:06;80767072;80370481;396591;
14.01.2019;09:20:06;80767115;80370622;396493;
14.01.2019;09:21:04;80767158;80370763;396395;
14.01.2019;09:22:11;80767203;80370907;396296;
14.01.2019;09:23:04;80767252;80371021;396231;
14.01.2019;09:24:10;80767301;80371210;396091;
14.01.2019;09:25:04;80767334;80371346;395988;
14.01.2019;09:26:11;80767386;80371508;395878;
14.01.2019;09:27:05;80767439;80371673;395766;
14.01.2019;09:28:05;80767501;80371837;395664;
14.01.2019;09:29:06;80767527;80371986;395541;
14.01.2019;09:30:05;80767566;80372156;395410;
14.01.2019;09:31:10;80767619;80372332;395287;
14.01.2019;09:32:05;80767670;80372447;395223;
14.01.2019;09:33:11;80767726;80372615;395111;
14.01.2019;09:34:07;80767766;80372754;395012;
14.01.2019;09:35:07;80767819;80372913;394906;
14.01.2019;09:36:05;80767855;80373063;394792;
14.01.2019;09:37:04;80767845;80373175;394670;
14.01.2019;09:38:04;80767882;80373323;394559;
14.01.2019;09:39:12;80767931;80373480;394451;
14.01.2019;09:40:04;80767966;80373610;394356;
14.01.2019;09:41:10;80768007;80373773;394234;
14.01.2019;09:42:05;80768047;80373930;394117;
14.01.2019;09:43:11;80768124;80374114;394010;
14.01.2019;09:44:04;80768163;80374259;393904;
14.01.2019;09:45:10;80768205;80374433;393772;
14.01.2019;09:46:10;80768245;80374616;393629;
14.01.2019;09:47:11;80768287;80374767;393520;
14.01.2019;09:48:05;80768320;80374899;393421;
14.01.2019;09:49:04;80768373;80375043;393330;
14.01.2019;09:50:11;80768413;80375227;393186;
14.01.2019;09:51:04;80768445;80375393;393052;
14.01.2019;09:52:10;80768497;80375558;392939;
14.01.2019;09:53:05;80768549;80375692;392857;
14.01.2019;09:54:10;80768593;80375859;392734;
14.01.2019;09:55:05;80768644;80375992;392652;
14.01.2019;09:56:04;80768694;80376174;392520;
14.01.2019;09:57:04;80768742;80376334;392408;
14.01.2019;09:58:11;80768783;80376489;392294;
14.01.2019;09:59:10;80768841;80376626;392215;
14.01.2019;10:00:05;80768884;80376764;392120;
14.01.2019;10:01:04;80768929;80376904;392025;
14.01.2019;10:02:05;80768971;80377040;391931;
14.01.2019;10:03:12;80769016;80377196;391820;
14.01.2019;10:04:10;80769069;80377351;391718;
14.01.2019;10:05:04;80769141;80377493;391648;
14.01.2019;10:06:04;80769182;80377657;391525;
14.01.2019;10:07:10;80769205;80377829;391376;
14.01.2019;10:08:04;80769215;80377936;391279;
14.01.2019;10:09:06;80769245;80378055;391190;
14.01.2019;10:10:10;80769248;80378182;391066;
14.01.2019;10:11:06;80769262;80378298;390964;
14.01.2019;10:12:05;80769314;80378419;390895;
14.01.2019;10:13:06;80769344;80378559;390785;
14.01.2019;10:14:10;80769381;80378702;390679;
14.01.2019;10:15:06;80769414;80378833;390581;
14.01.2019;10:16:04;80769453;80378958;390495;
14.01.2019;10:17:05;80769495;80379122;390373;
14.01.2019;10:18:04;80769524;80379256;390268;
14.01.2019;10:19:06;80769570;80379434;390136;
14.01.2019;10:20:04;80769638;80379571;390067;
14.01.2019;10:21:04;80769689;80379728;389961;
14.01.2019;10:22:05;80769732;80379902;389830;
14.01.2019;10:23:04;80769783;80380059;389724;
14.01.2019;10:24:06;80769822;80380213;389609;
14.01.2019;10:25:07;80769889;80380388;389501;
14.01.2019;10:26:05;80769936;80380537;389399;
14.01.2019;10:27:06;80769970;80380681;389289;
14.01.2019;10:28:06;80770001;80380831;389170;
14.01.2019;10:29:04;80770059;80380972;389087;
14.01.2019;10:30:04;80770096;80381110;388986;
14.01.2019;10:31:05;80770139;80381271;388868;
14.01.2019;10:32:06;80770173;80381415;388758;
14.01.2019;10:33:04;80770223;80381556;388667;
14.01.2019;10:34:05;80770263;80381719;388544;
14.01.2019;10:35:06;80770299;80381902;388397;
14.01.2019;10:36:10;80770352;80382065;388287;
14.01.2019;10:37:05;80770400;80382211;388189;
14.01.2019;10:38:04;80770442;80382378;388064;
14.01.2019;10:39:06;80770491;80382550;387941;
14.01.2019;10:40:05;80770530;80382713;387817;
14.01.2019;10:41:04;80770575;80382867;387708;
14.01.2019;10:42:05;80770635;80383009;387626;
14.01.2019;10:43:04;80770679;80383151;387528;
14.01.2019;10:44:05;80770730;80383306;387424;
14.01.2019;10:45:12;80770791;80383471;387320;
14.01.2019;10:46:10;80770839;80383599;387240;
14.01.2019;10:47:06;80770888;80383747;387141;
14.01.2019;10:48:04;80770925;80383887;387038;
14.01.2019;10:49:05;80770977;80384057;386920;
14.01.2019;10:50:06;80771029;80384228;386801;
14.01.2019;10:51:05;80771060;80384382;386678;
14.01.2019;10:52:04;80771106;80384546;386560;
14.01.2019;10:53:10;80771163;80384730;386433;
14.01.2019;10:54:04;80771220;80384884;386336;
14.01.2019;10:55:06;80771264;80385039;386225;
14.01.2019;10:56:06;80771323;80385197;386126;
14.01.2019;10:57:04;80771370;80385354;386016;
14.01.2019;10:58:09;80771399;80385539;385860;
14.01.2019;10:59:05;80771455;80385653;385802;
14.01.2019;11:00:10;80771497;80385828;385669;
14.01.2019;11:01:05;80771530;80385978;385552;
14.01.2019;11:02:07;80771574;80386157;385417;
14.01.2019;11:03:04;80771627;80386287;385340;
14.01.2019;11:04:05;80771682;80386445;385237;
14.01.2019;11:05:05;80771724;80386599;385125;
14.01.2019;11:06:05;80771773;80386773;385000;
14.01.2019;11:07:04;80771808;80386910;384898;
14.01.2019;11:08:05;80771861;80387087;384774;
14.01.2019;11:09:06;80771908;80387247;384661;
14.01.2019;11:10:05;80771968;80387414;384554;
14.01.2019;11:11:04;80772016;80387583;384433;
14.01.2019;11:12:05;80772072;80387725;384347;
14.01.2019;11:13:05;80772127;80387878;384249;
14.01.2019;11:14:04;80772175;80388055;384120;
14.01.2019;11:15:11;80772225;80388227;383998;
14.01.2019;11:16:04;80772257;80388370;383887;
14.01.2019;11:17:05;80772302;80388522;383780;
14.01.2019;11:18:06;80772359;80388685;383674;
14.01.2019;11:19:04;80772412;80388804;383608;
14.01.2019;11:20:04;80772452;80388952;383500;
14.01.2019;11:21:11;80772489;80389120;383369;
14.01.2019;11:22:05;80772521;80389262;383259;
14.01.2019;11:23:05;80772579;80389415;383164;
14.01.2019;11:24:05;80772631;80389579;383052;
14.01.2019;11:25:04;80772681;80389739;382942;
14.01.2019;11:26:10;80772719;80389898;382821;
14.01.2019;11:27:04;80772773;80390037;382736;
14.01.2019;11:28:06;80772830;80390195;382635;
14.01.2019;11:29:04;80772872;80390367;382505;
14.01.2019;11:30:04;80772909;80390523;382386;
14.01.2019;11:31:06;80772954;80390676;382278;
14.01.2019;11:32:05;80773000;80390829;382171;
14.01.2019;11:33:04;80773037;80390975;382062;
14.01.2019;11:34:06;80773097;80391128;381969;
14.01.2019;11:35:06;80773154;80391312;381842;
14.01.2019;11:36:05;80773191;80391478;381713;
14.01.2019;11:37:04;80773248;80391615;381633;
14.01.2019;11:38:06;80773288;80391765;381523;
14.01.2019;11:39:06;80773331;80391909;381422;
14.01.2019;11:40:10;80773376;80392061;381315;
14.01.2019;11:41:10;80773429;80392212;381217;
14.01.2019;11:42:10;80773477;80392349;381128;
14.01.2019;11:43:07;80773514;80392489;381025;
14.01.2019;11:44:04;80773557;80392635;380922;
14.01.2019;11:45:05;80773624;80392788;380836;
14.01.2019;11:46:04;80773681;80392942;380739;
14.01.2019;11:47:05;80773730;80393100;380630;
14.01.2019;11:48:10;80773778;80393261;380517;
14.01.2019;11:49:07;80773818;80393432;380386;
14.01.2019;11:50:04;80773871;80393574;380297;
14.01.2019;11:51:04;80773903;80393723;380180;
14.01.2019;11:52:11;80773951;80393900;380051;
14.01.2019;11:53:05;80774014;80394019;379995;
14.01.2019;11:54:10;80774072;80394186;379886;
14.01.2019;11:55:04;80774141;80394346;379795;
14.01.2019;11:56:10;80774203;80394503;379700;
14.01.2019;11:57:05;80774233;80394619;379614;
14.01.2019;11:58:09;80774288;80394781;379507;
14.01.2019;11:59:04;80774333;80394944;379389;
14.01.2019;12:00:05;80774392;80395114;379278;
14.01.2019;12:01:05;80774459;80395260;379199;
14.01.2019;12:02:12;80774511;80395426;379085;
14.01.2019;12:03:04;80774550;80395567;378983;
14.01.2019;12:04:05;80774602;80395702;378900;
14.01.2019;12:05:04;80774641;80395837;378804;
14.01.2019;12:06:05;80774692;80395984;378708;
14.01.2019;12:07:05;80774738;80396146;378592;
14.01.2019;12:08:04;80774759;80396251;378508;
14.01.2019;12:09:04;80774785;80396326;378459;
14.01.2019;12:10:05;80774812;80396426;378386;
14.01.2019;12:11:04;80774822;80396522;378300;
14.01.2019;12:12:05;80774835;80396641;378194;
14.01.2019;12:13:04;80774865;80396769;378096;
14.01.2019;12:14:10;80774903;80396917;377986;
14.01.2019;12:15:04;80774940;80397070;377870;
14.01.2019;12:16:10;80774994;80397219;377775;
14.01.2019;12:17:05;80775037;80397365;377672;
14.01.2019;12:18:04;80775076;80397538;377538;
14.01.2019;12:19:11;80775124;80397701;377423;
14.01.2019;12:20:04;80775175;80397822;377353;
14.01.2019;12:21:10;80775223;80397994;377229;
14.01.2019;12:22:06;80775264;80398125;377139;
14.01.2019;12:23:05;80775315;80398284;377031;
14.01.2019;12:24:04;80775381;80398414;376967;
14.01.2019;12:25:05;80775431;80398575;376856;
14.01.2019;12:26:04;80775479;80398754;376725;
14.01.2019;12:27:05;80775539;80398927;376612;
14.01.2019;12:28:10;80775585;80399105;376480;
14.01.2019;12:29:04;80775641;80399258;376383;
14.01.2019;12:30:05;80775695;80399422;376273;
14.01.2019;12:31:10;80775748;80399595;376153;
14.01.2019;12:32:05;80775808;80399726;376082;
14.01.2019;12:33:06;80775863;80399861;376002;
14.01.2019;12:34:04;80775912;80399951;375961;
14.01.2019;12:35:05;80775959;80400080;375879;
14.01.2019;12:36:04;80775795;80400004;375791;
14.01.2019;12:37:10;80775475;80399897;375578;
14.01.2019;12:38:05;80775550;80400021;375529;
14.01.2019;12:39:12;80775644;80400176;375468;
14.01.2019;12:40:05;80775708;80400301;375407;
14.01.2019;12:41:04;80775767;80400439;375328;
14.01.2019;12:42:04;80775836;80400586;375250;
14.01.2019;12:43:04;80775898;80400738;375160;
14.01.2019;12:44:04;80775959;80400885;375074;
14.01.2019;12:45:04;80776016;80401019;374997;
14.01.2019;12:46:07;80776060;80401169;374891;
14.01.2019;12:47:06;80776103;80401303;374800;
14.01.2019;12:48:10;80776148;80401451;374697;
14.01.2019;12:49:09;80776204;80401573;374631;
14.01.2019;12:50:07;80776259;80401696;374563;
14.01.2019;12:51:05;80776326;80401819;374507;
14.01.2019;12:52:04;80776390;80401959;374431;
14.01.2019;12:53:05;80776438;80402088;374350;
14.01.2019;12:54:05;80776492;80402234;374258;
14.01.2019;12:55:04;80776551;80402364;374187;
14.01.2019;12:56:05;80776624;80402495;374129;
14.01.2019;12:57:04;80776681;80402652;374029;
14.01.2019;12:58:05;80776750;80402826;373924;
14.01.2019;12:59:11;80776825;80403000;373825;
14.01.2019;13:00:04;80776884;80403157;373727;
14.01.2019;13:01:04;80776943;80403278;373665;
14.01.2019;13:02:04;80777014;80403455;373559;
14.01.2019;13:03:10;80777082;80403625;373457;
14.01.2019;13:04:07;80777154;80403757;373397;
14.01.2019;13:05:05;80777223;80403906;373317;
14.01.2019;13:06:04;80777314;80404069;373245;
14.01.2019;13:07:11;80777398;80404242;373156;
14.01.2019;13:08:04;80777481;80404386;373095;
14.01.2019;13:09:06;80777576;80404556;373020;
14.01.2019;13:10:05;80777661;80404709;372952;
14.01.2019;13:11:04;80777750;80404828;372922;
14.01.2019;13:12:05;80777836;80404975;372861;
14.01.2019;13:13:04;80777927;80405121;372806;
14.01.2019;13:14:10;80778033;80405258;372775;
14.01.2019;13:15:07;80778115;80405404;372711;
14.01.2019;13:16:10;80778202;80405529;372673;
14.01.2019;13:17:06;80778309;80405657;372652;
14.01.2019;13:18:05;80778401;80405803;372598;
14.01.2019;13:19:04;80778495;80405924;372571;
14.01.2019;13:20:04;80778588;80406096;372492;
14.01.2019;13:21:05;80778683;80406233;372450;
14.01.2019;13:22:05;80778780;80406356;372424;
14.01.2019;13:23:04;80778873;80406512;372361;
14.01.2019;13:24:06;80778972;80406659;372313;
14.01.2019;13:25:06;80779092;80406829;372263;
14.01.2019;13:26:06;80779182;80407007;372175;
14.01.2019;13:27:12;80779270;80407160;372110;
14.01.2019;13:28:10;80779373;80407282;372091;
14.01.2019;13:29:05;80779473;80407428;372045;
14.01.2019;13:30:05;80779558;80407599;371959;
14.01.2019;13:31:04;80779627;80407739;371888;
14.01.2019;13:32:05;80779732;80407890;371842;
14.01.2019;13:33:05;80779814;80408020;371794;
14.01.2019;13:34:04;80779891;80408189;371702;
14.01.2019;13:35:10;80779993;80408377;371616;
14.01.2019;13:36:05;80780094;80408527;371567;
14.01.2019;13:37:10;80780186;80408688;371498;
14.01.2019;13:38:11;80780291;80408825;371466;
14.01.2019;13:39:07;80780380;80408958;371422;
14.01.2019;13:40:05;80780454;80409093;371361;
14.01.2019;13:41:05;80780548;80409264;371284;
14.01.2019;13:42:10;80780644;80409448;371196;
14.01.2019;13:43:10;80780725;80409636;371089;
14.01.2019;13:44:04;80780821;80409800;371021;
14.01.2019;13:45:06;80780907;80409960;370947;
14.01.2019;13:46:04;80780973;80410127;370846;
14.01.2019;13:47:05;80781036;80410280;370756;
14.01.2019;13:48:06;80781122;80410454;370668;
14.01.2019;13:49:04;80781200;80410599;370601;
14.01.2019;13:50:06;80781287;80410773;370514;
14.01.2019;13:51:09;80781372;80410956;370416;
14.01.2019;13:52:04;80781458;80411102;370356;
14.01.2019;13:53:06;80781556;80411276;370280;
14.01.2019;13:54:05;80781623;80411433;370190;
14.01.2019;13:55:05;80781713;80411580;370133;
14.01.2019;13:56:05;80781793;80411743;370050;
14.01.2019;13:57:05;80781879;80411913;369966;
14.01.2019;13:58:11;80781981;80412100;369881;
14.01.2019;13:59:04;80782067;80412229;369838;
14.01.2019;14:00:05;80782158;80412376;369782;
14.01.2019;14:01:04;80782253;80412553;369700;
14.01.2019;14:02:04;80782355;80412731;369624;
14.01.2019;14:03:04;80782446;80412902;369544;
14.01.2019;14:04:05;80782530;80413049;369481;
14.01.2019;14:05:04;80782633;80413208;369425;
14.01.2019;14:06:05;80782725;80413375;369350;
14.01.2019;14:07:04;80782799;80413531;369268;
14.01.2019;14:08:05;80782870;80413708;369162;
14.01.2019;14:09:12;80782961;80413887;369074;
14.01.2019;14:10:10;80783054;80414056;368998;
14.01.2019;14:11:04;80783145;80414208;368937;
14.01.2019;14:12:04;80783208;80414314;368894;
14.01.2019;14:13:10;80783294;80414436;368858;
14.01.2019;14:14:11;80783365;80414607;368758;
14.01.2019;14:15:06;80783458;80414718;368740;
14.01.2019;14:16:07;80783550;80414874;368676;
14.01.2019;14:17:06;80783633;80415029;368604;
14.01.2019;14:18:11;80783737;80415230;368507;
14.01.2019;14:19:11;80783805;80415391;368414;
14.01.2019;14:20:09;80783872;80415510;368362;
14.01.2019;14:21:05;80783959;80415600;368359;
14.01.2019;14:22:04;80784039;80415723;368316;
14.01.2019;14:23:11;80784131;80415880;368251;
14.01.2019;14:24:05;80784213;80415991;368222;
14.01.2019;14:25:10;80784295;80416134;368161;
14.01.2019;14:26:10;80784371;80416296;368075;
14.01.2019;14:27:05;80784466;80416463;368003;
14.01.2019;14:28:10;80784558;80416605;367953;
14.01.2019;14:29:05;80784645;80416755;367890;
14.01.2019;14:30:11;80784722;80416938;367784;
14.01.2019;14:31:12;80784806;80417091;367715;
14.01.2019;14:32:04;80784887;80417225;367662;
14.01.2019;14:33:05;80784987;80417384;367603;
14.01.2019;14:34:11;80785084;80417533;367551;
14.01.2019;14:35:10;80785155;80417689;367466;
14.01.2019;14:36:05;80785245;80417820;367425;
14.01.2019;14:37:10;80785361;80417978;367383;
14.01.2019;14:38:10;80785455;80418147;367308;
14.01.2019;14:39:08;80785570;80418293;367277;
14.01.2019;14:40:06;80785676;80418464;367212;
14.01.2019;14:41:06;80785783;80418622;367161;
14.01.2019;14:42:10;80785872;80418792;367080;
14.01.2019;14:43:04;80785993;80418973;367020;
14.01.2019;14:44:05;80786088;80419141;366947;
14.01.2019;14:45:05;80786191;80419310;366881;
14.01.2019;14:46:12;80786320;80419520;366800;
14.01.2019;14:47:05;80786405;80419656;366749;
14.01.2019;14:48:05;80786511;80419805;366706;
14.01.2019;14:49:11;80786616;80419991;366625;
14.01.2019;14:50:06;80786732;80420141;366591;
14.01.2019;14:51:05;80786831;80420329;366502;
14.01.2019;14:52:05;80786934;80420491;366443;
14.01.2019;14:53:04;80787038;80420625;366413;
14.01.2019;14:54:10;80787148;80420817;366331;
14.01.2019;14:55:11;80787232;80420950;366282;
14.01.2019;14:56:10;80787360;80421103;366257;
14.01.2019;14:57:06;80787462;80421266;366196;
14.01.2019;14:58:16;80787586;80421455;366131;
14.01.2019;14:59:06;80787700;80421601;366099;
14.01.2019;15:00:09;80787826;80421764;366062;
14.01.2019;15:01:07;80787931;80421942;365989;
14.01.2019;15:02:08;80788037;80422098;365939;
14.01.2019;15:03:09;80788175;80422258;365917;
14.01.2019;15:04:14;80788306;80422442;365864;
14.01.2019;15:05:07;80788390;80422586;365804;
14.01.2019;15:06:15;80788501;80422807;365694;
14.01.2019;15:07:14;80788634;80422977;365657;
14.01.2019;15:08:08;80788729;80423119;365610;
14.01.2019;15:09:12;80788833;80423275;365558;
14.01.2019;15:10:07;80788925;80423444;365481;
14.01.2019;15:11:08;80789032;80423577;365455;
14.01.2019;15:12:08;80789124;80423723;365401;
14.01.2019;15:13:12;80789236;80423888;365348;
14.01.2019;15:14:08;80789344;80424054;365290;
14.01.2019;15:15:08;80789437;80424203;365234;
14.01.2019;15:16:10;80789540;80424385;365155;
14.01.2019;15:17:08;80789647;80424539;365108;
14.01.2019;15:18:07;80789731;80424658;365073;
14.01.2019;15:19:07;80789830;80424825;365005;
14.01.2019;15:20:08;80789939;80424973;364966;
14.01.2019;15:21:08;80790040;80425148;364892;
14.01.2019;15:22:08;80790154;80425302;364852;
14.01.2019;15:23:08;80790245;80425497;364748;
14.01.2019;15:24:07;80790325;80425640;364685;
14.01.2019;15:25:07;80790428;80425808;364620;
14.01.2019;15:26:13;80790537;80425999;364538;
14.01.2019;15:27:14;80790661;80426191;364470;
14.01.2019;15:28:07;80790745;80426346;364399;
14.01.2019;15:29:08;80790840;80426520;364320;
14.01.2019;15:30:08;80790942;80426710;364232;
14.01.2019;15:31:09;80791050;80426870;364180;
14.01.2019;15:32:07;80791130;80427024;364106;
14.01.2019;15:33:09;80791243;80427198;364045;
14.01.2019;15:34:07;80791358;80427382;363976;
14.01.2019;15:35:08;80791457;80427564;363893;
14.01.2019;15:36:08;80791579;80427730;363849;
14.01.2019;15:37:07;80791684;80427886;363798;
14.01.2019;15:38:08;80791783;80428071;363712;
14.01.2019;15:39:09;80791880;80428256;363624;
14.01.2019;15:40:08;80791981;80428438;363543;
14.01.2019;15:41:13;80792093;80428607;363486;
14.01.2019;15:42:09;80792200;80428755;363445;
14.01.2019;15:43:07;80792298;80428940;363358;
14.01.2019;15:44:12;80792409;80429144;363265;
14.01.2019;15:45:13;80792520;80429299;363221;
14.01.2019;15:46:08;80792630;80429475;363155;
14.01.2019;15:47:09;80792725;80429634;363091;
14.01.2019;15:48:08;80792841;80429815;363026;
14.01.2019;15:49:08;80792934;80429994;362940;
14.01.2019;15:50:08;80793063;80430170;362893;
14.01.2019;15:51:08;80793169;80430337;362832;
14.01.2019;15:52:10;80793266;80430515;362751;
14.01.2019;15:53:10;80793378;80430672;362706;
14.01.2019;15:54:07;80793490;80430864;362626;
14.01.2019;15:55:13;80793619;80431064;362555;
14.01.2019;15:56:09;80793718;80431247;362471;
14.01.2019;15:57:07;80793829;80431387;362442;
14.01.2019;15:58:08;80793933;80431560;362373;
14.01.2019;15:59:07;80794039;80431712;362327;
14.01.2019;16:00:05;80794151;80431880;362271;
14.01.2019;16:01:05;80794233;80432037;362196;
14.01.2019;16:02:06;80794330;80432208;362122;
14.01.2019;16:03:06;80794427;80432386;362041;
14.01.2019;16:04:05;80794545;80432541;362004;
14.01.2019;16:05:13;80794638;80432743;361895;
14.01.2019;16:06:04;80794746;80432905;361841;
14.01.2019;16:07:06;80794856;80433057;361799;
14.01.2019;16:08:06;80794976;80433232;361744;
14.01.2019;16:09:08;80795073;80433412;361661;
14.01.2019;16:10:06;80795175;80433587;361588;
14.01.2019;16:11:05;80795268;80433751;361517;
14.01.2019;16:12:06;80795357;80433906;361451;
14.01.2019;16:13:05;80795449;80434052;361397;
14.01.2019;16:14:10;80795524;80434235;361289;
14.01.2019;16:15:06;80795625;80434344;361281;
14.01.2019;16:16:05;80795716;80434480;361236;
14.01.2019;16:17:06;80795825;80434642;361183;
14.01.2019;16:18:06;80795919;80434820;361099;
14.01.2019;16:19:10;80796023;80435017;361006;
14.01.2019;16:20:07;80796097;80435181;360916;
14.01.2019;16:21:12;80796203;80435359;360844;
14.01.2019;16:22:06;80796281;80435490;360791;
14.01.2019;16:23:06;80796365;80435615;360750;
14.01.2019;16:24:06;80796462;80435784;360678;
14.01.2019;16:25:05;80796553;80435945;360608;
14.01.2019;16:26:06;80796646;80436100;360546;
14.01.2019;16:27:07;80796738;80436268;360470;
14.01.2019;16:28:05;80796830;80436413;360417;
14.01.2019;16:29:06;80796936;80436561;360375;
14.01.2019;16:30:06;80797026;80436717;360309;
14.01.2019;16:31:10;80797127;80436918;360209;
14.01.2019;16:32:06;80797222;80437070;360152;
14.01.2019;16:33:04;80797332;80437222;360110;
14.01.2019;16:34:11;80797457;80437403;360054;
14.01.2019;16:35:05;80797559;80437537;360022;
14.01.2019;16:36:06;80797662;80437708;359954;
14.01.2019;16:38:28;80797875;80438095;359780;
14.01.2019;16:39:09;80797962;80438198;359764;
14.01.2019;16:40:07;80798075;80438347;359728;
14.01.2019;16:41:06;80798183;80438519;359664;
14.01.2019;16:42:08;80798305;80438687;359618;
14.01.2019;16:43:04;80798397;80438833;359564;
14.01.2019;16:44:10;80798491;80439023;359468;
14.01.2019;16:45:10;80798591;80439179;359412;
14.01.2019;16:46:10;80798693;80439352;359341;
14.01.2019;16:47:06;80798809;80439518;359291;
14.01.2019;16:48:12;80798924;80439665;359259;
14.01.2019;16:49:06;80799043;80439806;359237;
14.01.2019;16:50:06;80799134;80439972;359162;
14.01.2019;16:51:06;80799237;80440159;359078;
14.01.2019;16:52:06;80799331;80440302;359029;
14.01.2019;16:53:04;80799415;80440483;358932;
14.01.2019;16:54:05;80799541;80440670;358871;
14.01.2019;16:55:07;80799649;80440842;358807;
14.01.2019;16:56:11;80799733;80441009;358724;
14.01.2019;16:57:04;80799831;80441173;358658;
14.01.2019;16:58:10;80799963;80441342;358621;
14.01.2019;16:59:05;80800063;80441474;358589;
14.01.2019;17:00:04;80800182;80441616;358566;
14.01.2019;17:01:10;80800290;80441804;358486;
14.01.2019;17:02:06;80800411;80441963;358448;
14.01.2019;17:03:05;80800501;80442112;358389;
14.01.2019;17:04:07;80800594;80442280;358314;
14.01.2019;17:05:13;80800721;80442457;358264;
14.01.2019;17:06:12;80800835;80442651;358184;
14.01.2019;17:07:06;80800930;80442817;358113;
14.01.2019;17:08:11;80801025;80442981;358044;
14.01.2019;17:09:08;80801116;80443150;357966;
14.01.2019;17:10:09;80801225;80443315;357910;
14.01.2019;17:11:05;80801320;80443490;357830;
14.01.2019;17:12:10;80801463;80443658;357805;
14.01.2019;17:13:07;80801549;80443814;357735;
14.01.2019;17:14:11;80801648;80443991;357657;
14.01.2019;17:15:05;80801747;80444140;357607;
14.01.2019;17:16:05;80801831;80444306;357525;
14.01.2019;17:17:05;80801926;80444461;357465;
14.01.2019;17:18:10;80802029;80444638;357391;
14.01.2019;17:19:10;80802136;80444789;357347;
14.01.2019;17:20:06;80802241;80444951;357290;
14.01.2019;17:21:05;80802356;80445095;357261;
14.01.2019;17:22:05;80802461;80445279;357182;
14.01.2019;17:23:15;80802609;80445461;357148;
14.01.2019;17:24:06;80802712;80445594;357118;
14.01.2019;17:25:05;80802789;80445747;357042;
14.01.2019;17:26:05;80802909;80445905;357004;
14.01.2019;17:27:04;80802987;80446079;356908;
14.01.2019;17:28:05;80803083;80446222;356861;
14.01.2019;17:29:05;80803192;80446382;356810;
14.01.2019;17:30:05;80803291;80446524;356767;
14.01.2019;17:31:05;80803377;80446681;356696;
14.01.2019;17:32:05;80803471;80446859;356612;
14.01.2019;17:33:04;80803579;80447044;356535;
14.01.2019;17:34:05;80803665;80447184;356481;
14.01.2019;17:35:09;80803787;80447346;356441;
14.01.2019;17:36:06;80803880;80447507;356373;
14.01.2019;17:38:06;80804065;80447819;356246;
14.01.2019;17:39:09;80804164;80447968;356196;
14.01.2019;17:40:04;80804253;80448097;356156;
14.01.2019;17:41:06;80804359;80448237;356122;
14.01.2019;17:42:05;80804461;80448375;356086;
14.01.2019;17:43:07;80804573;80448547;356026;
14.01.2019;17:44:05;80804678;80448673;356005;
14.01.2019;17:45:07;80804767;80448835;355932;
14.01.2019;17:46:06;80804887;80448986;355901;
14.01.2019;17:47:06;80804984;80449143;355841;
14.01.2019;17:48:11;80805079;80449330;355749;
14.01.2019;17:49:12;80805178;80449481;355697;
14.01.2019;17:50:07;80805294;80449616;355678;
14.01.2019;17:51:06;80805405;80449748;355657;
14.01.2019;17:52:05;80805515;80449888;355627;
14.01.2019;17:53:12;80805631;80450059;355572;
14.01.2019;17:54:06;80805715;80450189;355526;
14.01.2019;17:55:06;80805830;80450340;355490;
14.01.2019;17:56:09;80805936;80450497;355439;
14.01.2019;17:57:06;80806042;80450644;355398;
14.01.2019;17:58:06;80806169;80450784;355385;
14.01.2019;17:59:05;80806276;80450930;355346;
14.01.2019;18:00:08;80806393;80451090;355303;
14.01.2019;18:01:14;80806504;80451244;355260;
14.01.2019;18:02:05;80806595;80451381;355214;
14.01.2019;18:03:10;80806683;80451559;355124;
14.01.2019;18:04:07;80806809;80451684;355125;
14.01.2019;18:05:05;80806897;80451811;355086;
14.01.2019;18:06:12;80806996;80452001;354995;
14.01.2019;18:07:05;80807069;80452101;354968;
14.01.2019;18:08:05;80807176;80452215;354961;
14.01.2019;18:09:13;80807269;80452380;354889;
14.01.2019;18:10:06;80807353;80452524;354829;
14.01.2019;18:11:05;80807448;80452687;354761;
14.01.2019;18:12:11;80807542;80452842;354700;
14.01.2019;18:13:11;80807649;80452955;354694;
14.01.2019;18:14:05;80807738;80453056;354682;
14.01.2019;18:15:05;80807847;80453177;354670;
14.01.2019;18:16:06;80807973;80453318;354655;
14.01.2019;18:17:05;80808034;80453414;354620;
14.01.2019;18:18:05;80808103;80453492;354611;
14.01.2019;18:19:10;80808187;80453597;354590;
14.01.2019;18:20:04;80808229;80453667;354562;
14.01.2019;18:21:06;80808283;80453766;354517;
14.01.2019;18:22:07;80808343;80453858;354485;
14.01.2019;18:23:07;80808435;80454004;354431;
14.01.2019;18:24:06;80808523;80454120;354403;
14.01.2019;18:25:05;80808607;80454267;354340;
14.01.2019;18:26:11;80808716;80454395;354321;
14.01.2019;18:27:09;80808798;80454518;354280;
14.01.2019;18:28:13;80808880;80454638;354242;
14.01.2019;18:29:12;80808962;80454757;354205;
14.01.2019;18:30:06;80809047;80454857;354190;
14.01.2019;18:31:06;80809123;80454997;354126;
14.01.2019;18:32:10;80809215;80455128;354087;
14.01.2019;18:33:06;80809284;80455227;354057;
14.01.2019;18:34:06;80809395;80455337;354058;
14.01.2019;18:35:07;80809509;80455450;354059;
14.01.2019;18:36:05;80809600;80455574;354026;
14.01.2019;18:37:06;80809617;80455627;353990;
14.01.2019;18:38:06;80809719;80455746;353973;
14.01.2019;18:40:05;80809941;80455980;353961;
14.01.2019;18:41:06;80810045;80456103;353942;
14.01.2019;18:42:06;80810154;80456204;353950;
14.01.2019;18:43:06;80810238;80456315;353923;
14.01.2019;18:44:05;80810336;80456417;353919;
14.01.2019;18:45:07;80810462;80456562;353900;
14.01.2019;18:46:08;80810540;80456691;353849;
14.01.2019;18:47:11;80810643;80456800;353843;
14.01.2019;18:48:05;80810709;80456895;353814;
14.01.2019;18:49:05;80810789;80457002;353787;
14.01.2019;18:50:08;80810877;80457130;353747;
14.01.2019;18:51:11;80810985;80457236;353749;
14.01.2019;18:52:11;80811065;80457335;353730;
14.01.2019;18:53:07;80811180;80457463;353717;
14.01.2019;18:54:08;80811280;80457574;353706;
14.01.2019;18:55:05;80811370;80457697;353673;
14.01.2019;18:56:05;80811472;80457800;353672;
14.01.2019;18:57:06;80811583;80457894;353689;
14.01.2019;18:58:07;80811676;80458005;353671;
14.01.2019;18:59:07;80811766;80458111;353655;
14.01.2019;19:00:06;80811866;80458231;353635;
14.01.2019;19:01:06;80811953;80458341;353612;
14.01.2019;19:02:06;80812035;80458444;353591;
14.01.2019;19:03:09;80812116;80458546;353570;
14.01.2019;19:04:06;80812203;80458631;353572;
14.01.2019;19:05:05;80812306;80458741;353565;
14.01.2019;19:06:05;80812425;80458829;353596;
14.01.2019;19:07:05;80812518;80458922;353596;
14.01.2019;19:08:06;80812623;80459026;353597;
14.01.2019;19:09:12;80812732;80459142;353590;
14.01.2019;19:10:10;80812816;80459269;353547;
14.01.2019;19:11:05;80812903;80459363;353540;
14.01.2019;19:12:07;80813021;80459471;353550;
14.01.2019;19:13:04;80813102;80459568;353534;
14.01.2019;19:14:06;80813199;80459676;353523;
14.01.2019;19:15:05;80813282;80459778;353504;
14.01.2019;19:16:05;80813376;80459876;353500;
14.01.2019;19:17:11;80813478;80459980;353498;
14.01.2019;19:18:05;80813565;80460075;353490;
14.01.2019;19:19:04;80813653;80460159;353494;
14.01.2019;19:20:05;80813753;80460268;353485;
14.01.2019;19:21:04;80813869;80460373;353496;
14.01.2019;19:22:04;80813981;80460454;353527;
14.01.2019;19:23:04;80814070;80460550;353520;
14.01.2019;19:24:05;80814145;80460663;353482;
14.01.2019;19:25:08;80814247;80460776;353471;
14.01.2019;19:26:10;80814346;80460859;353487;
14.01.2019;19:27:06;80814421;80460930;353491;
14.01.2019;19:28:05;80814516;80461020;353496;
14.01.2019;19:29:05;80814613;80461115;353498;
14.01.2019;19:30:05;80814713;80461205;353508;
14.01.2019;19:31:05;80814790;80461301;353489;
14.01.2019;19:32:05;80814889;80461378;353511;
14.01.2019;19:33:05;80814995;80461468;353527;
14.01.2019;19:34:05;80815077;80461558;353519;
14.01.2019;19:35:11;80815176;80461667;353509;
14.01.2019;19:36:10;80815276;80461769;353507;
14.01.2019;19:37:06;80815377;80461855;353522;
14.01.2019;19:38:11;80815475;80461948;353527;
14.01.2019;19:39:09;80815555;80462021;353534;
14.01.2019;19:40:05;80815646;80462081;353565;
14.01.2019;19:41:06;80815737;80462165;353572;
14.01.2019;19:42:10;80815828;80462263;353565;
14.01.2019;19:43:10;80815908;80462338;353570;
14.01.2019;19:44:05;80816010;80462409;353601;
14.01.2019;19:45:05;80816123;80462475;353648;
14.01.2019;19:46:05;80816229;80462566;353663;
14.01.2019;19:47:04;80816328;80462630;353698;
14.01.2019;19:48:06;80816429;80462714;353715;
14.01.2019;19:49:05;80816528;80462789;353739;
14.01.2019;19:50:06;80816617;80462883;353734;
14.01.2019;19:51:05;80816701;80462961;353740;
14.01.2019;19:52:06;80816779;80463029;353750;
14.01.2019;19:53:05;80816876;80463089;353787;
14.01.2019;19:54:08;80816984;80463195;353789;
14.01.2019;19:55:06;80817077;80463281;353796;
14.01.2019;19:56:05;80817193;80463366;353827;
14.01.2019;19:57:05;80817284;80463435;353849;
14.01.2019;19:58:05;80817396;80463520;353876;
14.01.2019;19:59:05;80817504;80463597;353907;
14.01.2019;20:00:10;80817629;80463688;353941;
14.01.2019;20:01:04;80817705;80463758;353947;
14.01.2019;20:02:05;80817806;80463835;353971;
14.01.2019;20:03:05;80817892;80463887;354005;
14.01.2019;20:04:07;80818000;80463962;354038;
14.01.2019;20:05:07;80818083;80464036;354047;
14.01.2019;20:06:06;80818173;80464113;354060;
14.01.2019;20:07:05;80818295;80464175;354120;
14.01.2019;20:08:11;80818400;80464266;354134;
14.01.2019;20:09:06;80818490;80464311;354179;
14.01.2019;20:10:11;80818580;80464401;354179;
14.01.2019;20:11:07;80818684;80464477;354207;
14.01.2019;20:12:06;80818771;80464543;354228;
14.01.2019;20:13:05;80818859;80464538;354321;
14.01.2019;20:14:06;80818968;80471680;347288;
14.01.2019;20:15:05;80816966;80471723;345243;
14.01.2019;20:16:12;80817026;80471772;345254;
14.01.2019;20:17:10;80817063;80471822;345241;
14.01.2019;20:18:06;80817112;80471876;345236;
14.01.2019;20:19:04;80817171;80471941;345230;
14.01.2019;20:20:05;80817265;80472008;345257;
14.01.2019;20:21:06;80817350;80472071;345279;
14.01.2019;20:22:08;80817420;80472127;345293;
14.01.2019;20:23:06;80817480;80472184;345296;
14.01.2019;20:25:06;80817556;80472292;345264;
14.01.2019;20:26:07;80817565;80472343;345222;
14.01.2019;20:27:06;80817621;80472392;345229;
14.01.2019;20:28:05;80817679;80472447;345232;
14.01.2019;20:29:05;80817754;80472501;345253;
14.01.2019;20:30:11;80817817;80472554;345263;
14.01.2019;20:31:05;80817871;80472590;345281;
14.01.2019;20:32:10;80817965;80472652;345313;
14.01.2019;20:33:11;80818027;80472715;345312;
14.01.2019;20:34:10;80818101;80472776;345325;
14.01.2019;20:35:08;80818188;80472809;345379;
14.01.2019;20:36:11;80818253;80472870;345383;
14.01.2019;20:37:05;80818359;80472930;345429;
14.01.2019;20:38:11;80818485;80472965;345520;
14.01.2019;20:39:07;80818577;80473033;345544;
14.01.2019;20:40:07;80818685;80473104;345581;
14.01.2019;20:41:05;80818743;80473157;345586;
14.01.2019;20:42:07;80818824;80473208;345616;
14.01.2019;20:43:07;80818901;80473269;345632;
14.01.2019;20:44:11;80819017;80473327;345690;
14.01.2019;20:45:07;80819135;80473374;345761;
14.01.2019;20:46:07;80819355;80473455;345900;
14.01.2019;20:47:06;80819648;80473500;346148;
14.01.2019;20:48:11;80819943;80473555;346388;
14.01.2019;20:49:05;80820281;80473593;346688;
14.01.2019;20:50:05;80820640;80473664;346976;
14.01.2019;20:51:09;80821070;80473719;347351;
14.01.2019;20:52:13;80821483;80473781;347702;
14.01.2019;20:53:11;80821883;80473817;348066;
14.01.2019;20:54:13;80822272;80473865;348407;
14.01.2019;20:55:05;80822611;80473908;348703;
14.01.2019;20:56:06;80822988;80473963;349025;
14.01.2019;20:57:07;80823421;80474019;349402;
14.01.2019;20:58:06;80823807;80474060;349747;
14.01.2019;20:59:08;80824219;80474103;350116;
14.01.2019;21:00:06;80824636;80474155;350481;
14.01.2019;21:01:12;80825118;80474204;350914;
14.01.2019;21:02:06;80825473;80474250;351223;
14.01.2019;21:03:08;80825885;80474306;351579;
14.01.2019;21:04:06;80826312;80474352;351960;
14.01.2019;21:05:06;80826699;80474392;352307;
14.01.2019;21:06:06;80827068;80474443;352625;
14.01.2019;21:07:05;80827457;80474482;352975;
14.01.2019;21:08:09;80827856;80474532;353324;
14.01.2019;21:09:09;80828235;80474584;353651;
14.01.2019;21:10:05;80828557;80474632;353925;
14.01.2019;21:11:09;80828947;80474677;354270;
14.01.2019;21:12:05;80829337;80474722;354615;
14.01.2019;21:13:05;80829750;80474753;354997;
14.01.2019;21:14:05;80830167;80474787;355380;
14.01.2019;21:15:06;80830595;80474829;355766;
14.01.2019;21:16:06;80830944;80474875;356069;
14.01.2019;21:17:05;80831283;80474916;356367;
14.01.2019;21:18:05;80831676;80474962;356714;
14.01.2019;21:19:08;80832107;80475006;357101;
14.01.2019;21:20:06;80832461;80475063;357398;
14.01.2019;21:21:05;80832855;80475115;357740;
14.01.2019;21:22:06;80833191;80475160;358031;
14.01.2019;21:23:05;80833594;80475214;358380;
14.01.2019;21:24:06;80833955;80475263;358692;
14.01.2019;21:25:06;80834309;80475307;359002;
14.01.2019;21:26:06;80834673;80475353;359320;
14.01.2019;21:27:06;80835064;80475397;359667;
14.01.2019;21:28:05;80835400;80475433;359967;
14.01.2019;21:29:05;80835757;80475483;360274;
14.01.2019;21:30:07;80836133;80475525;360608;
14.01.2019;21:31:05;80836498;80475565;360933;
14.01.2019;21:32:10;80836838;80475599;361239;
14.01.2019;21:33:09;80837184;80475636;361548;
14.01.2019;21:34:11;80837548;80475673;361875;
14.01.2019;21:35:06;80837915;80475721;362194;
14.01.2019;21:36:05;80838289;80475760;362529;
14.01.2019;21:37:06;80838650;80475806;362844;
14.01.2019;21:38:04;80838993;80475846;363147;
14.01.2019;21:39:07;80839389;80475885;363504;
14.01.2019;21:40:06;80839757;80475928;363829;
14.01.2019;21:41:11;80840152;80475954;364198;
14.01.2019;21:42:05;80840488;80475963;364525;
14.01.2019;21:43:06;80840867;80476012;364855;
14.01.2019;21:44:07;80841227;80476043;365184;
14.01.2019;21:45:11;80841509;80476069;365440;
14.01.2019;21:46:05;80841855;80476095;365760;
14.01.2019;21:47:04;80842188;80476124;366064;
14.01.2019;21:48:06;80842560;80476154;366406;
14.01.2019;21:49:06;80842891;80476180;366711;
14.01.2019;21:50:04;80843216;80476216;367000;
14.01.2019;21:51:05;80843595;80476261;367334;
14.01.2019;21:52:07;80843942;80476307;367635;
14.01.2019;21:53:06;80844267;80476344;367923;
14.01.2019;21:54:05;80844633;80476376;368257;
14.01.2019;21:55:05;80845002;80476410;368592;
14.01.2019;21:56:05;80845335;80476433;368902;
14.01.2019;21:57:05;80845694;80476467;369227;
14.01.2019;21:58:05;80846067;80476503;369564;
14.01.2019;21:59:05;80846422;80476545;369877;
14.01.2019;22:00:05;80846738;80476574;370164;
14.01.2019;22:01:05;80847091;80476621;370470;
14.01.2019;22:02:06;80847438;80476661;370777;
14.01.2019;22:03:04;80847794;80476691;371103;
14.01.2019;22:04:04;80848057;80476732;371325;
14.01.2019;22:05:10;80848389;80476757;371632;
14.01.2019;22:06:04;80848646;80476791;371855;
14.01.2019;22:07:05;80849062;80476829;372233;
14.01.2019;22:08:05;80849415;80476858;372557;
14.01.2019;22:09:05;80849667;80476900;372767;
14.01.2019;22:10:05;80850089;80476933;373156;
14.01.2019;22:11:05;80850396;80476975;373421;
14.01.2019;22:12:05;80850724;80477004;373720;
14.01.2019;22:13:06;80851058;80477040;374018;
14.01.2019;22:14:05;80851377;80477069;374308;
14.01.2019;22:15:06;80851708;80477108;374600;
14.01.2019;22:16:05;80852040;80477145;374895;
14.01.2019;22:17:05;80852375;80477187;375188;
14.01.2019;22:18:05;80852707;80477211;375496;
14.01.2019;22:19:05;80853012;80477231;375781;
14.01.2019;22:20:05;80853246;80477248;375998;
14.01.2019;22:21:05;80853446;80477272;376174;
14.01.2019;22:22:05;80853711;80477288;376423;
14.01.2019;22:23:04;80853953;80477296;376657;
14.01.2019;22:24:04;80854238;80477306;376932;
14.01.2019;22:25:04;80854510;80477328;377182;
14.01.2019;22:26:04;80854740;80477351;377389;
14.01.2019;22:27:11;80854900;80477362;377538;
14.01.2019;22:28:04;80855106;80477380;377726;
14.01.2019;22:29:04;80855373;80477408;377965;
14.01.2019;22:30:05;80855626;80477443;378183;
14.01.2019;22:31:12;80855939;80477461;378478;
14.01.2019;22:32:05;80856169;80477493;378676;
14.01.2019;22:33:05;80856475;80477507;378968;
14.01.2019;22:34:06;80856762;80477534;379228;
14.01.2019;22:35:05;80857062;80477571;379491;
14.01.2019;22:36:05;80857352;80477604;379748;
14.01.2019;22:37:10;80857628;80477638;379990;
14.01.2019;22:38:04;80857917;80477663;380254;
14.01.2019;22:39:06;80858215;80477684;380531;
14.01.2019;22:40:05;80858469;80477715;380754;
14.01.2019;22:41:05;80858720;80477732;380988;
14.01.2019;22:42:07;80859014;80477759;381255;
14.01.2019;22:43:05;80859294;80477787;381507;
14.01.2019;22:44:07;80859590;80477816;381774;
14.01.2019;22:45:04;80859863;80477840;382023;
14.01.2019;22:46:04;80860093;80477871;382222;
14.01.2019;22:47:05;80860371;80477897;382474;
14.01.2019;22:48:05;80860648;80477925;382723;
14.01.2019;22:49:05;80860943;80477939;383004;
14.01.2019;22:50:06;80861282;80477962;383320;
14.01.2019;22:51:05;80861584;80477989;383595;
14.01.2019;22:52:08;80861907;80478022;383885;
14.01.2019;22:53:06;80862196;80478042;384154;
14.01.2019;22:54:05;80862495;80478076;384419;
14.01.2019;22:55:05;80862763;80478094;384669;
14.01.2019;22:56:06;80863093;80478125;384968;
14.01.2019;22:57:05;80863361;80478149;385212;
14.01.2019;22:58:04;80863627;80478180;385447;
14.01.2019;22:59:06;80863901;80478211;385690;
14.01.2019;23:00:04;80864183;80478247;385936;
14.01.2019;23:01:05;80864455;80478273;386182;
14.01.2019;23:02:05;80864740;80478307;386433;
14.01.2019;23:03:05;80864998;80478333;386665;
14.01.2019;23:04:06;80865237;80478356;386881;
14.01.2019;23:05:05;80865468;80478379;387089;
14.01.2019;23:06:04;80865741;80478405;387336;
14.01.2019;23:07:05;80866009;80478437;387572;
14.01.2019;23:08:04;80866275;80478469;387806;
14.01.2019;23:09:07;80866499;80478497;388002;
14.01.2019;23:10:04;80866765;80478518;388247;
14.01.2019;23:11:05;80866994;80478538;388456;
14.01.2019;23:12:06;80867227;80478561;388666;
14.01.2019;23:13:05;80867491;80478584;388907;
14.01.2019;23:14:04;80867759;80478609;389150;
14.01.2019;23:15:04;80868030;80478642;389388;
14.01.2019;23:16:05;80868296;80478658;389638;
14.01.2019;23:17:05;80868569;80478692;389877;
14.01.2019;23:18:05;80868852;80478716;390136;
14.01.2019;23:19:06;80869107;80478739;390368;
14.01.2019;23:20:05;80869381;80478768;390613;
14.01.2019;23:21:05;80869645;80478787;390858;
14.01.2019;23:22:12;80869938;80478817;391121;
14.01.2019;23:23:05;80870155;80478855;391300;
14.01.2019;23:24:05;80870380;80478875;391505;
14.01.2019;23:25:05;80870636;80478894;391742;
14.01.2019;23:26:05;80870924;80478920;392004;
14.01.2019;23:27:05;80871179;80478949;392230;
14.01.2019;23:28:04;80871441;80478971;392470;
14.01.2019;23:29:04;80871699;80478994;392705;
14.01.2019;23:30:06;80871924;80479027;392897;
14.01.2019;23:31:06;80872175;80479045;393130;
14.01.2019;23:32:06;80872460;80479063;393397;
14.01.2019;23:33:06;80872732;80479078;393654;
14.01.2019;23:34:05;80872984;80479109;393875;
14.01.2019;23:35:04;80873214;80479132;394082;
14.01.2019;23:36:04;80873446;80479161;394285;
14.01.2019;23:37:07;80873665;80479184;394481;
14.01.2019;23:38:11;80873908;80479223;394685;
14.01.2019;23:39:07;80874111;80479239;394872;
14.01.2019;23:40:05;80874336;80479252;395084;
14.01.2019;23:41:05;80874540;80479270;395270;
14.01.2019;23:42:05;80874769;80479302;395467;
14.01.2019;23:43:07;80874997;80479315;395682;
14.01.2019;23:44:05;80875233;80479338;395895;
14.01.2019;23:45:04;80875460;80479350;396110;
14.01.2019;23:46:04;80875674;80479370;396304;
14.01.2019;23:47:07;80875917;80479393;396524;
14.01.2019;23:48:04;80876137;80479414;396723;
14.01.2019;23:49:04;80876355;80479439;396916;
14.01.2019;23:50:10;80876613;80479461;397152;
14.01.2019;23:51:06;80876826;80479487;397339;
14.01.2019;23:52:06;80877062;80479512;397550;
14.01.2019;23:53:06;80877280;80479531;397749;
14.01.2019;23:54:05;80877555;80479549;398006;
14.01.2019;23:55:06;80877777;80479575;398202;
14.01.2019;23:56:05;80877973;80479608;398365;
14.01.2019;23:57:05;80878178;80479625;398553;
14.01.2019;23:58:11;80878395;80479646;398749;
14.01.2019;23:59:05;80878568;80479662;398906;
15.01.2019;00:00:07;80878762;80479684;399078;
15.01.2019;00:01:09;80878961;80479714;399247;
15.01.2019;00:02:08;80879147;80479727;399420;
15.01.2019;00:03:09;80879333;80479746;399587;
15.01.2019;00:04:06;80879523;80479773;399750;
15.01.2019;00:05:13;80879754;80479797;399957;
15.01.2019;00:06:08;80879961;80479813;400148;
15.01.2019;00:07:07;80880152;80479823;400329;
15.01.2019;00:08:08;80880374;80479838;400536;
15.01.2019;00:09:07;80880595;80479861;400734;
15.01.2019;00:10:08;80880828;80479886;400942;
15.01.2019;00:11:07;80881065;80479901;401164;
15.01.2019;00:12:07;80881250;80479910;401340;
15.01.2019;00:13:07;80881215;80479923;401292;
15.01.2019;00:14:08;80881143;80479934;401209;
15.01.2019;00:15:07;80881046;80479936;401110;
15.01.2019;00:16:08;80880953;80479945;401008;
15.01.2019;00:17:08;80881022;80479967;401055;
15.01.2019;00:18:08;80881153;80480000;401153;
15.01.2019;00:19:08;80881231;80480029;401202;
15.01.2019;00:20:07;80881277;80480039;401238;
15.01.2019;00:21:08;80881260;80480053;401207;
15.01.2019;00:22:07;80881316;80480069;401247;
15.01.2019;00:23:07;80881340;80480084;401256;
15.01.2019;00:24:08;80881325;80480107;401218;
15.01.2019;00:25:08;80881328;80480119;401209;
15.01.2019;00:26:08;80881377;80480138;401239;
15.01.2019;00:27:08;80881460;80480156;401304;
15.01.2019;00:28:08;80881536;80480182;401354;
15.01.2019;00:29:08;80881655;80480206;401449;
15.01.2019;00:30:08;80881845;80480228;401617;
15.01.2019;00:31:07;80882040;80480255;401785;
15.01.2019;00:32:08;80882250;80480274;401976;
15.01.2019;00:33:08;80882431;80480304;402127;
15.01.2019;00:34:07;80882603;80480324;402279;
15.01.2019;00:35:07;80882824;80480339;402485;
15.01.2019;00:36:08;80883043;80480370;402673;
15.01.2019;00:37:08;80883218;80480390;402828;
15.01.2019;00:38:07;80883396;80480427;402969;
15.01.2019;00:39:08;80883590;80480456;403134;
15.01.2019;00:40:07;80883820;80480481;403339;
15.01.2019;00:41:07;80884034;80480493;403541;
15.01.2019;00:42:08;80884274;80480513;403761;
15.01.2019;00:43:07;80884446;80480545;403901;
15.01.2019;00:44:07;80884633;80480568;404065;
15.01.2019;00:45:07;80884831;80480587;404244;
15.01.2019;00:46:07;80885004;80480620;404384;
15.01.2019;00:47:07;80885207;80480642;404565;
15.01.2019;00:48:07;80885402;80480666;404736;
15.01.2019;00:49:08;80885630;80480684;404946;
15.01.2019;00:50:07;80885864;80480707;405157;
15.01.2019;00:51:07;80886056;80480726;405330;
15.01.2019;00:52:07;80886229;80480749;405480;
15.01.2019;00:53:07;80886421;80480775;405646;
15.01.2019;00:54:07;80886613;80480803;405810;
15.01.2019;00:55:07;80886788;80480829;405959;
15.01.2019;00:56:08;80886979;80480848;406131;
15.01.2019;00:57:08;80887182;80480873;406309;
15.01.2019;00:58:07;80887316;80480865;406451;
15.01.2019;00:59:07;80887493;80480887;406606;
15.01.2019;01:00:04;80887687;80480910;406777;
15.01.2019;01:01:05;80887873;80480936;406937;
15.01.2019;01:02:05;80888036;80480961;407075;
15.01.2019;01:03:05;80888212;80481002;407210;
15.01.2019;01:04:04;80888415;80481030;407385;
15.01.2019;01:05:04;80888582;80481062;407520;
15.01.2019;01:06:04;80888749;80481080;407669;
15.01.2019;01:07:05;80888931;80481104;407827;
15.01.2019;01:08:05;80889120;80481131;407989;
15.01.2019;01:09:07;80889295;80481150;408145;
15.01.2019;01:10:09;80889491;80481174;408317;
15.01.2019;01:11:04;80889666;80481196;408470;
15.01.2019;01:12:05;80889805;80481233;408572;
15.01.2019;01:13:05;80890032;80481262;408770;
15.01.2019;01:14:05;80890221;80481282;408939;
15.01.2019;01:15:05;80890381;80481311;409070;
15.01.2019;01:16:04;80890519;80481338;409181;
15.01.2019;01:17:04;80890683;80481381;409302;
15.01.2019;01:18:04;80890871;80481404;409467;
15.01.2019;01:19:05;80891064;80481433;409631;
15.01.2019;01:20:05;80891265;80481455;409810;
15.01.2019;01:21:04;80891432;80481482;409950;
15.01.2019;01:22:04;80891586;80481512;410074;
15.01.2019;01:23:05;80891752;80481541;410211;
15.01.2019;01:24:05;80891931;80481573;410358;
15.01.2019;01:25:05;80892133;80481603;410530;
15.01.2019;01:26:04;80892287;80481638;410649;
15.01.2019;01:27:04;80892449;80481657;410792;
15.01.2019;01:28:05;80892652;80481685;410967;
15.01.2019;01:29:05;80892834;80481714;411120;
15.01.2019;01:30:04;80893036;80481744;411292;
15.01.2019;01:31:04;80893197;80481771;411426;
15.01.2019;01:32:05;80893383;80481810;411573;
15.01.2019;01:33:05;80893566;80481846;411720;
15.01.2019;01:34:04;80893740;80481877;411863;
15.01.2019;01:35:04;80893901;80481903;411998;
15.01.2019;01:36:05;80894053;80481952;412101;
15.01.2019;01:37:05;80894231;80481995;412236;
15.01.2019;01:38:04;80894423;80482045;412378;
15.01.2019;01:39:04;80894604;80482088;412516;
15.01.2019;01:40:04;80894784;80482119;412665;
15.01.2019;01:41:05;80894997;80482150;412847;
15.01.2019;01:42:05;80895163;80482196;412967;
15.01.2019;01:43:04;80895354;80482223;413131;
15.01.2019;01:44:04;80895511;80482270;413241;
15.01.2019;01:45:04;80895675;80482311;413364;
15.01.2019;01:46:05;80895822;80482340;413482;
15.01.2019;01:47:04;80896005;80482381;413624;
15.01.2019;01:48:04;80896192;80482407;413785;
15.01.2019;01:49:04;80896337;80482444;413893;
15.01.2019;01:50:05;80896514;80482489;414025;
15.01.2019;01:51:04;80896678;80482528;414150;
15.01.2019;01:52:04;80896832;80482566;414266;
15.01.2019;01:53:05;80896971;80482606;414365;
15.01.2019;01:54:05;80897142;80482654;414488;
15.01.2019;01:55:05;80897325;80482700;414625;
15.01.2019;01:56:04;80897472;80482743;414729;
15.01.2019;01:57:05;80897603;80482774;414829;
15.01.2019;01:58:05;80897728;80482819;414909;
15.01.2019;01:59:04;80897864;80482866;414998;
15.01.2019;02:00:04;80898022;80482913;415109;
15.01.2019;02:01:05;80898194;80482974;415220;
15.01.2019;02:02:04;80898346;80483023;415323;
15.01.2019;02:03:04;80898497;80483072;415425;
15.01.2019;02:04:05;80898681;80483116;415565;
15.01.2019;02:05:04;80898840;80483149;415691;
15.01.2019;02:06:04;80899006;80483193;415813;
15.01.2019;02:07:05;80899164;80483249;415915;
15.01.2019;02:08:05;80899314;80483290;416024;
15.01.2019;02:09:06;80899465;80483332;416133;
15.01.2019;02:10:05;80899588;80483390;416198;
15.01.2019;02:11:05;80899728;80483439;416289;
15.01.2019;02:12:04;80899897;80483489;416408;
15.01.2019;02:13:05;80900085;80483536;416549;
15.01.2019;02:14:05;80900158;80483591;416567;
15.01.2019;02:15:04;80900071;80483643;416428;
15.01.2019;02:16:04;80899955;80483691;416264;
15.01.2019;02:17:06;80899847;80483743;416104;
15.01.2019;02:18:05;80899851;80483797;416054;
15.01.2019;02:19:04;80899969;80483851;416118;
15.01.2019;02:20:04;80900086;80483907;416179;
15.01.2019;02:21:05;80900120;80483966;416154;
15.01.2019;02:22:05;80900139;80484013;416126;
15.01.2019;02:23:05;80900194;80484067;416127;
15.01.2019;02:24:04;80900254;80484116;416138;
15.01.2019;02:25:05;80900275;80484171;416104;
15.01.2019;02:26:04;80900363;80484224;416139;
15.01.2019;02:27:04;80900454;80484283;416171;
15.01.2019;02:28:05;80900574;80484365;416209;
15.01.2019;02:29:05;80900716;80484433;416283;
15.01.2019;02:30:04;80900862;80484507;416355;
15.01.2019;02:31:04;80901001;80484570;416431;
15.01.2019;02:32:05;80901148;80484623;416525;
15.01.2019;02:33:05;80901291;80484674;416617;
15.01.2019;02:34:05;80901452;80484741;416711;
15.01.2019;02:35:05;80901625;80484800;416825;
15.01.2019;02:36:04;80901787;80484860;416927;
15.01.2019;02:37:05;80901958;80484913;417045;
15.01.2019;02:38:05;80902122;80484978;417144;
15.01.2019;02:39:06;80902286;80485036;417250;
15.01.2019;02:40:05;80902422;80485105;417317;
15.01.2019;02:41:05;80902569;80485175;417394;
15.01.2019;02:42:04;80902716;80485242;417474;
15.01.2019;02:43:04;80902850;80485306;417544;
15.01.2019;02:44:05;80903013;80485381;417632;
15.01.2019;02:45:04;80903179;80485446;417733;
15.01.2019;02:46:04;80903342;80485501;417841;
15.01.2019;02:47:05;80903479;80485576;417903;
15.01.2019;02:48:04;80903654;80485644;418010;
15.01.2019;02:49:04;80903802;80485734;418068;
15.01.2019;02:50:05;80903992;80485811;418181;
15.01.2019;02:51:04;80904183;80485885;418298;
15.01.2019;02:52:04;80904333;80485967;418366;
15.01.2019;02:53:05;80904480;80486056;418424;
15.01.2019;02:54:04;80904618;80486128;418490;
15.01.2019;02:55:04;80904810;80486192;418618;
15.01.2019;02:56:05;80904977;80486272;418705;
15.01.2019;02:57:05;80905115;80486347;418768;
15.01.2019;02:58:04;80905266;80486429;418837;
15.01.2019;02:59:04;80905425;80486527;418898;
15.01.2019;03:00:05;80905574;80486624;418950;
15.01.2019;03:01:05;80905731;80486703;419028;
15.01.2019;03:02:04;80905829;80486811;419018;
15.01.2019;03:03:04;80905973;80486892;419081;
15.01.2019;03:04:05;80906127;80486983;419144;
15.01.2019;03:05:04;80906276;80487062;419214;
15.01.2019;03:06:04;80906422;80487153;419269;
15.01.2019;03:07:05;80906585;80487230;419355;
15.01.2019;03:08:05;80906714;80487310;419404;
15.01.2019;03:09:04;80906880;80487404;419476;
15.01.2019;03:10:04;80907015;80487506;419509;
15.01.2019;03:11:05;80907163;80487597;419566;
15.01.2019;03:12:05;80907272;80487677;419595;
15.01.2019;03:13:04;80907410;80487764;419646;
15.01.2019;03:14:05;80907562;80487835;419727;
15.01.2019;03:15:05;80907709;80487934;419775;
15.01.2019;03:16:04;80907847;80488035;419812;
15.01.2019;03:17:04;80907975;80488128;419847;
15.01.2019;03:18:05;80908105;80488210;419895;
15.01.2019;03:19:05;80908245;80488276;419969;
15.01.2019;03:20:04;80908361;80488374;419987;
15.01.2019;03:21:05;80908492;80488473;420019;
15.01.2019;03:22:05;80908620;80488578;420042;
15.01.2019;03:23:04;80908738;80488680;420058;
15.01.2019;03:24:04;80908876;80488770;420106;
15.01.2019;03:25:06;80909001;80488871;420130;
15.01.2019;03:26:04;80909134;80488956;420178;
15.01.2019;03:27:04;80909267;80489046;420221;
15.01.2019;03:28:05;80909400;80489165;420235;
15.01.2019;03:29:05;80909527;80489284;420243;
15.01.2019;03:30:04;80909671;80489392;420279;
15.01.2019;03:31:04;80909821;80489496;420325;
15.01.2019;03:32:05;80909985;80489623;420362;
15.01.2019;03:33:04;80910135;80489707;420428;
15.01.2019;03:34:04;80910267;80489798;420469;
15.01.2019;03:35:05;80910391;80489909;420482;
15.01.2019;03:36:05;80910540;80489967;420573;
15.01.2019;03:37:05;80910683;80490054;420629;
15.01.2019;03:38:06;80910809;80490128;420681;
15.01.2019;03:39:06;80910940;80490245;420695;
15.01.2019;03:40:05;80911070;80490324;420746;
15.01.2019;03:41:05;80911224;80490444;420780;
15.01.2019;03:42:04;80911335;80490568;420767;
15.01.2019;03:43:04;80911440;80490669;420771;
15.01.2019;03:44:06;80911548;80490781;420767;
15.01.2019;03:45:06;80911662;80490882;420780;
15.01.2019;03:46:06;80911808;80490993;420815;
15.01.2019;03:47:05;80911932;80491098;420834;
15.01.2019;03:48:05;80912060;80491187;420873;
15.01.2019;03:49:06;80912204;80491310;420894;
15.01.2019;03:50:06;80912365;80491433;420932;
15.01.2019;03:51:06;80912496;80491551;420945;
15.01.2019;03:52:05;80912604;80491634;420970;
15.01.2019;03:53:11;80912756;80491736;421020;
15.01.2019;03:54:05;80912864;80491848;421016;
15.01.2019;03:55:06;80913016;80491954;421062;
15.01.2019;03:56:06;80913126;80492084;421042;
15.01.2019;03:57:06;80913278;80492192;421086;
15.01.2019;03:58:04;80913402;80492300;421102;
15.01.2019;03:59:04;80913522;80492413;421109;
15.01.2019;04:00:05;80913652;80492539;421113;
15.01.2019;04:01:06;80913734;80492635;421099;
15.01.2019;04:02:05;80913818;80492736;421082;
15.01.2019;04:03:04;80913932;80492852;421080;
15.01.2019;04:04:04;80914081;80492958;421123;
15.01.2019;04:05:05;80914220;80493072;421148;
15.01.2019;04:06:04;80914348;80493192;421156;
15.01.2019;04:07:05;80914511;80493324;421187;
15.01.2019;04:08:04;80914658;80493420;421238;
15.01.2019;04:09:08;80914800;80493525;421275;
15.01.2019;04:10:05;80914916;80493647;421269;
15.01.2019;04:11:04;80915041;80493748;421293;
15.01.2019;04:12:06;80915174;80493866;421308;
15.01.2019;04:13:06;80915198;80493974;421224;
15.01.2019;04:14:06;80915116;80494089;421027;
15.01.2019;04:15:05;80915072;80494191;420881;
15.01.2019;04:16:04;80915021;80494309;420712;
15.01.2019;04:17:04;80915011;80494421;420590;
15.01.2019;04:18:04;80915033;80494536;420497;
15.01.2019;04:19:05;80915071;80494629;420442;
15.01.2019;04:20:05;80915180;80494749;420431;
15.01.2019;04:21:04;80915315;80494854;420461;
15.01.2019;04:22:06;80915425;80494966;420459;
15.01.2019;04:23:05;80915540;80495087;420453;
15.01.2019;04:24:05;80915617;80495191;420426;
15.01.2019;04:25:05;80915729;80495303;420426;
15.01.2019;04:26:06;80915846;80495409;420437;
15.01.2019;04:27:04;80915978;80495514;420464;
15.01.2019;04:28:05;80916119;80495644;420475;
15.01.2019;04:29:07;80916242;80495769;420473;
15.01.2019;04:30:05;80916355;80495863;420492;
15.01.2019;04:31:05;80916478;80496002;420476;
15.01.2019;04:32:04;80916597;80496130;420467;
15.01.2019;04:33:05;80916744;80496249;420495;
15.01.2019;04:34:06;80916858;80496361;420497;
15.01.2019;04:35:06;80916995;80496492;420503;
15.01.2019;04:36:06;80917122;80496603;420519;
15.01.2019;04:37:06;80917250;80496718;420532;
15.01.2019;04:38:06;80917372;80496852;420520;
15.01.2019;04:39:12;80917547;80496971;420576;
15.01.2019;04:40:11;80917661;80497093;420568;
15.01.2019;04:41:04;80917811;80497209;420602;
15.01.2019;04:42:05;80917937;80497320;420617;
15.01.2019;04:43:12;80918063;80497452;420611;
15.01.2019;04:44:06;80918143;80497543;420600;
15.01.2019;04:45:06;80918305;80497669;420636;
15.01.2019;04:46:05;80918428;80497776;420652;
15.01.2019;04:47:05;80918544;80497900;420644;
15.01.2019;04:48:04;80918680;80498020;420660;
15.01.2019;04:49:04;80918817;80498146;420671;
15.01.2019;04:50:06;80918920;80498261;420659;
15.01.2019;04:51:06;80919038;80498394;420644;
15.01.2019;04:52:06;80919137;80498518;420619;
15.01.2019;04:53:04;80919242;80498626;420616;
15.01.2019;04:54:05;80919359;80498765;420594;
15.01.2019;04:55:06;80919487;80498888;420599;
15.01.2019;04:56:06;80919601;80499033;420568;
15.01.2019;04:57:05;80919727;80499146;420581;
15.01.2019;04:58:04;80919856;80499262;420594;
15.01.2019;04:59:05;80919974;80499360;420614;
15.01.2019;05:00:05;80920074;80499497;420577;
15.01.2019;05:01:04;80920190;80499600;420590;
15.01.2019;05:02:06;80920324;80499734;420590;
15.01.2019;05:03:05;80920445;80499861;420584;
15.01.2019;05:04:06;80920559;80499978;420581;
15.01.2019;05:05:06;80920675;80500094;420581;
15.01.2019;05:06:05;80920801;80500225;420576;
15.01.2019;05:07:06;80920910;80500348;420562;
15.01.2019;05:08:06;80921020;80500473;420547;
15.01.2019;05:09:06;80921139;80500590;420549;
15.01.2019;05:10:06;80921249;80500715;420534;
15.01.2019;05:11:06;80921349;80500826;420523;
15.01.2019;05:12:11;80921454;80500947;420507;
15.01.2019;05:13:06;80921560;80501065;420495;
15.01.2019;05:14:10;80921661;80501221;420440;
15.01.2019;05:15:04;80921779;80501330;420449;
15.01.2019;05:16:05;80921904;80501458;420446;
15.01.2019;05:17:05;80921999;80501595;420404;
15.01.2019;05:18:10;80922108;80501711;420397;
15.01.2019;05:19:05;80922225;80501818;420407;
15.01.2019;05:20:05;80922339;80501935;420404;
15.01.2019;05:21:04;80922452;80502058;420394;
15.01.2019;05:22:04;80922561;80502175;420386;
15.01.2019;05:23:06;80922664;80502307;420357;
15.01.2019;05:24:04;80922792;80502440;420352;
15.01.2019;05:25:05;80922903;80502588;420315;
15.01.2019;05:26:04;80922995;80502705;420290;
15.01.2019;05:27:06;80923114;80502819;420295;
15.01.2019;05:28:05;80923221;80502968;420253;
15.01.2019;05:29:06;80923340;80503108;420232;
15.01.2019;05:30:06;80923444;80503234;420210;
15.01.2019;05:31:04;80923556;80503325;420231;
15.01.2019;05:32:04;80923669;80503476;420193;
15.01.2019;05:33:05;80923804;80503603;420201;
15.01.2019;05:34:04;80923916;80503744;420172;
15.01.2019;05:35:04;80924009;80503917;420092;
15.01.2019;05:36:05;80924116;80504045;420071;
15.01.2019;05:37:07;80924242;80504158;420084;
15.01.2019;05:38:06;80924355;80504274;420081;
15.01.2019;05:39:08;80924465;80504394;420071;
15.01.2019;05:40:07;80924560;80504536;420024;
15.01.2019;05:41:06;80924663;80504662;420001;
15.01.2019;05:42:06;80924758;80504800;419958;
15.01.2019;05:43:07;80924867;80504936;419931;
15.01.2019;05:44:08;80924968;80505054;419914;
15.01.2019;05:45:11;80925085;80505191;419894;
15.01.2019;05:46:16;80925188;80505341;419847;
15.01.2019;05:47:04;80925291;80505450;419841;
15.01.2019;05:48:05;80925390;80505567;419823;
15.01.2019;05:49:06;80925488;80505702;419786;
15.01.2019;05:50:05;80925595;80505820;419775;
15.01.2019;05:51:05;80925717;80505957;419760;
15.01.2019;05:52:10;80925831;80506106;419725;
15.01.2019;05:53:11;80925962;80506216;419746;
15.01.2019;05:54:06;80926071;80506347;419724;
15.01.2019;05:55:08;80926161;80506468;419693;
15.01.2019;05:56:11;80926243;80506579;419664;
15.01.2019;05:57:05;80926331;80506691;419640;
15.01.2019;05:58:05;80926439;80506830;419609;
15.01.2019;05:59:05;80926541;80506956;419585;
15.01.2019;06:00:06;80926634;80507112;419522;
15.01.2019;06:01:07;80926740;80507247;419493;
15.01.2019;06:02:07;80926837;80507376;419461;
15.01.2019;06:03:05;80926925;80507518;419407;
15.01.2019;06:04:06;80927018;80507654;419364;
15.01.2019;06:05:06;80927108;80507780;419328;
15.01.2019;06:06:11;80927211;80507911;419300;
15.01.2019;06:07:10;80927331;80508019;419312;
15.01.2019;06:08:11;80927404;80508152;419252;
15.01.2019;06:09:07;80927485;80508300;419185;
15.01.2019;06:10:10;80927581;80508428;419153;
15.01.2019;06:11:05;80927683;80508531;419152;
15.01.2019;06:12:04;80927718;80508644;419074;
15.01.2019;06:13:06;80927753;80508753;419000;
15.01.2019;06:14:12;80927751;80508896;418855;
15.01.2019;06:15:06;80927759;80508991;418768;
15.01.2019;06:16:07;80927740;80509111;418629;
15.01.2019;06:17:06;80927727;80509233;418494;
15.01.2019;06:18:06;80927756;80509365;418391;
15.01.2019;06:19:05;80927763;80509460;418303;
15.01.2019;06:20:06;80927816;80509584;418232;
15.01.2019;06:21:13;80927879;80509741;418138;
15.01.2019;06:22:05;80927957;80509854;418103;
15.01.2019;06:23:05;80928023;80509979;418044;
15.01.2019;06:24:05;80928106;80510133;417973;
15.01.2019;06:25:08;80928184;80510285;417899;
15.01.2019;06:26:06;80928251;80510403;417848;
15.01.2019;06:27:06;80928327;80510528;417799;
15.01.2019;06:28:06;80928404;80510667;417737;
15.01.2019;06:29:06;80928492;80510794;417698;
15.01.2019;06:30:06;80928603;80510940;417663;
15.01.2019;06:31:06;80928703;80511079;417624;
15.01.2019;06:32:07;80928798;80511223;417575;
15.01.2019;06:33:06;80928899;80511361;417538;
15.01.2019;06:34:11;80928988;80511508;417480;
15.01.2019;06:35:12;80929070;80511641;417429;
15.01.2019;06:36:06;80929155;80511769;417386;
15.01.2019;06:37:11;80929254;80511916;417338;
15.01.2019;06:38:11;80929361;80512060;417301;
15.01.2019;06:39:08;80929427;80512176;417251;
15.01.2019;06:40:07;80929527;80512306;417221;
15.01.2019;06:41:05;80929617;80512438;417179;
15.01.2019;06:42:08;80929735;80512599;417136;
15.01.2019;06:43:10;80929823;80512761;417062;
15.01.2019;06:44:11;80929902;80512880;417022;
15.01.2019;06:45:05;80929986;80512987;416999;
15.01.2019;06:46:11;80930086;80513129;416957;
15.01.2019;06:47:06;80930161;80513271;416890;
15.01.2019;06:48:04;80930241;80513393;416848;
15.01.2019;06:49:11;80930327;80513534;416793;
15.01.2019;06:50:05;80930409;80513664;416745;
15.01.2019;06:51:08;80930489;80513796;416693;
15.01.2019;06:52:13;80930597;80513941;416656;
15.01.2019;06:53:06;80930694;80514051;416643;
15.01.2019;06:54:05;80930753;80514185;416568;
15.01.2019;06:55:06;80930856;80514334;416522;
15.01.2019;06:56:09;80930949;80514470;416479;
15.01.2019;06:57:04;80931019;80514602;416417;
15.01.2019;06:58:06;80931107;80514714;416393;
15.01.2019;06:59:04;80931186;80514867;416319;
15.01.2019;07:00:04;80931278;80515015;416263;
15.01.2019;07:01:07;80931358;80515138;416220;
15.01.2019;07:02:05;80931439;80515292;416147;
15.01.2019;07:03:05;80931522;80515446;416076;
15.01.2019;07:04:09;80931611;80515576;416035;
15.01.2019;07:05:05;80931680;80515709;415971;
15.01.2019;07:06:07;80931771;80515839;415932;
15.01.2019;07:07:17;80931839;80515939;415900;
15.01.2019;07:08:06;80931905;80516062;415843;
15.01.2019;07:09:13;80931989;80516220;415769;
15.01.2019;07:10:06;80932066;80516360;415706;
15.01.2019;07:11:05;80932127;80516471;415656;
15.01.2019;07:12:06;80932205;80516613;415592;
15.01.2019;07:13:07;80932290;80516759;415531;
15.01.2019;07:14:06;80932360;80516880;415480;
15.01.2019;07:15:05;80932462;80517011;415451;
15.01.2019;07:16:08;80932555;80517166;415389;
15.01.2019;07:17:07;80932632;80517298;415334;
15.01.2019;07:18:05;80932714;80517432;415282;
15.01.2019;07:19:05;80932777;80517571;415206;
15.01.2019;07:20:10;80932861;80517730;415131;
15.01.2019;07:21:04;80932927;80517852;415075;
15.01.2019;07:22:12;80933009;80518017;414992;
15.01.2019;07:23:07;80933094;80518139;414955;
15.01.2019;07:24:05;80933188;80518250;414938;
15.01.2019;07:25:10;80933276;80518398;414878;
15.01.2019;07:26:07;80933358;80518530;414828;
15.01.2019;07:27:06;80933431;80518640;414791;
15.01.2019;07:28:10;80933499;80518770;414729;
15.01.2019;07:29:05;80933574;80518901;414673;
15.01.2019;07:30:04;80933652;80519054;414598;
15.01.2019;07:31:05;80933718;80519193;414525;
15.01.2019;07:32:05;80933797;80519312;414485;
15.01.2019;07:33:06;80933867;80519417;414450;
15.01.2019;07:34:07;80933956;80519540;414416;
15.01.2019;07:35:04;80934020;80519672;414348;
15.01.2019;07:36:04;80934084;80519798;414286;
15.01.2019;07:37:11;80934165;80519942;414223;
15.01.2019;07:38:12;80934252;80520069;414183;
15.01.2019;07:39:09;80934313;80520184;414129;
15.01.2019;07:40:08;80934393;80520319;414074;
15.01.2019;07:41:06;80934456;80520462;413994;
15.01.2019;07:42:05;80934510;80520562;413948;
15.01.2019;07:43:04;80934579;80520692;413887;
15.01.2019;07:44:05;80934642;80520809;413833;
15.01.2019;07:45:13;80934713;80520932;413781;
15.01.2019;07:46:05;80934773;80521031;413742;
15.01.2019;07:47:07;80934842;80521158;413684;
15.01.2019;07:48:05;80934920;80521265;413655;
15.01.2019;07:49:04;80934987;80521398;413589;
15.01.2019;07:50:05;80935051;80521518;413533;
15.01.2019;07:51:04;80935104;80521644;413460;
15.01.2019;07:52:05;80935194;80521788;413406;
15.01.2019;07:53:05;80935277;80521951;413326;
15.01.2019;07:54:10;80935352;80522079;413273;
15.01.2019;07:55:05;80935444;80522190;413254;
15.01.2019;07:56:05;80935500;80522307;413193;
15.01.2019;07:57:05;80935573;80522448;413125;
15.01.2019;07:58:06;80935651;80522567;413084;
15.01.2019;07:59:07;80935719;80522716;413003;
15.01.2019;08:00:14;80935818;80522874;412944;
15.01.2019;08:01:07;80935873;80522990;412883;
15.01.2019;08:02:05;80935947;80523108;412839;
15.01.2019;08:03:04;80936018;80523249;412769;
15.01.2019;08:04:05;80936112;80523403;412709;
15.01.2019;08:05:07;80936177;80523547;412630;
15.01.2019;08:06:04;80936255;80523657;412598;
15.01.2019;08:07:08;80936342;80523779;412563;
15.01.2019;08:08:12;80936408;80523901;412507;
15.01.2019;08:09:08;80936465;80524021;412444;
15.01.2019;08:10:06;80936530;80524152;412378;
15.01.2019;08:11:10;80936608;80524304;412304;
15.01.2019;08:12:04;80936680;80524393;412287;
15.01.2019;08:13:08;80936700;80524521;412179;
15.01.2019;08:14:07;80936693;80524632;412061;
15.01.2019;08:15:05;80936658;80524741;411917;
15.01.2019;08:16:12;80936629;80524864;411765;
15.01.2019;08:17:05;80936600;80524956;411644;
15.01.2019;08:18:07;80936589;80525065;411524;
15.01.2019;08:19:05;80936587;80525187;411400;
15.01.2019;08:20:07;80936627;80525317;411310;
15.01.2019;08:21:05;80936668;80525448;411220;
15.01.2019;08:22:05;80936736;80525572;411164;
15.01.2019;08:23:06;80936801;80525692;411109;
15.01.2019;08:24:05;80936842;80525814;411028;
15.01.2019;08:25:12;80936916;80525967;410949;
15.01.2019;08:26:06;80936983;80526077;410906;
15.01.2019;08:27:08;80937043;80526210;410833;
15.01.2019;08:28:10;80937100;80526353;410747;
15.01.2019;08:29:07;80937164;80526494;410670;
15.01.2019;08:30:06;80937232;80526634;410598;
15.01.2019;08:31:09;80937309;80526767;410542;
15.01.2019;08:32:04;80937372;80526890;410482;
15.01.2019;08:33:18;80937450;80527037;410413;
15.01.2019;08:34:07;80937502;80527169;410333;
15.01.2019;08:35:04;80937566;80527300;410266;
15.01.2019;08:36:05;80937640;80527440;410200;
15.01.2019;08:37:11;80937728;80527621;410107;
15.01.2019;08:38:07;80937781;80527766;410015;
15.01.2019;08:39:07;80937842;80527914;409928;
15.01.2019;08:40:12;80937915;80528073;409842;
15.01.2019;08:41:13;80937980;80528207;409773;
15.01.2019;08:42:06;80938051;80528332;409719;
15.01.2019;08:43:06;80938115;80528475;409640;
15.01.2019;08:44:06;80938190;80528601;409589;
15.01.2019;08:45:06;80938239;80528730;409509;
15.01.2019;08:46:06;80938313;80528866;409447;
15.01.2019;08:47:05;80938376;80528994;409382;
15.01.2019;08:48:12;80938456;80529149;409307;
15.01.2019;08:49:06;80938530;80529264;409266;
15.01.2019;08:50:06;80938600;80529405;409195;
15.01.2019;08:51:05;80938656;80529531;409125;
15.01.2019;08:52:06;80938734;80529647;409087;
15.01.2019;08:53:13;80938808;80529813;408995;
15.01.2019;08:54:06;80938859;80529928;408931;
15.01.2019;08:55:06;80938941;80530068;408873;
15.01.2019;08:56:05;80939006;80530187;408819;
15.01.2019;08:57:05;80939074;80530299;408775;
15.01.2019;08:58:10;80939162;80530435;408727;
15.01.2019;08:59:07;80939229;80530575;408654;
15.01.2019;09:00:06;80939288;80530725;408563;
15.01.2019;09:01:06;80939347;80530879;408468;
15.01.2019;09:02:05;80939406;80531027;408379;
15.01.2019;09:03:05;80939471;80531183;408288;
15.01.2019;09:04:11;80939536;80531302;408234;
15.01.2019;09:05:05;80939574;80531435;408139;
15.01.2019;09:06:12;80939646;80531583;408063;
15.01.2019;09:07:05;80939707;80531695;408012;
15.01.2019;09:08:06;80939768;80531835;407933;
15.01.2019;09:09:06;80939845;80531979;407866;
15.01.2019;09:10:04;80939899;80532111;407788;
15.01.2019;09:11:07;80939969;80532265;407704;
15.01.2019;09:12:11;80940028;80532419;407609;
15.01.2019;09:13:07;80940104;80532542;407562;
15.01.2019;09:14:12;80940160;80532678;407482;
15.01.2019;09:15:06;80940220;80532782;407438;
15.01.2019;09:16:06;80940291;80532897;407394;
15.01.2019;09:17:11;80940370;80533046;407324;
15.01.2019;09:18:10;80940428;80533161;407267;
15.01.2019;09:19:10;80940497;80533303;407194;
15.01.2019;09:20:06;80940548;80533448;407100;
15.01.2019;09:21:04;80940598;80533565;407033;
15.01.2019;09:22:04;80940666;80533675;406991;
15.01.2019;09:23:04;80940733;80533809;406924;
15.01.2019;09:24:06;80940791;80533954;406837;
15.01.2019;09:25:06;80940849;80534114;406735;
15.01.2019;09:26:05;80940913;80534257;406656;
15.01.2019;09:27:10;80940978;80534397;406581;
15.01.2019;09:28:05;80941053;80534537;406516;
15.01.2019;09:29:11;80941136;80534685;406451;
15.01.2019;09:30:05;80941196;80534834;406362;
15.01.2019;09:31:10;80941259;80534981;406278;
15.01.2019;09:32:07;80941314;80535108;406206;
15.01.2019;09:33:08;80941375;80535248;406127;
15.01.2019;09:34:11;80941438;80535398;406040;
15.01.2019;09:35:11;80941502;80535527;405975;
15.01.2019;09:36:05;80941563;80535645;405918;
15.01.2019;09:37:06;80941620;80535808;405812;
15.01.2019;09:38:06;80941670;80535941;405729;
15.01.2019;09:39:07;80941736;80536057;405679;
15.01.2019;09:40:07;80941791;80536203;405588;
15.01.2019;09:41:04;80941841;80536339;405502;
15.01.2019;09:42:10;80941894;80536479;405415;
15.01.2019;09:43:12;80941974;80536626;405348;
15.01.2019;09:44:11;80942039;80536756;405283;
15.01.2019;09:45:07;80942098;80536902;405196;
15.01.2019;09:46:11;80942166;80537060;405106;
15.01.2019;09:47:05;80942226;80537171;405055;
15.01.2019;09:48:05;80942294;80537300;404994;
15.01.2019;09:49:10;80942380;80537431;404949;
15.01.2019;09:50:04;80942440;80537564;404876;
15.01.2019;09:51:04;80942493;80537684;404809;
15.01.2019;09:52:05;80942525;80537799;404726;
15.01.2019;09:53:05;80942571;80537920;404651;
15.01.2019;09:54:04;80942622;80538054;404568;
15.01.2019;09:55:11;80942688;80538209;404479;
15.01.2019;09:56:06;80942739;80538333;404406;
15.01.2019;09:57:05;80942801;80538454;404347;
15.01.2019;09:58:04;80942862;80538590;404272;
15.01.2019;09:59:06;80942911;80538750;404161;
15.01.2019;10:00:10;80942966;80538897;404069;
15.01.2019;10:01:06;80943027;80539021;404006;
15.01.2019;10:02:09;80943090;80539173;403917;
15.01.2019;10:03:05;80943134;80539303;403831;
15.01.2019;10:04:05;80943190;80539441;403749;
15.01.2019;10:05:13;80943244;80539607;403637;
15.01.2019;10:06:12;80943306;80539756;403550;
15.01.2019;10:07:06;80943356;80539861;403495;
15.01.2019;10:08:06;80943423;80539991;403432;
15.01.2019;10:09:12;80943498;80540113;403385;
15.01.2019;10:10:11;80943548;80540266;403282;
15.01.2019;10:11:10;80943611;80540399;403212;
15.01.2019;10:12:12;80943652;80540551;403101;
15.01.2019;10:13:06;80943713;80540688;403025;
15.01.2019;10:14:10;80943781;80540842;402939;
15.01.2019;10:15:04;80943850;80540983;402867;
15.01.2019;10:16:07;80943916;80541133;402783;
15.01.2019;10:17:06;80943959;80541265;402694;
15.01.2019;10:18:06;80944012;80541425;402587;
15.01.2019;10:19:04;80944056;80541588;402468;
15.01.2019;10:20:06;80944094;80541715;402379;
15.01.2019;10:21:04;80944125;80541834;402291;
15.01.2019;10:22:05;80944179;80541968;402211;
15.01.2019;10:23:05;80944216;80542097;402119;
15.01.2019;10:24:04;80944235;80542203;402032;
15.01.2019;10:25:04;80944248;80542325;401923;
15.01.2019;10:26:05;80944258;80542461;401797;
15.01.2019;10:27:04;80944297;80542581;401716;
15.01.2019;10:28:04;80944347;80542709;401638;
15.01.2019;10:29:05;80944405;80542849;401556;
15.01.2019;10:30:04;80944425;80542989;401436;
15.01.2019;10:31:04;80944464;80543108;401356;
15.01.2019;10:32:05;80944495;80543229;401266;
15.01.2019;10:33:04;80944554;80543346;401208;
15.01.2019;10:34:05;80944601;80543501;401100;
15.01.2019;10:35:05;80944628;80543630;400998;
15.01.2019;10:36:04;80944692;80543775;400917;
15.01.2019;10:37:04;80944750;80543917;400833;
15.01.2019;10:38:05;80944811;80544076;400735;
15.01.2019;10:39:04;80944873;80544242;400631;
15.01.2019;10:40:04;80944941;80544388;400553;
15.01.2019;10:41:06;80945008;80544535;400473;
15.01.2019;10:42:05;80945074;80544645;400429;
15.01.2019;10:43:04;80945140;80544784;400356;
15.01.2019;10:44:04;80945207;80544922;400285;
15.01.2019;10:45:05;80945273;80545080;400193;
15.01.2019;10:46:05;80945327;80545214;400113;
15.01.2019;10:47:04;80945391;80545345;400046;
15.01.2019;10:48:04;80945457;80545488;399969;
15.01.2019;10:49:05;80945538;80545609;399929;
15.01.2019;10:50:04;80945596;80545751;399845;
15.01.2019;10:51:04;80945665;80545864;399801;
15.01.2019;10:52:06;80945730;80546004;399726;
15.01.2019;10:53:04;80945773;80546132;399641;
15.01.2019;10:54:05;80945838;80546264;399574;
15.01.2019;10:55:05;80945890;80546430;399460;
15.01.2019;10:56:04;80945960;80546570;399390;
15.01.2019;10:57:05;80946032;80546712;399320;
15.01.2019;10:58:04;80946112;80546865;399247;
15.01.2019;10:59:04;80946183;80547006;399177;
15.01.2019;11:00:05;80946252;80547145;399107;
15.01.2019;11:01:05;80946328;80547289;399039;
15.01.2019;11:02:04;80946400;80547432;398968;
15.01.2019;11:03:04;80946471;80547564;398907;
15.01.2019;11:04:05;80946533;80547694;398839;
15.01.2019;11:05:04;80946591;80547827;398764;
15.01.2019;11:06:04;80946658;80547953;398705;
15.01.2019;11:07:05;80946728;80548088;398640;
15.01.2019;11:08:04;80946785;80548221;398564;
15.01.2019;11:09:06;80946836;80548344;398492;
15.01.2019;11:10:05;80946892;80548477;398415;
15.01.2019;11:11:04;80946958;80548609;398349;
15.01.2019;11:12:05;80947026;80548730;398296;
15.01.2019;11:13:04;80947090;80548865;398225;
15.01.2019;11:14:04;80947163;80549005;398158;
15.01.2019;11:15:05;80947243;80549153;398090;
15.01.2019;11:16:04;80947301;80549309;397992;
15.01.2019;11:17:04;80947386;80549463;397923;
15.01.2019;11:18:05;80947466;80549575;397891;
15.01.2019;11:19:05;80947537;80549697;397840;
15.01.2019;11:20:04;80947608;80549819;397789;
15.01.2019;11:21:04;80947663;80549986;397677;
15.01.2019;11:22:05;80947722;80550134;397588;
15.01.2019;11:23:04;80947778;80550281;397497;
15.01.2019;11:24:04;80947829;80550420;397409;
15.01.2019;11:25:05;80947896;80550519;397377;
15.01.2019;11:26:04;80947946;80550639;397307;
15.01.2019;11:27:04;80948015;80550762;397253;
15.01.2019;11:28:05;80948071;80550911;397160;
15.01.2019;11:29:04;80948137;80551055;397082;
15.01.2019;11:30:04;80948201;80551210;396991;
15.01.2019;11:31:04;80948260;80551339;396921;
15.01.2019;11:32:05;80948321;80551475;396846;
15.01.2019;11:33:05;80948379;80551631;396748;
15.01.2019;11:34:04;80948455;80551776;396679;
15.01.2019;11:35:04;80948528;80551931;396597;
15.01.2019;11:36:05;80948587;80552054;396533;
15.01.2019;11:37:04;80948667;80552181;396486;
15.01.2019;11:38:04;80948727;80552311;396416;
15.01.2019;11:39:07;80948793;80552454;396339;
15.01.2019;11:40:04;80948850;80552588;396262;
15.01.2019;11:41:04;80948900;80552720;396180;
15.01.2019;11:42:05;80948961;80552872;396089;
15.01.2019;11:43:04;80949004;80552978;396026;
15.01.2019;11:44:04;80949055;80553110;395945;
15.01.2019;11:45:05;80949118;80553238;395880;
15.01.2019;11:46:05;80949191;80553369;395822;
15.01.2019;11:47:04;80949255;80553500;395755;
15.01.2019;11:48:04;80949327;80553654;395673;
15.01.2019;11:49:05;80949398;80553761;395637;
15.01.2019;11:50:05;80949492;80553895;395597;
15.01.2019;11:51:05;80949561;80554027;395534;
15.01.2019;11:52:04;80949633;80554147;395486;
15.01.2019;11:53:04;80949700;80554290;395410;
15.01.2019;11:54:05;80949758;80554420;395338;
15.01.2019;11:55:05;80949842;80554549;395293;
15.01.2019;11:56:04;80949904;80554661;395243;
15.01.2019;11:57:04;80949993;80554793;395200;
15.01.2019;11:58:04;80950061;80554903;395158;
15.01.2019;11:59:05;80950130;80555040;395090;
15.01.2019;12:00:04;80950222;80555172;395050;
15.01.2019;12:01:04;80950285;80555314;394971;
15.01.2019;12:02:05;80950344;80555461;394883;
15.01.2019;12:03:04;80950403;80555604;394799;
15.01.2019;12:04:05;80950473;80555753;394720;
15.01.2019;12:05:05;80950529;80555875;394654;
15.01.2019;12:06:05;80950608;80555976;394632;
15.01.2019;12:07:04;80950671;80556147;394524;
15.01.2019;12:08:04;80950746;80556299;394447;
15.01.2019;12:09:05;80950835;80556431;394404;
15.01.2019;12:10:05;80950899;80556566;394333;
15.01.2019;12:11:04;80950961;80556700;394261;
15.01.2019;12:12:04;80950960;80556775;394185;
15.01.2019;12:13:04;80950961;80556864;394097;
15.01.2019;12:14:05;80950938;80556956;393982;
15.01.2019;12:15:05;80950917;80557054;393863;
15.01.2019;12:16:04;80950911;80557163;393748;
15.01.2019;12:17:04;80950981;80557271;393710;
15.01.2019;12:18:04;80951059;80557385;393674;
15.01.2019;12:19:05;80951134;80557518;393616;
15.01.2019;12:20:05;80951207;80557673;393534;
15.01.2019;12:21:05;80951266;80557777;393489;
15.01.2019;12:22:04;80951340;80557909;393431;
15.01.2019;12:23:04;80951400;80558063;393337;
15.01.2019;12:24:05;80951488;80558197;393291;
15.01.2019;12:25:05;80951575;80558318;393257;
15.01.2019;12:26:05;80951646;80558458;393188;
15.01.2019;12:27:04;80951722;80558598;393124;
15.01.2019;12:28:04;80951807;80558721;393086;
15.01.2019;12:29:05;80951881;80558868;393013;
15.01.2019;12:30:05;80951952;80559000;392952;
15.01.2019;12:31:04;80952025;80559135;392890;
15.01.2019;12:32:04;80952111;80559266;392845;
15.01.2019;12:33:05;80952189;80559383;392806;
15.01.2019;12:34:04;80952276;80559522;392754;
15.01.2019;12:35:04;80952349;80559644;392705;
15.01.2019;12:36:05;80952414;80559806;392608;
15.01.2019;12:37:05;80952484;80559942;392542;
15.01.2019;12:38:05;80952546;80560070;392476;
15.01.2019;12:39:06;80952611;80560199;392412;
15.01.2019;12:40:04;80952680;80560327;392353;
15.01.2019;12:41:05;80952741;80560450;392291;
15.01.2019;12:42:05;80952831;80560584;392247;
15.01.2019;12:43:05;80952928;80560737;392191;
15.01.2019;12:44:04;80953001;80560873;392128;
15.01.2019;12:45:05;80953073;80561033;392040;
15.01.2019;12:46:07;80953148;80561159;391989;
15.01.2019;12:47:09;80953226;80561327;391899;
15.01.2019;12:48:10;80953306;80561478;391828;
15.01.2019;12:49:06;80953371;80561619;391752;
15.01.2019;12:50:05;80953444;80561752;391692;
15.01.2019;12:51:04;80953517;80561902;391615;
15.01.2019;12:52:04;80953583;80562023;391560;
15.01.2019;12:53:05;80953673;80562157;391516;
15.01.2019;12:54:06;80953755;80562292;391463;
15.01.2019;12:55:11;80953433;80562095;391338;
15.01.2019;12:56:05;80953438;80562195;391243;
15.01.2019;12:57:05;80953447;80562274;391173;
15.01.2019;12:58:06;80953501;80562412;391089;
15.01.2019;12:59:05;80953589;80562562;391027;
15.01.2019;13:00:04;80953655;80562705;390950;
15.01.2019;13:01:05;80953726;80562838;390888;
15.01.2019;13:02:09;80953808;80562997;390811;
15.01.2019;13:03:05;80953876;80563129;390747;
15.01.2019;13:04:05;80953947;80563259;390688;
15.01.2019;13:05:06;80954017;80563405;390612;
15.01.2019;13:06:07;80954108;80563551;390557;
15.01.2019;13:07:05;80954179;80563685;390494;
15.01.2019;13:08:05;80954242;80563834;390408;
15.01.2019;13:09:07;80954319;80563991;390328;
15.01.2019;13:10:06;80954391;80564131;390260;
15.01.2019;13:11:04;80954485;80564278;390207;
15.01.2019;13:12:05;80954547;80564435;390112;
15.01.2019;13:13:04;80954643;80564577;390066;
15.01.2019;13:14:05;80954728;80564718;390010;
15.01.2019;13:15:05;80954792;80564856;389936;
15.01.2019;13:16:05;80954886;80565007;389879;
15.01.2019;13:17:07;80954954;80565159;389795;
15.01.2019;13:18:06;80955025;80565294;389731;
15.01.2019;13:19:06;80955111;80565480;389631;
15.01.2019;13:20:04;80955187;80565632;389555;
15.01.2019;13:21:06;80955273;80565761;389512;
15.01.2019;13:22:04;80955362;80565906;389456;
15.01.2019;13:23:04;80955451;80566065;389386;
15.01.2019;13:24:05;80955528;80566235;389293;
15.01.2019;13:25:06;80955616;80566375;389241;
15.01.2019;13:26:04;80955692;80566500;389192;
15.01.2019;13:27:08;80955797;80566639;389158;
15.01.2019;13:28:09;80955888;80566769;389119;
15.01.2019;13:29:04;80955982;80566907;389075;
15.01.2019;13:30:05;80956054;80567082;388972;
15.01.2019;13:31:05;80956137;80567225;388912;
15.01.2019;13:32:05;80956213;80567353;388860;
15.01.2019;13:33:05;80956299;80567488;388811;
15.01.2019;13:34:05;80956387;80567594;388793;
15.01.2019;13:35:05;80956469;80567714;388755;
15.01.2019;13:36:04;80956553;80567825;388728;
15.01.2019;13:37:05;80956652;80567915;388737;
15.01.2019;13:38:12;80956752;80568054;388698;
15.01.2019;13:39:07;80956842;80568172;388670;
15.01.2019;13:40:06;80956935;80568305;388630;
15.01.2019;13:41:04;80957047;80568437;388610;
15.01.2019;13:42:04;80957134;80568568;388566;
15.01.2019;13:43:06;80957249;80568722;388527;
15.01.2019;13:44:06;80957342;80568863;388479;
15.01.2019;13:45:04;80957447;80568986;388461;
15.01.2019;13:46:05;80957533;80569119;388414;
15.01.2019;13:47:05;80957632;80569258;388374;
15.01.2019;13:48:05;80957738;80569396;388342;
15.01.2019;13:49:04;80957830;80569524;388306;
15.01.2019;13:50:05;80957923;80569674;388249;
15.01.2019;13:51:05;80957999;80569799;388200;
15.01.2019;13:52:06;80958081;80569909;388172;
15.01.2019;13:53:04;80958164;80570026;388138;
15.01.2019;13:54:05;80958262;80570190;388072;
15.01.2019;13:55:06;80958337;80570310;388027;
15.01.2019;13:56:05;80958430;80570439;387991;
15.01.2019;13:57:12;80958545;80570594;387951;
15.01.2019;13:58:11;80958654;80570751;387903;
15.01.2019;13:59:05;80958737;80570883;387854;
15.01.2019;14:00:05;80958831;80571032;387799;
15.01.2019;14:01:06;80958950;80571168;387782;
15.01.2019;14:02:05;80959027;80571335;387692;
15.01.2019;14:03:05;80959130;80571483;387647;
15.01.2019;14:04:04;80959212;80571623;387589;
15.01.2019;14:05:04;80959304;80571769;387535;
15.01.2019;14:06:05;80959399;80571906;387493;
15.01.2019;14:07:05;80959502;80572054;387448;
15.01.2019;14:08:05;80959606;80572193;387413;
15.01.2019;14:09:13;80959698;80572375;387323;
15.01.2019;14:10:07;80959782;80572512;387270;
15.01.2019;14:11:06;80959889;80572673;387216;
15.01.2019;14:12:05;80960008;80572812;387196;
15.01.2019;14:13:04;80960094;80572987;387107;
15.01.2019;14:14:10;80960186;80573127;387059;
15.01.2019;14:15:04;80960246;80573227;387019;
15.01.2019;14:16:05;80960273;80573334;386939;
15.01.2019;14:17:06;80960331;80573416;386915;
15.01.2019;14:18:04;80960367;80573561;386806;
15.01.2019;14:19:10;80960423;80573699;386724;
15.01.2019;14:20:06;80960502;80573807;386695;
15.01.2019;14:21:06;80960570;80573897;386673;
15.01.2019;14:22:09;80960648;80574001;386647;
15.01.2019;14:23:07;80960705;80574110;386595;
15.01.2019;14:24:11;80960772;80574227;386545;
15.01.2019;14:25:05;80960876;80574339;386537;
15.01.2019;14:26:11;80961000;80574498;386502;
15.01.2019;14:27:07;80961067;80574611;386456;
15.01.2019;14:28:05;80961183;80574748;386435;
15.01.2019;14:29:04;80961265;80574900;386365;
15.01.2019;14:30:05;80961370;80575034;386336;
15.01.2019;14:31:05;80961479;80575167;386312;
15.01.2019;14:32:07;80961582;80575316;386266;
15.01.2019;14:33:07;80961679;80575457;386222;
15.01.2019;14:34:09;80961773;80575565;386208;
15.01.2019;14:35:05;80961877;80575709;386168;
15.01.2019;14:36:05;80961956;80575860;386096;
15.01.2019;14:37:06;80962071;80575990;386081;
15.01.2019;14:38:04;80962164;80576111;386053;
15.01.2019;14:39:05;80962250;80576244;386006;
15.01.2019;14:40:10;80962355;80576410;385945;
15.01.2019;14:41:07;80962457;80576571;385886;
15.01.2019;14:42:04;80962574;80576696;385878;
15.01.2019;14:43:05;80962661;80576837;385824;
15.01.2019;14:44:05;80962745;80576998;385747;
15.01.2019;14:45:11;80962859;80577180;385679;
15.01.2019;14:46:06;80962934;80577318;385616;
15.01.2019;14:47:05;80963040;80577455;385585;
15.01.2019;14:48:05;80963143;80577612;385531;
15.01.2019;14:49:09;80963245;80577757;385488;
15.01.2019;14:50:04;80963335;80577880;385455;
15.01.2019;14:51:06;80963439;80578027;385412;
15.01.2019;14:52:06;80963546;80578174;385372;
15.01.2019;14:53:05;80963648;80578313;385335;
15.01.2019;14:54:05;80963768;80578446;385322;
15.01.2019;14:55:06;80963862;80578607;385255;
15.01.2019;14:56:05;80963977;80578781;385196;
15.01.2019;14:57:04;80964082;80578932;385150;
15.01.2019;14:58:06;80964194;80579081;385113;
15.01.2019;14:59:05;80964295;80579210;385085;
15.01.2019;15:00:09;80964405;80579403;385002;
15.01.2019;15:01:07;80964492;80579551;384941;
15.01.2019;15:02:09;80964615;80579692;384923;
15.01.2019;15:03:07;80964706;80579833;384873;
15.01.2019;15:04:09;80964818;80580003;384815;
15.01.2019;15:05:07;80964909;80580126;384783;
15.01.2019;15:06:14;80965002;80580312;384690;
15.01.2019;15:07:07;80965099;80580449;384650;
15.01.2019;15:08:08;80965201;80580599;384602;
15.01.2019;15:09:09;80965320;80580739;384581;
15.01.2019;15:10:10;80965442;80580929;384513;
15.01.2019;15:11:08;80965539;80581029;384510;
15.01.2019;15:12:09;80965651;80581163;384488;
15.01.2019;15:13:09;80965763;80581317;384446;
15.01.2019;15:14:08;80965872;80581451;384421;
15.01.2019;15:15:09;80965987;80581615;384372;
15.01.2019;15:16:08;80966103;80581782;384321;
15.01.2019;15:17:08;80966215;80581905;384310;
15.01.2019;15:18:07;80966306;80582066;384240;
15.01.2019;15:19:09;80966400;80582220;384180;
15.01.2019;15:20:08;80966483;80582339;384144;
15.01.2019;15:21:09;80966592;80582466;384126;
15.01.2019;15:22:09;80966726;80582639;384087;
15.01.2019;15:23:07;80966850;80582775;384075;
15.01.2019;15:24:08;80966957;80582931;384026;
15.01.2019;15:25:09;80967069;80583081;383988;
15.01.2019;15:26:08;80967165;80583259;383906;
15.01.2019;15:27:08;80967281;80583402;383879;
15.01.2019;15:28:07;80967384;80583570;383814;
15.01.2019;15:29:13;80967481;80583743;383738;
15.01.2019;15:30:09;80967592;80583889;383703;
15.01.2019;15:31:13;80967698;80584045;383653;
15.01.2019;15:32:08;80967800;80584182;383618;
15.01.2019;15:33:08;80967917;80584334;383583;
15.01.2019;15:34:13;80968028;80584506;383522;
15.01.2019;15:35:09;80968143;80584645;383498;
15.01.2019;15:36:07;80968253;80584798;383455;
15.01.2019;15:37:09;80968377;80584963;383414;
15.01.2019;15:38:08;80968470;80585119;383351;
15.01.2019;15:39:08;80968563;80585290;383273;
15.01.2019;15:40:08;80968687;80585438;383249;
15.01.2019;15:41:08;80968810;80585588;383222;
15.01.2019;15:42:09;80968905;80585732;383173;
15.01.2019;15:43:07;80969007;80585905;383102;
15.01.2019;15:44:08;80969096;80586044;383052;
15.01.2019;15:45:08;80969185;80586223;382962;
15.01.2019;15:46:08;80969285;80586362;382923;
15.01.2019;15:47:15;80969416;80586532;382884;
15.01.2019;15:48:09;80969536;80586677;382859;
15.01.2019;15:49:08;80969632;80586843;382789;
15.01.2019;15:50:08;80969733;80586973;382760;
15.01.2019;15:51:08;80969830;80587133;382697;
15.01.2019;15:52:08;80969933;80587295;382638;
15.01.2019;15:53:08;80970029;80587461;382568;
15.01.2019;15:54:08;80970135;80587622;382513;
15.01.2019;15:55:08;80970267;80587785;382482;
15.01.2019;15:56:07;80970383;80587934;382449;
15.01.2019;15:57:07;80970484;80588064;382420;
15.01.2019;15:58:07;80970570;80588224;382346;
15.01.2019;15:59:07;80970684;80588369;382315;
15.01.2019;16:00:06;80970775;80588499;382276;
15.01.2019;16:01:04;80970872;80588660;382212;
15.01.2019;16:02:04;80970968;80588823;382145;
15.01.2019;16:03:04;80971061;80588990;382071;
15.01.2019;16:04:05;80971177;80589157;382020;
15.01.2019;16:05:04;80971286;80589336;381950;
15.01.2019;16:06:04;80971395;80589477;381918;
15.01.2019;16:07:05;80971500;80589622;381878;
15.01.2019;16:08:06;80971594;80589781;381813;
15.01.2019;16:09:07;80971714;80589977;381737;
15.01.2019;17:13:05;80977875;80599764;378111;
15.01.2019;17:14:05;80977988;80599933;378055;
15.01.2019;17:15:06;80978098;80600099;377999;
15.01.2019;17:16:05;80978213;80600254;377959;
15.01.2019;17:17:05;80978316;80600433;377883;
15.01.2019;17:18:04;80978425;80600592;377833;
15.01.2019;17:19:04;80978539;80600753;377786;
15.01.2019;17:20:05;80978667;80600922;377745;
15.01.2019;17:21:05;80978777;80601050;377727;
15.01.2019;17:22:05;80978903;80601195;377708;
15.01.2019;17:23:04;80979023;80601355;377668;
15.01.2019;17:24:04;80979150;80601499;377651;
15.01.2019;17:25:05;80979260;80601641;377619;
15.01.2019;17:26:05;80979379;80601798;377581;
15.01.2019;17:27:05;80979488;80601968;377520;
15.01.2019;17:34:10;80980252;80602990;377262;
15.01.2019;17:35:04;80980353;80603126;377227;
15.01.2019;17:36:10;80980456;80603274;377182;
15.01.2019;17:37:05;80980567;80603406;377161;
15.01.2019;17:38:05;80980653;80603546;377107;
15.01.2019;17:39:05;80980782;80603684;377098;
15.01.2019;17:40:05;80980890;80603840;377050;
15.01.2019;17:41:04;80980999;80603971;377028;
15.01.2019;17:42:05;80981117;80604088;377029;
15.01.2019;17:43:05;80981235;80604238;376997;
15.01.2019;17:44:05;80981315;80604364;376951;
15.01.2019;17:45:05;80981406;80604495;376911;
15.01.2019;17:46:05;80981517;80604617;376900;
15.01.2019;17:47:05;80981616;80604724;376892;
15.01.2019;17:48:04;80981724;80604877;376847;
15.01.2019;17:49:04;80981829;80605025;376804;
15.01.2019;17:50:04;80981951;80605189;376762;
15.01.2019;17:51:04;80982067;80605330;376737;
15.01.2019;17:52:05;80982168;80605484;376684;
15.01.2019;17:53:05;80982287;80605607;376680;
15.01.2019;17:54:05;80982374;80605766;376608;
15.01.2019;17:55:05;80982498;80605897;376601;
15.01.2019;17:56:04;80982601;80606029;376572;
15.01.2019;17:57:04;80982711;80606164;376547;
15.01.2019;17:58:05;80982826;80606297;376529;
15.01.2019;17:59:05;80982943;80606432;376511;
15.01.2019;18:00:06;80983055;80606586;376469;
15.01.2019;18:01:05;80983181;80606734;376447;
15.01.2019;18:02:04;80983287;80606842;376445;
15.01.2019;18:03:06;80983427;80606976;376451;
15.01.2019;18:04:04;80983576;80607120;376456;
15.01.2019;18:06:05;80983808;80607404;376404;
15.01.2019;18:07:05;80983915;80607521;376394;
15.01.2019;18:08:05;80984030;80607631;376399;
15.01.2019;18:09:06;80984125;80607766;376359;
15.01.2019;18:10:04;80984231;80607881;376350;
15.01.2019;18:11:04;80984369;80608031;376338;
15.01.2019;18:12:05;80984501;80608158;376343;
15.01.2019;18:13:05;80984604;80608272;376332;
15.01.2019;18:14:05;80984730;80608381;376349;
15.01.2019;18:15:05;80984840;80608515;376325;
15.01.2019;18:16:05;80984957;80608635;376322;
15.01.2019;18:17:05;80985089;80608771;376318;
15.01.2019;18:18:04;80985205;80608905;376300;
15.01.2019;18:19:04;80985265;80609019;376246;
15.01.2019;18:20:04;80985324;80609135;376189;
15.01.2019;18:22:05;80985372;80609265;376107;
15.01.2019;18:23:05;80985418;80609365;376053;
15.01.2019;18:24:04;80985480;80609456;376024;
15.01.2019;18:25:04;80985552;80609582;375970;
15.01.2019;18:26:04;80985628;80609695;375933;
15.01.2019;18:27:05;80985703;80609824;375879;
15.01.2019;18:28:05;80985798;80609908;375890;
15.01.2019;18:29:05;80985896;80609981;375915;
15.01.2019;18:30:05;80985979;80610108;375871;
15.01.2019;18:31:05;80986056;80610219;375837;
15.01.2019;18:32:05;80986093;80610329;375764;
15.01.2019;18:33:05;80986104;80610450;375654;
15.01.2019;18:34:12;80986189;80610623;375566;
15.01.2019;18:35:14;80986260;80610725;375535;
15.01.2019;18:36:12;80986321;80610827;375494;
15.01.2019;18:37:13;80986434;80610950;375484;
15.01.2019;18:38:19;80986551;80611061;375490;
15.01.2019;18:39:18;80986611;80611182;375429;
15.01.2019;18:40:14;80986621;80611220;375401;
15.01.2019;18:41:18;80986690;80611341;375349;
15.01.2019;18:42:11;80986770;80611449;375321;
15.01.2019;18:43:14;80986866;80611557;375309;
15.01.2019;18:44:14;80986952;80611644;375308;
15.01.2019;18:45:16;80987036;80611747;375289;
15.01.2019;18:46:15;80987120;80611880;375240;
15.01.2019;18:47:11;80987213;80611990;375223;
15.01.2019;18:48:08;80987293;80612101;375192;
15.01.2019;18:49:12;80987380;80612229;375151;
15.01.2019;18:50:06;80987463;80612319;375144;
15.01.2019;18:51:08;80987560;80612426;375134;
15.01.2019;18:52:12;80987657;80612558;375099;
15.01.2019;18:53:18;80987769;80612667;375102;
15.01.2019;18:54:12;80987837;80612737;375100;
15.01.2019;18:55:11;80987944;80612845;375099;
15.01.2019;18:56:19;80988034;80612953;375081;
15.01.2019;18:57:05;80988124;80613055;375069;
15.01.2019;18:58:13;80988241;80613172;375069;
15.01.2019;18:59:12;80988338;80613267;375071;
15.01.2019;19:00:16;80988428;80613388;375040;
15.01.2019;19:01:21;80988504;80613492;375012;
15.01.2019;19:02:17;80988613;80613587;375026;
15.01.2019;19:03:10;80988696;80613694;375002;
15.01.2019;19:04:12;80988818;80613785;375033;
15.01.2019;19:05:17;80988916;80613915;375001;
15.01.2019;19:06:11;80988994;80614017;374977;
15.01.2019;19:07:17;80989111;80614107;375004;
15.01.2019;19:08:09;80989189;80614220;374969;
15.01.2019;19:09:07;80989275;80614315;374960;
15.01.2019;19:10:12;80989382;80614414;374968;
15.01.2019;19:11:13;80989471;80614497;374974;
15.01.2019;19:12:13;80989565;80614585;374980;
15.01.2019;19:13:16;80989671;80614705;374966;
15.01.2019;19:14:04;80989755;80614795;374960;
15.01.2019;19:15:09;80989874;80614872;375002;
15.01.2019;19:16:13;80989984;80614977;375007;
15.01.2019;19:17:13;80990090;80615079;375011;
15.01.2019;19:18:16;80990185;80615164;375021;
15.01.2019;19:19:13;80990287;80615243;375044;
15.01.2019;19:20:06;80990369;80615321;375048;
15.01.2019;19:21:18;80990496;80615422;375074;
15.01.2019;19:23:11;80990669;80615568;375101;
15.01.2019;19:24:15;80990784;80615667;375117;
15.01.2019;19:26:10;80990985;80615840;375145;
15.01.2019;19:27:05;80991076;80615914;375162;
15.01.2019;19:28:05;80991172;80616001;375171;
15.01.2019;19:29:05;80991276;80616075;375201;
15.01.2019;19:30:05;80991390;80616165;375225;
15.01.2019;19:31:05;80991514;80616236;375278;
15.01.2019;19:32:05;80991619;80616331;375288;
15.01.2019;19:33:05;80991713;80616415;375298;
15.01.2019;19:34:05;80991831;80616527;375304;
15.01.2019;19:35:09;80991959;80616619;375340;
15.01.2019;19:36:05;80992072;80616712;375360;
15.01.2019;19:37:05;80992183;80616768;375415;
15.01.2019;19:38:05;80992279;80616821;375458;
15.01.2019;19:39:07;80992395;80616908;375487;
15.01.2019;19:40:05;80992512;80616976;375536;
15.01.2019;19:41:05;80992630;80617056;375574;
15.01.2019;19:42:04;80992735;80617131;375604;
15.01.2019;19:43:04;80992820;80617215;375605;
15.01.2019;19:44:04;80992935;80617290;375645;
15.01.2019;19:45:04;80993033;80617350;375683;
15.01.2019;19:46:06;80993137;80617424;375713;
15.01.2019;19:47:11;80993239;80617506;375733;
15.01.2019;19:48:06;80993340;80617565;375775;
15.01.2019;19:49:05;80993443;80617635;375808;
15.01.2019;19:50:07;80993553;80617717;375836;
15.01.2019;19:51:05;80993656;80617785;375871;
15.01.2019;19:52:05;80993755;80617845;375910;
15.01.2019;19:53:05;80993861;80617931;375930;
15.01.2019;19:54:05;80993966;80617981;375985;
15.01.2019;19:55:05;80994053;80618050;376003;
15.01.2019;19:56:10;80994161;80618118;376043;
15.01.2019;19:57:05;80994253;80618189;376064;
15.01.2019;19:58:05;80994332;80618243;376089;
15.01.2019;19:59:08;80994459;80618312;376147;
15.01.2019;20:00:05;80994562;80618385;376177;
15.01.2019;20:01:05;80994683;80618463;376220;
15.01.2019;20:02:05;80994784;80618551;376233;
15.01.2019;20:03:05;80994912;80618605;376307;
15.01.2019;20:04:05;80995036;80618669;376367;
15.01.2019;20:05:05;80995163;80618741;376422;
15.01.2019;20:06:05;80995276;80618803;376473;
15.01.2019;20:07:05;80995383;80618883;376500;
15.01.2019;20:08:05;80995491;80618930;376561;
15.01.2019;20:09:07;80995598;80618989;376609;
15.01.2019;20:10:05;80995721;80619053;376668;
15.01.2019;20:11:06;80995824;80619129;376695;
15.01.2019;20:12:08;80995953;80619186;376767;
15.01.2019;20:13:06;80996055;80619240;376815;
15.01.2019;20:14:05;80996157;80619319;376838;
15.01.2019;20:15:05;80996260;80619381;376879;
15.01.2019;20:16:05;80996343;80619447;376896;
15.01.2019;20:17:06;80996422;80619510;376912;
15.01.2019;20:18:05;80996496;80619538;376958;
15.01.2019;20:20:04;80996586;80619628;376958;
15.01.2019;20:22:05;80998098;80625697;372401;
15.01.2019;20:23:05;80998191;80625737;372454;
15.01.2019;20:24:07;80998276;80625787;372489;
15.01.2019;20:25:05;80998333;80625831;372502;
15.01.2019;20:26:05;80998432;80625866;372566;
15.01.2019;20:27:05;80998532;80625898;372634;
15.01.2019;20:28:04;80998596;80625946;372650;
15.01.2019;20:29:05;80998685;80625967;372718;
15.01.2019;20:30:05;80998761;80626009;372752;
15.01.2019;20:31:05;80998887;80626041;372846;
15.01.2019;20:32:04;80999010;80626086;372924;
15.01.2019;20:33:04;80999124;80626139;372985;
15.01.2019;20:34:04;80999234;80626191;373043;
15.01.2019;20:35:04;80999337;80626242;373095;
15.01.2019;20:36:07;80999457;80626273;373184;
15.01.2019;20:37:05;80999585;80626323;373262;
15.01.2019;20:38:04;80999667;80626369;373298;
15.01.2019;20:39:07;80999811;80626422;373389;
15.01.2019;20:40:05;80999928;80626471;373457;
15.01.2019;20:41:09;81000127;80626525;373602;
15.01.2019;20:42:05;81000258;80626562;373696;
15.01.2019;20:43:04;81000367;80626620;373747;
15.01.2019;20:44:04;81000458;80626667;373791;
15.01.2019;20:45:05;81000544;80626723;373821;
15.01.2019;20:46:05;81000663;80626775;373888;
15.01.2019;20:47:05;81000803;80626835;373968;
15.01.2019;20:48:06;81000913;80626910;374003;
15.01.2019;20:49:05;81001018;80626965;374053;
15.01.2019;20:50:05;81001137;80627019;374118;
15.01.2019;20:51:05;81001234;80627070;374164;
15.01.2019;20:52:05;81001346;80627134;374212;
15.01.2019;20:53:05;81001455;80627193;374262;
15.01.2019;20:54:05;81001565;80627261;374304;
15.01.2019;20:55:07;81001667;80627318;374349;
15.01.2019;20:56:04;81001761;80627356;374405;
15.01.2019;20:57:04;81001894;80627410;374484;
15.01.2019;20:58:05;81002045;80627463;374582;
15.01.2019;20:59:05;81002146;80627529;374617;
15.01.2019;21:00:06;81002275;80627593;374682;
15.01.2019;21:01:05;81002377;80627643;374734;
15.01.2019;21:02:06;81002479;80627690;374789;
15.01.2019;21:03:05;81002572;80627736;374836;
15.01.2019;21:04:06;81002676;80627783;374893;
15.01.2019;21:05:05;81002784;80627840;374944;
15.01.2019;21:06:06;81002893;80627883;375010;
15.01.2019;21:07:05;81002987;80627926;375061;
15.01.2019;21:08:06;81003110;80627966;375144;
15.01.2019;21:09:06;81003207;80628002;375205;
15.01.2019;21:10:04;81003311;80628034;375277;
15.01.2019;21:11:05;81003419;80628080;375339;
15.01.2019;21:12:05;81003527;80628130;375397;
15.01.2019;21:13:07;81003645;80628169;375476;
15.01.2019;21:14:05;81003734;80628212;375522;
15.01.2019;21:15:05;81003825;80628249;375576;
15.01.2019;21:16:06;81003930;80628294;375636;
15.01.2019;21:17:05;81004037;80628339;375698;
15.01.2019;21:18:04;81004144;80628373;375771;
15.01.2019;21:19:13;81004255;80628421;375834;
15.01.2019;21:20:06;81004343;80628454;375889;
15.01.2019;21:21:05;81004449;80628498;375951;
15.01.2019;21:22:05;81004562;80628549;376013;
15.01.2019;21:24:05;81004777;80628631;376146;
15.01.2019;21:25:08;81004898;80628681;376217;
15.01.2019;21:26:10;81005018;80628729;376289;
15.01.2019;21:27:05;81005136;80628764;376372;
15.01.2019;21:28:06;81005227;80628807;376420;
15.01.2019;21:29:05;81005320;80628837;376483;
15.01.2019;21:30:06;81005428;80628880;376548;
15.01.2019;21:31:05;81005527;80628923;376604;
15.01.2019;21:32:05;81005629;80628957;376672;
15.01.2019;21:33:05;81005735;80628998;376737;
15.01.2019;21:34:05;81005833;80629020;376813;
15.01.2019;21:35:10;81005951;80629058;376893;
15.01.2019;21:36:05;81006045;80629082;376963;
15.01.2019;21:37:07;81006124;80629115;377009;
15.01.2019;21:38:04;81006223;80629140;377083;
15.01.2019;21:39:06;81006333;80629173;377160;
15.01.2019;21:40:05;81006426;80629212;377214;
15.01.2019;21:41:05;81006531;80629246;377285;
15.01.2019;21:42:05;81006627;80629284;377343;
15.01.2019;21:43:06;81006728;80629326;377402;
15.01.2019;21:44:06;81006839;80629358;377481;
15.01.2019;21:45:05;81006940;80629387;377553;
15.01.2019;21:46:05;81007021;80629423;377598;
15.01.2019;21:47:06;81007136;80629460;377676;
15.01.2019;21:48:05;81007256;80629502;377754;
15.01.2019;21:49:09;81007383;80629535;377848;
15.01.2019;21:50:05;81007503;80629567;377936;
15.01.2019;21:51:05;81007591;80629593;377998;
15.01.2019;21:52:06;81007700;80629636;378064;
15.01.2019;21:53:05;81007802;80629669;378133;
15.01.2019;21:54:06;81007907;80629706;378201;
15.01.2019;21:55:05;81008019;80629743;378276;
15.01.2019;21:56:07;81008095;80629772;378323;
15.01.2019;21:57:06;81008189;80629812;378377;
15.01.2019;21:58:06;81008290;80629844;378446;
15.01.2019;21:59:06;81008383;80629865;378518;
15.01.2019;22:00:11;81008492;80629907;378585;
15.01.2019;22:01:07;81008593;80629940;378653;
15.01.2019;22:02:06;81008721;80629960;378761;
15.01.2019;22:03:12;81008821;80629994;378827;
15.01.2019;22:04:07;81008905;80630040;378865;
15.01.2019;22:05:05;81009007;80630067;378940;
15.01.2019;22:06:05;81009130;80630112;379018;
15.01.2019;22:07:04;81009240;80630146;379094;
15.01.2019;22:08:06;81009331;80630179;379152;
15.01.2019;22:09:12;81009440;80630209;379231;
15.01.2019;22:10:06;81009547;80630245;379302;
15.01.2019;22:11:07;81009654;80630277;379377;
15.01.2019;22:12:05;81009773;80630307;379466;
15.01.2019;22:13:05;81009856;80630335;379521;
15.01.2019;22:14:05;81009945;80630365;379580;
15.01.2019;22:15:06;81010061;80630403;379658;
15.01.2019;22:16:05;81010162;80630438;379724;
15.01.2019;22:17:05;81010279;80630475;379804;
15.01.2019;22:18:06;81010385;80630494;379891;
15.01.2019;22:19:05;81010468;80630520;379948;
15.01.2019;22:20:06;81010511;80630539;379972;
15.01.2019;22:21:05;81010608;80630573;380035;
15.01.2019;22:22:05;81010648;80630599;380049;
15.01.2019;22:23:05;81010687;80630598;380089;
15.01.2019;22:24:06;81010748;80630593;380155;
15.01.2019;22:25:05;81010788;80630604;380184;
15.01.2019;22:26:05;81010845;80630629;380216;
15.01.2019;22:27:07;81010906;80630638;380268;
15.01.2019;22:28:08;81010967;80630660;380307;
15.01.2019;22:29:06;81011046;80630670;380376;
15.01.2019;22:30:10;81011101;80630679;380422;
15.01.2019;22:31:08;81011153;80630694;380459;
15.01.2019;22:32:06;81011217;80630704;380513;
15.01.2019;22:33:06;81011285;80630727;380558;
15.01.2019;22:34:07;81011388;80630743;380645;
15.01.2019;22:35:06;81011470;80630762;380708;
15.01.2019;22:36:08;81011552;80630779;380773;
15.01.2019;22:37:12;81011629;80630805;380824;
15.01.2019;22:38:04;81011706;80630824;380882;
15.01.2019;22:39:08;81011808;80630841;380967;
15.01.2019;22:40:07;81011901;80630869;381032;
15.01.2019;22:41:12;81012015;80630905;381110;
15.01.2019;22:42:07;81012055;80630861;381194;
15.01.2019;22:43:06;81012128;80630860;381268;
15.01.2019;22:44:06;81012231;80630886;381345;
15.01.2019;22:45:12;81012334;80630921;381413;
15.01.2019;22:46:05;81012412;80630951;381461;
15.01.2019;22:47:08;81012522;80630985;381537;
15.01.2019;22:48:10;81012593;80631016;381577;
15.01.2019;22:49:07;81012675;80631044;381631;
15.01.2019;22:50:12;81012780;80631064;381716;
15.01.2019;22:51:06;81012883;80631083;381800;
15.01.2019;22:52:06;81012985;80631103;381882;
15.01.2019;22:53:05;81013065;80631131;381934;
15.01.2019;22:54:08;81013156;80631159;381997;
15.01.2019;22:55:06;81013257;80631178;382079;
15.01.2019;22:56:11;81013364;80631203;382161;
15.01.2019;22:57:09;81013457;80631228;382229;
15.01.2019;22:58:07;81013553;80631259;382294;
15.01.2019;22:59:12;81013640;80631277;382363;
15.01.2019;23:00:12;81013725;80631313;382412;
15.01.2019;23:01:06;81013802;80631332;382470;
15.01.2019;23:02:06;81013883;80631357;382526;
15.01.2019;23:03:08;81013981;80631381;382600;
15.01.2019;23:04:11;81014099;80631415;382684;
15.01.2019;23:05:06;81014194;80631438;382756;
15.01.2019;23:06:10;81014280;80631448;382832;
15.01.2019;23:07:06;81014359;80631470;382889;
15.01.2019;23:08:07;81014453;80631488;382965;
15.01.2019;23:09:04;81014541;80631505;383036;
15.01.2019;23:10:06;81014641;80631530;383111;
15.01.2019;23:11:10;81014725;80631545;383180;
15.01.2019;23:12:06;81014814;80631568;383246;
15.01.2019;23:13:06;81014897;80631586;383311;
15.01.2019;23:14:06;81014965;80631603;383362;
15.01.2019;23:15:07;81015062;80631624;383438;
15.01.2019;23:16:06;81015157;80631635;383522;
15.01.2019;23:17:10;81015257;80631660;383597;
15.01.2019;23:18:08;81015332;80631678;383654;
15.01.2019;23:19:11;81015428;80631702;383726;
15.01.2019;23:20:04;81015528;80631716;383812;
15.01.2019;23:21:05;81015619;80631740;383879;
15.01.2019;23:22:06;81015736;80631762;383974;
15.01.2019;23:23:06;81015831;80631782;384049;
15.01.2019;23:24:10;81015930;80631789;384141;
15.01.2019;23:25:06;81016029;80631811;384218;
15.01.2019;23:26:12;81016128;80631837;384291;
15.01.2019;23:27:07;81016203;80631846;384357;
15.01.2019;23:28:08;81016286;80631870;384416;
15.01.2019;23:29:12;81016393;80631897;384496;
15.01.2019;23:30:09;81016504;80631910;384594;
15.01.2019;23:31:04;81016601;80631929;384672;
15.01.2019;23:32:06;81016698;80631954;384744;
15.01.2019;23:33:09;81016797;80631969;384828;
15.01.2019;23:34:06;81016890;80631983;384907;
15.01.2019;23:35:06;81016971;80632010;384961;
15.01.2019;23:36:04;81017066;80632041;385025;
15.01.2019;23:37:06;81017151;80632062;385089;
15.01.2019;23:38:06;81017242;80632074;385168;
15.01.2019;23:39:06;81017343;80632093;385250;
15.01.2019;23:40:04;81017449;80632112;385337;
15.01.2019;23:41:06;81017538;80632131;385407;
15.01.2019;23:42:06;81017624;80632149;385475;
15.01.2019;23:43:06;81017730;80632174;385556;
15.01.2019;23:44:10;81017802;80632195;385607;
15.01.2019;23:45:07;81017876;80632224;385652;
15.01.2019;23:46:12;81017964;80632242;385722;
15.01.2019;23:47:07;81018030;80632261;385769;
15.01.2019;23:48:06;81018128;80632285;385843;
15.01.2019;23:49:07;81018230;80632301;385929;
15.01.2019;23:50:06;81018327;80632322;386005;
15.01.2019;23:51:04;81018436;80632331;386105;
15.01.2019;23:52:04;81018519;80632356;386163;
15.01.2019;23:53:05;81018601;80632377;386224;
15.01.2019;23:54:05;81018670;80632395;386275;
15.01.2019;23:55:06;81018776;80632412;386364;
15.01.2019;23:56:05;81018854;80632436;386418;
15.01.2019;23:57:05;81018947;80632453;386494;
15.01.2019;23:58:04;81019043;80632469;386574;
15.01.2019;23:59:05;81019113;80632493;386620;
16.01.2019;00:00:08;81019202;80632511;386691;
16.01.2019;00:01:08;81019279;80632528;386751;
16.01.2019;00:02:08;81019340;80632543;386797;
16.01.2019;00:03:09;81019426;80632557;386869;
16.01.2019;00:04:09;81019509;80632580;386929;
16.01.2019;00:05:10;81019597;80632605;386992;
16.01.2019;00:06:08;81019686;80632637;387049;
16.01.2019;00:07:07;81019801;80632658;387143;
16.01.2019;00:08:07;81019889;80632682;387207;
16.01.2019;00:09:09;81019966;80632683;387283;
16.01.2019;00:10:09;81020046;80632705;387341;
16.01.2019;00:11:07;81020152;80632732;387420;
16.01.2019;00:12:08;81020295;80632753;387542;
16.01.2019;00:13:18;81020403;80632777;387626;
16.01.2019;00:14:09;81020481;80632793;387688;
16.01.2019;00:15:08;81020533;80632815;387718;
16.01.2019;00:16:09;81020610;80632837;387773;
16.01.2019;00:17:07;81020693;80632853;387840;
16.01.2019;00:18:12;81020797;80632876;387921;
16.01.2019;00:19:09;81020824;80632901;387923;
16.01.2019;00:20:12;81020842;80632914;387928;
16.01.2019;00:21:09;81020869;80632923;387946;
16.01.2019;00:22:08;81020915;80632936;387979;
16.01.2019;00:23:08;81020903;80632942;387961;
16.01.2019;00:24:12;81020950;80632949;388001;
16.01.2019;00:25:07;81020983;80632960;388023;
16.01.2019;00:26:09;81021034;80632978;388056;
16.01.2019;00:27:08;81021098;80632990;388108;
16.01.2019;00:28:09;81021155;80633004;388151;
16.01.2019;00:29:09;81021200;80633017;388183;
16.01.2019;00:30:07;81021266;80633027;388239;
16.01.2019;00:31:09;81021314;80633044;388270;
16.01.2019;00:32:07;81021390;80633060;388330;
16.01.2019;00:33:07;81021471;80633081;388390;
16.01.2019;00:34:08;81021560;80633102;388458;
16.01.2019;00:35:08;81021642;80633112;388530;
16.01.2019;00:36:08;81021719;80633138;388581;
16.01.2019;00:37:08;81021789;80633165;388624;
16.01.2019;00:38:10;81021866;80633180;388686;
16.01.2019;00:39:09;81021952;80633203;388749;
16.01.2019;00:40:09;81022011;80633216;388795;
16.01.2019;00:41:09;81022093;80633236;388857;
16.01.2019;00:42:07;81022164;80633265;388899;
16.01.2019;00:43:08;81022241;80633286;388955;
16.01.2019;00:44:07;81022352;80633310;389042;
16.01.2019;00:45:09;81022415;80633332;389083;
16.01.2019;00:46:08;81022498;80633349;389149;
16.01.2019;00:47:09;81022578;80633369;389209;
16.01.2019;00:48:12;81022679;80633394;389285;
16.01.2019;00:49:09;81022767;80633414;389353;
16.01.2019;00:50:08;81022839;80633437;389402;
16.01.2019;00:51:09;81022918;80633464;389454;
16.01.2019;00:52:07;81022987;80633480;389507;
16.01.2019;00:53:09;81023066;80633496;389570;
16.01.2019;00:54:08;81023135;80633523;389612;
16.01.2019;00:55:12;81023213;80633541;389672;
16.01.2019;00:56:08;81023293;80633570;389723;
16.01.2019;00:57:08;81023364;80633589;389775;
16.01.2019;00:58:09;81023437;80633617;389820;
16.01.2019;00:59:12;81023512;80633636;389876;
16.01.2019;01:00:05;81023589;80633651;389938;
16.01.2019;01:01:06;81023659;80633676;389983;
16.01.2019;01:02:05;81023722;80633703;390019;
16.01.2019;01:03:04;81023801;80633728;390073;
16.01.2019;01:04:05;81023878;80633750;390128;
16.01.2019;01:05:11;81023938;80633755;390183;
16.01.2019;01:06:05;81024009;80633765;390244;
16.01.2019;01:07:06;81024091;80633784;390307;
16.01.2019;01:08:05;81024169;80633798;390371;
16.01.2019;01:09:06;81024251;80633828;390423;
16.01.2019;01:10:05;81024350;80633850;390500;
16.01.2019;01:11:05;81024443;80633874;390569;
16.01.2019;01:12:04;81024517;80633898;390619;
16.01.2019;01:13:05;81024588;80633925;390663;
16.01.2019;01:14:05;81024656;80633959;390697;
16.01.2019;01:15:04;81024728;80633984;390744;
16.01.2019;01:16:05;81024793;80634002;390791;
16.01.2019;01:17:05;81024861;80634022;390839;
16.01.2019;01:18:04;81024925;80634049;390876;
16.01.2019;01:19:04;81024997;80634077;390920;
16.01.2019;01:20:05;81025067;80634105;390962;
16.01.2019;01:21:04;81025144;80634121;391023;
16.01.2019;01:22:05;81025235;80634155;391080;
16.01.2019;01:23:05;81025306;80634186;391120;
16.01.2019;01:24:04;81025377;80634218;391159;
16.01.2019;01:25:05;81025484;80634253;391231;
16.01.2019;01:26:05;81025564;80634279;391285;
16.01.2019;01:27:04;81025635;80634309;391326;
16.01.2019;01:28:09;81025724;80634348;391376;
16.01.2019;01:29:05;81025808;80634376;391432;
16.01.2019;01:30:05;81025881;80634411;391470;
16.01.2019;01:31:04;81025964;80634426;391538;
16.01.2019;01:32:05;81026028;80634457;391571;
16.01.2019;01:33:05;81026096;80634486;391610;
16.01.2019;01:34:04;81026163;80634513;391650;
16.01.2019;01:35:04;81026242;80634542;391700;
16.01.2019;01:36:05;81026321;80634567;391754;
16.01.2019;01:37:04;81026390;80634589;391801;
16.01.2019;01:38:04;81026458;80634625;391833;
16.01.2019;01:39:05;81026549;80634667;391882;
16.01.2019;01:40:05;81026645;80634697;391948;
16.01.2019;01:41:04;81026705;80634727;391978;
16.01.2019;01:42:05;81026806;80634762;392044;
16.01.2019;01:43:05;81026867;80634795;392072;
16.01.2019;01:44:04;81026930;80634838;392092;
16.01.2019;01:45:04;81027020;80634876;392144;
16.01.2019;01:46:05;81027124;80634913;392211;
16.01.2019;01:47:04;81027224;80634948;392276;
16.01.2019;01:48:04;81027280;80635003;392277;
16.01.2019;01:49:05;81027391;80635042;392349;
16.01.2019;01:50:04;81027461;80635081;392380;
16.01.2019;01:51:05;81027522;80635120;392402;
16.01.2019;01:52:04;81027594;80635163;392431;
16.01.2019;01:53:04;81027660;80635199;392461;
16.01.2019;01:54:05;81027761;80635232;392529;
16.01.2019;01:55:04;81027824;80635262;392562;
16.01.2019;01:56:05;81027891;80635313;392578;
16.01.2019;01:57:04;81027967;80635345;392622;
16.01.2019;01:58:04;81028047;80635381;392666;
16.01.2019;01:59:05;81028132;80635434;392698;
16.01.2019;02:00:05;81028197;80635477;392720;
16.01.2019;02:01:04;81028272;80635515;392757;
16.01.2019;02:02:04;81028358;80635563;392795;
16.01.2019;02:03:05;81028423;80635619;392804;
16.01.2019;02:04:04;81028510;80635665;392845;
16.01.2019;02:05:04;81028576;80635725;392851;
16.01.2019;02:06:05;81028650;80635786;392864;
16.01.2019;02:07:04;81028714;80635830;392884;
16.01.2019;02:08:04;81028797;80635883;392914;
16.01.2019;02:09:06;81028862;80635921;392941;
16.01.2019;02:10:04;81028932;80635961;392971;
16.01.2019;02:11:04;81029011;80636016;392995;
16.01.2019;02:12:04;81029089;80636083;393006;
16.01.2019;02:13:05;81029167;80636139;393028;
16.01.2019;02:14:04;81029252;80636209;393043;
16.01.2019;02:15:04;81029331;80636274;393057;
16.01.2019;02:16:05;81029402;80636328;393074;
16.01.2019;02:17:05;81029465;80636384;393081;
16.01.2019;02:18:04;81029537;80636452;393085;
16.01.2019;02:19:05;81029593;80636495;393098;
16.01.2019;02:20:05;81029608;80636539;393069;
16.01.2019;02:21:04;81029637;80636586;393051;
16.01.2019;02:22:04;81029709;80636627;393082;
16.01.2019;02:23:05;81029752;80636685;393067;
16.01.2019;02:24:04;81029804;80636731;393073;
16.01.2019;02:25:04;81029831;80636789;393042;
16.01.2019;02:26:05;81029856;80636836;393020;
16.01.2019;02:27:04;81029901;80636902;392999;
16.01.2019;02:28:04;81029948;80636966;392982;
16.01.2019;02:29:05;81029994;80637025;392969;
16.01.2019;02:30:04;81030054;80637087;392967;
16.01.2019;02:31:04;81030124;80637150;392974;
16.01.2019;02:32:04;81030190;80637212;392978;
16.01.2019;02:33:04;81030255;80637272;392983;
16.01.2019;02:34:05;81030321;80637342;392979;
16.01.2019;02:35:05;81030386;80637402;392984;
16.01.2019;02:36:04;81030447;80637472;392975;
16.01.2019;02:37:05;81030528;80637552;392976;
16.01.2019;02:38:04;81030599;80637607;392992;
16.01.2019;02:39:05;81030681;80637672;393009;
16.01.2019;02:40:05;81030752;80637726;393026;
16.01.2019;02:41:04;81030828;80637796;393032;
16.01.2019;02:42:05;81030897;80637870;393027;
16.01.2019;02:43:05;81030967;80637931;393036;
16.01.2019;02:44:04;81031029;80637991;393038;
16.01.2019;02:45:05;81031112;80638060;393052;
16.01.2019;02:46:05;81031213;80638147;393066;
16.01.2019;02:47:04;81031299;80638211;393088;
16.01.2019;02:48:04;81031398;80638282;393116;
16.01.2019;02:49:05;81031473;80638348;393125;
16.01.2019;02:50:04;81031548;80638413;393135;
16.01.2019;02:51:05;81031619;80638483;393136;
16.01.2019;02:52:04;81031717;80638561;393156;
16.01.2019;02:53:04;81031820;80638628;393192;
16.01.2019;02:54:05;81031879;80638702;393177;
16.01.2019;02:55:04;81031957;80638805;393152;
16.01.2019;02:56:04;81032031;80638875;393156;
16.01.2019;02:57:05;81032121;80638952;393169;
16.01.2019;02:58:04;81032199;80639039;393160;
16.01.2019;02:59:05;81032303;80639121;393182;
16.01.2019;03:00:05;81032388;80639198;393190;
16.01.2019;03:01:04;81032459;80639264;393195;
16.01.2019;03:02:05;81032543;80639357;393186;
16.01.2019;03:03:05;81032615;80639436;393179;
16.01.2019;03:04:04;81032707;80639522;393185;
16.01.2019;03:05:05;81032794;80639606;393188;
16.01.2019;03:06:04;81032882;80639684;393198;
16.01.2019;03:07:04;81032969;80639766;393203;
16.01.2019;03:08:05;81033025;80639861;393164;
16.01.2019;03:09:06;81033095;80639956;393139;
16.01.2019;03:10:05;81033185;80640028;393157;
16.01.2019;03:11:05;81033268;80640127;393141;
16.01.2019;03:12:04;81033359;80640206;393153;
16.01.2019;03:13:04;81033433;80640294;393139;
16.01.2019;03:14:05;81033499;80640370;393129;
16.01.2019;03:15:04;81033567;80640448;393119;
16.01.2019;03:16:05;81033626;80640538;393088;
16.01.2019;03:17:05;81033709;80640638;393071;
16.01.2019;03:18:04;81033799;80640707;393092;
16.01.2019;03:19:04;81033887;80640788;393099;
16.01.2019;03:20:05;81033975;80640875;393100;
16.01.2019;03:21:04;81034058;80640966;393092;
16.01.2019;03:22:05;81034150;80641055;393095;
16.01.2019;03:23:04;81034222;80641156;393066;
16.01.2019;03:24:04;81034313;80641274;393039;
16.01.2019;03:25:05;81034390;80641369;393021;
16.01.2019;03:26:04;81034483;80641460;393023;
16.01.2019;03:27:04;81034566;80641545;393021;
16.01.2019;03:28:05;81034649;80641638;393011;
16.01.2019;03:29:04;81034716;80641726;392990;
16.01.2019;03:30:05;81034807;80641823;392984;
16.01.2019;03:31:04;81034905;80641929;392976;
16.01.2019;03:32:04;81034999;80642014;392985;
16.01.2019;03:33:05;81035083;80642136;392947;
16.01.2019;03:34:04;81035173;80642239;392934;
16.01.2019;03:35:04;81035268;80642326;392942;
16.01.2019;03:36:05;81035334;80642434;392900;
16.01.2019;03:37:04;81035423;80642525;392898;
16.01.2019;03:38:04;81035507;80642643;392864;
16.01.2019;03:39:06;81035588;80642741;392847;
16.01.2019;03:40:04;81035676;80642809;392867;
16.01.2019;03:41:05;81035759;80642902;392857;
16.01.2019;03:42:04;81035824;80642995;392829;
16.01.2019;03:43:04;81035883;80643096;392787;
16.01.2019;03:44:05;81035965;80643182;392783;
16.01.2019;03:45:04;81036032;80643282;392750;
16.01.2019;03:46:05;81036134;80643396;392738;
16.01.2019;03:47:04;81036223;80643479;392744;
16.01.2019;03:48:04;81036304;80643558;392746;
16.01.2019;03:49:05;81036379;80643658;392721;
16.01.2019;03:50:04;81036463;80643738;392725;
16.01.2019;03:51:04;81036547;80643858;392689;
16.01.2019;03:52:05;81036628;80643962;392666;
16.01.2019;03:53:04;81036707;80644063;392644;
16.01.2019;03:54:04;81036813;80644167;392646;
16.01.2019;03:55:05;81036888;80644261;392627;
16.01.2019;03:56:04;81036964;80644355;392609;
16.01.2019;03:57:04;81037032;80644474;392558;
16.01.2019;03:58:05;81037101;80644577;392524;
16.01.2019;03:59:04;81037172;80644674;392498;
16.01.2019;04:00:04;81037243;80644770;392473;
16.01.2019;04:01:05;81037316;80644868;392448;
16.01.2019;04:02:04;81037368;80644988;392380;
16.01.2019;04:03:05;81037450;80645096;392354;
16.01.2019;04:04:04;81037519;80645183;392336;
16.01.2019;04:05:04;81037615;80645267;392348;
16.01.2019;04:06:05;81037701;80645353;392348;
16.01.2019;04:07:04;81037763;80645454;392309;
16.01.2019;04:08:04;81037845;80645546;392299;
16.01.2019;04:09:05;81037886;80645629;392257;
16.01.2019;04:10:05;81037936;80645716;392220;
16.01.2019;04:11:04;81038010;80645814;392196;
16.01.2019;04:12:05;81038083;80645929;392154;
16.01.2019;04:13:06;81038162;80646028;392134;
16.01.2019;04:14:04;81038222;80646156;392066;
16.01.2019;04:15:05;81038311;80646270;392041;
16.01.2019;04:16:05;81038385;80646379;392006;
16.01.2019;04:17:04;81038436;80646476;391960;
16.01.2019;04:18:04;81038465;80646595;391870;
16.01.2019;04:19:05;81038501;80646703;391798;
16.01.2019;04:20:04;81038571;80646809;391762;
16.01.2019;04:21:04;81038636;80646908;391728;
16.01.2019;04:22:05;81038688;80647026;391662;
16.01.2019;04:23:04;81038748;80647125;391623;
16.01.2019;04:24:04;81038800;80647221;391579;
16.01.2019;04:25:05;81038853;80647329;391524;
16.01.2019;04:26:05;81038903;80647433;391470;
16.01.2019;04:27:04;81038962;80647534;391428;
16.01.2019;04:28:05;81039034;80647632;391402;
16.01.2019;04:29:05;81039101;80647746;391355;
16.01.2019;04:30:04;81039180;80647861;391319;
16.01.2019;04:31:04;81039242;80647963;391279;
16.01.2019;04:32:05;81039328;80648070;391258;
16.01.2019;04:33:04;81039407;80648182;391225;
16.01.2019;04:34:05;81039480;80648293;391187;
16.01.2019;04:35:04;81039547;80648398;391149;
16.01.2019;04:36:04;81039606;80648513;391093;
16.01.2019;04:37:05;81039671;80648626;391045;
16.01.2019;04:38:04;81039733;80648723;391010;
16.01.2019;04:39:06;81039814;80648852;390962;
16.01.2019;04:40:05;81039881;80648963;390918;
16.01.2019;04:41:04;81039952;80649073;390879;
16.01.2019;04:42:05;81040023;80649191;390832;
16.01.2019;04:43:04;81040097;80649311;390786;
16.01.2019;04:44:04;81040177;80649422;390755;
16.01.2019;04:45:05;81040241;80649533;390708;
16.01.2019;04:46:04;81040295;80649649;390646;
16.01.2019;04:47:04;81040375;80649760;390615;
16.01.2019;04:48:05;81040442;80649879;390563;
16.01.2019;04:49:04;81040533;80649970;390563;
16.01.2019;04:50:05;81040594;80650103;390491;
16.01.2019;04:51:05;81040673;80650213;390460;
16.01.2019;04:52:04;81040770;80650358;390412;
16.01.2019;04:53:04;81040840;80650474;390366;
16.01.2019;04:54:05;81040926;80650573;390353;
16.01.2019;04:55:04;81041008;80650704;390304;
16.01.2019;04:56:05;81041088;80650811;390277;
16.01.2019;04:57:05;81041158;80650923;390235;
16.01.2019;04:58:04;81041223;80651016;390207;
16.01.2019;04:59:04;81041315;80651130;390185;
16.01.2019;05:00:10;81041395;80651279;390116;
16.01.2019;05:01:04;81041462;80651375;390087;
16.01.2019;05:02:04;81041534;80651487;390047;
16.01.2019;05:03:05;81041597;80651611;389986;
16.01.2019;05:04:04;81041652;80651718;389934;
16.01.2019;05:05:04;81041715;80651838;389877;
16.01.2019;05:06:05;81041793;80651958;389835;
16.01.2019;05:07:04;81041883;80652062;389821;
16.01.2019;05:08:04;81041973;80652178;389795;
16.01.2019;05:09:06;81042039;80652318;389721;
16.01.2019;05:10:04;81042095;80652433;389662;
16.01.2019;05:11:05;81042169;80652563;389606;
16.01.2019;05:12:04;81042219;80652692;389527;
16.01.2019;05:13:04;81042282;80652815;389467;
16.01.2019;05:14:05;81042336;80652945;389391;
16.01.2019;05:15:04;81042405;80653071;389334;
16.01.2019;05:16:05;81042466;80653159;389307;
16.01.2019;05:17:05;81042542;80653258;389284;
16.01.2019;05:18:04;81042610;80653381;389229;
16.01.2019;05:19:04;81042663;80653491;389172;
16.01.2019;05:20:05;81042714;80653605;389109;
16.01.2019;05:21:04;81042790;80653728;389062;
16.01.2019;05:22:05;81042860;80653851;389009;
16.01.2019;05:23:05;81042913;80653981;388932;
16.01.2019;05:24:04;81042992;80654096;388896;
16.01.2019;05:25:05;81043046;80654200;388846;
16.01.2019;05:26:04;81043104;80654291;388813;
16.01.2019;05:27:04;81043188;80654385;388803;
16.01.2019;05:28:05;81043262;80654514;388748;
16.01.2019;05:29:04;81043322;80654639;388683;
16.01.2019;05:30:04;81043393;80654753;388640;
16.01.2019;05:31:05;81043454;80654854;388600;
16.01.2019;05:32:05;81043532;80655001;388531;
16.01.2019;05:33:04;81043582;80655094;388488;
16.01.2019;05:34:05;81043641;80655208;388433;
16.01.2019;05:35:04;81043709;80655330;388379;
16.01.2019;05:36:04;81043760;80655464;388296;
16.01.2019;05:37:05;81043827;80655576;388251;
16.01.2019;05:38:04;81043895;80655696;388199;
16.01.2019;05:39:06;81043957;80655792;388165;
16.01.2019;05:40:04;81044020;80655929;388091;
16.01.2019;05:41:04;81044081;80656025;388056;
16.01.2019;05:42:05;81044153;80656131;388022;
16.01.2019;05:43:04;81044215;80656258;387957;
16.01.2019;05:44:04;81044268;80656342;387926;
16.01.2019;05:45:05;81044332;80656466;387866;
16.01.2019;05:46:04;81044392;80656603;387789;
16.01.2019;05:47:04;81044449;80656714;387735;
16.01.2019;05:48:05;81044513;80656821;387692;
16.01.2019;05:49:04;81044574;80656937;387637;
16.01.2019;05:50:04;81044632;80657061;387571;
16.01.2019;05:51:05;81044703;80657178;387525;
16.01.2019;05:52:05;81044762;80657292;387470;
16.01.2019;05:53:05;81044812;80657410;387402;
16.01.2019;05:54:04;81044878;80657521;387357;
16.01.2019;05:55:05;81044928;80657628;387300;
16.01.2019;05:56:04;81044998;80657753;387245;
16.01.2019;05:57:04;81045062;80657860;387202;
16.01.2019;05:58:05;81045113;80657972;387141;
16.01.2019;05:59:05;81045207;80658087;387120;
16.01.2019;06:00:05;81045287;80658192;387095;
16.01.2019;06:01:05;81045347;80658337;387010;
16.01.2019;06:02:04;81045409;80658467;386942;
16.01.2019;06:03:04;81045471;80658579;386892;
16.01.2019;06:04:05;81045516;80658694;386822;
16.01.2019;06:05:04;81045555;80658816;386739;
16.01.2019;06:06:04;81045605;80658945;386660;
16.01.2019;06:07:05;81045671;80659053;386618;
16.01.2019;06:08:04;81045734;80659164;386570;
16.01.2019;06:09:04;81045810;80659297;386513;
16.01.2019;06:10:05;81045871;80659425;386446;
16.01.2019;06:11:05;81045930;80659549;386381;
16.01.2019;06:12:04;81045980;80659681;386299;
16.01.2019;06:13:05;81046033;80659818;386215;
16.01.2019;06:14:05;81046071;80659941;386130;
16.01.2019;06:15:04;81046106;80660069;386037;
16.01.2019;06:17:04;81046191;80660288;385903;
16.01.2019;06:18:05;81046223;80660381;385842;
16.01.2019;06:19:04;81046265;80660484;385781;
16.01.2019;06:20:05;81046299;80660594;385705;
16.01.2019;06:21:04;81046325;80660697;385628;
16.01.2019;06:22:04;81046383;80660816;385567;
16.01.2019;06:23:05;81046423;80660928;385495;
16.01.2019;06:24:04;81046456;80661047;385409;
16.01.2019;06:25:07;81046514;80661153;385361;
16.01.2019;06:26:04;81046567;80661272;385295;
16.01.2019;06:27:05;81046627;80661396;385231;
16.01.2019;06:28:05;81046658;80661493;385165;
16.01.2019;06:29:04;81046715;80661647;385068;
16.01.2019;06:30:04;81046760;80661752;385008;
16.01.2019;06:31:04;81046805;80661874;384931;
16.01.2019;06:32:05;81046851;80661983;384868;
16.01.2019;06:33:04;81046904;80662098;384806;
16.01.2019;06:34:04;81046969;80662227;384742;
16.01.2019;06:35:05;81047020;80662332;384688;
16.01.2019;06:36:05;81047076;80662457;384619;
16.01.2019;06:37:04;81047134;80662570;384564;
16.01.2019;06:38:04;81047210;80662686;384524;
16.01.2019;06:39:05;81047266;80662807;384459;
16.01.2019;06:40:05;81047307;80662925;384382;
16.01.2019;06:41:05;81047361;80663058;384303;
16.01.2019;06:42:04;81047421;80663187;384234;
16.01.2019;06:43:05;81047485;80663310;384175;
16.01.2019;06:44:05;81047546;80663431;384115;
16.01.2019;06:45:04;81047595;80663543;384052;
16.01.2019;06:46:05;81047648;80663645;384003;
16.01.2019;06:47:04;81047691;80663742;383949;
16.01.2019;06:48:05;81047742;80663847;383895;
16.01.2019;06:49:05;81047794;80663973;383821;
16.01.2019;06:50:04;81047863;80664087;383776;
16.01.2019;06:51:04;81047932;80664197;383735;
16.01.2019;06:52:04;81047981;80664336;383645;
16.01.2019;06:53:05;81048041;80664475;383566;
16.01.2019;06:54:05;81048109;80664592;383517;
16.01.2019;06:55:04;81048167;80664722;383445;
16.01.2019;06:56:04;81048208;80664843;383365;
16.01.2019;06:57:05;81048257;80664968;383289;
16.01.2019;06:58:05;81048313;80665099;383214;
16.01.2019;06:59:04;81048378;80665211;383167;
16.01.2019;07:00:04;81048419;80665335;383084;
16.01.2019;07:01:05;81048491;80665443;383048;
16.01.2019;07:02:04;81048537;80665550;382987;
16.01.2019;07:03:04;81048556;80665646;382910;
16.01.2019;07:04:05;81048611;80665770;382841;
16.01.2019;07:05:05;81048673;80665893;382780;
16.01.2019;07:06:05;81048719;80666038;382681;
16.01.2019;07:07:05;81048773;80666146;382627;
16.01.2019;07:08:05;81048838;80666264;382574;
16.01.2019;07:09:06;81048879;80666393;382486;
16.01.2019;07:10:09;81048933;80666511;382422;
16.01.2019;07:11:05;81048981;80666621;382360;
16.01.2019;07:12:05;81049048;80666768;382280;
16.01.2019;07:13:04;81049109;80666880;382229;
16.01.2019;07:14:04;81049170;80666988;382182;
16.01.2019;07:15:04;81049226;80667093;382133;
16.01.2019;07:16:05;81049273;80667210;382063;
16.01.2019;07:17:05;81049309;80667352;381957;
16.01.2019;07:18:05;81049367;80667447;381920;
16.01.2019;07:19:05;81049402;80667580;381822;
16.01.2019;07:20:04;81049446;80667692;381754;
16.01.2019;07:21:05;81049493;80667818;381675;
16.01.2019;07:22:05;81049547;80667941;381606;
16.01.2019;07:23:05;81049596;80668054;381542;
16.01.2019;07:24:05;81049651;80668172;381479;
16.01.2019;07:25:04;81049699;80668296;381403;
16.01.2019;07:26:04;81049751;80668412;381339;
16.01.2019;07:27:05;81049803;80668550;381253;
16.01.2019;07:28:05;81049859;80668660;381199;
16.01.2019;07:29:04;81049915;80668790;381125;
16.01.2019;07:30:04;81049959;80668899;381060;
16.01.2019;07:31:04;81049999;80669007;380992;
16.01.2019;07:32:04;81050047;80669115;380932;
16.01.2019;07:33:05;81050091;80669244;380847;
16.01.2019;07:34:05;81050143;80669373;380770;
16.01.2019;07:35:04;81050207;80669504;380703;
16.01.2019;07:36:11;81050265;80669609;380656;
16.01.2019;07:37:10;81050312;80669696;380616;
16.01.2019;07:38:07;81050361;80669782;380579;
16.01.2019;07:39:05;81050415;80669850;380565;
16.01.2019;07:40:05;81050466;80669936;380530;
16.01.2019;07:41:06;81050514;80670063;380451;
16.01.2019;07:42:06;81050570;80670167;380403;
16.01.2019;07:43:06;81050626;80670292;380334;
16.01.2019;07:44:06;81050679;80670411;380268;
16.01.2019;07:45:10;81050726;80670528;380198;
16.01.2019;07:46:04;81050772;80670629;380143;
16.01.2019;07:47:06;81050821;80670742;380079;
16.01.2019;07:48:06;81050874;80670860;380014;
16.01.2019;07:49:09;81050948;80670965;379983;
16.01.2019;07:50:11;81050997;80671064;379933;
16.01.2019;07:51:07;81051044;80671161;379883;
16.01.2019;07:52:05;81051077;80671276;379801;
16.01.2019;07:53:06;81051122;80671364;379758;
16.01.2019;07:54:05;81051172;80671456;379716;
16.01.2019;07:55:06;81051207;80671556;379651;
16.01.2019;07:56:05;81051268;80671652;379616;
16.01.2019;07:57:05;81051320;80671766;379554;
16.01.2019;07:58:05;81051388;80671880;379508;
16.01.2019;07:59:05;81051433;80672005;379428;
16.01.2019;08:00:10;81051499;80672134;379365;
16.01.2019;08:01:06;81051554;80672225;379329;
16.01.2019;08:02:06;81051585;80672328;379257;
16.01.2019;08:03:06;81051646;80672433;379213;
16.01.2019;08:04:06;81051696;80672554;379142;
16.01.2019;08:05:05;81051745;80672661;379084;
16.01.2019;08:06:05;81051788;80672764;379024;
16.01.2019;08:07:04;81051831;80672859;378972;
16.01.2019;08:09:06;81051916;80673090;378826;
16.01.2019;08:10:04;81051963;80673212;378751;
16.01.2019;08:11:07;81052012;80673339;378673;
16.01.2019;08:12:05;81052078;80673446;378632;
16.01.2019;08:13:06;81052119;80673552;378567;
16.01.2019;08:14:05;81052149;80673656;378493;
16.01.2019;08:15:06;81052198;80673750;378448;
16.01.2019;08:16:06;81052230;80673819;378411;
16.01.2019;08:17:05;81052268;80673898;378370;
16.01.2019;08:18:06;81052304;80673994;378310;
16.01.2019;08:19:05;81052328;80674079;378249;
16.01.2019;08:20:04;81052347;80674188;378159;
16.01.2019;08:21:06;81052374;80674307;378067;
16.01.2019;08:22:06;81052400;80674416;377984;
16.01.2019;08:23:05;81052413;80674509;377904;
16.01.2019;08:24:06;81052442;80674609;377833;
16.01.2019;08:25:07;81052459;80674699;377760;
16.01.2019;08:26:06;81052506;80674811;377695;
16.01.2019;08:27:06;81052562;80674902;377660;
16.01.2019;08:28:05;81052597;80675013;377584;
16.01.2019;08:29:05;81052631;80675126;377505;
16.01.2019;08:30:05;81052672;80675231;377441;
16.01.2019;08:31:05;81052713;80675346;377367;
16.01.2019;08:32:04;81052748;80675451;377297;
16.01.2019;08:33:05;81052799;80675539;377260;
16.01.2019;08:34:05;81052846;80675657;377189;
16.01.2019;08:35:05;81052893;80675761;377132;
16.01.2019;08:36:05;81052928;80675888;377040;
16.01.2019;08:37:04;81052968;80675978;376990;
16.01.2019;08:38:04;81052998;80676073;376925;
16.01.2019;08:39:05;81053043;80676184;376859;
16.01.2019;08:40:05;81053081;80676297;376784;
16.01.2019;08:41:05;81053127;80676415;376712;
16.01.2019;08:42:05;81053175;80676547;376628;
16.01.2019;08:43:04;81053210;80676654;376556;
16.01.2019;08:44:04;81053251;80676768;376483;
16.01.2019;08:45:05;81053298;80676883;376415;
16.01.2019;08:46:04;81053342;80677002;376340;
16.01.2019;08:47:04;81053386;80677093;376293;
16.01.2019;08:48:04;81053451;80677227;376224;
16.01.2019;08:49:04;81053501;80677338;376163;
16.01.2019;08:50:05;81053544;80677470;376074;
16.01.2019;08:51:05;81053590;80677608;375982;
16.01.2019;08:52:04;81053637;80677743;375894;
16.01.2019;08:53:04;81053695;80677865;375830;
16.01.2019;08:54:05;81053733;80677972;375761;
16.01.2019;08:55:05;81053779;80678083;375696;
16.01.2019;08:56:05;81053823;80678190;375633;
16.01.2019;08:57:05;81053861;80678320;375541;
16.01.2019;08:58:04;81053906;80678456;375450;
16.01.2019;08:59:05;81053961;80678578;375383;
16.01.2019;09:00:05;81054005;80678711;375294;
16.01.2019;09:01:05;81054057;80678856;375201;
16.01.2019;09:02:04;81054094;80678983;375111;
16.01.2019;09:03:04;81054158;80679103;375055;
16.01.2019;09:04:05;81054199;80679239;374960;
16.01.2019;09:05:05;81054243;80679359;374884;
16.01.2019;09:06:04;81054302;80679476;374826;
16.01.2019;09:07:04;81054349;80679612;374737;
16.01.2019;09:08:05;81054386;80679705;374681;
16.01.2019;09:09:05;81054439;80679839;374600;
16.01.2019;09:10:05;81054480;80679963;374517;
16.01.2019;09:11:05;81054536;80680073;374463;
16.01.2019;09:12:04;81054592;80680186;374406;
16.01.2019;09:13:05;81054638;80680330;374308;
16.01.2019;09:14:05;81054676;80680455;374221;
16.01.2019;09:15:04;81054723;80680564;374159;
16.01.2019;09:16:04;81054767;80680693;374074;
16.01.2019;09:17:05;81054798;80680836;373962;
16.01.2019;09:18:05;81054844;80680957;373887;
16.01.2019;09:19:04;81054877;80681092;373785;
16.01.2019;09:20:05;81054923;80681232;373691;
16.01.2019;09:21:05;81054965;80681358;373607;
16.01.2019;09:22:04;81055006;80681506;373500;
16.01.2019;09:23:04;81055055;80681651;373404;
16.01.2019;09:24:04;81055087;80681765;373322;
16.01.2019;09:25:04;81055128;80681871;373257;
16.01.2019;09:26:04;81055160;80682002;373158;
16.01.2019;09:27:05;81055199;80682147;373052;
16.01.2019;09:28:04;81055226;80682275;372951;
16.01.2019;09:29:05;81055287;80682414;372873;
16.01.2019;09:30:05;81055326;80682553;372773;
16.01.2019;09:31:05;81055374;80682699;372675;
16.01.2019;09:32:05;81055419;80682838;372581;
16.01.2019;09:33:05;81055471;80682974;372497;
16.01.2019;09:34:04;81055522;80683081;372441;
16.01.2019;09:35:04;81055557;80683214;372343;
16.01.2019;09:36:05;81055593;80683369;372224;
16.01.2019;09:37:05;81055629;80683480;372149;
16.01.2019;09:38:05;81055684;80683622;372062;
16.01.2019;09:39:06;81055727;80683755;371972;
16.01.2019;09:40:05;81055774;80683894;371880;
16.01.2019;09:41:05;81055827;80684043;371784;
16.01.2019;09:42:05;81055881;80684191;371690;
16.01.2019;09:43:05;81055926;80684326;371600;
16.01.2019;09:44:04;81055963;80684449;371514;
16.01.2019;09:45:04;81056012;80684569;371443;
16.01.2019;09:46:05;81056063;80684700;371363;
16.01.2019;09:47:05;81056106;80684849;371257;
16.01.2019;09:48:04;81056166;80684977;371189;
16.01.2019;09:49:05;81056207;80685107;371100;
16.01.2019;09:50:05;81056249;80685238;371011;
16.01.2019;09:51:04;81056282;80685383;370899;
16.01.2019;09:52:04;81056320;80685502;370818;
16.01.2019;09:53:05;81056355;80685628;370727;
16.01.2019;09:54:05;81056394;80685767;370627;
16.01.2019;09:55:05;81056440;80685897;370543;
16.01.2019;09:56:05;81056492;80686037;370455;
16.01.2019;09:57:05;81056500;80686129;370371;
16.01.2019;09:58:04;81056511;80686273;370238;
16.01.2019;09:59:04;81056549;80686416;370133;
16.01.2019;10:00:05;81056591;80686556;370035;
16.01.2019;10:01:05;81056639;80686712;369927;
16.01.2019;10:02:06;81056680;80686841;369839;
16.01.2019;10:03:06;81056718;80686984;369734;
16.01.2019;10:04:05;81056766;80687113;369653;
16.01.2019;10:05:05;81056806;80687235;369571;
16.01.2019;10:06:05;81056843;80687369;369474;
16.01.2019;10:07:05;81056887;80687493;369394;
16.01.2019;10:08:04;81056923;80687635;369288;
16.01.2019;10:09:04;81056969;80687769;369200;
16.01.2019;10:10:05;81057023;80687915;369108;
16.01.2019;10:11:05;81057065;80688055;369010;
16.01.2019;10:12:04;81057104;80688208;368896;
16.01.2019;10:13:05;81057148;80688344;368804;
16.01.2019;10:14:05;81057200;80688501;368699;
16.01.2019;10:15:06;81057238;80688625;368613;
16.01.2019;10:16:04;81057263;80688750;368513;
16.01.2019;10:17:05;81057289;80688860;368429;
16.01.2019;10:18:06;81057313;80688993;368320;
16.01.2019;10:19:04;81057341;80689119;368222;
16.01.2019;10:20:04;81057369;80689244;368125;
16.01.2019;10:21:04;81057403;80689373;368030;
16.01.2019;10:22:05;81057435;80689496;367939;
16.01.2019;10:23:04;81057457;80689619;367838;
16.01.2019;10:24:05;81057493;80689743;367750;
16.01.2019;10:25:05;81057522;80689888;367634;
16.01.2019;10:26:05;81057547;80690041;367506;
16.01.2019;10:27:04;81057593;80690174;367419;
16.01.2019;10:28:04;81057633;80690313;367320;
16.01.2019;10:29:05;81057666;80690458;367208;
16.01.2019;10:30:05;81057700;80690576;367124;
16.01.2019;10:31:04;81057755;80690742;367013;
16.01.2019;10:32:04;81057786;80690918;366868;
16.01.2019;10:33:05;81057837;80691052;366785;
16.01.2019;10:34:05;81057879;80691187;366692;
16.01.2019;10:35:04;81057929;80691319;366610;
16.01.2019;10:36:06;81057957;80691434;366523;
16.01.2019;10:37:04;81058006;80691551;366455;
16.01.2019;10:38:04;81058068;80691713;366355;
16.01.2019;10:39:05;81058107;80691852;366255;
16.01.2019;10:40:05;81058143;80691986;366157;
16.01.2019;10:41:04;81058189;80692137;366052;
16.01.2019;10:42:04;81058226;80692267;365959;
16.01.2019;10:43:05;81058274;80692433;365841;
16.01.2019;10:44:05;81058321;80692585;365736;
16.01.2019;10:45:04;81058362;80692736;365626;
16.01.2019;10:46:04;81058400;80692894;365506;
16.01.2019;10:47:05;81058444;80693014;365430;
16.01.2019;10:48:05;81058477;80693167;365310;
16.01.2019;10:49:04;81058526;80693330;365196;
16.01.2019;10:50:04;81058572;80693474;365098;
16.01.2019;10:51:05;81058620;80693629;364991;
16.01.2019;10:52:04;81058661;80693771;364890;
16.01.2019;10:53:04;81058692;80693926;364766;
16.01.2019;10:54:04;81058730;80694056;364674;
16.01.2019;10:55:05;81058766;80694227;364539;
16.01.2019;10:56:05;81058830;80694366;364464;
16.01.2019;10:57:05;81058879;80694492;364387;
16.01.2019;10:58:04;81058920;80694636;364284;
16.01.2019;10:59:04;81058970;80694760;364210;
16.01.2019;11:00:05;81059029;80694912;364117;
16.01.2019;11:01:05;81059077;80695044;364033;
16.01.2019;11:02:04;81059111;80695182;363929;
16.01.2019;11:03:04;81059170;80695334;363836;
16.01.2019;11:04:05;81059217;80695478;363739;
16.01.2019;11:05:05;81059261;80695636;363625;
16.01.2019;11:06:05;81059307;80695781;363526;
16.01.2019;11:07:04;81059358;80695913;363445;
16.01.2019;11:08:04;81059412;80696061;363351;
16.01.2019;11:09:05;81059463;80696219;363244;
16.01.2019;11:10:05;81059514;80696358;363156;
16.01.2019;11:11:05;81059560;80696475;363085;
16.01.2019;11:12:04;81059599;80696599;363000;
16.01.2019;11:13:05;81059656;80696763;362893;
16.01.2019;11:14:04;81059703;80696880;362823;
16.01.2019;11:15:05;81059767;80697022;362745;
16.01.2019;11:16:05;81059812;80697168;362644;
16.01.2019;11:17:05;81059849;80697327;362522;
16.01.2019;11:18:05;81059887;80697442;362445;
16.01.2019;11:19:04;81059949;80697593;362356;
16.01.2019;11:20:05;81059989;80697739;362250;
16.01.2019;11:21:05;81060037;80697890;362147;
16.01.2019;11:22:04;81060077;80698047;362030;
16.01.2019;11:23:04;81060124;80698178;361946;
16.01.2019;11:24:04;81060165;80698302;361863;
16.01.2019;11:25:04;81060213;80698439;361774;
16.01.2019;11:26:15;81060265;80698609;361656;
16.01.2019;11:27:04;81060306;80698726;361580;
16.01.2019;11:28:05;81060370;80698877;361493;
16.01.2019;11:29:05;81060429;80699043;361386;
16.01.2019;11:30:05;81060476;80699164;361312;
16.01.2019;11:31:05;81060527;80699306;361221;
16.01.2019;11:32:05;81060581;80699433;361148;
16.01.2019;11:33:05;81060648;80699563;361085;
16.01.2019;11:34:04;81060695;80699692;361003;
16.01.2019;11:35:05;81060747;80699842;360905;
16.01.2019;11:36:05;81060780;80700007;360773;
16.01.2019;11:37:04;81060825;80700175;360650;
16.01.2019;11:38:04;81060887;80700353;360534;
16.01.2019;11:39:07;81060953;80700509;360444;
16.01.2019;11:40:05;81061007;80700652;360355;
16.01.2019;11:41:04;81061080;80700808;360272;
16.01.2019;11:42:04;81061123;80700953;360170;
16.01.2019;11:43:04;81061177;80701077;360100;
16.01.2019;11:44:05;81061236;80701228;360008;
16.01.2019;11:45:05;81061282;80701375;359907;
16.01.2019;11:46:05;81061346;80701542;359804;
16.01.2019;11:47:04;81061393;80701668;359725;
16.01.2019;11:48:04;81061446;80701814;359632;
16.01.2019;11:49:05;81061488;80701956;359532;
16.01.2019;11:50:05;81061543;80702073;359470;
16.01.2019;11:51:04;81061596;80702185;359411;
16.01.2019;11:52:04;81061635;80702325;359310;
16.01.2019;11:53:05;81061685;80702484;359201;
16.01.2019;11:54:05;81061745;80702635;359110;
16.01.2019;11:55:05;81061786;80702788;358998;
16.01.2019;11:56:05;81061822;80702936;358886;
16.01.2019;11:57:05;81061872;80703106;358766;
16.01.2019;11:58:05;81061914;80703230;358684;
16.01.2019;11:59:05;81061961;80703372;358589;
16.01.2019;12:00:05;81062016;80703524;358492;
16.01.2019;12:01:05;81062060;80703675;358385;
16.01.2019;12:02:04;81062110;80703824;358286;
16.01.2019;12:03:04;81062149;80703969;358180;
16.01.2019;12:04:04;81062213;80704097;358116;
16.01.2019;12:05:05;81062272;80704239;358033;
16.01.2019;12:06:05;81062330;80704351;357979;
16.01.2019;12:07:05;81062383;80704522;357861;
16.01.2019;12:08:05;81062418;80704639;357779;
16.01.2019;12:09:07;81062476;80704759;357717;
16.01.2019;12:10:05;81062531;80704893;357638;
16.01.2019;12:11:05;81062584;80705022;357562;
16.01.2019;12:12:05;81062636;80705174;357462;
16.01.2019;12:13:05;81062675;80705311;357364;
16.01.2019;12:14:04;81062703;80705381;357322;
16.01.2019;12:15:05;81062653;80705450;357203;
16.01.2019;12:16:05;81062628;80705527;357101;
16.01.2019;12:17:05;81062670;80705654;357016;
16.01.2019;12:18:04;81062729;80705797;356932;
16.01.2019;12:19:04;81062779;80705944;356835;
16.01.2019;12:20:05;81062839;80706100;356739;
16.01.2019;12:21:05;81062892;80706246;356646;
16.01.2019;12:22:05;81062943;80706420;356523;
16.01.2019;12:23:05;81062995;80706593;356402;
16.01.2019;12:24:05;81063046;80706744;356302;
16.01.2019;12:25:10;81063111;80706914;356197;
16.01.2019;12:26:04;81063169;80707047;356122;
16.01.2019;12:27:05;81063231;80707191;356040;
16.01.2019;12:28:05;81063280;80707313;355967;
16.01.2019;12:29:05;81063348;80707470;355878;
16.01.2019;12:30:04;81063394;80707612;355782;
16.01.2019;12:31:04;81063446;80707753;355693;
16.01.2019;12:32:05;81063518;80707913;355605;
16.01.2019;12:33:05;81063577;80708034;355543;
16.01.2019;12:34:04;81063638;80708182;355456;
16.01.2019;12:35:04;81063704;80708345;355359;
16.01.2019;12:36:05;81063768;80708508;355260;
16.01.2019;12:37:05;81063816;80708646;355170;
16.01.2019;12:38:05;81063867;80708795;355072;
16.01.2019;12:39:06;81063925;80708932;354993;
16.01.2019;12:40:04;81063991;80709061;354930;
16.01.2019;12:41:05;81064036;80709210;354826;
16.01.2019;12:42:04;81064102;80709356;354746;
16.01.2019;12:43:04;81064155;80709497;354658;
16.01.2019;12:44:05;81064212;80709645;354567;
16.01.2019;12:45:05;81064282;80709775;354507;
16.01.2019;12:46:04;81064353;80709909;354444;
16.01.2019;12:47:05;81064411;80710065;354346;
16.01.2019;12:48:05;81064464;80710203;354261;
16.01.2019;12:49:04;81064185;80710080;354105;
16.01.2019;12:50:05;81064013;80710017;353996;
16.01.2019;12:51:05;81064081;80710171;353910;
16.01.2019;12:52:05;81064141;80710310;353831;
16.01.2019;12:53:05;81064209;80710469;353740;
16.01.2019;12:54:04;81064265;80710622;353643;
16.01.2019;12:55:05;81064352;80710762;353590;
16.01.2019;12:56:05;81064428;80710925;353503;
16.01.2019;12:57:10;81064497;80711062;353435;
16.01.2019;12:58:04;81064539;80711183;353356;
16.01.2019;12:59:04;81064607;80711329;353278;
16.01.2019;13:00:04;81064656;80711471;353185;
16.01.2019;13:01:06;81064725;80711627;353098;
16.01.2019;13:02:05;81064765;80711771;352994;
16.01.2019;13:03:05;81064809;80711939;352870;
16.01.2019;13:04:04;81064871;80712076;352795;
16.01.2019;13:05:04;81064939;80712233;352706;
16.01.2019;13:06:10;81065031;80712401;352630;
16.01.2019;13:07:05;81065068;80712539;352529;
16.01.2019;13:08:05;81065132;80712689;352443;
16.01.2019;13:09:05;81065188;80712846;352342;
16.01.2019;13:10:05;81065255;80712995;352260;
16.01.2019;13:11:04;81065325;80713130;352195;
16.01.2019;13:12:04;81065391;80713268;352123;
16.01.2019;13:13:05;81065454;80713410;352044;
16.01.2019;13:14:04;81065500;80713539;351961;
16.01.2019;13:15:04;81065569;80713685;351884;
16.01.2019;13:16:05;81065625;80713849;351776;
16.01.2019;13:17:05;81065699;80714004;351695;
16.01.2019;13:18:05;81065760;80714163;351597;
16.01.2019;13:19:05;81065841;80714308;351533;
16.01.2019;13:20:04;81065918;80714442;351476;
16.01.2019;13:21:04;81065975;80714588;351387;
16.01.2019;13:22:05;81066037;80714736;351301;
16.01.2019;13:24:05;81066184;80715069;351115;
16.01.2019;13:25:05;81066233;80715233;351000;
16.01.2019;13:26:04;81066299;80715362;350937;
16.01.2019;13:27:04;81066368;80715524;350844;
16.01.2019;13:28:04;81066451;80715664;350787;
16.01.2019;13:29:04;81066522;80715811;350711;
16.01.2019;13:30:05;81066598;80715987;350611;
16.01.2019;13:31:05;81066660;80716116;350544;
16.01.2019;13:32:05;81066745;80716262;350483;
16.01.2019;13:33:04;81066827;80716446;350381;
16.01.2019;13:34:04;81066916;80716601;350315;
16.01.2019;13:35:05;81066990;80716788;350202;
16.01.2019;13:36:05;81067062;80716926;350136;
16.01.2019;13:37:05;81067147;80717093;350054;
16.01.2019;13:38:05;81067230;80717242;349988;
16.01.2019;13:39:08;81067312;80717401;349911;
16.01.2019;13:40:05;81067372;80717568;349804;
16.01.2019;13:41:04;81067456;80717745;349711;
16.01.2019;13:42:04;81067510;80717911;349599;
16.01.2019;13:43:05;81067588;80718075;349513;
16.01.2019;13:44:05;81067649;80718214;349435;
16.01.2019;13:45:05;81067722;80718358;349364;
16.01.2019;13:46:07;81067788;80718527;349261;
16.01.2019;13:47:13;81067847;80718698;349149;
16.01.2019;13:48:05;81067915;80718823;349092;
16.01.2019;13:49:05;81067982;80718959;349023;
16.01.2019;13:50:04;81068057;80719097;348960;
16.01.2019;13:51:04;81068129;80719245;348884;
16.01.2019;13:52:05;81068192;80719399;348793;
16.01.2019;13:53:05;81068269;80719561;348708;
16.01.2019;13:54:05;81068335;80719718;348617;
16.01.2019;13:55:10;81068414;80719871;348543;
16.01.2019;13:56:04;81068487;80720016;348471;
16.01.2019;13:57:04;81068566;80720193;348373;
16.01.2019;13:58:05;81068636;80720368;348268;
16.01.2019;13:59:05;81068717;80720519;348198;
16.01.2019;14:00:05;81068778;80720668;348110;
16.01.2019;14:01:05;81068857;80720833;348024;
16.01.2019;14:02:05;81068944;80720999;347945;
16.01.2019;14:03:05;81069018;80721151;347867;
16.01.2019;14:04:05;81069104;80721296;347808;
16.01.2019;14:05:05;81069184;80721451;347733;
16.01.2019;14:06:04;81069250;80721603;347647;
16.01.2019;14:07:04;81069321;80721783;347538;
16.01.2019;14:08:04;81069402;80721940;347462;
16.01.2019;14:09:05;81069481;80722096;347385;
16.01.2019;14:10:05;81069542;80722253;347289;
16.01.2019;14:11:05;81069577;80722355;347222;
16.01.2019;14:12:04;81069622;80722468;347154;
16.01.2019;14:13:05;81069656;80722591;347065;
16.01.2019;14:14:05;81069711;80722718;346993;
16.01.2019;14:15:05;81069771;80722834;346937;
16.01.2019;14:16:05;81069825;80722971;346854;
16.01.2019;14:17:05;81069894;80723116;346778;
16.01.2019;14:18:05;81069967;80723277;346690;
16.01.2019;14:19:04;81070033;80723433;346600;
16.01.2019;14:20:05;81070105;80723603;346502;
16.01.2019;14:21:05;81070186;80723764;346422;
16.01.2019;14:22:05;81070261;80723944;346317;
16.01.2019;14:23:05;81070332;80724114;346218;
16.01.2019;14:24:04;81070429;80724282;346147;
16.01.2019;14:25:06;81070505;80724444;346061;
16.01.2019;14:26:05;81070585;80724586;345999;
16.01.2019;14:27:04;81070668;80724749;345919;
16.01.2019;14:28:04;81070754;80724913;345841;
16.01.2019;14:29:04;81070835;80725073;345762;
16.01.2019;14:30:11;81070897;80725250;345647;
16.01.2019;14:31:04;81070971;80725420;345551;
16.01.2019;14:32:04;81071053;80725590;345463;
16.01.2019;14:33:04;81071143;80725758;345385;
16.01.2019;14:34:04;81071218;80725920;345298;
16.01.2019;14:35:05;81071305;80726094;345211;
16.01.2019;14:36:05;81071374;80726260;345114;
16.01.2019;14:37:05;81071449;80726440;345009;
16.01.2019;14:38:05;81071538;80726627;344911;
16.01.2019;14:39:06;81071612;80726792;344820;
16.01.2019;14:40:05;81071681;80726955;344726;
16.01.2019;14:41:05;81071764;80727094;344670;
16.01.2019;14:42:04;81071854;80727235;344619;
16.01.2019;14:43:04;81071945;80727410;344535;
16.01.2019;14:44:05;81072025;80727575;344450;
16.01.2019;14:45:05;81072099;80727730;344369;
16.01.2019;14:46:04;81072193;80727896;344297;
16.01.2019;14:47:04;81072290;80728078;344212;
16.01.2019;14:48:04;81072362;80728242;344120;
16.01.2019;14:49:05;81072462;80728460;344002;
16.01.2019;14:50:05;81072540;80728639;343901;
16.01.2019;14:51:05;81072617;80728818;343799;
16.01.2019;14:52:05;81072706;80728970;343736;
16.01.2019;14:53:05;81072804;80729153;343651;
16.01.2019;14:54:05;81072874;80729317;343557;
16.01.2019;14:55:05;81072968;80729502;343466;
16.01.2019;14:56:06;81073041;80729632;343409;
16.01.2019;14:57:05;81073117;80729819;343298;
16.01.2019;14:58:05;81073201;80729992;343209;
16.01.2019;15:00:07;81073373;80730361;343012;
16.01.2019;15:01:08;81073429;80730536;342893;
16.01.2019;15:02:07;81073501;80730702;342799;
16.01.2019;15:03:08;81073574;80730862;342712;
16.01.2019;15:04:07;81073657;80731039;342618;
16.01.2019;15:05:08;81073772;80731221;342551;
16.01.2019;15:06:07;81073861;80731395;342466;
16.01.2019;15:07:07;81073929;80731525;342404;
16.01.2019;15:08:08;81074014;80731677;342337;
16.01.2019;15:09:08;81074101;80731837;342264;
16.01.2019;15:10:08;81074189;80732013;342176;
16.01.2019;15:12:13;81074336;80732368;341968;
16.01.2019;15:13:08;81074418;80732530;341888;
16.01.2019;15:14:08;81074500;80732691;341809;
16.01.2019;15:15:09;81074583;80732864;341719;
16.01.2019;15:16:08;81074665;80733036;341629;
16.01.2019;15:17:07;81074748;80733213;341535;
16.01.2019;15:18:11;81074847;80733393;341454;
16.01.2019;15:19:08;81074926;80733548;341378;
16.01.2019;15:20:07;81075017;80733728;341289;
16.01.2019;15:21:08;81075105;80733928;341177;
16.01.2019;15:22:08;81075200;80734087;341113;
16.01.2019;15:23:06;81075277;80734256;341021;
16.01.2019;15:24:08;81075370;80734428;340942;
16.01.2019;15:25:08;81075460;80734591;340869;
16.01.2019;15:26:08;81075541;80734798;340743;
16.01.2019;15:27:08;81075624;80734978;340646;
16.01.2019;15:29:07;81075785;80735338;340447;
16.01.2019;15:30:07;81075849;80735520;340329;
16.01.2019;15:31:07;81075945;80735678;340267;
16.01.2019;15:32:08;81076008;80735871;340137;
16.01.2019;15:33:07;81076071;80736043;340028;
16.01.2019;15:34:08;81076144;80736191;339953;
16.01.2019;15:35:07;81076229;80736359;339870;
16.01.2019;15:36:07;81076327;80736527;339800;
16.01.2019;15:37:07;81076401;80736694;339707;
16.01.2019;15:38:07;81076478;80736849;339629;
16.01.2019;15:39:08;81076560;80737032;339528;
16.01.2019;15:40:06;81076617;80737212;339405;
16.01.2019;15:41:07;81076698;80737372;339326;
16.01.2019;15:42:07;81076795;80737545;339250;
16.01.2019;15:43:08;81076879;80737727;339152;
16.01.2019;15:44:08;81076970;80737915;339055;
16.01.2019;15:45:08;81077052;80738081;338971;
16.01.2019;15:46:08;81077133;80738239;338894;
16.01.2019;15:47:08;81077193;80738436;338757;
16.01.2019;15:48:06;81077291;80738607;338684;
16.01.2019;15:49:08;81077391;80738794;338597;
16.01.2019;15:50:08;81077468;80738952;338516;
16.01.2019;15:51:13;81077546;80739147;338399;
16.01.2019;15:52:14;81077635;80739315;338320;
16.01.2019;15:53:14;81077709;80739491;338218;
16.01.2019;15:54:11;81077774;80739668;338106;
16.01.2019;15:55:12;81077839;80739830;338009;
16.01.2019;15:56:12;81077917;80740010;337907;
16.01.2019;15:57:13;81078016;80740171;337845;
16.01.2019;15:59:12;81078172;80740546;337626;
16.01.2019;16:00:12;81078244;80740749;337495;
16.01.2019;16:01:08;81078314;80740927;337387;
16.01.2019;16:02:08;81078382;80741101;337281;
16.01.2019;16:03:09;81078459;80741288;337171;
16.01.2019;16:04:10;81078562;80741450;337112;
16.01.2019;16:05:09;81078654;80741640;337014;
16.01.2019;16:06:08;81078735;80741815;336920;
16.01.2019;16:07:09;81078818;80741972;336846;
16.01.2019;16:08:10;81078892;80742184;336708;
16.01.2019;16:09:10;81078977;80742336;336641;
16.01.2019;16:10:15;81079081;80742523;336558;
16.01.2019;16:11:11;81079155;80742682;336473;
16.01.2019;16:12:09;81079223;80742864;336359;
16.01.2019;16:13:08;81079296;80743042;336254;
16.01.2019;16:14:10;81079375;80743220;336155;
16.01.2019;16:15:09;81079438;80743402;336036;
16.01.2019;16:16:10;81079509;80743590;335919;
16.01.2019;16:17:10;81079534;80743712;335822;
16.01.2019;16:18:11;81079545;80743802;335743;
16.01.2019;16:19:10;81079571;80743943;335628;
16.01.2019;16:20:11;81079596;80744050;335546;
16.01.2019;16:21:10;81079666;80744221;335445;
16.01.2019;16:22:10;81079747;80744384;335363;
16.01.2019;16:23:10;81079838;80744564;335274;
16.01.2019;16:24:10;81079950;80744744;335206;
16.01.2019;16:25:11;81080057;80744921;335136;
16.01.2019;16:26:12;81080181;80745078;335103;
16.01.2019;16:27:11;81080252;80745240;335012;
16.01.2019;16:28:10;81080360;80745412;334948;
16.01.2019;16:29:10;81080440;80745621;334819;
16.01.2019;16:30:16;81080508;80745804;334704;
16.01.2019;16:31:11;81080602;80745982;334620;
16.01.2019;16:32:08;81080674;80746156;334518;
16.01.2019;16:33:09;81080762;80746340;334422;
16.01.2019;16:34:09;81080855;80746530;334325;
16.01.2019;16:35:09;81080933;80746701;334232;
16.01.2019;16:36:09;81081035;80746852;334183;
16.01.2019;16:37:11;81081123;80747064;334059;
16.01.2019;16:38:10;81081205;80747261;333944;
16.01.2019;16:39:08;81081292;80747425;333867;
16.01.2019;16:40:09;81081373;80747576;333797;
16.01.2019;16:41:12;81081465;80747752;333713;
16.01.2019;16:42:10;81081548;80747905;333643;
16.01.2019;16:43:11;81081628;80748082;333546;
16.01.2019;16:44:11;81081719;80748274;333445;
16.01.2019;16:45:09;81081817;80748469;333348;
16.01.2019;16:46:09;81081895;80748637;333258;
16.01.2019;16:47:13;81081985;80748814;333171;
16.01.2019;16:48:09;81082061;80749007;333054;
16.01.2019;16:49:09;81082153;80749177;332976;
16.01.2019;16:50:10;81082266;80749354;332912;
16.01.2019;16:51:11;81082379;80749529;332850;
16.01.2019;16:52:11;81082449;80749706;332743;
16.01.2019;16:53:10;81082526;80749862;332664;
16.01.2019;16:54:10;81082603;80750027;332576;
16.01.2019;16:55:10;81082704;80750194;332510;
16.01.2019;16:56:10;81082796;80750379;332417;
16.01.2019;16:57:09;81082868;80750562;332306;
16.01.2019;16:58:10;81082972;80750747;332225;
16.01.2019;16:59:10;81083059;80750928;332131;
16.01.2019;17:00:11;81083138;80751103;332035;
16.01.2019;17:01:11;81083211;80751249;331962;
16.01.2019;17:03:08;81083371;80751569;331802;
16.01.2019;17:04:08;81083454;80751748;331706;
16.01.2019;17:05:11;81083529;80751944;331585;
16.01.2019;17:06:09;81083614;80752117;331497;
16.01.2019;17:07:11;81083718;80752303;331415;
16.01.2019;17:08:10;81083812;80752478;331334;
16.01.2019;17:09:12;81083899;80752665;331234;
16.01.2019;17:10:09;81083971;80752815;331156;
16.01.2019;17:12:09;81084152;80753177;330975;
16.01.2019;17:13:10;81084254;80753354;330900;
16.01.2019;17:14:09;81084339;80753542;330797;
16.01.2019;17:15:11;81084408;80753702;330706;
16.01.2019;17:16:11;81084498;80753860;330638;
16.01.2019;17:17:09;81084581;80754038;330543;
16.01.2019;17:18:11;81084648;80754212;330436;
16.01.2019;17:19:11;81084758;80754386;330372;
16.01.2019;17:20:11;81084843;80754603;330240;
16.01.2019;17:21:09;81084925;80754778;330147;
16.01.2019;17:22:09;81085039;80754951;330088;
16.01.2019;17:23:08;81085126;80755128;329998;
16.01.2019;17:24:10;81085233;80755314;329919;
16.01.2019;17:25:11;81085336;80755490;329846;
16.01.2019;17:26:11;81085425;80755672;329753;
16.01.2019;17:27:23;81085530;80755917;329613;
16.01.2019;17:28:09;81085604;80756040;329564;
16.01.2019;17:29:12;81085687;80756203;329484;
16.01.2019;17:30:11;81085781;80756355;329426;
16.01.2019;17:31:11;81085871;80756513;329358;
16.01.2019;17:32:10;81085976;80756695;329281;
16.01.2019;17:33:08;81086066;80756878;329188;
16.01.2019;17:34:07;81086157;80757024;329133;
16.01.2019;17:35:09;81086245;80757201;329044;
16.01.2019;17:36:09;81086341;80757370;328971;
16.01.2019;17:37:10;81086448;80757546;328902;
16.01.2019;17:38:15;81086532;80757717;328815;
16.01.2019;17:39:15;81086644;80757931;328713;
16.01.2019;17:40:10;81086722;80758102;328620;
16.01.2019;17:41:09;81086814;80758265;328549;
16.01.2019;17:42:10;81086880;80758430;328450;
16.01.2019;17:43:10;81087003;80758593;328410;
16.01.2019;17:44:11;81087085;80758736;328349;
16.01.2019;17:45:10;81087186;80758912;328274;
16.01.2019;17:46:11;81087263;80759080;328183;
16.01.2019;17:47:11;81087354;80759222;328132;
16.01.2019;17:48:10;81087427;80759388;328039;
16.01.2019;17:49:12;81087534;80759558;327976;
16.01.2019;17:51:17;81087732;80759913;327819;
16.01.2019;17:52:13;81087820;80760029;327791;
16.01.2019;17:53:12;81087910;80760192;327718;
16.01.2019;17:54:19;81088002;80760353;327649;
16.01.2019;17:55:16;81088081;80760502;327579;
16.01.2019;17:56:18;81088170;80760650;327520;
16.01.2019;17:57:17;81088256;80760786;327470;
16.01.2019;17:58:14;81088358;80760946;327412;
16.01.2019;17:59:13;81088451;80761111;327340;
16.01.2019;18:00:11;81088548;80761271;327277;
16.01.2019;18:01:10;81088634;80761442;327192;
16.01.2019;18:02:09;81088746;80761585;327161;
16.01.2019;18:03:10;81088828;80761730;327098;
16.01.2019;18:04:10;81088929;80761895;327034;
16.01.2019;18:05:11;81089044;80762059;326985;
16.01.2019;18:06:11;81089128;80762212;326916;
16.01.2019;18:07:11;81089215;80762362;326853;
16.01.2019;18:08:12;81089296;80762502;326794;
16.01.2019;18:09:10;81089376;80762642;326734;
16.01.2019;18:10:08;81089447;80762798;326649;
16.01.2019;18:11:11;81089558;80762958;326600;
16.01.2019;18:12:11;81089665;80763127;326538;
16.01.2019;18:13:11;81089747;80763276;326471;
16.01.2019;18:14:11;81089844;80763423;326421;
16.01.2019;18:15:11;81089945;80763587;326358;
16.01.2019;18:16:13;81090035;80763747;326288;
16.01.2019;18:17:09;81090123;80763876;326247;
16.01.2019;18:18:10;81090248;80764040;326208;
16.01.2019;18:19:10;81090321;80764169;326152;
16.01.2019;18:20:10;81090397;80764316;326081;
16.01.2019;18:21:10;81090492;80764439;326053;
16.01.2019;18:22:12;81090591;80764597;325994;
16.01.2019;18:23:09;81090692;80764726;325966;
16.01.2019;18:24:10;81090760;80764859;325901;
16.01.2019;18:25:11;81090806;80764967;325839;
16.01.2019;18:26:16;81090882;80765076;325806;
16.01.2019;18:27:11;81090940;80765186;325754;
16.01.2019;18:28:13;81090973;80765273;325700;
16.01.2019;18:29:10;81091034;80765389;325645;
16.01.2019;18:30:11;81091055;80765481;325574;
16.01.2019;18:31:11;81091120;80765600;325520;
16.01.2019;18:32:11;81091199;80765735;325464;
16.01.2019;18:33:10;81091288;80765871;325417;
16.01.2019;18:34:09;81091351;80765992;325359;
16.01.2019;18:35:11;81091428;80766118;325310;
16.01.2019;18:36:11;81091513;80766247;325266;
16.01.2019;18:37:09;81091588;80766398;325190;
16.01.2019;18:38:10;81091681;80766501;325180;
16.01.2019;18:39:09;81091691;80766591;325100;
16.01.2019;18:40:06;81091781;80766714;325067;
16.01.2019;18:41:10;81091870;80766851;325019;
16.01.2019;18:42:08;81091964;80766972;324992;
16.01.2019;18:43:10;81092057;80767092;324965;
16.01.2019;18:44:09;81092152;80767197;324955;
16.01.2019;18:45:09;81092227;80767333;324894;
16.01.2019;18:46:08;81092302;80767471;324831;
16.01.2019;18:47:11;81092290;80767596;324694;
16.01.2019;18:48:10;81092319;80767675;324644;
16.01.2019;18:49:08;81092382;80767798;324584;
16.01.2019;18:50:05;81092415;80767917;324498;
16.01.2019;18:51:09;81092492;80768036;324456;
16.01.2019;18:52:16;81092553;80768154;324399;
16.01.2019;18:53:11;81092621;80768246;324375;
16.01.2019;18:54:09;81092685;80768376;324309;
16.01.2019;18:55:12;81092746;80768501;324245;
16.01.2019;18:56:11;81092808;80768628;324180;
16.01.2019;18:57:10;81092870;80768735;324135;
16.01.2019;18:58:16;81092951;80768886;324065;
16.01.2019;18:59:10;81093008;80768970;324038;
16.01.2019;19:00:11;81093087;80769106;323981;
16.01.2019;19:01:13;81093125;80769263;323862;
16.01.2019;19:02:08;81093195;80769373;323822;
16.01.2019;19:03:09;81093254;80769500;323754;
16.01.2019;19:04:17;81093329;80769623;323706;
16.01.2019;19:05:11;81093411;80769726;323685;
16.01.2019;19:06:12;81093446;80769843;323603;
16.01.2019;19:07:09;81093510;80769950;323560;
16.01.2019;19:08:10;81093591;80770079;323512;
16.01.2019;19:09:11;81093670;80770184;323486;
16.01.2019;19:10:11;81093748;80770305;323443;
16.01.2019;19:11:11;81093803;80770410;323393;
16.01.2019;19:12:12;81093868;80770517;323351;
16.01.2019;19:13:12;81093959;80770639;323320;
16.01.2019;19:14:09;81094010;80770759;323251;
16.01.2019;19:15:17;81094088;80770888;323200;
16.01.2019;19:16:18;81094151;80771005;323146;
16.01.2019;19:17:18;81094227;80771112;323115;
16.01.2019;19:18:13;81094287;80771212;323075;
16.01.2019;19:19:15;81094354;80771315;323039;
16.01.2019;19:20:09;81094416;80771418;322998;
16.01.2019;19:21:11;81094519;80771532;322987;
16.01.2019;19:22:12;81094593;80771650;322943;
16.01.2019;19:23:09;81094641;80771748;322893;
16.01.2019;19:24:09;81094719;80771870;322849;
16.01.2019;19:25:11;81094791;80771950;322841;
16.01.2019;19:26:10;81094875;80772040;322835;
16.01.2019;19:27:11;81094952;80772143;322809;
16.01.2019;19:28:10;81095032;80772235;322797;
16.01.2019;19:29:11;81095095;80772342;322753;
16.01.2019;19:31:09;81095267;80772542;322725;
16.01.2019;19:32:10;81095335;80772668;322667;
16.01.2019;19:33:11;81095411;80772757;322654;
16.01.2019;19:34:11;81095492;80772839;322653;
16.01.2019;19:35:12;81095565;80772955;322610;
16.01.2019;19:36:10;81095641;80773055;322586;
16.01.2019;19:37:10;81095715;80773161;322554;
16.01.2019;19:38:11;81095792;80773250;322542;
16.01.2019;19:39:08;81095888;80773349;322539;
16.01.2019;19:40:10;81095956;80773441;322515;
16.01.2019;19:41:11;81096023;80773538;322485;
16.01.2019;19:42:11;81096087;80773628;322459;
16.01.2019;19:43:11;81096168;80773728;322440;
16.01.2019;19:44:09;81096233;80773836;322397;
16.01.2019;19:45:09;81096295;80773926;322369;
16.01.2019;19:46:11;81096357;80774016;322341;
16.01.2019;19:47:14;81096417;80774091;322326;
16.01.2019;19:48:11;81096489;80774164;322325;
16.01.2019;19:49:12;81096551;80774249;322302;
16.01.2019;19:50:10;81096622;80774337;322285;
16.01.2019;19:51:10;81096700;80774419;322281;
16.01.2019;19:52:11;81096780;80774507;322273;
16.01.2019;19:53:15;81096872;80774577;322295;
16.01.2019;19:54:11;81096949;80774669;322280;
16.01.2019;19:55:11;81097021;80774736;322285;
16.01.2019;19:56:12;81097098;80774823;322275;
16.01.2019;19:57:10;81097173;80774912;322261;
16.01.2019;19:58:18;81097271;80775005;322266;
16.01.2019;19:59:17;81097365;80775090;322275;
16.01.2019;20:00:25;81097454;80775181;322273;
16.01.2019;20:01:19;81097519;80775259;322260;
16.01.2019;20:03:20;81099417;80775421;323996;
16.01.2019;20:04:18;81099500;80781200;318300;
16.01.2019;20:05:18;81099565;80781256;318309;
16.01.2019;20:06:21;81099642;80781323;318319;
16.01.2019;20:07:24;81099734;80781397;318337;
16.01.2019;20:08:19;81099817;80781467;318350;
16.01.2019;20:09:18;81099888;80781537;318351;
16.01.2019;20:10:18;81099953;80781618;318335;
16.01.2019;20:11:19;81100049;80781676;318373;
16.01.2019;20:12:20;81100126;80781748;318378;
16.01.2019;20:13:09;81100179;80781795;318384;
16.01.2019;20:19:04;81100343;80781896;318447;
16.01.2019;20:20:05;81100407;80781935;318472;
16.01.2019;20:21:05;81100476;80782007;318469;
16.01.2019;20:22:05;81100548;80782070;318478;
16.01.2019;20:23:05;81100633;80782156;318477;
16.01.2019;20:24:05;81100735;80782227;318508;
16.01.2019;20:25:05;81100804;80782287;318517;
16.01.2019;20:26:05;81100893;80782367;318526;
16.01.2019;20:27:04;81100950;80782436;318514;
16.01.2019;20:28:05;81101036;80782496;318540;
16.01.2019;20:29:05;81101134;80782561;318573;
16.01.2019;20:30:05;81101226;80782637;318589;
16.01.2019;20:31:05;81101299;80782716;318583;
16.01.2019;20:32:05;81101393;80782791;318602;
16.01.2019;20:33:05;81101471;80782873;318598;
16.01.2019;20:37:05;81101816;80783141;318675;
16.01.2019;20:38:05;81101908;80783202;318706;
16.01.2019;20:39:05;81101977;80783272;318705;
16.01.2019;20:40:05;81102072;80783342;318730;
16.01.2019;20:41:06;81102154;80783406;318748;
16.01.2019;20:42:05;81102247;80783469;318778;
16.01.2019;20:43:05;81102345;80783529;318816;
16.01.2019;20:44:04;81102428;80783592;318836;
16.01.2019;20:45:04;81102493;80783651;318842;
16.01.2019;20:46:05;81102566;80783704;318862;
16.01.2019;20:47:05;81102642;80783760;318882;
16.01.2019;20:48:05;81102728;80783805;318923;
16.01.2019;20:49:05;81102826;80783870;318956;
16.01.2019;20:50:04;81102898;80783926;318972;
16.01.2019;20:51:05;81102979;80783984;318995;
16.01.2019;20:53:05;81103156;80784115;319041;
16.01.2019;20:54:05;81103242;80784161;319081;
16.01.2019;20:55:05;81103316;80784213;319103;
16.01.2019;20:56:05;81103405;80784275;319130;
16.01.2019;20:57:05;81103496;80784324;319172;
16.01.2019;20:58:05;81103583;80784380;319203;
16.01.2019;20:59:04;81103677;80784440;319237;
16.01.2019;21:00:04;81103742;80784493;319249;
16.01.2019;21:01:04;81103833;80784528;319305;
16.01.2019;21:02:05;81103910;80784577;319333;
16.01.2019;21:03:05;81103988;80784614;319374;
16.01.2019;21:04:05;81104057;80784666;319391;
16.01.2019;21:05:05;81104139;80784718;319421;
16.01.2019;21:06:05;81104215;80784764;319451;
16.01.2019;21:07:05;81104296;80784814;319482;
16.01.2019;21:09:05;81104431;80784917;319514;
16.01.2019;21:10:05;81104517;80784979;319538;
16.01.2019;21:11:05;81104595;80785020;319575;
16.01.2019;21:12:05;81104654;80785055;319599;
16.01.2019;21:13:04;81104721;80785112;319609;
16.01.2019;21:14:04;81104809;80785169;319640;
16.01.2019;21:15:04;81104909;80785205;319704;
16.01.2019;21:16:04;81104992;80785261;319731;
16.01.2019;21:17:05;81105066;80785297;319769;
16.01.2019;21:18:04;81105152;80785350;319802;
16.01.2019;21:19:04;81105206;80785390;319816;
16.01.2019;21:20:04;81105280;80785439;319841;
16.01.2019;21:21:04;81105353;80785484;319869;
16.01.2019;21:22:05;81105444;80785532;319912;
16.01.2019;21:23:06;81105519;80785583;319936;
16.01.2019;21:26:06;81106425;80787867;318558;
16.01.2019;21:27:05;81106528;80787913;318615;
16.01.2019;21:28:04;81106622;80787952;318670;
16.01.2019;21:29:05;81106718;80788004;318714;
16.01.2019;21:30:05;81106806;80788062;318744;
16.01.2019;21:31:05;81106894;80788107;318787;
16.01.2019;21:32:05;81106999;80788155;318844;
16.01.2019;21:33:05;81107081;80788208;318873;
16.01.2019;21:34:05;81107161;80788253;318908;
16.01.2019;21:35:05;81107229;80788300;318929;
16.01.2019;21:36:05;81107324;80788356;318968;
16.01.2019;21:37:05;81107409;80788411;318998;
16.01.2019;21:38:05;81107498;80788445;319053;
16.01.2019;21:39:05;81107544;80788429;319115;
16.01.2019;21:40:05;81107579;80788458;319121;
16.01.2019;21:42:05;81107749;80788531;319218;
16.01.2019;21:43:05;81107837;80788565;319272;
16.01.2019;21:44:05;81107909;80788621;319288;
16.01.2019;21:45:05;81108006;80788653;319353;
16.01.2019;21:46:05;81108123;80788687;319436;
16.01.2019;21:47:05;81108211;80788737;319474;
16.01.2019;21:48:17;81108313;80788776;319537;
16.01.2019;21:49:17;81108374;80788819;319555;
16.01.2019;21:50:13;81108470;80788865;319605;
16.01.2019;21:51:16;81108537;80788903;319634;
16.01.2019;21:52:17;81108615;80788943;319672;
16.01.2019;21:53:17;81108695;80788983;319712;
16.01.2019;21:54:19;81108773;80789032;319741;
16.01.2019;21:55:14;81108854;80789056;319798;
16.01.2019;21:56:18;81108932;80789106;319826;
16.01.2019;21:57:22;81109011;80789156;319855;
16.01.2019;21:58:16;81109083;80789191;319892;
16.01.2019;21:59:12;81109174;80789219;319955;
16.01.2019;22:00:12;81109251;80789260;319991;
16.01.2019;22:01:11;81109306;80789294;320012;
16.01.2019;22:02:09;81109367;80789338;320029;
16.01.2019;22:03:17;81109453;80789382;320071;
16.01.2019;22:04:12;81109527;80789426;320101;
16.01.2019;22:05:11;81109619;80789451;320168;
16.01.2019;22:06:10;81109689;80789473;320216;
16.01.2019;22:07:10;81109759;80789505;320254;
16.01.2019;22:08:11;81109829;80789548;320281;
16.01.2019;22:09:11;81109906;80789569;320337;
16.01.2019;22:10:11;81109981;80789608;320373;
16.01.2019;22:11:09;81110055;80789636;320419;
16.01.2019;22:12:10;81110127;80789669;320458;
16.01.2019;22:13:11;81110223;80789705;320518;
16.01.2019;22:14:11;81110291;80789743;320548;
16.01.2019;22:15:12;81110368;80789767;320601;
16.01.2019;22:16:09;81110430;80789797;320633;
16.01.2019;22:17:09;81110501;80789828;320673;
16.01.2019;22:18:06;81110566;80789856;320710;
16.01.2019;22:19:11;81110606;80789877;320729;
16.01.2019;22:20:11;81110633;80789886;320747;
16.01.2019;22:21:10;81110664;80789889;320775;
16.01.2019;22:22:10;81110679;80789885;320794;
16.01.2019;22:23:11;81110712;80789902;320810;
16.01.2019;22:24:12;81110765;80789921;320844;
16.01.2019;22:25:11;81110845;80789960;320885;
16.01.2019;22:26:12;81110926;80789992;320934;
16.01.2019;22:27:12;81111005;80790022;320983;
16.01.2019;22:28:11;81111070;80790052;321018;
16.01.2019;22:29:11;81111112;80790082;321030;
16.01.2019;22:30:11;81111195;80790102;321093;
16.01.2019;22:31:10;81111268;80790130;321138;
16.01.2019;22:32:13;81111329;80790145;321184;
16.01.2019;22:33:11;81111407;80790175;321232;
16.01.2019;22:34:07;81111480;80790191;321289;
16.01.2019;22:35:06;81111556;80790227;321329;
16.01.2019;22:36:05;81111628;80790259;321369;
16.01.2019;22:37:05;81111711;80790285;321426;
16.01.2019;22:38:05;81111806;80790316;321490;
16.01.2019;22:39:05;81111890;80790350;321540;
16.01.2019;22:40:05;81111955;80790394;321561;
16.01.2019;22:41:05;81112018;80790431;321587;
16.01.2019;22:42:05;81112092;80790460;321632;
16.01.2019;22:43:05;81112170;80790487;321683;
16.01.2019;22:44:05;81112258;80790512;321746;
16.01.2019;22:45:05;81112335;80790543;321792;
16.01.2019;22:46:05;81112432;80790570;321862;
16.01.2019;22:47:05;81112501;80790613;321888;
16.01.2019;22:48:04;81112593;80790637;321956;
16.01.2019;22:49:05;81112690;80790658;322032;
16.01.2019;22:50:05;81112783;80790676;322107;
16.01.2019;22:51:05;81112857;80790706;322151;
16.01.2019;22:52:05;81112959;80790741;322218;
16.01.2019;22:53:05;81113044;80790769;322275;
16.01.2019;22:54:05;81113152;80790794;322358;
16.01.2019;22:55:05;81113226;80790832;322394;
16.01.2019;22:56:05;81113313;80790857;322456;
16.01.2019;22:57:05;81113411;80790880;322531;
16.01.2019;22:58:05;81113477;80790915;322562;
16.01.2019;22:59:05;81113569;80790944;322625;
16.01.2019;23:00:04;81113632;80790961;322671;
16.01.2019;23:01:05;81113736;80790983;322753;
16.01.2019;23:02:04;81113804;80790998;322806;
16.01.2019;23:03:05;81113903;80791035;322868;
16.01.2019;23:04:04;81113980;80791062;322918;
16.01.2019;23:05:05;81114074;80791086;322988;
16.01.2019;23:06:05;81114129;80791113;323016;
16.01.2019;23:07:05;81114207;80791146;323061;
16.01.2019;23:08:05;81114295;80791168;323127;
16.01.2019;23:09:06;81114405;80791187;323218;
16.01.2019;23:10:04;81114477;80791222;323255;
16.01.2019;23:11:04;81114575;80791238;323337;
16.01.2019;23:12:06;81114688;80791268;323420;
16.01.2019;23:13:05;81114753;80791296;323457;
16.01.2019;23:14:05;81114852;80791315;323537;
16.01.2019;23:15:05;81114955;80791348;323607;
16.01.2019;23:16:05;81115033;80791374;323659;
16.01.2019;23:17:04;81115105;80791402;323703;
16.01.2019;23:18:04;81115196;80791436;323760;
16.01.2019;23:19:05;81115286;80791459;323827;
16.01.2019;23:20:04;81115361;80791479;323882;
16.01.2019;23:21:05;81115467;80791499;323968;
16.01.2019;23:22:05;81115562;80791523;324039;
16.01.2019;23:23:05;81115638;80791541;324097;
16.01.2019;23:24:04;81115712;80791566;324146;
16.01.2019;23:25:04;81115807;80791597;324210;
16.01.2019;23:26:04;81115881;80791614;324267;
16.01.2019;23:27:04;81115964;80791653;324311;
16.01.2019;23:28:04;81116041;80791676;324365;
16.01.2019;23:29:05;81116116;80791696;324420;
16.01.2019;23:30:05;81116203;80791717;324486;
16.01.2019;23:31:05;81116271;80791732;324539;
16.01.2019;23:32:05;81116349;80791750;324599;
16.01.2019;23:33:04;81116434;80791775;324659;
16.01.2019;23:34:04;81116524;80791799;324725;
16.01.2019;23:35:05;81116610;80791827;324783;
16.01.2019;23:36:05;81116707;80791859;324848;
16.01.2019;23:37:05;81116804;80791883;324921;
16.01.2019;23:38:05;81116901;80791907;324994;
16.01.2019;23:39:05;81116976;80791941;325035;
16.01.2019;23:40:05;81117059;80791961;325098;
16.01.2019;23:41:05;81117126;80791987;325139;
16.01.2019;23:42:05;81117206;80792014;325192;
16.01.2019;23:43:05;81117287;80792048;325239;
16.01.2019;23:44:05;81117359;80792066;325293;
16.01.2019;23:45:05;81117447;80792087;325360;
16.01.2019;23:46:04;81117542;80792107;325435;
16.01.2019;23:47:04;81117632;80792136;325496;
16.01.2019;23:48:05;81117713;80792162;325551;
16.01.2019;23:49:04;81117791;80792178;325613;
16.01.2019;23:50:04;81117880;80792199;325681;
16.01.2019;23:51:05;81117953;80792220;325733;
16.01.2019;23:52:05;81118029;80792247;325782;
16.01.2019;23:53:04;81118130;80792272;325858;
16.01.2019;23:54:05;81118231;80792290;325941;
16.01.2019;23:55:05;81118303;80792317;325986;
16.01.2019;23:56:05;81118381;80792336;326045;
16.01.2019;23:57:05;81118456;80792364;326092;
16.01.2019;23:58:05;81118568;80792393;326175;
16.01.2019;23:59:05;81118674;80792409;326265;
17.01.2019;00:00:07;81118765;80792435;326330;
17.01.2019;00:01:07;81118858;80792473;326385;
17.01.2019;00:02:08;81118942;80792503;326439;
17.01.2019;00:03:07;81119026;80792530;326496;
17.01.2019;00:04:07;81119085;80792552;326533;
17.01.2019;00:05:09;81119163;80792584;326579;
17.01.2019;00:06:08;81119239;80792614;326625;
17.01.2019;00:07:08;81119320;80792637;326683;
17.01.2019;00:08:07;81119399;80792652;326747;
17.01.2019;00:09:07;81119470;80792677;326793;
17.01.2019;00:10:07;81119548;80792688;326860;
17.01.2019;00:11:08;81119653;80792714;326939;
17.01.2019;00:12:07;81119710;80792738;326972;
17.01.2019;00:13:07;81119807;80792766;327041;
17.01.2019;00:14:07;81119893;80792784;327109;
17.01.2019;00:15:07;81119957;80792815;327142;
17.01.2019;00:16:08;81119970;80792825;327145;
17.01.2019;00:17:07;81119983;80792842;327141;
17.01.2019;00:18:08;81120009;80792845;327164;
17.01.2019;00:19:08;81120066;80792848;327218;
17.01.2019;00:20:07;81120118;80792856;327262;
17.01.2019;00:21:07;81120174;80792877;327297;
17.01.2019;00:22:08;81120239;80792900;327339;
17.01.2019;00:23:07;81120321;80792926;327395;
17.01.2019;00:24:07;81120409;80792951;327458;
17.01.2019;00:25:08;81120467;80792966;327501;
17.01.2019;00:26:07;81120545;80793002;327543;
17.01.2019;00:27:08;81120628;80793023;327605;
17.01.2019;00:28:08;81120700;80793048;327652;
17.01.2019;00:29:09;81120807;80793079;327728;
17.01.2019;00:30:09;81120892;80793103;327789;
17.01.2019;00:31:12;81120963;80793123;327840;
17.01.2019;00:32:07;81121045;80793140;327905;
17.01.2019;00:33:07;81121137;80793165;327972;
17.01.2019;00:34:08;81121215;80793186;328029;
17.01.2019;00:35:07;81121307;80793214;328093;
17.01.2019;00:36:07;81121392;80793238;328154;
17.01.2019;00:37:07;81121467;80793258;328209;
17.01.2019;00:38:08;81121534;80793284;328250;
17.01.2019;00:39:09;81121611;80793308;328303;
17.01.2019;00:40:06;81121684;80793325;328359;
17.01.2019;00:41:07;81121753;80793349;328404;
17.01.2019;00:42:07;81121758;80793322;328436;
17.01.2019;00:43:08;81121831;80793351;328480;
17.01.2019;00:44:07;81121909;80793368;328541;
17.01.2019;00:45:08;81121982;80793389;328593;
17.01.2019;00:46:08;81122041;80793410;328631;
17.01.2019;00:47:07;81122116;80793432;328684;
17.01.2019;00:48:07;81122204;80793455;328749;
17.01.2019;00:49:07;81122286;80793487;328799;
17.01.2019;00:50:08;81122360;80793525;328835;
17.01.2019;00:51:08;81122426;80793545;328881;
17.01.2019;00:52:09;81122492;80793565;328927;
17.01.2019;00:53:07;81122564;80793590;328974;
17.01.2019;00:54:07;81122649;80793614;329035;
17.01.2019;00:55:08;81122730;80793635;329095;
17.01.2019;00:56:07;81122791;80793675;329116;
17.01.2019;00:57:07;81122864;80793701;329163;
17.01.2019;00:58:08;81122926;80793733;329193;
17.01.2019;00:59:08;81123016;80793752;329264;
17.01.2019;01:00:05;81123094;80793783;329311;
17.01.2019;01:01:04;81123159;80793813;329346;
17.01.2019;01:02:05;81123243;80793839;329404;
17.01.2019;01:03:05;81123333;80793873;329460;
17.01.2019;01:04:05;81123402;80793896;329506;
17.01.2019;01:05:05;81123469;80793926;329543;
17.01.2019;01:06:04;81123527;80793960;329567;
17.01.2019;01:07:04;81123603;80793985;329618;
17.01.2019;01:08:05;81123671;80794011;329660;
17.01.2019;01:09:05;81123746;80794048;329698;
17.01.2019;01:10:04;81123805;80794072;329733;
17.01.2019;01:11:04;81123880;80794096;329784;
17.01.2019;01:12:05;81123941;80794132;329809;
17.01.2019;01:13:05;81124012;80794156;329856;
17.01.2019;01:14:04;81124091;80794185;329906;
17.01.2019;01:15:04;81124168;80794208;329960;
17.01.2019;01:16:05;81124255;80794232;330023;
17.01.2019;01:17:05;81124327;80794254;330073;
17.01.2019;01:18:05;81124405;80794282;330123;
17.01.2019;01:19:05;81124479;80794320;330159;
17.01.2019;01:20:04;81124555;80794349;330206;
17.01.2019;01:21:05;81124615;80794386;330229;
17.01.2019;01:22:04;81124689;80794401;330288;
17.01.2019;01:23:04;81124764;80794433;330331;
17.01.2019;01:24:04;81124825;80794482;330343;
17.01.2019;01:25:05;81124902;80794500;330402;
17.01.2019;01:26:05;81124971;80794534;330437;
17.01.2019;01:27:05;81125038;80794555;330483;
17.01.2019;01:28:04;81125115;80794590;330525;
17.01.2019;01:29:04;81125182;80794624;330558;
17.01.2019;01:30:04;81125249;80794656;330593;
17.01.2019;01:31:05;81125328;80794685;330643;
17.01.2019;01:32:05;81125393;80794721;330672;
17.01.2019;01:33:05;81125469;80794733;330736;
17.01.2019;01:34:04;81125544;80794767;330777;
17.01.2019;01:35:04;81125625;80794807;330818;
17.01.2019;01:36:05;81125682;80794843;330839;
17.01.2019;01:37:04;81125762;80794885;330877;
17.01.2019;01:38:04;81125833;80794906;330927;
17.01.2019;01:39:06;81125918;80794941;330977;
17.01.2019;01:40:04;81125984;80794989;330995;
17.01.2019;01:41:05;81126057;80795027;331030;
17.01.2019;01:42:05;81126138;80795069;331069;
17.01.2019;01:43:04;81126209;80795108;331101;
17.01.2019;01:44:05;81126282;80795153;331129;
17.01.2019;01:45:05;81126345;80795196;331149;
17.01.2019;01:46:04;81126410;80795237;331173;
17.01.2019;01:47:04;81126476;80795284;331192;
17.01.2019;01:48:05;81126567;80795329;331238;
17.01.2019;01:49:06;81126640;80795353;331287;
17.01.2019;01:50:04;81126705;80795401;331304;
17.01.2019;01:51:04;81126761;80795442;331319;
17.01.2019;01:52:05;81126846;80795479;331367;
17.01.2019;01:53:04;81126911;80795519;331392;
17.01.2019;01:54:05;81126994;80795575;331419;
17.01.2019;01:55:05;81127056;80795613;331443;
17.01.2019;01:56:04;81127136;80795655;331481;
17.01.2019;01:57:04;81127211;80795709;331502;
17.01.2019;01:58:05;81127295;80795778;331517;
17.01.2019;01:59:05;81127373;80795824;331549;
17.01.2019;02:00:05;81127464;80795864;331600;
17.01.2019;02:01:05;81127521;80795926;331595;
17.01.2019;02:02:04;81127607;80795971;331636;
17.01.2019;02:03:04;81127672;80796027;331645;
17.01.2019;02:04:05;81127782;80796081;331701;
17.01.2019;02:05:05;81127868;80796132;331736;
17.01.2019;02:06:04;81127944;80796194;331750;
17.01.2019;02:07:04;81128023;80796236;331787;
17.01.2019;02:08:04;81128093;80796292;331801;
17.01.2019;02:09:07;81128174;80796368;331806;
17.01.2019;02:10:04;81128250;80796425;331825;
17.01.2019;02:11:04;81128308;80796468;331840;
17.01.2019;02:12:05;81128328;80796515;331813;
17.01.2019;02:13:05;81128340;80796572;331768;
17.01.2019;02:14:05;81128394;80796618;331776;
17.01.2019;02:15:05;81128460;80796693;331767;
17.01.2019;02:16:05;81128520;80796756;331764;
17.01.2019;02:17:05;81128580;80796822;331758;
17.01.2019;02:18:04;81128635;80796897;331738;
17.01.2019;02:19:04;81128701;80796963;331738;
17.01.2019;02:20:05;81128771;80797029;331742;
17.01.2019;02:21:05;81128841;80797078;331763;
17.01.2019;02:22:05;81128920;80797149;331771;
17.01.2019;02:23:05;81128997;80797211;331786;
17.01.2019;02:24:04;81129057;80797291;331766;
17.01.2019;02:25:05;81129126;80797356;331770;
17.01.2019;02:26:05;81129197;80797430;331767;
17.01.2019;02:27:04;81129262;80797492;331770;
17.01.2019;02:28:04;81129328;80797567;331761;
17.01.2019;02:29:05;81129406;80797628;331778;
17.01.2019;02:30:05;81129476;80797712;331764;
17.01.2019;02:31:04;81129529;80797796;331733;
17.01.2019;02:32:05;81129596;80797863;331733;
17.01.2019;02:33:05;81129656;80797930;331726;
17.01.2019;02:34:05;81129720;80798000;331720;
17.01.2019;02:35:04;81129795;80798072;331723;
17.01.2019;02:36:04;81129871;80798139;331732;
17.01.2019;02:37:05;81129965;80798208;331757;
17.01.2019;02:38:05;81130046;80798276;331770;
17.01.2019;02:39:05;81130126;80798360;331766;
17.01.2019;02:40:04;81130191;80798429;331762;
17.01.2019;02:41:05;81130265;80798499;331766;
17.01.2019;02:42:05;81130341;80798595;331746;
17.01.2019;02:43:05;81130440;80798677;331763;
17.01.2019;02:44:05;81130519;80798749;331770;
17.01.2019;02:45:05;81130608;80798843;331765;
17.01.2019;02:46:04;81130667;80798918;331749;
17.01.2019;02:47:04;81130730;80798998;331732;
17.01.2019;02:48:05;81130804;80799096;331708;
17.01.2019;02:49:05;81130874;80799178;331696;
17.01.2019;02:50:05;81130947;80799275;331672;
17.01.2019;02:51:04;81131033;80799355;331678;
17.01.2019;02:52:04;81131101;80799438;331663;
17.01.2019;02:53:05;81131164;80799530;331634;
17.01.2019;02:54:05;81131246;80799613;331633;
17.01.2019;02:55:04;81131330;80799682;331648;
17.01.2019;02:56:05;81131400;80799764;331636;
17.01.2019;02:57:04;81131465;80799863;331602;
17.01.2019;02:58:04;81131542;80799964;331578;
17.01.2019;02:59:05;81131613;80800066;331547;
17.01.2019;03:00:05;81131692;80800170;331522;
17.01.2019;03:01:04;81131760;80800277;331483;
17.01.2019;03:02:04;81131842;80800378;331464;
17.01.2019;03:03:05;81131916;80800475;331441;
17.01.2019;03:04:05;81131993;80800570;331423;
17.01.2019;03:05:04;81132067;80800669;331398;
17.01.2019;03:06:04;81132155;80800759;331396;
17.01.2019;03:07:05;81132229;80800860;331369;
17.01.2019;03:08:05;81132295;80800955;331340;
17.01.2019;03:09:06;81132372;80801050;331322;
17.01.2019;03:10:04;81132430;80801153;331277;
17.01.2019;03:11:05;81132502;80801257;331245;
17.01.2019;03:12:04;81132568;80801368;331200;
17.01.2019;03:13:04;81132638;80801472;331166;
17.01.2019;03:14:05;81132712;80801593;331119;
17.01.2019;03:15:05;81132797;80801694;331103;
17.01.2019;03:16:05;81132866;80801799;331067;
17.01.2019;03:17:05;81132942;80801905;331037;
17.01.2019;03:18:04;81133009;80802001;331008;
17.01.2019;03:19:04;81133063;80802115;330948;
17.01.2019;03:20:05;81133138;80802245;330893;
17.01.2019;03:21:05;81133219;80802361;330858;
17.01.2019;03:22:04;81133326;80802481;330845;
17.01.2019;03:23:04;81133403;80802588;330815;
17.01.2019;03:24:05;81133468;80802690;330778;
17.01.2019;03:25:05;81133539;80802781;330758;
17.01.2019;03:26:05;81133606;80802918;330688;
17.01.2019;03:27:04;81133703;80803023;330680;
17.01.2019;03:28:04;81133777;80803135;330642;
17.01.2019;03:29:05;81133850;80803263;330587;
17.01.2019;03:30:04;81133925;80803374;330551;
17.01.2019;03:31:05;81133994;80803486;330508;
17.01.2019;03:32:05;81134077;80803574;330503;
17.01.2019;03:33:05;81134141;80803688;330453;
17.01.2019;03:34:04;81134205;80803807;330398;
17.01.2019;03:35:05;81134275;80803919;330356;
17.01.2019;03:36:04;81134335;80804051;330284;
17.01.2019;03:37:04;81134402;80804163;330239;
17.01.2019;03:38:04;81134478;80804265;330213;
17.01.2019;03:39:05;81134567;80804400;330167;
17.01.2019;03:40:04;81134638;80804533;330105;
17.01.2019;03:41:04;81134719;80804637;330082;
17.01.2019;03:42:05;81134789;80804733;330056;
17.01.2019;03:43:05;81134861;80804855;330006;
17.01.2019;03:44:05;81134922;80804969;329953;
17.01.2019;03:45:05;81135011;80805086;329925;
17.01.2019;03:46:04;81135073;80805192;329881;
17.01.2019;03:47:04;81135138;80805308;329830;
17.01.2019;03:48:05;81135224;80805427;329797;
17.01.2019;03:49:04;81135289;80805542;329747;
17.01.2019;03:50:04;81135352;80805648;329704;
17.01.2019;03:51:05;81135402;80805767;329635;
17.01.2019;03:52:05;81135484;80805902;329582;
17.01.2019;03:53:05;81135505;80805993;329512;
17.01.2019;03:54:04;81135577;80806087;329490;
17.01.2019;03:55:05;81135648;80806213;329435;
17.01.2019;03:56:05;81135728;80806321;329407;
17.01.2019;03:57:05;81135820;80806442;329378;
17.01.2019;03:58:04;81135903;80806581;329322;
17.01.2019;03:59:04;81135991;80806675;329316;
17.01.2019;04:00:05;81136063;80806806;329257;
17.01.2019;04:01:05;81136150;80806922;329228;
17.01.2019;04:02:04;81136231;80807053;329178;
17.01.2019;04:03:04;81136330;80807175;329155;
17.01.2019;04:04:05;81136416;80807285;329131;
17.01.2019;04:05:05;81136515;80807420;329095;
17.01.2019;04:06:05;81136584;80807543;329041;
17.01.2019;04:07:04;81136665;80807669;328996;
17.01.2019;04:08:04;81136745;80807788;328957;
17.01.2019;04:09:05;81136819;80807916;328903;
17.01.2019;04:10:05;81136887;80808012;328875;
17.01.2019;04:11:05;81136954;80808147;328807;
17.01.2019;04:12:04;81137026;80808248;328778;
17.01.2019;04:13:04;81137089;80808388;328701;
17.01.2019;04:14:06;81137167;80808516;328651;
17.01.2019;04:15:04;81137229;80808619;328610;
17.01.2019;04:16:04;81137270;80808739;328531;
17.01.2019;04:17:04;81137316;80808858;328458;
17.01.2019;04:18:04;81137355;80808967;328388;
17.01.2019;04:19:05;81137408;80809067;328341;
17.01.2019;04:20:05;81137461;80809176;328285;
17.01.2019;04:21:04;81137517;80809282;328235;
17.01.2019;04:22:04;81137566;80809422;328144;
17.01.2019;04:23:05;81137634;80809536;328098;
17.01.2019;04:24:05;81137714;80809647;328067;
17.01.2019;04:25:05;81137769;80809762;328007;
17.01.2019;04:26:05;81137840;80809882;327958;
17.01.2019;04:27:04;81137916;80810009;327907;
17.01.2019;04:28:04;81137992;80810126;327866;
17.01.2019;04:29:05;81138068;80810247;327821;
17.01.2019;04:30:05;81138139;80810384;327755;
17.01.2019;04:31:05;81138216;80810510;327706;
17.01.2019;04:32:04;81138293;80810633;327660;
17.01.2019;04:33:04;81138375;80810766;327609;
17.01.2019;04:34:04;81138429;80810873;327556;
17.01.2019;04:35:05;81138508;80811004;327504;
17.01.2019;04:36:04;81138562;80811131;327431;
17.01.2019;04:37:04;81138617;80811229;327388;
17.01.2019;04:38:05;81138678;80811349;327329;
17.01.2019;04:39:05;81138745;80811475;327270;
17.01.2019;04:40:05;81138815;80811595;327220;
17.01.2019;04:41:05;81138885;80811720;327165;
17.01.2019;04:42:04;81138968;80811811;327157;
17.01.2019;04:43:05;81139044;80811936;327108;
17.01.2019;04:44:04;81139107;80812073;327034;
17.01.2019;04:45:09;81139193;80812202;326991;
17.01.2019;04:46:04;81139260;80812303;326957;
17.01.2019;04:47:05;81139337;80812424;326913;
17.01.2019;04:48:10;81139417;80812567;326850;
17.01.2019;04:49:05;81139485;80812666;326819;
17.01.2019;04:50:05;81139558;80812793;326765;
17.01.2019;04:51:05;81139644;80812903;326741;
17.01.2019;04:52:05;81139713;80813052;326661;
17.01.2019;04:53:05;81139760;80813159;326601;
17.01.2019;04:54:04;81139828;80813288;326540;
17.01.2019;04:55:04;81139900;80813413;326487;
17.01.2019;04:56:05;81139973;80813537;326436;
17.01.2019;04:57:05;81140050;80813638;326412;
17.01.2019;04:58:04;81140121;80813771;326350;
17.01.2019;04:59:05;81140197;80813887;326310;
17.01.2019;05:00:05;81140243;80814016;326227;
17.01.2019;05:01:05;81140321;80814137;326184;
17.01.2019;05:02:04;81140386;80814273;326113;
17.01.2019;05:03:04;81140443;80814418;326025;
17.01.2019;05:04:05;81140515;80814555;325960;
17.01.2019;05:05:05;81140591;80814660;325931;
17.01.2019;05:06:05;81140657;80814798;325859;
17.01.2019;05:07:05;81140722;80814909;325813;
17.01.2019;05:08:05;81140809;80815037;325772;
17.01.2019;05:09:06;81140875;80815180;325695;
17.01.2019;05:10:04;81140942;80815309;325633;
17.01.2019;05:11:05;81141028;80815440;325588;
17.01.2019;05:12:05;81141123;80815583;325540;
17.01.2019;05:13:04;81141194;80815703;325491;
17.01.2019;05:14:04;81141255;80815835;325420;
17.01.2019;05:15:05;81141311;80815969;325342;
17.01.2019;05:16:05;81141366;80816086;325280;
17.01.2019;05:17:04;81141443;80816212;325231;
17.01.2019;05:18:05;81141516;80816323;325193;
17.01.2019;05:19:05;81141571;80816451;325120;
17.01.2019;05:20:04;81141635;80816556;325079;
17.01.2019;05:21:04;81141701;80816682;325019;
17.01.2019;05:22:05;81141778;80816826;324952;
17.01.2019;05:23:04;81141862;80816952;324910;
17.01.2019;05:24:04;81141952;80817092;324860;
17.01.2019;05:25:05;81142009;80817223;324786;
17.01.2019;05:26:05;81142072;80817354;324718;
17.01.2019;05:27:05;81142134;80817485;324649;
17.01.2019;05:28:05;81142198;80817626;324572;
17.01.2019;05:29:04;81142247;80817750;324497;
17.01.2019;05:30:04;81142311;80817855;324456;
17.01.2019;05:31:05;81142371;80817965;324406;
17.01.2019;05:32:05;81142400;80818072;324328;
17.01.2019;05:33:04;81142460;80818181;324279;
17.01.2019;05:34:04;81142534;80818279;324255;
17.01.2019;05:35:05;81142604;80818387;324217;
17.01.2019;05:36:05;81142667;80818495;324172;
17.01.2019;05:37:04;81142725;80818612;324113;
17.01.2019;05:38:04;81142787;80818719;324068;
17.01.2019;05:39:07;81142867;80818832;324035;
17.01.2019;05:40:04;81142908;80818961;323947;
17.01.2019;05:41:04;81142971;80819082;323889;
17.01.2019;05:42:05;81143018;80819202;323816;
17.01.2019;05:43:05;81143080;80819325;323755;
17.01.2019;05:44:04;81143121;80819425;323696;
17.01.2019;05:45:04;81143182;80819549;323633;
17.01.2019;05:46:05;81143241;80819670;323571;
17.01.2019;05:47:04;81143316;80819803;323513;
17.01.2019;05:48:04;81143378;80819945;323433;
17.01.2019;05:49:05;81143437;80820058;323379;
17.01.2019;05:50:04;81143498;80820162;323336;
17.01.2019;05:51:04;81143565;80820291;323274;
17.01.2019;05:52:05;81143625;80820422;323203;
17.01.2019;05:53:05;81143686;80820554;323132;
17.01.2019;05:54:05;81143737;80820682;323055;
17.01.2019;05:55:05;81143792;80820813;322979;
17.01.2019;05:56:05;81143872;80820945;322927;
17.01.2019;05:57:05;81143932;80821074;322858;
17.01.2019;05:58:04;81143996;80821199;322797;
17.01.2019;05:59:04;81144060;80821329;322731;
17.01.2019;06:00:04;81144109;80821439;322670;
17.01.2019;06:01:05;81144161;80821568;322593;
17.01.2019;06:02:04;81144216;80821708;322508;
17.01.2019;06:03:04;81144274;80821850;322424;
17.01.2019;06:04:05;81144331;80821969;322362;
17.01.2019;06:05:05;81144395;80822108;322287;
17.01.2019;06:06:05;81144431;80822222;322209;
17.01.2019;06:07:05;81144494;80822356;322138;
17.01.2019;06:08:05;81144546;80822479;322067;
17.01.2019;06:09:06;81144613;80822590;322023;
17.01.2019;06:10:05;81144671;80822701;321970;
17.01.2019;06:11:05;81144735;80822817;321918;
17.01.2019;06:12:04;81144777;80822937;321840;
17.01.2019;06:13:04;81144818;80823075;321743;
17.01.2019;06:14:05;81144845;80823176;321669;
17.01.2019;06:15:05;81144859;80823275;321584;
17.01.2019;06:16:04;81144865;80823368;321497;
17.01.2019;06:17:04;81144879;80823464;321415;
17.01.2019;06:18:04;81144915;80823574;321341;
17.01.2019;06:19:05;81144970;80823713;321257;
17.01.2019;06:20:04;81145019;80823842;321177;
17.01.2019;06:21:04;81145068;80823949;321119;
17.01.2019;06:22:05;81145108;80824058;321050;
17.01.2019;06:23:05;81145147;80824173;320974;
17.01.2019;06:24:05;81145179;80824290;320889;
17.01.2019;06:25:08;81145224;80824425;320799;
17.01.2019;06:26:05;81145276;80824545;320731;
17.01.2019;06:27:05;81145331;80824653;320678;
17.01.2019;06:28:04;81145380;80824775;320605;
17.01.2019;06:29:04;81145438;80824912;320526;
17.01.2019;06:30:05;81145505;80825038;320467;
17.01.2019;06:31:04;81145560;80825194;320366;
17.01.2019;06:32:05;81145623;80825332;320291;
17.01.2019;06:33:05;81145685;80825472;320213;
17.01.2019;06:34:04;81145738;80825617;320121;
17.01.2019;06:35:05;81145782;80825759;320023;
17.01.2019;06:36:04;81145839;80825880;319959;
17.01.2019;06:37:04;81145899;80826015;319884;
17.01.2019;06:38:05;81145948;80826145;319803;
17.01.2019;06:39:06;81146014;80826279;319735;
17.01.2019;06:40:04;81146067;80826394;319673;
17.01.2019;06:41:05;81146110;80826528;319582;
17.01.2019;06:42:05;81146160;80826646;319514;
17.01.2019;06:43:04;81146215;80826768;319447;
17.01.2019;06:44:04;81146284;80826879;319405;
17.01.2019;06:45:05;81146330;80827020;319310;
17.01.2019;06:46:04;81146383;80827151;319232;
17.01.2019;06:47:04;81146457;80827271;319186;
17.01.2019;06:48:05;81146518;80827396;319122;
17.01.2019;06:49:05;81146563;80827506;319057;
17.01.2019;06:50:05;81146605;80827628;318977;
17.01.2019;06:51:04;81146657;80827754;318903;
17.01.2019;06:52:04;81146702;80827870;318832;
17.01.2019;06:53:05;81146749;80828021;318728;
17.01.2019;06:54:05;81146828;80828159;318669;
17.01.2019;06:55:05;81146901;80828279;318622;
17.01.2019;06:56:05;81146887;80828343;318544;
17.01.2019;06:57:04;81146937;80828460;318477;
17.01.2019;06:58:05;81146985;80828583;318402;
17.01.2019;06:59:05;81147046;80828715;318331;
17.01.2019;07:00:04;81147092;80828826;318266;
17.01.2019;07:01:04;81147148;80828961;318187;
17.01.2019;07:02:05;81147206;80829118;318088;
17.01.2019;07:03:05;81147261;80829244;318017;
17.01.2019;07:04:04;81147312;80829369;317943;
17.01.2019;07:05:04;81147368;80829530;317838;
17.01.2019;07:06:04;81147421;80829642;317779;
17.01.2019;07:07:05;81147469;80829779;317690;
17.01.2019;07:08:05;81147511;80829924;317587;
17.01.2019;07:09:05;81147558;80830030;317528;
17.01.2019;07:10:05;81147594;80830184;317410;
17.01.2019;07:11:05;81147642;80830328;317314;
17.01.2019;07:12:05;81147699;80830452;317247;
17.01.2019;07:13:05;81147756;80830591;317165;
17.01.2019;07:14:05;81147817;80830716;317101;
17.01.2019;07:15:05;81147869;80830843;317026;
17.01.2019;07:16:05;81147923;80830976;316947;
17.01.2019;07:17:06;81147978;80831102;316876;
17.01.2019;07:18:05;81148021;80831220;316801;
17.01.2019;07:19:05;81148071;80831352;316719;
17.01.2019;07:20:04;81148113;80831494;316619;
17.01.2019;07:21:04;81148167;80831637;316530;
17.01.2019;07:22:05;81148232;80831762;316470;
17.01.2019;07:23:05;81148280;80831899;316381;
17.01.2019;07:24:05;81148312;80832028;316284;
17.01.2019;07:25:05;81148369;80832164;316205;
17.01.2019;07:26:04;81148434;80832294;316140;
17.01.2019;07:27:09;81148476;80832445;316031;
17.01.2019;07:28:05;81148513;80832573;315940;
17.01.2019;07:29:05;81148553;80832706;315847;
17.01.2019;07:30:04;81148612;80832844;315768;
17.01.2019;07:31:04;81148677;80832964;315713;
17.01.2019;07:32:05;81148732;80833100;315632;
17.01.2019;07:33:05;81148777;80833212;315565;
17.01.2019;07:34:04;81148816;80833328;315488;
17.01.2019;07:35:04;81148867;80833439;315428;
17.01.2019;07:36:04;81148902;80833540;315362;
17.01.2019;07:37:05;81148947;80833657;315290;
17.01.2019;07:38:04;81148990;80833768;315222;
17.01.2019;07:39:05;81149054;80833883;315171;
17.01.2019;07:40:05;81149115;80833997;315118;
17.01.2019;07:41:05;81149172;80834131;315041;
17.01.2019;07:42:05;81149210;80834235;314975;
17.01.2019;07:43:05;81149247;80834356;314891;
17.01.2019;07:44:04;81149287;80834471;314816;
17.01.2019;07:45:05;81149335;80834583;314752;
17.01.2019;07:46:10;81149390;80834739;314651;
17.01.2019;07:47:04;81149432;80834847;314585;
17.01.2019;07:48:04;81149473;80834963;314510;
17.01.2019;07:49:05;81149502;80835081;314421;
17.01.2019;07:50:05;81149548;80835213;314335;
17.01.2019;07:51:04;81149582;80835323;314259;
17.01.2019;07:52:04;81149613;80835428;314185;
17.01.2019;07:53:04;81149665;80835568;314097;
17.01.2019;07:54:05;81149722;80835699;314023;
17.01.2019;07:55:05;81149759;80835846;313913;
17.01.2019;07:56:05;81149818;80835961;313857;
17.01.2019;07:57:05;81149867;80836116;313751;
17.01.2019;07:58:05;81149915;80836230;313685;
17.01.2019;07:59:04;81149944;80836348;313596;
17.01.2019;08:00:04;81149991;80836496;313495;
17.01.2019;08:01:05;81150054;80836625;313429;
17.01.2019;08:02:05;81150111;80836768;313343;
17.01.2019;08:03:05;81150156;80836881;313275;
17.01.2019;08:04:05;81150191;80837018;313173;
17.01.2019;08:05:05;81150236;80837150;313086;
17.01.2019;08:06:05;81150284;80837263;313021;
17.01.2019;08:07:05;81150332;80837390;312942;
17.01.2019;08:08:05;81150361;80837493;312868;
17.01.2019;08:09:05;81150393;80837616;312777;
17.01.2019;08:10:05;81150431;80837720;312711;
17.01.2019;08:11:05;81150428;80837795;312633;
17.01.2019;08:12:04;81150409;80837878;312531;
17.01.2019;08:13:05;81150394;80838002;312392;
17.01.2019;08:14:05;81150425;80838110;312315;
17.01.2019;08:15:04;81150455;80838239;312216;
17.01.2019;08:16:04;81150488;80838339;312149;
17.01.2019;08:17:05;81150524;80838465;312059;
17.01.2019;08:18:05;81150564;80838610;311954;
17.01.2019;08:19:05;81150599;80838748;311851;
17.01.2019;08:20:04;81150640;80838904;311736;
17.01.2019;08:21:04;81150686;80839036;311650;
17.01.2019;08:22:05;81150734;80839175;311559;
17.01.2019;08:23:05;81150780;80839310;311470;
17.01.2019;08:24:05;81150825;80839452;311373;
17.01.2019;08:25:05;81150867;80839564;311303;
17.01.2019;08:26:05;81150893;80839680;311213;
17.01.2019;08:27:05;81150938;80839804;311134;
17.01.2019;08:28:04;81150980;80839926;311054;
17.01.2019;08:29:04;81151025;80840055;310970;
17.01.2019;08:30:05;81151065;80840180;310885;
17.01.2019;08:31:05;81151101;80840312;310789;
17.01.2019;08:32:05;81151146;80840467;310679;
17.01.2019;08:33:04;81151189;80840611;310578;
17.01.2019;08:34:04;81151243;80840728;310515;
17.01.2019;08:35:10;81151296;80840873;310423;
17.01.2019;08:36:05;81151346;80841003;310343;
17.01.2019;08:37:05;81151388;80841127;310261;
17.01.2019;08:38:04;81151427;80841234;310193;
17.01.2019;08:39:05;81151475;80841374;310101;
17.01.2019;08:40:05;81151517;80841520;309997;
17.01.2019;08:41:05;81151550;80841662;309888;
17.01.2019;08:42:04;81151585;80841801;309784;
17.01.2019;08:43:05;81151625;80841928;309697;
17.01.2019;08:44:04;81151665;80842046;309619;
17.01.2019;08:45:04;81151714;80842182;309532;
17.01.2019;08:46:05;81151753;80842313;309440;
17.01.2019;08:47:05;81151796;80842439;309357;
17.01.2019;08:48:05;81151847;80842567;309280;
17.01.2019;08:49:05;81151891;80842686;309205;
17.01.2019;08:50:04;81151936;80842833;309103;
17.01.2019;08:51:04;81151978;80842962;309016;
17.01.2019;08:52:05;81152014;80843084;308930;
17.01.2019;08:53:05;81152057;80843217;308840;
17.01.2019;08:54:06;81152095;80843374;308721;
17.01.2019;08:55:05;81152149;80843484;308665;
17.01.2019;08:56:04;81152202;80843625;308577;
17.01.2019;08:57:05;81152238;80843776;308462;
17.01.2019;08:58:05;81152284;80843911;308373;
17.01.2019;08:59:05;81152331;80844058;308273;
17.01.2019;09:00:04;81152370;80844189;308181;
17.01.2019;09:01:04;81152416;80844318;308098;
17.01.2019;09:02:05;81152458;80844447;308011;
17.01.2019;09:03:05;81152501;80844567;307934;
17.01.2019;09:04:05;81152562;80844711;307851;
17.01.2019;09:05:05;81152623;80844835;307788;
17.01.2019;09:06:05;81152660;80844963;307697;
17.01.2019;09:07:05;81152694;80845082;307612;
17.01.2019;09:08:06;81152747;80845225;307522;
17.01.2019;09:09:04;81152792;80845364;307428;
17.01.2019;09:10:04;81152840;80845503;307337;
17.01.2019;09:11:05;81152894;80845665;307229;
17.01.2019;09:12:05;81152924;80845795;307129;
17.01.2019;09:13:04;81152966;80845942;307024;
17.01.2019;09:14:04;81153008;80846065;306943;
17.01.2019;09:15:05;81153056;80846174;306882;
17.01.2019;09:16:05;81153113;80846303;306810;
17.01.2019;09:17:05;81153173;80846430;306743;
17.01.2019;09:18:05;81153217;80846572;306645;
17.01.2019;09:19:05;81153261;80846699;306562;
17.01.2019;09:20:04;81153302;80846810;306492;
17.01.2019;09:21:04;81153366;80846951;306415;
17.01.2019;09:22:05;81153411;80847091;306320;
17.01.2019;09:23:05;81153464;80847219;306245;
17.01.2019;09:24:05;81153498;80847341;306157;
17.01.2019;09:25:04;81153549;80847452;306097;
17.01.2019;09:26:04;81153588;80847602;305986;
17.01.2019;09:27:05;81153635;80847719;305916;
17.01.2019;09:28:04;81153667;80847847;305820;
17.01.2019;09:29:05;81153715;80847992;305723;
17.01.2019;09:30:05;81153760;80848110;305650;
17.01.2019;09:31:05;81153806;80848241;305565;
17.01.2019;09:32:05;81153847;80848369;305478;
17.01.2019;09:33:05;81153888;80848484;305404;
17.01.2019;09:34:04;81153928;80848600;305328;
17.01.2019;09:35:04;81153960;80848730;305230;
17.01.2019;09:36:05;81154003;80848881;305122;
17.01.2019;09:38:04;81154111;80849145;304966;
17.01.2019;09:39:05;81154158;80849273;304885;
17.01.2019;09:40:05;81154188;80849403;304785;
17.01.2019;09:41:04;81154230;80849531;304699;
17.01.2019;09:42:04;81154269;80849660;304609;
17.01.2019;09:43:05;81154323;80849806;304517;
17.01.2019;09:44:04;81154369;80849956;304413;
17.01.2019;09:45:04;81154415;80850113;304302;
17.01.2019;09:46:04;81154460;80850255;304205;
17.01.2019;09:47:05;81154466;80850389;304077;
17.01.2019;09:48:05;81154471;80850444;304027;
17.01.2019;09:49:05;81154508;80850551;303957;
17.01.2019;09:50:05;81154544;80850707;303837;
17.01.2019;09:51:04;81154573;80850836;303737;
17.01.2019;09:52:04;81154601;80850953;303648;
17.01.2019;09:53:05;81154654;80851103;303551;
17.01.2019;09:54:05;81154710;80851243;303467;
17.01.2019;09:55:05;81154764;80851379;303385;
17.01.2019;09:56:05;81154790;80851535;303255;
17.01.2019;09:57:04;81154837;80851663;303174;
17.01.2019;09:58:04;81154884;80851792;303092;
17.01.2019;09:59:05;81154921;80851929;302992;
17.01.2019;10:00:05;81154963;80852050;302913;
17.01.2019;10:01:05;81155004;80852166;302838;
17.01.2019;10:02:04;81155043;80852316;302727;
17.01.2019;10:03:04;81155080;80852446;302634;
17.01.2019;10:04:05;81155121;80852589;302532;
17.01.2019;10:05:05;81155171;80852710;302461;
17.01.2019;10:06:04;81155215;80852834;302381;
17.01.2019;10:07:04;81155263;80852972;302291;
17.01.2019;10:08:04;81155301;80853113;302188;
17.01.2019;10:09:06;81155348;80853255;302093;
17.01.2019;10:10:05;81155387;80853386;302001;
17.01.2019;10:11:05;81155418;80853506;301912;
17.01.2019;10:12:04;81155437;80853644;301793;
17.01.2019;10:13:04;81155464;80853741;301723;
17.01.2019;10:14:04;81155488;80853858;301630;
17.01.2019;10:15:05;81155502;80853957;301545;
17.01.2019;10:16:05;81155517;80854043;301474;
17.01.2019;10:17:05;81155542;80854154;301388;
17.01.2019;10:18:05;81155584;80854268;301316;
17.01.2019;10:19:04;81155608;80854388;301220;
17.01.2019;10:20:04;81155639;80854534;301105;
17.01.2019;10:21:05;81155682;80854650;301032;
17.01.2019;10:22:04;81155714;80854773;300941;
17.01.2019;10:23:05;81155749;80854918;300831;
17.01.2019;10:24:05;81155785;80855041;300744;
17.01.2019;10:25:04;81155835;80855190;300645;
17.01.2019;10:26:05;81155874;80855330;300544;
17.01.2019;10:27:05;81155911;80855467;300444;
17.01.2019;10:28:05;81155964;80855616;300348;
17.01.2019;10:29:05;81156020;80855783;300237;
17.01.2019;10:30:04;81156059;80855913;300146;
17.01.2019;10:31:04;81156091;80856050;300041;
17.01.2019;10:32:04;81156126;80856154;299972;
17.01.2019;10:33:05;81156165;80856240;299925;
17.01.2019;10:34:05;81156203;80856337;299866;
17.01.2019;10:35:04;81156236;80856439;299797;
17.01.2019;10:36:05;81156274;80856570;299704;
17.01.2019;10:37:05;81156327;80856659;299668;
17.01.2019;10:38:05;81156377;80856802;299575;
17.01.2019;10:39:05;81156418;80856922;299496;
17.01.2019;10:40:05;81156455;80857023;299432;
17.01.2019;10:41:04;81156501;80857146;299355;
17.01.2019;10:42:04;81156541;80857270;299271;
17.01.2019;10:43:10;81156596;80857418;299178;
17.01.2019;10:44:05;81156646;80857510;299136;
17.01.2019;10:45:08;81156677;80857648;299029;
17.01.2019;10:46:05;81156718;80857738;298980;
17.01.2019;10:47:05;81156759;80857884;298875;
17.01.2019;10:48:05;81156795;80858015;298780;
17.01.2019;10:49:04;81156829;80858151;298678;
17.01.2019;10:50:05;81156879;80858295;298584;
17.01.2019;10:51:05;81156912;80858430;298482;
17.01.2019;10:52:04;81156943;80858558;298385;
17.01.2019;10:53:05;81156993;80858703;298290;
17.01.2019;10:54:05;81157033;80858831;298202;
17.01.2019;10:55:05;81157072;80858974;298098;
17.01.2019;10:56:05;81157115;80859098;298017;
17.01.2019;10:57:05;81157144;80859248;297896;
17.01.2019;10:58:05;81157196;80859411;297785;
17.01.2019;10:59:05;81157245;80859566;297679;
17.01.2019;11:00:04;81157296;80859679;297617;
17.01.2019;11:01:04;81157340;80859787;297553;
17.01.2019;11:02:04;81157375;80859929;297446;
17.01.2019;11:03:05;81157428;80860050;297378;
17.01.2019;11:04:04;81157477;80860197;297280;
17.01.2019;11:05:04;81157506;80860344;297162;
17.01.2019;11:06:04;81157550;80860486;297064;
17.01.2019;11:07:08;81157595;80860633;296962;
17.01.2019;11:08:08;81157641;80860757;296884;
17.01.2019;11:09:04;81157685;80860871;296814;
17.01.2019;11:10:04;81157727;80861008;296719;
17.01.2019;11:11:05;81157759;80861184;296575;
17.01.2019;11:12:05;81157799;80861331;296468;
17.01.2019;11:13:05;81157862;80861464;296398;
17.01.2019;11:14:04;81157919;80861598;296321;
17.01.2019;11:15:04;81157967;80861735;296232;
17.01.2019;11:16:04;81157999;80861858;296141;
17.01.2019;11:17:04;81158037;80862003;296034;
17.01.2019;11:18:05;81158076;80862145;295931;
17.01.2019;11:19:05;81158133;80862272;295861;
17.01.2019;11:20:05;81158170;80862405;295765;
17.01.2019;11:21:05;81158217;80862542;295675;
17.01.2019;11:22:05;81158259;80862679;295580;
17.01.2019;11:23:43;81158322;80862843;295479;
17.01.2019;11:24:05;81158366;80862983;295383;
17.01.2019;11:25:05;81158419;80863129;295290;
17.01.2019;11:26:05;81158451;80863259;295192;
17.01.2019;11:27:09;81158506;80863442;295064;
17.01.2019;11:28:04;81158547;80863575;294972;
17.01.2019;11:29:04;81158618;80863680;294938;
17.01.2019;11:30:05;81158665;80863838;294827;
17.01.2019;11:31:04;81158713;80863960;294753;
17.01.2019;11:32:04;81158778;80864079;294699;
17.01.2019;11:33:05;81158822;80864234;294588;
17.01.2019;11:34:05;81158875;80864375;294500;
17.01.2019;11:35:05;81158922;80864504;294418;
17.01.2019;11:36:05;81158976;80864637;294339;
17.01.2019;11:37:04;81159023;80864749;294274;
17.01.2019;11:38:04;81159066;80864894;294172;
17.01.2019;11:39:04;81159121;80865036;294085;
17.01.2019;11:40:05;81159149;80865179;293970;
17.01.2019;11:41:05;81159184;80865324;293860;
17.01.2019;11:42:04;81159229;80865495;293734;
17.01.2019;11:43:04;81159280;80865667;293613;
17.01.2019;11:44:05;81159324;80865809;293515;
17.01.2019;11:45:05;81159383;80865940;293443;
17.01.2019;11:46:04;81159431;80866077;293354;
17.01.2019;11:47:04;81159476;80866230;293246;
17.01.2019;11:48:04;81159535;80866368;293167;
17.01.2019;11:49:05;81159583;80866526;293057;
17.01.2019;11:50:05;81159631;80866654;292977;
17.01.2019;11:51:04;81159687;80866791;292896;
17.01.2019;11:52:05;81159726;80866929;292797;
17.01.2019;11:53:05;81159762;80867074;292688;
17.01.2019;11:54:05;81159809;80867223;292586;
17.01.2019;11:55:05;81159853;80867354;292499;
17.01.2019;11:56:04;81159895;80867493;292402;
17.01.2019;11:57:04;81159949;80867622;292327;
17.01.2019;11:58:06;81159999;80867776;292223;
17.01.2019;11:59:05;81160045;80867917;292128;
17.01.2019;12:00:05;81160088;80868052;292036;
17.01.2019;12:01:05;81160138;80868183;291955;
17.01.2019;12:02:05;81160184;80868311;291873;
17.01.2019;12:03:05;81160227;80868457;291770;
17.01.2019;12:04:05;81160272;80868586;291686;
17.01.2019;12:05:05;81160322;80868717;291605;
17.01.2019;12:06:05;81160358;80868857;291501;
17.01.2019;12:07:05;81160394;80868987;291407;
17.01.2019;12:08:05;81160424;80869137;291287;
17.01.2019;12:09:05;81160475;80869238;291237;
17.01.2019;12:10:05;81160517;80869358;291159;
17.01.2019;12:11:05;81160558;80869463;291095;
17.01.2019;12:12:05;81160572;80869585;290987;
17.01.2019;12:13:05;81160605;80869698;290907;
17.01.2019;12:14:04;81160622;80869821;290801;
17.01.2019;12:15:04;81160670;80869951;290719;
17.01.2019;12:16:04;81160714;80870065;290649;
17.01.2019;12:17:04;81160762;80870208;290554;
17.01.2019;12:18:04;81160818;80870337;290481;
17.01.2019;12:19:04;81160867;80870466;290401;
17.01.2019;12:20:04;81160899;80870624;290275;
17.01.2019;12:21:04;81160944;80870766;290178;
17.01.2019;12:22:05;81160982;80870908;290074;
17.01.2019;12:23:05;81161029;80871055;289974;
17.01.2019;12:24:04;81161071;80871187;289884;
17.01.2019;12:25:04;81161106;80871312;289794;
17.01.2019;12:26:04;81161159;80871457;289702;
17.01.2019;12:27:05;81161231;80871611;289620;
17.01.2019;12:28:05;81161275;80871745;289530;
17.01.2019;12:29:05;81161323;80871916;289407;
17.01.2019;12:30:05;81161382;80872039;289343;
17.01.2019;12:31:04;81161436;80872188;289248;
17.01.2019;12:32:04;81161485;80872328;289157;
17.01.2019;12:33:05;81161535;80872464;289071;
17.01.2019;12:34:04;81161587;80872608;288979;
17.01.2019;12:35:05;81161658;80872749;288909;
17.01.2019;12:36:05;81161710;80872889;288821;
17.01.2019;12:37:05;81161785;80873044;288741;
17.01.2019;12:38:05;81161843;80873191;288652;
17.01.2019;12:39:06;81161915;80873331;288584;
17.01.2019;12:40:04;81161996;80873464;288532;
17.01.2019;12:41:05;81162059;80873601;288458;
17.01.2019;12:42:05;81162093;80873734;288359;
17.01.2019;12:43:05;81162128;80873886;288242;
17.01.2019;12:44:04;81162187;80874031;288156;
17.01.2019;12:45:04;81162244;80874167;288077;
17.01.2019;12:46:04;81162165;80874173;287992;
17.01.2019;12:47:10;81161823;80873975;287848;
17.01.2019;12:48:05;81161857;80874104;287753;
17.01.2019;12:49:05;81161900;80874262;287638;
17.01.2019;12:50:04;81161951;80874410;287541;
17.01.2019;12:51:04;81162020;80874550;287470;
17.01.2019;12:52:05;81162082;80874699;287383;
17.01.2019;12:53:05;81162130;80874838;287292;
17.01.2019;12:54:05;81162184;80874999;287185;
17.01.2019;12:55:05;81162240;80875131;287109;
17.01.2019;12:56:05;81162307;80875257;287050;
17.01.2019;12:57:05;81162371;80875418;286953;
17.01.2019;12:58:05;81162442;80875573;286869;
17.01.2019;12:59:05;81162501;80875727;286774;
17.01.2019;13:00:05;81162555;80875890;286665;
17.01.2019;13:01:05;81162615;80876018;286597;
17.01.2019;13:02:05;81162669;80876161;286508;
17.01.2019;13:03:05;81162720;80876286;286434;
17.01.2019;13:04:05;81162786;80876434;286352;
17.01.2019;13:05:05;81162844;80876561;286283;
17.01.2019;13:06:05;81162913;80876731;286182;
17.01.2019;13:07:04;81162963;80876848;286115;
17.01.2019;13:08:05;81163018;80876969;286049;
17.01.2019;13:09:05;81163065;80877115;285950;
17.01.2019;13:10:05;81163124;80877244;285880;
17.01.2019;13:11:05;81163185;80877392;285793;
17.01.2019;13:12:04;81163242;80877529;285713;
17.01.2019;13:13:05;81163322;80877693;285629;
17.01.2019;13:14:05;81163391;80877853;285538;
17.01.2019;13:15:05;81163449;80878017;285432;
17.01.2019;13:16:05;81163506;80878171;285335;
17.01.2019;13:17:05;81163577;80878309;285268;
17.01.2019;13:18:05;81163639;80878474;285165;
17.01.2019;13:19:05;81163697;80878623;285074;
17.01.2019;13:20:05;81163765;80878794;284971;
17.01.2019;13:21:05;81163815;80878941;284874;
17.01.2019;13:22:05;81163883;80879096;284787;
17.01.2019;13:23:05;81163934;80879254;284680;
17.01.2019;13:24:05;81164006;80879394;284612;
17.01.2019;13:25:05;81164071;80879537;284534;
17.01.2019;13:26:05;81164133;80879694;284439;
17.01.2019;13:27:04;81164194;80879836;284358;
17.01.2019;13:28:05;81164270;80879969;284301;
17.01.2019;13:29:05;81164331;80880100;284231;
17.01.2019;13:30:04;81164391;80880255;284136;
17.01.2019;13:31:05;81164464;80880394;284070;
17.01.2019;13:32:05;81164541;80880534;284007;
17.01.2019;13:33:05;81164609;80880645;283964;
17.01.2019;13:34:04;81164702;80880777;283925;
17.01.2019;13:35:05;81164788;80880916;283872;
17.01.2019;13:36:04;81164860;80881054;283806;
17.01.2019;13:37:04;81164935;80881219;283716;
17.01.2019;13:38:06;81165004;80881377;283627;
17.01.2019;13:39:06;81165075;80881534;283541;
17.01.2019;13:40:05;81165141;80881674;283467;
17.01.2019;13:41:05;81165217;80881817;283400;
17.01.2019;13:42:04;81165285;80881971;283314;
17.01.2019;13:43:04;81165338;80882124;283214;
17.01.2019;13:44:05;81165414;80882265;283149;
17.01.2019;13:45:04;81165478;80882411;283067;
17.01.2019;13:46:04;81165548;80882574;282974;
17.01.2019;13:47:05;81165628;80882738;282890;
17.01.2019;13:48:04;81165699;80882851;282848;
17.01.2019;13:49:05;81165772;80883011;282761;
17.01.2019;13:50:05;81165850;80883190;282660;
17.01.2019;13:51:05;81165938;80883346;282592;
17.01.2019;13:52:05;81166009;80883495;282514;
17.01.2019;13:53:05;81166073;80883659;282414;
17.01.2019;13:54:04;81166136;80883830;282306;
17.01.2019;13:55:04;81166209;80883981;282228;
17.01.2019;13:56:05;81166275;80884120;282155;
17.01.2019;13:57:05;81166349;80884292;282057;
17.01.2019;13:58:04;81166419;80884437;281982;
17.01.2019;13:59:05;81166494;80884621;281873;
17.01.2019;14:00:04;81166554;80884775;281779;
17.01.2019;14:01:04;81166632;80884948;281684;
17.01.2019;14:02:05;81166698;80885095;281603;
17.01.2019;14:03:05;81166768;80885250;281518;
17.01.2019;14:04:05;81166845;80885396;281449;
17.01.2019;14:05:05;81166933;80885558;281375;
17.01.2019;14:06:05;81167022;80885719;281303;
17.01.2019;14:07:05;81167077;80885879;281198;
17.01.2019;14:08:04;81167142;80886023;281119;
17.01.2019;14:09:04;81167207;80886188;281019;
17.01.2019;14:10:05;81167289;80886377;280912;
17.01.2019;14:11:05;81167375;80886555;280820;
17.01.2019;14:12:05;81167440;80886717;280723;
17.01.2019;14:13:05;81167514;80886880;280634;
17.01.2019;14:14:05;81167566;80887053;280513;
17.01.2019;14:15:05;81167645;80887249;280396;
17.01.2019;14:16:04;81167730;80887415;280315;
17.01.2019;14:17:04;81167807;80887564;280243;
17.01.2019;14:18:04;81167885;80887708;280177;
17.01.2019;14:19:05;81167948;80887856;280092;
17.01.2019;14:20:04;81168019;80888004;280015;
17.01.2019;14:21:04;81168074;80888133;279941;
17.01.2019;14:22:05;81168122;80888290;279832;
17.01.2019;14:23:05;81168198;80888442;279756;
17.01.2019;14:24:05;81168258;80888586;279672;
17.01.2019;14:25:04;81168322;80888732;279590;
17.01.2019;14:26:04;81168364;80888885;279479;
17.01.2019;14:27:05;81168437;80889031;279406;
17.01.2019;14:28:05;81168500;80889176;279324;
17.01.2019;14:29:05;81168561;80889315;279246;
17.01.2019;14:30:04;81168598;80889449;279149;
17.01.2019;14:31:05;81168638;80889592;279046;
17.01.2019;14:32:05;81168716;80889706;279010;
17.01.2019;14:33:05;81168770;80889832;278938;
17.01.2019;14:34:05;81168826;80889999;278827;
17.01.2019;14:35:04;81168882;80890142;278740;
17.01.2019;14:36:04;81168918;80890278;278640;
17.01.2019;14:37:04;81168988;80890429;278559;
17.01.2019;14:38:04;81169041;80890603;278438;
17.01.2019;14:40:05;81169168;80890935;278233;
17.01.2019;14:41:04;81169232;80891098;278134;
17.01.2019;14:42:04;81169306;80891246;278060;
17.01.2019;14:43:05;81169355;80891420;277935;
17.01.2019;14:44:05;81169424;80891596;277828;
17.01.2019;14:45:04;81169481;80891759;277722;
17.01.2019;14:46:04;81169552;80891906;277646;
17.01.2019;14:47:05;81169627;80892075;277552;
17.01.2019;14:48:05;81169693;80892228;277465;
17.01.2019;14:49:04;81169739;80892358;277381;
17.01.2019;14:50:04;81169832;80892527;277305;
17.01.2019;14:51:05;81169903;80892692;277211;
17.01.2019;14:52:05;81169978;80892863;277115;
17.01.2019;14:53:05;81170058;80893012;277046;
17.01.2019;14:54:05;81170153;80893216;276937;
17.01.2019;14:55:05;81170214;80893392;276822;
17.01.2019;14:56:04;81170293;80893558;276735;
17.01.2019;14:57:05;81170367;80893723;276644;
17.01.2019;14:58:05;81170449;80893900;276549;
17.01.2019;14:59:05;81170522;80894039;276483;
17.01.2019;15:00:07;81170591;80894221;276370;
17.01.2019;15:01:08;81170646;80894398;276248;
17.01.2019;15:02:08;81170716;80894551;276165;
17.01.2019;15:03:08;81170793;80894681;276112;
17.01.2019;15:04:07;81170868;80894846;276022;
17.01.2019;15:05:07;81170945;80895014;275931;
17.01.2019;15:06:08;81170999;80895149;275850;
17.01.2019;15:07:07;81171088;80895334;275754;
17.01.2019;15:08:07;81171167;80895497;275670;
17.01.2019;15:09:08;81171248;80895662;275586;
17.01.2019;15:10:08;81171315;80895839;275476;
17.01.2019;15:11:07;81171399;80895982;275417;
17.01.2019;15:12:08;81171483;80896151;275332;
17.01.2019;15:13:07;81171564;80896327;275237;
17.01.2019;15:14:08;81171638;80896479;275159;
17.01.2019;15:15:07;81171702;80896646;275056;
17.01.2019;15:16:07;81171761;80896814;274947;
17.01.2019;15:17:08;81171814;80896969;274845;
17.01.2019;15:18:08;81171875;80897133;274742;
17.01.2019;15:19:07;81171949;80897313;274636;
17.01.2019;15:20:08;81172030;80897472;274558;
17.01.2019;15:21:08;81172103;80897633;274470;
17.01.2019;15:22:07;81172172;80897787;274385;
17.01.2019;15:23:07;81172226;80897979;274247;
17.01.2019;15:24:07;81172288;80898145;274143;
17.01.2019;15:25:07;81172360;80898352;274008;
17.01.2019;15:26:07;81172436;80898555;273881;
17.01.2019;15:27:08;81172507;80898717;273790;
17.01.2019;15:28:23;81172565;80898937;273628;
17.01.2019;15:29:08;81172639;80899067;273572;
17.01.2019;15:30:08;81172694;80899240;273454;
17.01.2019;15:31:08;81172767;80899377;273390;
17.01.2019;15:32:07;81172829;80899531;273298;
17.01.2019;15:33:07;81172906;80899728;273178;
17.01.2019;15:34:07;81172970;80899902;273068;
17.01.2019;15:35:06;81173037;80900054;272983;
17.01.2019;15:36:08;81173103;80900232;272871;
17.01.2019;15:37:09;81173193;80900433;272760;
17.01.2019;15:38:08;81173276;80900597;272679;
17.01.2019;15:39:07;81173351;80900774;272577;
17.01.2019;15:40:07;81173406;80900959;272447;
17.01.2019;15:41:08;81173487;80901126;272361;
17.01.2019;15:42:07;81173561;80901283;272278;
17.01.2019;15:43:07;81173633;80901455;272178;
17.01.2019;15:44:08;81173709;80901658;272051;
17.01.2019;15:45:07;81173768;80901827;271941;
17.01.2019;15:46:07;81173851;80902008;271843;
17.01.2019;15:47:07;81173918;80902182;271736;
17.01.2019;15:48:07;81173989;80902365;271624;
17.01.2019;15:49:07;81174059;80902539;271520;
17.01.2019;15:50:08;81174133;80902712;271421;
17.01.2019;15:51:08;81174194;80902900;271294;
17.01.2019;15:52:07;81174264;80903082;271182;
17.01.2019;15:53:08;81174359;80903266;271093;
17.01.2019;15:54:07;81174431;80903437;270994;
17.01.2019;15:55:07;81174502;80903604;270898;
17.01.2019;15:56:08;81174573;80903760;270813;
17.01.2019;15:57:07;81174642;80903924;270718;
17.01.2019;15:58:08;81174711;80904074;270637;
17.01.2019;15:59:08;81174775;80904252;270523;
17.01.2019;16:00:04;81174853;80904411;270442;
17.01.2019;16:01:04;81174934;80904573;270361;
17.01.2019;16:02:05;81175017;80904738;270279;
17.01.2019;16:03:05;81175097;80904908;270189;
17.01.2019;16:04:05;81175165;80905082;270083;
17.01.2019;16:05:05;81175248;80905269;269979;
17.01.2019;16:06:05;81175342;80905468;269874;
17.01.2019;16:07:04;81175421;80905650;269771;
17.01.2019;16:08:04;81175500;80905828;269672;
17.01.2019;16:09:06;81175566;80906026;269540;
17.01.2019;16:10:05;81175629;80906184;269445;
17.01.2019;16:11:04;81175714;80906341;269373;
17.01.2019;16:12:04;81175779;80906495;269284;
17.01.2019;16:13:05;81175863;80906670;269193;
17.01.2019;16:14:05;81175939;80906847;269092;
17.01.2019;16:15:05;81176018;80907012;269006;
17.01.2019;16:16:05;81176105;80907192;268913;
17.01.2019;16:17:05;81176172;80907335;268837;
17.01.2019;16:18:04;81176266;80907491;268775;
17.01.2019;16:19:04;81176346;80907691;268655;
17.01.2019;16:20:05;81176435;80907844;268591;
17.01.2019;16:21:04;81176515;80908006;268509;
17.01.2019;16:22:04;81176569;80908195;268374;
17.01.2019;16:23:05;81176642;80908370;268272;
17.01.2019;16:24:11;81176700;80908550;268150;
17.01.2019;16:25:04;81176744;80908686;268058;
17.01.2019;16:26:05;81176795;80908837;267958;
17.01.2019;16:27:05;81176855;80909000;267855;
17.01.2019;16:28:05;81176931;80909169;267762;
17.01.2019;16:29:05;81176998;80909357;267641;
17.01.2019;16:30:05;81177058;80909540;267518;
17.01.2019;16:31:04;81177142;80909716;267426;
17.01.2019;16:32:05;81177208;80909863;267345;
17.01.2019;16:33:05;81177293;80910043;267250;
17.01.2019;16:34:05;81177374;80910178;267196;
17.01.2019;16:35:04;81177456;80910307;267149;
17.01.2019;16:36:04;81177510;80910492;267018;
17.01.2019;16:37:07;81177570;80910666;266904;
17.01.2019;16:38:06;81177632;80910831;266801;
17.01.2019;16:39:08;81177690;80911009;266681;
17.01.2019;16:40:05;81177764;80911186;266578;
17.01.2019;16:41:05;81177857;80911346;266511;
17.01.2019;16:42:05;81177934;80911502;266432;
17.01.2019;16:43:04;81178003;80911674;266329;
17.01.2019;16:44:05;81178084;80911864;266220;
17.01.2019;16:45:05;81178152;80912045;266107;
17.01.2019;16:46:05;81178242;80912237;266005;
17.01.2019;16:47:05;81178318;80912403;265915;
17.01.2019;16:48:05;81178401;80912583;265818;
17.01.2019;16:49:05;81178480;80912775;265705;
17.01.2019;16:50:05;81178564;80912952;265612;
17.01.2019;16:51:05;81178633;80913140;265493;
17.01.2019;16:52:05;81178711;80913303;265408;
17.01.2019;16:53:05;81178786;80913494;265292;
17.01.2019;16:54:05;81178882;80913654;265228;
17.01.2019;16:55:05;81178936;80913826;265110;
17.01.2019;16:56:05;81179010;80913986;265024;
17.01.2019;16:57:05;81179112;80914158;264954;
17.01.2019;16:58:04;81179180;80914344;264836;
17.01.2019;16:59:05;81179242;80914500;264742;
17.01.2019;17:00:10;81179337;80914689;264648;
17.01.2019;17:01:05;81179414;80914872;264542;
17.01.2019;17:02:05;81179493;80915010;264483;
17.01.2019;17:03:05;81179570;80915199;264371;
17.01.2019;17:04:06;81179654;80915371;264283;
17.01.2019;17:05:05;81179739;80915507;264232;
17.01.2019;17:06:05;81179840;80915661;264179;
17.01.2019;17:07:06;81179933;80915846;264087;
17.01.2019;18:33:11;81186757;80929050;257707;
17.01.2019;18:34:05;81186833;80929164;257669;
17.01.2019;18:35:05;81186911;80929265;257646;
17.01.2019;18:36:04;81186981;80929383;257598;
17.01.2019;18:37:04;81187067;80929519;257548;
17.01.2019;18:38:05;81187152;80929653;257499;
17.01.2019;18:39:08;81187235;80929785;257450;
17.01.2019;18:40:05;81187294;80929888;257406;
17.01.2019;18:41:05;81187348;80930011;257337;
17.01.2019;18:42:05;81187371;80930089;257282;
17.01.2019;18:43:04;81187461;80930210;257251;
17.01.2019;18:44:04;81187535;80930350;257185;
17.01.2019;18:45:05;81187610;80930470;257140;
17.01.2019;18:46:05;81187698;80930574;257124;
17.01.2019;18:47:06;81187761;80930706;257055;
17.01.2019;18:48:05;81187810;80930810;257000;
17.01.2019;18:49:05;81187891;80930929;256962;
17.01.2019;18:50:05;81187949;80931052;256897;
17.01.2019;18:51:05;81188035;80931173;256862;
17.01.2019;18:52:05;81188094;80931291;256803;
17.01.2019;18:53:05;81188172;80931401;256771;
17.01.2019;18:54:05;81188251;80931539;256712;
17.01.2019;18:55:04;81188342;80931662;256680;
17.01.2019;18:56:06;81188428;80931778;256650;
17.01.2019;18:57:05;81188526;80931897;256629;
17.01.2019;18:58:05;81188612;80932031;256581;
17.01.2019;18:59:05;81188704;80932133;256571;
17.01.2019;19:00:05;81188758;80932248;256510;
17.01.2019;19:01:06;81188841;80932353;256488;
17.01.2019;19:02:04;81188920;80932466;256454;
17.01.2019;19:03:05;81188994;80932578;256416;
17.01.2019;19:04:05;81189086;80932689;256397;
17.01.2019;19:05:05;81189168;80932803;256365;
17.01.2019;19:06:05;81189255;80932911;256344;
17.01.2019;19:07:05;81189317;80933008;256309;
17.01.2019;19:08:05;81189396;80933121;256275;
17.01.2019;19:09:07;81189470;80933244;256226;
17.01.2019;19:10:05;81189525;80933332;256193;
17.01.2019;19:11:04;81189585;80933449;256136;
17.01.2019;19:12:05;81189653;80933537;256116;
17.01.2019;19:13:05;81189731;80933636;256095;
17.01.2019;19:14:05;81189797;80933752;256045;
17.01.2019;19:15:05;81189860;80933849;256011;
17.01.2019;19:16:05;81189932;80933948;255984;
17.01.2019;19:17:06;81189927;80934049;255878;
17.01.2019;19:18:05;81189966;80934177;255789;
17.01.2019;19:19:05;81190024;80934274;255750;
17.01.2019;19:20:05;81190113;80934365;255748;
17.01.2019;19:21:04;81190174;80934494;255680;
17.01.2019;19:22:04;81190206;80934569;255637;
17.01.2019;19:23:05;81190266;80934682;255584;
17.01.2019;19:24:04;81190313;80934778;255535;
17.01.2019;19:25:05;81190381;80934879;255502;
17.01.2019;19:26:04;81190434;80934989;255445;
17.01.2019;19:27:05;81190474;80935093;255381;
17.01.2019;19:28:05;81190540;80935184;255356;
17.01.2019;19:29:06;81190597;80935270;255327;
17.01.2019;19:30:06;81190679;80935360;255319;
17.01.2019;19:31:05;81190735;80935457;255278;
17.01.2019;19:32:05;81190809;80935553;255256;
17.01.2019;19:33:05;81190892;80935639;255253;
17.01.2019;19:34:05;81190962;80935724;255238;
17.01.2019;19:35:04;81191031;80935805;255226;
17.01.2019;19:36:05;81191096;80935905;255191;
17.01.2019;19:37:05;81191156;80935991;255165;
17.01.2019;19:38:05;81191221;80936071;255150;
17.01.2019;19:39:05;81191279;80936149;255130;
17.01.2019;19:40:05;81191336;80936248;255088;
17.01.2019;19:41:05;81191394;80936328;255066;
17.01.2019;19:42:05;81191458;80936446;255012;
17.01.2019;19:43:05;81191525;80936516;255009;
17.01.2019;19:44:04;81191600;80936588;255012;
17.01.2019;19:45:05;81191670;80936642;255028;
17.01.2019;19:46:05;81190599;80936730;253869;
17.01.2019;19:47:05;81190679;80936821;253858;
17.01.2019;19:48:05;81190752;80941314;249438;
17.01.2019;19:49:05;81190830;80941393;249437;
17.01.2019;19:50:05;81190880;80941479;249401;
17.01.2019;19:51:06;81190945;80941573;249372;
17.01.2019;19:52:05;81191039;80941664;249375;
17.01.2019;19:53:05;81191116;80941747;249369;
17.01.2019;19:54:05;81191176;80941829;249347;
17.01.2019;19:55:05;81191260;80941908;249352;
17.01.2019;19:56:05;81191328;80942007;249321;
17.01.2019;19:57:05;81191412;80942100;249312;
17.01.2019;19:58:05;81191465;80942174;249291;
17.01.2019;19:59:05;81191540;80942258;249282;
17.01.2019;20:00:05;81191623;80942356;249267;
17.01.2019;20:01:05;81191685;80942445;249240;
17.01.2019;20:02:05;81191761;80942509;249252;
17.01.2019;20:03:05;81191834;80942577;249257;
17.01.2019;20:04:06;81191912;80942657;249255;
17.01.2019;20:05:05;81191984;80942727;249257;
17.01.2019;20:06:05;81192063;80942788;249275;
17.01.2019;20:07:05;81192140;80942868;249272;
17.01.2019;20:08:05;81192211;80942946;249265;
17.01.2019;20:09:05;81192292;80943026;249266;
17.01.2019;20:10:05;81192367;80943101;249266;
17.01.2019;20:11:05;81192440;80943174;249266;
17.01.2019;20:12:05;81192523;80943250;249273;
17.01.2019;20:13:05;81192617;80943316;249301;
17.01.2019;20:14:05;81192696;80943385;249311;
17.01.2019;20:15:05;81192771;80943457;249314;
17.01.2019;20:16:05;81192847;80943513;249334;
17.01.2019;20:17:05;81192902;80943577;249325;
17.01.2019;20:18:05;81192973;80943635;249338;
17.01.2019;20:19:05;81193028;80943708;249320;
17.01.2019;20:20:05;81193088;80943773;249315;
17.01.2019;20:21:05;81193149;80943829;249320;
17.01.2019;20:22:05;81193207;80943877;249330;
17.01.2019;20:23:05;81193290;80943928;249362;
17.01.2019;20:24:05;81193349;80943974;249375;
17.01.2019;20:25:05;81193399;80944021;249378;
17.01.2019;20:26:05;81193480;80944070;249410;
17.01.2019;20:27:05;81193561;80944136;249425;
17.01.2019;20:28:05;81193646;80944186;249460;
17.01.2019;20:29:05;81193703;80944259;249444;
17.01.2019;20:30:05;81193758;80944326;249432;
17.01.2019;20:31:05;81193833;80944385;249448;
17.01.2019;20:32:04;81193912;80944430;249482;
17.01.2019;20:33:05;81193999;80944481;249518;
17.01.2019;20:34:05;81194069;80944536;249533;
17.01.2019;20:35:06;81194148;80944594;249554;
17.01.2019;20:36:05;81194232;80944640;249592;
17.01.2019;20:37:05;81194289;80944697;249592;
17.01.2019;20:38:05;81194376;80944752;249624;
17.01.2019;20:39:05;81194458;80944825;249633;
17.01.2019;20:40:05;81194539;80944868;249671;
17.01.2019;20:41:05;81194630;80944920;249710;
17.01.2019;20:42:05;81194703;80944976;249727;
17.01.2019;20:43:05;81194776;80945036;249740;
17.01.2019;20:44:05;81194833;80945070;249763;
17.01.2019;20:45:05;81194910;80945131;249779;
17.01.2019;20:46:06;81194981;80945196;249785;
17.01.2019;20:47:05;81195067;80945241;249826;
17.01.2019;20:48:06;81195141;80945293;249848;
17.01.2019;20:49:05;81195228;80945351;249877;
17.01.2019;20:50:05;81195300;80945415;249885;
17.01.2019;20:51:05;81195395;80945468;249927;
17.01.2019;20:52:05;81195473;80945525;249948;
17.01.2019;20:53:05;81195550;80945586;249964;
17.01.2019;20:54:07;81195629;80945649;249980;
17.01.2019;20:55:04;81195718;80945699;250019;
17.01.2019;20:56:05;81195801;80945755;250046;
17.01.2019;20:57:05;81195900;80945821;250079;
17.01.2019;20:58:06;81195981;80945879;250102;
17.01.2019;20:59:05;81196071;80945937;250134;
17.01.2019;21:00:04;81196170;80945985;250185;
17.01.2019;21:01:04;81196270;80946044;250226;
17.01.2019;21:02:05;81196354;80946109;250245;
17.01.2019;21:03:07;81196454;80946189;250265;
17.01.2019;21:04:05;81196537;80946242;250295;
17.01.2019;21:05:04;81196600;80946283;250317;
17.01.2019;21:06:04;81196673;80946358;250315;
17.01.2019;21:07:04;81196760;80946431;250329;
17.01.2019;21:08:04;81196847;80946473;250374;
17.01.2019;21:09:06;81196948;80946526;250422;
17.01.2019;21:10:05;81197046;80946588;250458;
17.01.2019;21:11:05;81197137;80946643;250494;
17.01.2019;21:12:04;81197202;80946689;250513;
17.01.2019;21:13:05;81197291;80946748;250543;
17.01.2019;21:14:05;81197387;80946792;250595;
17.01.2019;21:15:06;81197471;80946863;250608;
17.01.2019;21:16:05;81197562;80946905;250657;
17.01.2019;21:17:06;81197641;80946964;250677;
17.01.2019;21:18:06;81197721;80947026;250695;
17.01.2019;21:19:05;81197803;80947079;250724;
17.01.2019;21:20:05;81197903;80947132;250771;
17.01.2019;21:21:05;81197985;80947184;250801;
17.01.2019;21:22:05;81198063;80947233;250830;
17.01.2019;21:23:04;81198145;80947289;250856;
17.01.2019;21:24:05;81198242;80947338;250904;
17.01.2019;21:25:05;81198321;80947391;250930;
17.01.2019;21:26:05;81198417;80947461;250956;
17.01.2019;21:27:04;81198492;80947502;250990;
17.01.2019;21:28:05;81198562;80947550;251012;
17.01.2019;21:29:05;81198638;80947595;251043;
17.01.2019;21:30:05;81198704;80947636;251068;
17.01.2019;21:31:06;81198802;80947687;251115;
17.01.2019;21:32:05;81198907;80947722;251185;
17.01.2019;21:33:05;81198991;80947776;251215;
17.01.2019;21:34:05;81199073;80947812;251261;
17.01.2019;21:35:05;81199158;80947869;251289;
17.01.2019;21:36:05;81199225;80947915;251310;
17.01.2019;21:37:05;81199326;80947949;251377;
17.01.2019;21:38:06;81199390;80947971;251419;
17.01.2019;21:39:05;81199484;80947996;251488;
17.01.2019;21:40:05;81199576;80948056;251520;
17.01.2019;21:41:05;81199630;80948074;251556;
17.01.2019;21:42:06;81199715;80948122;251593;
17.01.2019;21:43:05;81199798;80948171;251627;
17.01.2019;21:44:06;81199868;80948211;251657;
17.01.2019;21:45:06;81199956;80948251;251705;
17.01.2019;21:46:06;81200040;80948282;251758;
17.01.2019;21:47:05;81200121;80948316;251805;
17.01.2019;21:48:05;81200205;80948361;251844;
17.01.2019;21:49:05;81200291;80948413;251878;
17.01.2019;21:50:05;81200354;80948458;251896;
17.01.2019;21:51:05;81200443;80948493;251950;
17.01.2019;21:52:04;81200518;80948526;251992;
17.01.2019;21:53:05;81200576;80948563;252013;
17.01.2019;21:54:04;81200638;80948599;252039;
17.01.2019;21:55:10;81200725;80948650;252075;
17.01.2019;21:56:04;81200808;80948690;252118;
17.01.2019;21:57:05;81200860;80948732;252128;
17.01.2019;21:58:05;81200952;80948778;252174;
17.01.2019;21:59:05;81201028;80948819;252209;
17.01.2019;22:00:05;81201114;80948869;252245;
17.01.2019;22:01:05;81201180;80948906;252274;
17.01.2019;22:02:06;81201271;80948948;252323;
17.01.2019;22:03:05;81201351;80948981;252370;
17.01.2019;22:04:05;81201436;80949028;252408;
17.01.2019;22:05:04;81201504;80949054;252450;
17.01.2019;22:06:04;81201572;80949090;252482;
17.01.2019;22:07:04;81201646;80949134;252512;
17.01.2019;22:08:05;81201737;80949168;252569;
17.01.2019;22:09:05;81201814;80949214;252600;
17.01.2019;22:10:05;81201898;80949244;252654;
17.01.2019;22:11:05;81201999;80949272;252727;
17.01.2019;22:12:05;81202090;80949298;252792;
17.01.2019;22:13:06;81202171;80949350;252821;
17.01.2019;22:14:05;81202256;80949378;252878;
17.01.2019;22:15:05;81202332;80949422;252910;
17.01.2019;22:16:04;81202411;80949461;252950;
17.01.2019;22:17:05;81202474;80949488;252986;
17.01.2019;22:18:05;81202542;80949518;253024;
17.01.2019;22:19:05;81202611;80949540;253071;
17.01.2019;22:20:05;81202666;80949583;253083;
17.01.2019;22:21:05;81202742;80949619;253123;
17.01.2019;22:22:05;81202805;80949635;253170;
17.01.2019;22:23:05;81202877;80949670;253207;
17.01.2019;22:24:05;81202933;80949684;253249;
17.01.2019;22:25:05;81203005;80949722;253283;
17.01.2019;22:26:05;81203068;80949735;253333;
17.01.2019;22:27:05;81203140;80949772;253368;
17.01.2019;22:28:05;81203197;80949794;253403;
17.01.2019;22:29:04;81203256;80949819;253437;
17.01.2019;22:30:04;81203281;80949829;253452;
17.01.2019;22:31:04;81203331;80949847;253484;
17.01.2019;22:32:05;81203403;80949863;253540;
17.01.2019;22:33:05;81203450;80949895;253555;
17.01.2019;22:34:04;81203534;80949913;253621;
17.01.2019;22:35:05;81203600;80949930;253670;
17.01.2019;22:36:05;81203670;80949951;253719;
17.01.2019;22:37:05;81203739;80949975;253764;
17.01.2019;22:38:05;81203805;80950000;253805;
17.01.2019;22:39:06;81203883;80950015;253868;
17.01.2019;22:40:04;81203958;80950038;253920;
17.01.2019;22:41:05;81204028;80950066;253962;
17.01.2019;22:42:05;81204095;80950092;254003;
17.01.2019;22:43:05;81204167;80950122;254045;
17.01.2019;22:44:04;81204220;80950152;254068;
17.01.2019;22:45:04;81204286;80950188;254098;
17.01.2019;22:46:05;81204351;80950217;254134;
17.01.2019;22:47:05;81204426;80950224;254202;
17.01.2019;22:48:05;81204504;80950241;254263;
17.01.2019;22:49:04;81204573;80950269;254304;
17.01.2019;22:50:04;81204663;80950296;254367;
17.01.2019;22:51:06;81204737;80950323;254414;
17.01.2019;22:52:04;81204840;80950358;254482;
17.01.2019;22:53:04;81204905;80950395;254510;
17.01.2019;22:54:05;81204956;80950424;254532;
17.01.2019;22:55:05;81205026;80950452;254574;
17.01.2019;22:56:06;81205093;80950479;254614;
17.01.2019;22:57:04;81205182;80950513;254669;
17.01.2019;22:58:06;81205264;80950539;254725;
17.01.2019;22:59:04;81205334;80950567;254767;
17.01.2019;23:00:04;81205401;80950599;254802;
17.01.2019;23:01:05;81205486;80950625;254861;
17.01.2019;23:02:05;81205586;80950646;254940;
17.01.2019;23:03:04;81205670;80950663;255007;
17.01.2019;23:04:04;81205739;80950690;255049;
17.01.2019;23:05:05;81205802;80950731;255071;
17.01.2019;23:06:05;81205888;80950759;255129;
17.01.2019;23:07:04;81205970;80950787;255183;
17.01.2019;23:08:04;81206033;80950821;255212;
17.01.2019;23:09:05;81206116;80950856;255260;
17.01.2019;23:10:05;81206161;80950889;255272;
17.01.2019;23:11:04;81206215;80950926;255289;
17.01.2019;23:12:04;81206314;80950959;255355;
17.01.2019;23:13:04;81206383;80950985;255398;
17.01.2019;23:14:04;81206442;80951013;255429;
17.01.2019;23:15:05;81206514;80951043;255471;
17.01.2019;23:16:05;81206582;80951074;255508;
17.01.2019;23:17:05;81206647;80951086;255561;
17.01.2019;23:18:04;81206705;80951112;255593;
17.01.2019;23:19:04;81206777;80951150;255627;
17.01.2019;23:20:05;81206863;80951177;255686;
17.01.2019;23:21:05;81206926;80951198;255728;
17.01.2019;23:22:04;81207001;80951227;255774;
17.01.2019;23:23:04;81207078;80951260;255818;
17.01.2019;23:24:05;81207151;80951278;255873;
17.01.2019;23:25:05;81207244;80951308;255936;
17.01.2019;23:26:04;81207331;80951334;255997;
17.01.2019;23:27:04;81207403;80951360;256043;
17.01.2019;23:28:05;81207467;80951384;256083;
17.01.2019;23:29:05;81207546;80951401;256145;
17.01.2019;23:30:04;81207621;80951424;256197;
17.01.2019;23:31:04;81207692;80951450;256242;
17.01.2019;23:32:05;81207756;80951477;256279;
17.01.2019;23:33:05;81207818;80951497;256321;
17.01.2019;23:34:05;81207894;80951520;256374;
17.01.2019;23:35:05;81207951;80951545;256406;
17.01.2019;23:36:05;81208024;80951564;256460;
17.01.2019;23:37:04;81208094;80951601;256493;
17.01.2019;23:38:04;81208163;80951623;256540;
17.01.2019;23:39:07;81208239;80951661;256578;
17.01.2019;23:40:05;81208322;80951686;256636;
17.01.2019;23:41:04;81208389;80951709;256680;
17.01.2019;23:42:04;81208458;80951735;256723;
17.01.2019;23:43:05;81208528;80951760;256768;
17.01.2019;23:44:37;81208633;80951797;256836;
17.01.2019;23:45:05;81208722;80951809;256913;
17.01.2019;23:46:05;81208814;80951833;256981;
17.01.2019;23:47:04;81208909;80951872;257037;
17.01.2019;23:48:04;81208992;80951884;257108;
17.01.2019;23:49:05;81209078;80951903;257175;
17.01.2019;23:50:05;81209163;80951929;257234;
17.01.2019;23:51:05;81209227;80951969;257258;
17.01.2019;23:52:05;81209310;80951993;257317;
17.01.2019;23:53:05;81209381;80952012;257369;
17.01.2019;23:54:04;81209471;80952043;257428;
17.01.2019;23:55:04;81209541;80952071;257470;
17.01.2019;23:56:05;81209611;80952097;257514;
17.01.2019;23:57:05;81209688;80952124;257564;
17.01.2019;23:58:04;81209745;80952145;257600;
17.01.2019;23:59:06;81209826;80952181;257645;
18.01.2019;00:00:07;81209880;80952201;257679;
18.01.2019;00:01:08;81209942;80952233;257709;
18.01.2019;00:02:08;81210006;80952254;257752;
18.01.2019;00:03:10;81210063;80952274;257789;
18.01.2019;00:04:09;81210120;80952290;257830;
18.01.2019;00:05:07;81210186;80952314;257872;
18.01.2019;00:06:08;81210241;80952342;257899;
18.01.2019;00:07:07;81210296;80952367;257929;
18.01.2019;00:08:08;81210368;80952393;257975;
18.01.2019;00:09:09;81210435;80952413;258022;
18.01.2019;00:10:08;81210505;80952439;258066;
18.01.2019;00:11:08;81210581;80952466;258115;
18.01.2019;00:12:08;81210639;80952500;258139;
18.01.2019;00:13:08;81210718;80952519;258199;
18.01.2019;00:14:07;81210792;80952540;258252;
18.01.2019;00:15:08;81210848;80952561;258287;
18.01.2019;00:16:07;81210888;80952574;258314;
18.01.2019;00:17:08;81210933;80952606;258327;
18.01.2019;00:18:07;81210978;80952619;258359;
18.01.2019;00:19:08;81211030;80952631;258399;
18.01.2019;00:20:08;81211090;80952654;258436;
18.01.2019;00:21:07;81211141;80952672;258469;
18.01.2019;00:22:08;81211185;80952684;258501;
18.01.2019;00:23:08;81211225;80952685;258540;
18.01.2019;00:24:07;81211301;80952698;258603;
18.01.2019;00:25:07;81211351;80952721;258630;
18.01.2019;00:26:08;81211390;80952730;258660;
18.01.2019;00:27:08;81211455;80952743;258712;
18.01.2019;00:28:07;81211497;80952766;258731;
18.01.2019;00:29:08;81211555;80952787;258768;
18.01.2019;00:30:09;81211613;80952802;258811;
18.01.2019;00:31:08;81211677;80952825;258852;
18.01.2019;00:32:08;81211720;80952846;258874;
18.01.2019;00:33:07;81211778;80952869;258909;
18.01.2019;00:34:07;81211843;80952882;258961;
18.01.2019;00:35:07;81211900;80952897;259003;
18.01.2019;00:36:07;81211959;80952924;259035;
18.01.2019;00:37:07;81212028;80952951;259077;
18.01.2019;00:38:07;81212092;80952967;259125;
18.01.2019;00:39:08;81212163;80953000;259163;
18.01.2019;00:40:07;81212222;80953018;259204;
18.01.2019;00:41:08;81212290;80953044;259246;
18.01.2019;00:42:07;81212329;80953067;259262;
18.01.2019;00:43:08;81212397;80953086;259311;
18.01.2019;00:44:07;81212462;80953117;259345;
18.01.2019;00:45:07;81212527;80953143;259384;
18.01.2019;00:46:07;81212572;80953174;259398;
18.01.2019;00:47:08;81212619;80953186;259433;
18.01.2019;00:48:10;81212662;80953170;259492;
18.01.2019;00:49:07;81212738;80953200;259538;
18.01.2019;00:50:07;81212813;80953218;259595;
18.01.2019;00:51:07;81212870;80953259;259611;
18.01.2019;00:52:07;81212935;80953275;259660;
18.01.2019;00:53:07;81213004;80953297;259707;
18.01.2019;00:54:07;81213079;80953312;259767;
18.01.2019;00:55:07;81213125;80953339;259786;
18.01.2019;00:56:08;81213196;80953375;259821;
18.01.2019;00:57:07;81213251;80953398;259853;
18.01.2019;00:58:07;81213312;80953426;259886;
18.01.2019;00:59:07;81213387;80953457;259930;
18.01.2019;01:00:04;81213435;80953487;259948;
18.01.2019;01:01:05;81213503;80953505;259998;
18.01.2019;01:02:04;81213553;80953539;260014;
18.01.2019;01:03:04;81213643;80953575;260068;
18.01.2019;01:04:05;81213700;80953602;260098;
18.01.2019;01:05:05;81213776;80953627;260149;
18.01.2019;01:06:04;81213859;80953658;260201;
18.01.2019;01:07:05;81213928;80953687;260241;
18.01.2019;01:08:04;81213994;80953699;260295;
18.01.2019;01:09:06;81214047;80953726;260321;
18.01.2019;01:10:05;81214121;80953759;260362;
18.01.2019;01:11:04;81214178;80953784;260394;
18.01.2019;01:12:04;81214245;80953816;260429;
18.01.2019;01:13:05;81214321;80953844;260477;
18.01.2019;01:14:04;81214392;80953864;260528;
18.01.2019;01:15:05;81214468;80953884;260584;
18.01.2019;01:16:05;81214514;80953909;260605;
18.01.2019;01:17:04;81214572;80953932;260640;
18.01.2019;01:18:04;81214659;80953970;260689;
18.01.2019;01:19:05;81214720;80953997;260723;
18.01.2019;01:20:05;81214775;80954027;260748;
18.01.2019;01:21:05;81214847;80954060;260787;
18.01.2019;01:22:05;81214909;80954085;260824;
18.01.2019;01:23:04;81214964;80954106;260858;
18.01.2019;01:24:04;81215036;80954133;260903;
18.01.2019;01:25:05;81215110;80954166;260944;
18.01.2019;01:26:04;81215177;80954205;260972;
18.01.2019;01:27:04;81215234;80954245;260989;
18.01.2019;01:28:05;81215313;80954275;261038;
18.01.2019;01:29:04;81215355;80954316;261039;
18.01.2019;01:30:04;81215411;80954348;261063;
18.01.2019;01:31:04;81215469;80954382;261087;
18.01.2019;01:32:05;81215528;80954410;261118;
18.01.2019;01:33:04;81215596;80954439;261157;
18.01.2019;01:34:04;81215642;80954488;261154;
18.01.2019;01:35:05;81215707;80954512;261195;
18.01.2019;01:36:04;81215760;80954544;261216;
18.01.2019;01:37:04;81215836;80954576;261260;
18.01.2019;01:38:04;81215901;80954598;261303;
18.01.2019;01:39:05;81215965;80954630;261335;
18.01.2019;01:40:04;81216023;80954670;261353;
18.01.2019;01:41:05;81216099;80954708;261391;
18.01.2019;01:42:05;81216163;80954741;261422;
18.01.2019;01:43:05;81216216;80954777;261439;
18.01.2019;01:44:05;81216271;80954815;261456;
18.01.2019;01:45:05;81216340;80954853;261487;
18.01.2019;01:46:05;81216385;80954892;261493;
18.01.2019;01:47:05;81216451;80954943;261508;
18.01.2019;01:48:04;81216513;80954969;261544;
18.01.2019;01:49:04;81216597;80955004;261593;
18.01.2019;01:50:05;81216674;80955046;261628;
18.01.2019;01:51:04;81216734;80955080;261654;
18.01.2019;01:52:04;81216791;80955109;261682;
18.01.2019;01:53:05;81216857;80955158;261699;
18.01.2019;01:54:04;81216943;80955215;261728;
18.01.2019;01:55:04;81217006;80955255;261751;
18.01.2019;01:56:05;81217081;80955309;261772;
18.01.2019;01:57:04;81217154;80955346;261808;
18.01.2019;01:58:04;81217214;80955391;261823;
18.01.2019;01:59:05;81217273;80955440;261833;
18.01.2019;02:00:04;81217307;80955488;261819;
18.01.2019;02:01:05;81217342;80955530;261812;
18.01.2019;02:02:05;81217392;80955564;261828;
18.01.2019;02:03:04;81217465;80955617;261848;
18.01.2019;02:04:04;81217536;80955664;261872;
18.01.2019;02:05:05;81217586;80955723;261863;
18.01.2019;02:06:05;81217662;80955771;261891;
18.01.2019;02:07:04;81217727;80955829;261898;
18.01.2019;02:08:04;81217799;80955899;261900;
18.01.2019;02:09:05;81217872;80955940;261932;
18.01.2019;02:10:05;81217951;80955997;261954;
18.01.2019;02:11:04;81218011;80956052;261959;
18.01.2019;02:12:04;81218075;80956124;261951;
18.01.2019;02:13:05;81218153;80956172;261981;
18.01.2019;02:14:05;81218219;80956219;262000;
18.01.2019;02:15:04;81218278;80956268;262010;
18.01.2019;02:16:04;81218344;80956328;262016;
18.01.2019;02:17:05;81218411;80956378;262033;
18.01.2019;02:18:05;81218451;80956456;261995;
18.01.2019;02:19:05;81218502;80956529;261973;
18.01.2019;02:20:05;81218561;80956585;261976;
18.01.2019;02:21:04;81218621;80956652;261969;
18.01.2019;02:22:04;81218678;80956711;261967;
18.01.2019;02:23:05;81218731;80956775;261956;
18.01.2019;02:24:04;81218793;80956823;261970;
18.01.2019;02:25:05;81218845;80956884;261961;
18.01.2019;02:26:05;81218900;80956942;261958;
18.01.2019;02:27:04;81218963;80957016;261947;
18.01.2019;02:28:05;81219026;80957095;261931;
18.01.2019;02:29:04;81219077;80957153;261924;
18.01.2019;02:30:04;81219132;80957218;261914;
18.01.2019;02:31:05;81219202;80957278;261924;
18.01.2019;02:32:05;81219249;80957342;261907;
18.01.2019;02:33:05;81219303;80957390;261913;
18.01.2019;02:34:04;81219359;80957462;261897;
18.01.2019;02:35:04;81219420;80957521;261899;
18.01.2019;02:36:05;81219457;80957614;261843;
18.01.2019;02:37:04;81219523;80957684;261839;
18.01.2019;02:38:04;81219572;80957753;261819;
18.01.2019;02:39:04;81219623;80957840;261783;
18.01.2019;02:40:05;81219667;80957915;261752;
18.01.2019;02:41:05;81219729;80957990;261739;
18.01.2019;02:42:05;81219785;80958055;261730;
18.01.2019;02:43:04;81219874;80958127;261747;
18.01.2019;02:44:05;81219957;80958207;261750;
18.01.2019;02:45:10;81220034;80958288;261746;
18.01.2019;02:46:05;81220091;80958378;261713;
18.01.2019;02:47:04;81220144;80958451;261693;
18.01.2019;02:48:04;81220216;80958510;261706;
18.01.2019;02:49:04;81220278;80958605;261673;
18.01.2019;02:50:04;81220345;80958678;261667;
18.01.2019;02:51:04;81220416;80958745;261671;
18.01.2019;02:52:05;81220474;80958835;261639;
18.01.2019;02:53:05;81220535;80958920;261615;
18.01.2019;02:54:04;81220591;80959014;261577;
18.01.2019;02:55:04;81220660;80959096;261564;
18.01.2019;02:56:05;81220744;80959176;261568;
18.01.2019;02:57:04;81220802;80959267;261535;
18.01.2019;02:58:04;81220869;80959364;261505;
18.01.2019;02:59:05;81220944;80959461;261483;
18.01.2019;03:00:05;81221011;80959547;261464;
18.01.2019;03:01:04;81221085;80959615;261470;
18.01.2019;03:02:04;81221158;80959714;261444;
18.01.2019;03:03:05;81221224;80959809;261415;
18.01.2019;03:04:04;81221279;80959915;261364;
18.01.2019;03:05:04;81221352;80960011;261341;
18.01.2019;03:06:05;81221421;80960102;261319;
18.01.2019;03:07:04;81221476;80960181;261295;
18.01.2019;03:08:04;81221563;80960260;261303;
18.01.2019;03:09:05;81221619;80960349;261270;
18.01.2019;03:10:05;81221702;80960428;261274;
18.01.2019;03:11:04;81221751;80960513;261238;
18.01.2019;03:12:05;81221828;80960618;261210;
18.01.2019;03:13:04;81221904;80960727;261177;
18.01.2019;03:14:04;81221970;80960841;261129;
18.01.2019;03:15:05;81222049;80960923;261126;
18.01.2019;03:16:04;81222127;80961019;261108;
18.01.2019;03:17:04;81222199;80961102;261097;
18.01.2019;03:18:05;81222264;80961213;261051;
18.01.2019;03:19:05;81222348;80961306;261042;
18.01.2019;03:20:04;81222414;80961399;261015;
18.01.2019;03:21:04;81222489;80961488;261001;
18.01.2019;03:22:05;81222558;80961580;260978;
18.01.2019;03:23:05;81222632;80961674;260958;
18.01.2019;03:24:04;81222699;80961754;260945;
18.01.2019;03:25:04;81222762;80961875;260887;
18.01.2019;03:26:05;81222821;80961981;260840;
18.01.2019;03:27:04;81222885;80962069;260816;
18.01.2019;03:28:04;81222955;80962170;260785;
18.01.2019;03:29:05;81223024;80962284;260740;
18.01.2019;03:30:05;81223098;80962361;260737;
18.01.2019;03:31:04;81223171;80962459;260712;
18.01.2019;03:32:05;81223238;80962555;260683;
18.01.2019;03:33:04;81223304;80962651;260653;
18.01.2019;03:34:09;81223357;80962743;260614;
18.01.2019;03:35:06;81223417;80962830;260587;
18.01.2019;03:36:04;81223485;80962948;260537;
18.01.2019;03:37:04;81223562;80963050;260512;
18.01.2019;03:38:05;81223641;80963149;260492;
18.01.2019;03:39:06;81223707;80963248;260459;
18.01.2019;03:40:05;81223792;80963365;260427;
18.01.2019;03:41:04;81223869;80963471;260398;
18.01.2019;03:42:04;81223944;80963580;260364;
18.01.2019;03:43:04;81223996;80963680;260316;
18.01.2019;03:44:04;81224070;80963791;260279;
18.01.2019;03:45:05;81224130;80963900;260230;
18.01.2019;03:46:05;81224176;80963993;260183;
18.01.2019;03:47:05;81224254;80964098;260156;
18.01.2019;03:48:05;81224317;80964211;260106;
18.01.2019;03:49:05;81224410;80964322;260088;
18.01.2019;03:50:04;81224482;80964431;260051;
18.01.2019;03:51:04;81224527;80964538;259989;
18.01.2019;03:52:05;81224604;80964656;259948;
18.01.2019;03:53:05;81224673;80964768;259905;
18.01.2019;03:54:04;81224740;80964887;259853;
18.01.2019;03:55:05;81224805;80964997;259808;
18.01.2019;03:56:04;81224882;80965105;259777;
18.01.2019;03:57:04;81224949;80965210;259739;
18.01.2019;03:58:05;81225022;80965330;259692;
18.01.2019;03:59:05;81225097;80965448;259649;
18.01.2019;04:00:05;81225152;80965550;259602;
18.01.2019;04:01:05;81225214;80965643;259571;
18.01.2019;04:02:04;81225291;80965759;259532;
18.01.2019;04:03:04;81225372;80965873;259499;
18.01.2019;04:04:05;81225436;80965961;259475;
18.01.2019;04:05:05;81225508;80966084;259424;
18.01.2019;04:06:04;81225569;80966187;259382;
18.01.2019;04:07:05;81225633;80966284;259349;
18.01.2019;04:08:04;81225710;80966417;259293;
18.01.2019;04:09:04;81225778;80966532;259246;
18.01.2019;04:10:05;81225849;80966651;259198;
18.01.2019;04:11:05;81225919;80966765;259154;
18.01.2019;04:12:05;81225978;80966880;259098;
18.01.2019;04:13:04;81226054;80966983;259071;
18.01.2019;04:14:05;81226136;80967094;259042;
18.01.2019;04:15:04;81226146;80967168;258978;
18.01.2019;04:16:04;81226226;80967289;258937;
18.01.2019;04:17:05;81226293;80967381;258912;
18.01.2019;04:18:05;81226357;80967489;258868;
18.01.2019;04:19:04;81226417;80967597;258820;
18.01.2019;04:20:05;81226461;80967697;258764;
18.01.2019;04:21:05;81226522;80967783;258739;
18.01.2019;04:22:05;81226570;80967877;258693;
18.01.2019;04:23:04;81226616;80967981;258635;
18.01.2019;04:24:05;81226676;80968086;258590;
18.01.2019;04:25:05;81226727;80968183;258544;
18.01.2019;04:26:04;81226793;80968265;258528;
18.01.2019;04:27:05;81226850;80968370;258480;
18.01.2019;04:28:05;81226901;80968470;258431;
18.01.2019;04:29:05;81226956;80968573;258383;
18.01.2019;04:30:04;81227020;80968695;258325;
18.01.2019;04:31:04;81227068;80968789;258279;
18.01.2019;04:32:05;81227130;80968911;258219;
18.01.2019;04:33:05;81227187;80969036;258151;
18.01.2019;04:34:04;81227238;80969155;258083;
18.01.2019;04:35:05;81227289;80969263;258026;
18.01.2019;04:36:04;81227359;80969366;257993;
18.01.2019;04:37:04;81227425;80969492;257933;
18.01.2019;04:38:05;81227491;80969612;257879;
18.01.2019;04:39:04;81227558;80969713;257845;
18.01.2019;04:40:04;81227615;80969820;257795;
18.01.2019;04:41:05;81227663;80969920;257743;
18.01.2019;04:42:05;81227716;80970041;257675;
18.01.2019;04:43:04;81227768;80970160;257608;
18.01.2019;04:44:04;81227824;80970264;257560;
18.01.2019;04:45:05;81227879;80970369;257510;
18.01.2019;04:46:04;81227959;80970487;257472;
18.01.2019;04:47:05;81228004;80970619;257385;
18.01.2019;04:48:05;81228058;80970740;257318;
18.01.2019;04:49:04;81228110;80970857;257253;
18.01.2019;04:50:04;81228159;80970974;257185;
18.01.2019;04:51:05;81228213;80971102;257111;
18.01.2019;04:52:04;81228281;80971208;257073;
18.01.2019;04:53:04;81228351;80971324;257027;
18.01.2019;04:54:04;81228420;80971438;256982;
18.01.2019;04:55:05;81228469;80971555;256914;
18.01.2019;04:56:04;81228527;80971652;256875;
18.01.2019;04:57:05;81228584;80971767;256817;
18.01.2019;04:58:04;81228648;80971881;256767;
18.01.2019;04:59:04;81228694;80972014;256680;
18.01.2019;05:00:05;81228756;80972128;256628;
18.01.2019;05:01:04;81228815;80972232;256583;
18.01.2019;05:02:05;81228887;80972365;256522;
18.01.2019;05:03:05;81228951;80972489;256462;
18.01.2019;05:04:04;81229015;80972577;256438;
18.01.2019;05:05:04;81229077;80972697;256380;
18.01.2019;05:06:05;81229125;80972807;256318;
18.01.2019;05:07:09;81229181;80972915;256266;
18.01.2019;05:08:05;81229226;80973026;256200;
18.01.2019;05:09:05;81229274;80973141;256133;
18.01.2019;05:10:04;81229331;80973247;256084;
18.01.2019;05:11:04;81229386;80973349;256037;
18.01.2019;05:12:04;81229449;80973459;255990;
18.01.2019;05:13:04;81229496;80973581;255915;
18.01.2019;05:14:04;81229572;80973698;255874;
18.01.2019;05:15:05;81229628;80973832;255796;
18.01.2019;05:16:04;81229707;80973954;255753;
18.01.2019;05:17:05;81229772;80974066;255706;
18.01.2019;05:18:05;81229847;80974181;255666;
18.01.2019;05:19:04;81229912;80974288;255624;
18.01.2019;05:20:05;81229965;80974433;255532;
18.01.2019;05:21:04;81230013;80974551;255462;
18.01.2019;05:22:04;81230082;80974671;255411;
18.01.2019;05:23:05;81230152;80974777;255375;
18.01.2019;05:24:04;81230224;80974897;255327;
18.01.2019;05:25:04;81230272;80975017;255255;
18.01.2019;05:26:05;81230345;80975130;255215;
18.01.2019;05:27:05;81230402;80975235;255167;
18.01.2019;05:28:05;81230465;80975341;255124;
18.01.2019;05:29:05;81230506;80975458;255048;
18.01.2019;05:30:05;81230561;80975564;254997;
18.01.2019;05:31:05;81230619;80975683;254936;
18.01.2019;05:32:05;81230688;80975817;254871;
18.01.2019;05:33:04;81230750;80975918;254832;
18.01.2019;05:34:04;81230813;80976051;254762;
18.01.2019;05:35:05;81230858;80976175;254683;
18.01.2019;05:36:05;81230913;80976291;254622;
18.01.2019;05:37:05;81230965;80976398;254567;
18.01.2019;05:38:04;81231037;80976530;254507;
18.01.2019;05:39:07;81231107;80976641;254466;
18.01.2019;05:40:05;81231153;80976747;254406;
18.01.2019;05:41:05;81231225;80976851;254374;
18.01.2019;05:42:04;81231282;80976976;254306;
18.01.2019;05:43:05;81231348;80977076;254272;
18.01.2019;05:44:04;81231395;80977186;254209;
18.01.2019;05:45:04;81231448;80977304;254144;
18.01.2019;05:46:05;81231506;80977447;254059;
18.01.2019;05:47:04;81231551;80977554;253997;
18.01.2019;05:48:04;81231612;80977673;253939;
18.01.2019;05:49:05;81231667;80977808;253859;
18.01.2019;05:50:04;81231717;80977928;253789;
18.01.2019;05:51:05;81231780;80978046;253734;
18.01.2019;05:52:05;81231833;80978158;253675;
18.01.2019;05:53:05;81231907;80978287;253620;
18.01.2019;05:54:04;81231977;80978404;253573;
18.01.2019;05:55:04;81232031;80978526;253505;
18.01.2019;05:56:04;81232093;80978662;253431;
18.01.2019;05:57:05;81232136;80978777;253359;
18.01.2019;05:58:04;81232205;80978882;253323;
18.01.2019;05:59:05;81232255;80979003;253252;
18.01.2019;06:00:05;81232330;80979124;253206;
18.01.2019;06:01:04;81232381;80979233;253148;
18.01.2019;06:02:05;81232441;80979353;253088;
18.01.2019;06:03:04;81232502;80979493;253009;
18.01.2019;06:04:04;81232554;80979584;252970;
18.01.2019;06:05:05;81232602;80979722;252880;
18.01.2019;06:06:04;81232657;80979844;252813;
18.01.2019;06:07:04;81232708;80979961;252747;
18.01.2019;06:08:05;81232757;80980082;252675;
18.01.2019;06:09:05;81232822;80980190;252632;
18.01.2019;06:10:04;81232867;80980342;252525;
18.01.2019;06:11:05;81232925;80980472;252453;
18.01.2019;06:12:04;81232964;80980572;252392;
18.01.2019;06:13:04;81233015;80980699;252316;
18.01.2019;06:14:05;81233047;80980831;252216;
18.01.2019;06:15:05;81233089;80980958;252131;
18.01.2019;06:16:05;81233131;80981067;252064;
18.01.2019;06:17:05;81233165;80981164;252001;
18.01.2019;06:18:05;81233203;80981276;251927;
18.01.2019;06:19:05;81233232;80981388;251844;
18.01.2019;06:20:05;81233271;80981523;251748;
18.01.2019;06:21:04;81233309;80981627;251682;
18.01.2019;06:22:04;81233351;80981726;251625;
18.01.2019;06:23:05;81233398;80981837;251561;
18.01.2019;06:24:04;81233446;80981956;251490;
18.01.2019;06:25:07;81233490;80982088;251402;
18.01.2019;06:26:04;81233522;80982199;251323;
18.01.2019;06:27:05;81233564;80982293;251271;
18.01.2019;06:28:04;81233599;80982384;251215;
18.01.2019;06:29:05;81233642;80982495;251147;
18.01.2019;06:30:04;81233696;80982595;251101;
18.01.2019;06:31:04;81233725;80982718;251007;
18.01.2019;06:32:05;81233788;80982826;250962;
18.01.2019;06:33:04;81233837;80982934;250903;
18.01.2019;06:34:04;81233877;80983022;250855;
18.01.2019;06:35:05;81233923;80983118;250805;
18.01.2019;06:36:04;81233961;80983240;250721;
18.01.2019;06:37:04;81234020;80983361;250659;
18.01.2019;06:38:05;81234069;80983472;250597;
18.01.2019;06:39:05;81234124;80983593;250531;
18.01.2019;06:40:04;81234166;80983691;250475;
18.01.2019;06:41:04;81234217;80983814;250403;
18.01.2019;06:42:05;81234259;80983936;250323;
18.01.2019;06:43:05;81234291;80984068;250223;
18.01.2019;06:44:05;81234339;80984175;250164;
18.01.2019;06:45:05;81234387;80984282;250105;
18.01.2019;06:46:04;81234426;80984397;250029;
18.01.2019;06:47:04;81234480;80984504;249976;
18.01.2019;06:48:04;81234519;80984618;249901;
18.01.2019;06:49:05;81234584;80984768;249816;
18.01.2019;06:50:05;81234625;80984881;249744;
18.01.2019;06:51:05;81234692;80985005;249687;
18.01.2019;06:52:04;81234742;80985137;249605;
18.01.2019;06:53:04;81234805;80985267;249538;
18.01.2019;06:54:05;81234859;80985361;249498;
18.01.2019;06:55:05;81234910;80985489;249421;
18.01.2019;06:56:05;81234950;80985613;249337;
18.01.2019;06:57:04;81234975;80985721;249254;
18.01.2019;06:58:04;81235024;80985833;249191;
18.01.2019;06:59:04;81235088;80985944;249144;
18.01.2019;07:00:04;81235138;80986053;249085;
18.01.2019;07:01:05;81235166;80986197;248969;
18.01.2019;07:02:04;81235224;80986325;248899;
18.01.2019;07:03:05;81235277;80986420;248857;
18.01.2019;07:04:05;81235316;80986528;248788;
18.01.2019;07:05:05;81235361;80986642;248719;
18.01.2019;07:06:05;81235404;80986769;248635;
18.01.2019;07:07:05;81235430;80986879;248551;
18.01.2019;07:08:05;81235482;80986982;248500;
18.01.2019;07:09:06;81235544;80987086;248458;
18.01.2019;07:10:04;81235584;80987182;248402;
18.01.2019;07:11:05;81235629;80987271;248358;
18.01.2019;07:12:05;81235691;80987376;248315;
18.01.2019;07:13:04;81235723;80987459;248264;
18.01.2019;07:14:05;81235762;80987551;248211;
18.01.2019;07:15:05;81235799;80987671;248128;
18.01.2019;07:16:04;81235844;80987783;248061;
18.01.2019;07:17:04;81235904;80987899;248005;
18.01.2019;07:18:05;81235954;80988014;247940;
18.01.2019;07:19:05;81235996;80988154;247842;
18.01.2019;07:20:05;81236057;80988266;247791;
18.01.2019;07:21:05;81236126;80988403;247723;
18.01.2019;07:22:04;81236166;80988517;247649;
18.01.2019;07:23:04;81236214;80988616;247598;
18.01.2019;07:24:05;81236254;80988729;247525;
18.01.2019;07:25:05;81236314;80988849;247465;
18.01.2019;07:26:05;81236357;80988953;247404;
18.01.2019;07:27:04;81236394;80989056;247338;
18.01.2019;07:28:05;81236449;80989176;247273;
18.01.2019;07:29:05;81236499;80989303;247196;
18.01.2019;07:30:04;81236541;80989418;247123;
18.01.2019;07:31:04;81236593;80989536;247057;
18.01.2019;07:32:05;81236638;80989643;246995;
18.01.2019;07:33:05;81236678;80989771;246907;
18.01.2019;07:34:05;81236719;80989899;246820;
18.01.2019;07:35:04;81236767;80990025;246742;
18.01.2019;07:36:05;81236812;80990130;246682;
18.01.2019;07:37:05;81236875;80990229;246646;
18.01.2019;07:38:05;81236910;80990349;246561;
18.01.2019;07:39:06;81236957;80990449;246508;
18.01.2019;07:40:05;81237016;80990571;246445;
18.01.2019;07:41:04;81237059;80990676;246383;
18.01.2019;07:42:04;81237095;80990812;246283;
18.01.2019;07:43:05;81237156;80990929;246227;
18.01.2019;07:44:04;81237203;80991040;246163;
18.01.2019;07:45:04;81237235;80991138;246097;
18.01.2019;07:46:05;81237288;80991281;246007;
18.01.2019;07:47:04;81237334;80991391;245943;
18.01.2019;07:48:04;81237381;80991521;245860;
18.01.2019;07:49:05;81237422;80991662;245760;
18.01.2019;07:50:04;81237461;80991770;245691;
18.01.2019;07:51:04;81237502;80991890;245612;
18.01.2019;07:52:05;81237560;80992018;245542;
18.01.2019;07:53:04;81237607;80992150;245457;
18.01.2019;07:54:04;81237650;80992274;245376;
18.01.2019;07:55:05;81237697;80992384;245313;
18.01.2019;07:56:04;81237718;80992508;245210;
18.01.2019;07:57:04;81237772;80992634;245138;
18.01.2019;07:58:05;81237818;80992746;245072;
18.01.2019;07:59:05;81237862;80992869;244993;
18.01.2019;08:00:05;81237920;80992983;244937;
18.01.2019;08:01:04;81237974;80993097;244877;
18.01.2019;08:02:04;81238026;80993211;244815;
18.01.2019;08:03:04;81238075;80993319;244756;
18.01.2019;08:04:04;81238126;80993471;244655;
18.01.2019;08:05:05;81238169;80993578;244591;
18.01.2019;08:06:04;81238218;80993689;244529;
18.01.2019;08:07:04;81238253;80993793;244460;
18.01.2019;08:08:05;81238291;80993911;244380;
18.01.2019;08:09:07;81238320;80994024;244296;
18.01.2019;08:10:04;81238360;80994135;244225;
18.01.2019;08:11:04;81238396;80994233;244163;
18.01.2019;08:12:04;81238425;80994336;244089;
18.01.2019;08:13:04;81238474;80994420;244054;
18.01.2019;08:14:05;81238492;80994529;243963;
18.01.2019;08:15:04;81238535;80994641;243894;
18.01.2019;08:16:04;81238553;80994756;243797;
18.01.2019;08:17:05;81238595;80994864;243731;
18.01.2019;08:18:05;81238630;80994969;243661;
18.01.2019;08:19:04;81238665;80995087;243578;
18.01.2019;08:20:05;81238684;80995192;243492;
18.01.2019;08:21:05;81238690;80995280;243410;
18.01.2019;08:22:05;81238734;80995399;243335;
18.01.2019;08:23:04;81238765;80995507;243258;
18.01.2019;08:24:04;81238780;80995609;243171;
18.01.2019;08:25:05;81238815;80995719;243096;
18.01.2019;08:26:04;81238856;80995827;243029;
18.01.2019;08:27:04;81238904;80995950;242954;
18.01.2019;08:28:05;81238948;80996078;242870;
18.01.2019;08:29:04;81238986;80996168;242818;
18.01.2019;08:30:05;81239037;80996290;242747;
18.01.2019;08:31:04;81239076;80996415;242661;
18.01.2019;08:32:05;81239105;80996518;242587;
18.01.2019;08:33:05;81239137;80996650;242487;
18.01.2019;08:34:04;81239174;80996764;242410;
18.01.2019;08:35:05;81239193;80996897;242296;
18.01.2019;08:36:04;81239233;80997036;242197;
18.01.2019;08:37:04;81239268;80997152;242116;
18.01.2019;08:38:05;81239294;80997274;242020;
18.01.2019;08:39:05;81239341;80997372;241969;
18.01.2019;08:40:05;81239378;80997492;241886;
18.01.2019;08:41:05;81239413;80997609;241804;
18.01.2019;08:42:04;81239462;80997723;241739;
18.01.2019;08:43:04;81239498;80997846;241652;
18.01.2019;08:44:05;81239550;80997962;241588;
18.01.2019;08:45:04;81239601;80998091;241510;
18.01.2019;08:46:04;81239648;80998217;241431;
18.01.2019;08:47:05;81239707;80998329;241378;
18.01.2019;08:48:04;81239755;80998451;241304;
18.01.2019;08:49:04;81239784;80998563;241221;
18.01.2019;08:50:04;81239825;80998706;241119;
18.01.2019;08:51:05;81239859;80998823;241036;
18.01.2019;08:52:05;81239911;80998946;240965;
18.01.2019;08:53:04;81239949;80999064;240885;
18.01.2019;08:54:05;81239998;80999206;240792;
18.01.2019;08:55:05;81240019;80999331;240688;
18.01.2019;08:56:04;81240068;80999454;240614;
18.01.2019;08:57:05;81240114;80999563;240551;
18.01.2019;08:58:04;81240151;80999685;240466;
18.01.2019;08:59:05;81240206;80999827;240379;
18.01.2019;09:00:04;81240247;80999965;240282;
18.01.2019;09:01:05;81240280;81000098;240182;
18.01.2019;09:02:05;81240321;81000241;240080;
18.01.2019;09:03:04;81240387;81000346;240041;
18.01.2019;09:04:04;81240426;81000483;239943;
18.01.2019;09:05:05;81240473;81000616;239857;
18.01.2019;09:06:04;81240518;81000722;239796;
18.01.2019;09:07:05;81240556;81000846;239710;
18.01.2019;09:08:05;81240604;81000970;239634;
18.01.2019;09:09:05;81240642;81001100;239542;
18.01.2019;09:10:05;81240677;81001212;239465;
18.01.2019;09:11:04;81240732;81001338;239394;
18.01.2019;09:12:04;81240768;81001452;239316;
18.01.2019;09:13:05;81240800;81001591;239209;
18.01.2019;09:14:05;81240848;81001705;239143;
18.01.2019;09:15:04;81240885;81001827;239058;
18.01.2019;09:16:05;81240909;81001973;238936;
18.01.2019;09:17:05;81240957;81002099;238858;
18.01.2019;09:18:04;81241003;81002237;238766;
18.01.2019;09:19:04;81241048;81002355;238693;
18.01.2019;09:20:05;81241082;81002487;238595;
18.01.2019;09:21:05;81241124;81002632;238492;
18.01.2019;09:22:05;81241175;81002771;238404;
18.01.2019;09:23:05;81241226;81002902;238324;
18.01.2019;09:24:05;81241277;81003026;238251;
18.01.2019;09:25:05;81241332;81003159;238173;
18.01.2019;09:26:04;81241376;81003288;238088;
18.01.2019;09:27:04;81241408;81003414;237994;
18.01.2019;09:28:05;81241449;81003532;237917;
18.01.2019;09:29:04;81241487;81003648;237839;
18.01.2019;09:30:05;81241522;81003794;237728;
18.01.2019;09:31:05;81241555;81003914;237641;
18.01.2019;09:32:04;81241584;81004049;237535;
18.01.2019;09:33:05;81241629;81004154;237475;
18.01.2019;09:34:05;81241658;81004274;237384;
18.01.2019;09:35:04;81241698;81004408;237290;
18.01.2019;09:36:05;81241744;81004546;237198;
18.01.2019;09:37:04;81241786;81004643;237143;
18.01.2019;09:38:04;81241815;81004733;237082;
18.01.2019;09:39:07;81241860;81004843;237017;
18.01.2019;09:40:04;81241894;81004961;236933;
18.01.2019;09:41:04;81241938;81005081;236857;
18.01.2019;09:42:05;81241979;81005197;236782;
18.01.2019;09:43:04;81242033;81005317;236716;
18.01.2019;09:44:04;81242075;81005450;236625;
18.01.2019;09:45:05;81242124;81005596;236528;
18.01.2019;09:46:05;81242166;81005706;236460;
18.01.2019;09:47:04;81242206;81005817;236389;
18.01.2019;09:48:04;81242242;81005937;236305;
18.01.2019;09:49:05;81242294;81006071;236223;
18.01.2019;09:50:04;81242340;81006184;236156;
18.01.2019;09:51:04;81242381;81006316;236065;
18.01.2019;09:52:05;81242407;81006435;235972;
18.01.2019;09:53:05;81242441;81006584;235857;
18.01.2019;09:54:04;81242488;81006686;235802;
18.01.2019;09:55:04;81242520;81006802;235718;
18.01.2019;09:56:05;81242568;81006920;235648;
18.01.2019;09:57:04;81242604;81007041;235563;
18.01.2019;09:58:05;81242654;81007149;235505;
18.01.2019;09:59:05;81242698;81007282;235416;
18.01.2019;10:00:04;81242738;81007414;235324;
18.01.2019;10:01:04;81242762;81007534;235228;
18.01.2019;10:02:05;81242799;81007665;235134;
18.01.2019;10:03:05;81242836;81007753;235083;
18.01.2019;10:04:04;81242859;81007829;235030;
18.01.2019;10:05:04;81242866;81007933;234933;
18.01.2019;10:06:04;81242906;81008054;234852;
18.01.2019;10:07:05;81242943;81008169;234774;
18.01.2019;10:08:04;81242982;81008282;234700;
18.01.2019;10:09:04;81243009;81008419;234590;
18.01.2019;10:10:05;81243054;81008541;234513;
18.01.2019;10:11:05;81243100;81008667;234433;
18.01.2019;10:12:05;81243136;81008787;234349;
18.01.2019;10:13:05;81243159;81008919;234240;
18.01.2019;10:14:04;81243207;81009039;234168;
18.01.2019;10:15:05;81243231;81009162;234069;
18.01.2019;10:16:05;81243263;81009295;233968;
18.01.2019;10:17:04;81243291;81009432;233859;
18.01.2019;10:18:04;81243325;81009554;233771;
18.01.2019;10:19:05;81243362;81009699;233663;
18.01.2019;10:20:05;81243382;81009816;233566;
18.01.2019;10:21:05;81243399;81009944;233455;
18.01.2019;10:22:05;81243419;81010060;233359;
18.01.2019;10:23:04;81243461;81010157;233304;
18.01.2019;10:24:05;81243502;81010261;233241;
18.01.2019;10:25:04;81243534;81010395;233139;
18.01.2019;10:26:04;81243562;81010531;233031;
18.01.2019;10:27:05;81243590;81010648;232942;
18.01.2019;10:28:05;81243625;81010788;232837;
18.01.2019;10:29:04;81243650;81010896;232754;
18.01.2019;10:30:04;81243664;81011012;232652;
18.01.2019;10:31:05;81243697;81011139;232558;
18.01.2019;10:32:05;81243730;81011277;232453;
18.01.2019;10:33:04;81243766;81011405;232361;
18.01.2019;10:34:04;81243804;81011530;232274;
18.01.2019;10:35:05;81243830;81011649;232181;
18.01.2019;10:36:04;81243870;81011768;232102;
18.01.2019;10:37:04;81243906;81011917;231989;
18.01.2019;10:38:05;81243948;81012060;231888;
18.01.2019;10:39:06;81244000;81012171;231829;
18.01.2019;10:40:05;81244046;81012294;231752;
18.01.2019;10:41:06;81244082;81012435;231647;
18.01.2019;10:42:04;81244114;81012539;231575;
18.01.2019;10:43:04;81244167;81012686;231481;
18.01.2019;10:44:04;81244216;81012812;231404;
18.01.2019;10:45:04;81244261;81012944;231317;
18.01.2019;10:46:04;81244306;81013070;231236;
18.01.2019;10:47:05;81244358;81013191;231167;
18.01.2019;10:48:04;81244389;81013355;231034;
18.01.2019;10:49:04;81244427;81013483;230944;
18.01.2019;10:50:04;81244467;81013621;230846;
18.01.2019;10:51:05;81244518;81013773;230745;
18.01.2019;10:52:05;81244552;81013885;230667;
18.01.2019;10:53:05;81244588;81014002;230586;
18.01.2019;10:54:05;81244618;81014133;230485;
18.01.2019;10:55:05;81244656;81014261;230395;
18.01.2019;10:56:05;81244695;81014407;230288;
18.01.2019;10:57:04;81244727;81014537;230190;
18.01.2019;10:58:05;81244777;81014661;230116;
18.01.2019;10:59:05;81244831;81014787;230044;
18.01.2019;11:00:04;81244885;81014912;229973;
18.01.2019;11:01:04;81244928;81015058;229870;
18.01.2019;11:02:05;81244956;81015206;229750;
18.01.2019;11:03:04;81245000;81015361;229639;
18.01.2019;11:04:05;81245047;81015492;229555;
18.01.2019;11:05:05;81245080;81015633;229447;
18.01.2019;11:06:04;81245119;81015769;229350;
18.01.2019;11:07:05;81245159;81015899;229260;
18.01.2019;11:08:04;81245185;81016038;229147;
18.01.2019;11:09:04;81245248;81016164;229084;
18.01.2019;11:10:04;81245292;81016289;229003;
18.01.2019;11:11:05;81245336;81016426;228910;
18.01.2019;11:12:05;81245376;81016552;228824;
18.01.2019;11:13:05;81245418;81016711;228707;
18.01.2019;11:14:04;81245459;81016863;228596;
18.01.2019;11:15:05;81245498;81016988;228510;
18.01.2019;11:16:04;81245529;81017098;228431;
18.01.2019;11:17:04;81245566;81017211;228355;
18.01.2019;11:18:04;81245611;81017335;228276;
18.01.2019;11:19:05;81245637;81017490;228147;
18.01.2019;11:20:05;81245687;81017629;228058;
18.01.2019;11:21:04;81245718;81017786;227932;
18.01.2019;11:22:04;81245750;81017903;227847;
18.01.2019;11:23:05;81245808;81018063;227745;
18.01.2019;11:24:04;81245850;81018208;227642;
18.01.2019;11:25:04;81245889;81018337;227552;
18.01.2019;11:26:05;81245932;81018465;227467;
18.01.2019;11:27:05;81245977;81018596;227381;
18.01.2019;11:28:05;81246019;81018738;227281;
18.01.2019;11:29:05;81246061;81018882;227179;
18.01.2019;11:30:04;81246092;81019021;227071;
18.01.2019;11:31:04;81246151;81019159;226992;
18.01.2019;11:32:05;81246202;81019295;226907;
18.01.2019;11:33:04;81246238;81019433;226805;
18.01.2019;11:34:05;81246272;81019555;226717;
18.01.2019;11:35:05;81246329;81019655;226674;
18.01.2019;11:36:04;81246374;81019763;226611;
18.01.2019;11:37:05;81246413;81019853;226560;
18.01.2019;11:38:04;81246457;81019948;226509;
18.01.2019;11:39:06;81246496;81020065;226431;
18.01.2019;11:40:05;81246539;81020163;226376;
18.01.2019;11:41:04;81246584;81020281;226303;
18.01.2019;11:42:05;81246615;81020400;226215;
18.01.2019;11:43:05;81246665;81020510;226155;
18.01.2019;11:44:04;81246710;81020628;226082;
18.01.2019;11:45:05;81246736;81020749;225987;
18.01.2019;11:46:04;81246774;81020864;225910;
18.01.2019;11:47:07;81246825;81021010;225815;
18.01.2019;11:48:05;81246870;81021114;225756;
18.01.2019;11:49:05;81246913;81021226;225687;
18.01.2019;11:50:04;81246949;81021345;225604;
18.01.2019;11:51:05;81246982;81021452;225530;
18.01.2019;11:52:04;81247022;81021576;225446;
18.01.2019;11:53:04;81247073;81021717;225356;
18.01.2019;11:54:05;81247111;81021823;225288;
18.01.2019;11:55:05;81247163;81021981;225182;
18.01.2019;11:56:04;81247206;81022117;225089;
18.01.2019;11:57:04;81247248;81022248;225000;
18.01.2019;11:58:05;81247281;81022399;224882;
18.01.2019;11:59:05;81247324;81022523;224801;
18.01.2019;12:00:04;81247359;81022650;224709;
18.01.2019;12:01:05;81247395;81022792;224603;
18.01.2019;12:02:04;81247442;81022949;224493;
18.01.2019;12:03:04;81247475;81023073;224402;
18.01.2019;12:04:04;81247512;81023179;224333;
18.01.2019;12:05:05;81247553;81023334;224219;
18.01.2019;12:06:04;81247594;81023450;224144;
18.01.2019;12:07:04;81247633;81023595;224038;
18.01.2019;12:08:05;81247698;81023731;223967;
18.01.2019;12:09:10;81247753;81023894;223859;
18.01.2019;12:10:05;81247804;81024006;223798;
18.01.2019;12:11:05;81247863;81024134;223729;
18.01.2019;12:12:04;81247924;81024261;223663;
18.01.2019;12:13:04;81247973;81024412;223561;
18.01.2019;12:14:05;81248015;81024554;223461;
18.01.2019;12:15:04;81248037;81024681;223356;
18.01.2019;12:16:05;81248054;81024713;223341;
18.01.2019;12:17:05;81248066;81024881;223185;
18.01.2019;12:18:05;81248103;81024987;223116;
18.01.2019;12:19:04;81248128;81025028;223100;
18.01.2019;12:20:04;81248135;81025180;222955;
18.01.2019;12:21:05;81248172;81025297;222875;
18.01.2019;12:22:05;81248208;81025425;222783;
18.01.2019;12:23:04;81248240;81025545;222695;
18.01.2019;12:24:04;81248294;81025689;222605;
18.01.2019;12:25:05;81248325;81025832;222493;
18.01.2019;12:26:04;81248356;81025938;222418;
18.01.2019;12:27:06;81248413;81026081;222332;
18.01.2019;12:28:05;81248456;81026238;222218;
18.01.2019;12:29:05;81248510;81026378;222132;
18.01.2019;12:30:04;81248551;81026524;222027;
18.01.2019;12:31:05;81248613;81026664;221949;
18.01.2019;12:32:04;81248660;81026815;221845;
18.01.2019;12:33:05;81248698;81026955;221743;
18.01.2019;12:34:04;81248734;81027084;221650;
18.01.2019;12:35:04;81248768;81027250;221518;
18.01.2019;12:36:05;81248823;81027380;221443;
18.01.2019;12:37:05;81248872;81027495;221377;
18.01.2019;12:38:04;81248921;81027634;221287;
18.01.2019;12:39:07;81248982;81027779;221203;
18.01.2019;12:40:05;81249037;81027920;221117;
18.01.2019;12:41:05;81249107;81028029;221078;
18.01.2019;12:42:04;81249169;81028170;220999;
18.01.2019;12:43:05;81249209;81028303;220906;
18.01.2019;12:44:04;81249264;81028424;220840;
18.01.2019;12:45:05;81249304;81028558;220746;
18.01.2019;12:46:05;81249375;81028708;220667;
18.01.2019;12:47:05;81249437;81028854;220583;
18.01.2019;12:48:04;81249483;81028987;220496;
18.01.2019;12:49:04;81249538;81029139;220399;
18.01.2019;12:50:05;81249587;81029296;220291;
18.01.2019;12:51:04;81249631;81029434;220197;
18.01.2019;12:52:05;81249699;81029555;220144;
18.01.2019;12:53:04;81249753;81029697;220056;
18.01.2019;12:54:04;81249786;81029822;219964;
18.01.2019;12:55:05;81249835;81029969;219866;
18.01.2019;12:56:05;81249873;81030116;219757;
18.01.2019;12:57:04;81249702;81030005;219697;
18.01.2019;12:58:04;81249374;81029816;219558;
18.01.2019;12:59:05;81249409;81029953;219456;
18.01.2019;13:00:05;81249472;81030102;219370;
18.01.2019;13:01:05;81249535;81030254;219281;
18.01.2019;13:02:04;81249594;81030399;219195;
18.01.2019;13:03:04;81249646;81030539;219107;
18.01.2019;13:04:06;81249710;81030675;219035;
18.01.2019;13:05:04;81249758;81030799;218959;
18.01.2019;13:06:04;81249799;81030945;218854;
18.01.2019;13:07:05;81249867;81031099;218768;
18.01.2019;13:08:04;81249913;81031229;218684;
18.01.2019;13:09:04;81249955;81031375;218580;
18.01.2019;13:10:04;81250014;81031537;218477;
18.01.2019;13:11:04;81250059;81031688;218371;
18.01.2019;13:12:04;81250111;81031829;218282;
18.01.2019;13:13:05;81250176;81031957;218219;
18.01.2019;13:14:04;81250230;81032108;218122;
18.01.2019;13:15:04;81250284;81032257;218027;
18.01.2019;13:16:05;81250339;81032417;217922;
18.01.2019;13:17:05;81250365;81032564;217801;
18.01.2019;13:18:05;81250426;81032707;217719;
18.01.2019;13:19:05;81250480;81032878;217602;
18.01.2019;13:20:04;81250536;81033010;217526;
18.01.2019;13:21:05;81250589;81033169;217420;
18.01.2019;13:22:04;81250655;81033330;217325;
18.01.2019;13:23:04;81250715;81033448;217267;
18.01.2019;13:24:06;81250779;81033597;217182;
18.01.2019;13:25:05;81250832;81033731;217101;
18.01.2019;13:26:04;81250906;81033873;217033;
18.01.2019;13:27:07;81250950;81034022;216928;
18.01.2019;13:28:04;81251002;81034162;216840;
18.01.2019;13:29:05;81251043;81034314;216729;
18.01.2019;13:30:04;81251091;81034438;216653;
18.01.2019;13:31:04;81251154;81034572;216582;
18.01.2019;13:32:04;81251212;81034740;216472;
18.01.2019;13:33:05;81251278;81034885;216393;
18.01.2019;13:34:05;81251344;81035023;216321;
18.01.2019;13:35:04;81251401;81035180;216221;
18.01.2019;13:36:05;81251470;81035338;216132;
18.01.2019;13:37:05;81251531;81035473;216058;
18.01.2019;13:38:05;81251595;81035616;215979;
18.01.2019;13:39:05;81251661;81035757;215904;
18.01.2019;13:40:05;81251730;81035927;215803;
18.01.2019;13:41:05;81251784;81036081;215703;
18.01.2019;13:42:04;81251854;81036215;215639;
18.01.2019;13:43:04;81251893;81036382;215511;
18.01.2019;13:44:05;81251957;81036536;215421;
18.01.2019;13:45:06;81252013;81036629;215384;
18.01.2019;13:46:04;81252083;81036782;215301;
18.01.2019;13:47:04;81252152;81036905;215247;
18.01.2019;13:48:05;81252225;81037045;215180;
18.01.2019;13:49:05;81252295;81037184;215111;
18.01.2019;13:50:04;81252365;81037306;215059;
18.01.2019;13:51:04;81252427;81037430;214997;
18.01.2019;13:52:05;81252490;81037600;214890;
18.01.2019;13:53:07;81252546;81037753;214793;
18.01.2019;13:54:04;81252622;81037894;214728;
18.01.2019;13:55:04;81252680;81038031;214649;
18.01.2019;13:56:05;81252740;81038204;214536;
18.01.2019;13:57:05;81252815;81038315;214500;
18.01.2019;13:58:05;81252897;81038459;214438;
18.01.2019;13:59:04;81252959;81038613;214346;
18.01.2019;14:00:05;81253027;81038752;214275;
18.01.2019;14:01:04;81253086;81038903;214183;
18.01.2019;14:02:05;81253153;81039054;214099;
18.01.2019;14:03:04;81253220;81039180;214040;
18.01.2019;14:04:05;81253294;81039344;213950;
18.01.2019;14:05:05;81253361;81039483;213878;
18.01.2019;14:06:04;81253427;81039620;213807;
18.01.2019;14:07:04;81253480;81039775;213705;
18.01.2019;14:08:08;81253560;81039930;213630;
18.01.2019;14:09:04;81253621;81040048;213573;
18.01.2019;14:10:05;81253706;81040219;213487;
18.01.2019;14:11:04;81253772;81040366;213406;
18.01.2019;14:12:04;81253831;81040503;213328;
18.01.2019;14:13:05;81253891;81040655;213236;
18.01.2019;14:14:05;81253943;81040800;213143;
18.01.2019;14:15:04;81254001;81040950;213051;
18.01.2019;14:16:05;81254074;81041100;212974;
18.01.2019;14:17:04;81254153;81041251;212902;
18.01.2019;14:18:04;81254207;81041373;212834;
18.01.2019;14:19:05;81254246;81041493;212753;
18.01.2019;14:20:05;81254290;81041595;212695;
18.01.2019;14:21:05;81254330;81041718;212612;
18.01.2019;14:22:05;81254394;81041843;212551;
18.01.2019;14:23:05;81254433;81041995;212438;
18.01.2019;14:24:05;81254492;81042139;212353;
18.01.2019;14:25:05;81254541;81042254;212287;
18.01.2019;14:26:05;81254598;81042393;212205;
18.01.2019;14:27:04;81254664;81042526;212138;
18.01.2019;14:28:05;81254727;81042677;212050;
18.01.2019;14:29:04;81254796;81042811;211985;
18.01.2019;14:30:05;81254858;81042934;211924;
18.01.2019;14:31:05;81254918;81043052;211866;
18.01.2019;14:32:04;81254974;81043198;211776;
18.01.2019;14:33:05;81255037;81043325;211712;
18.01.2019;14:34:05;81255086;81043486;211600;
18.01.2019;14:35:05;81255169;81043640;211529;
18.01.2019;14:36:05;81255254;81043775;211479;
18.01.2019;14:37:04;81255318;81043917;211401;
18.01.2019;14:38:04;81255406;81044063;211343;
18.01.2019;14:39:13;81255491;81044219;211272;
18.01.2019;14:40:10;81255572;81044359;211213;
18.01.2019;14:41:04;81255634;81044512;211122;
18.01.2019;14:42:04;81255705;81044665;211040;
18.01.2019;14:43:05;81255789;81044833;210956;
18.01.2019;14:44:09;81255855;81044990;210865;
18.01.2019;14:45:05;81255947;81045161;210786;
18.01.2019;14:46:04;81256029;81045300;210729;
18.01.2019;14:47:04;81256102;81045466;210636;
18.01.2019;14:48:04;81256179;81045656;210523;
18.01.2019;14:49:08;81256229;81045833;210396;
18.01.2019;14:50:04;81256303;81045943;210360;
18.01.2019;14:51:04;81256397;81046083;210314;
18.01.2019;14:52:08;81256475;81046242;210233;
18.01.2019;14:53:05;81256545;81046386;210159;
18.01.2019;14:54:05;81256624;81046552;210072;
18.01.2019;14:55:05;81256677;81046719;209958;
18.01.2019;14:56:05;81256757;81046858;209899;
18.01.2019;14:57:06;81256828;81047007;209821;
18.01.2019;14:58:07;81256911;81047143;209768;
18.01.2019;14:59:04;81256982;81047297;209685;
18.01.2019;15:00:09;81257065;81047454;209611;
18.01.2019;15:01:11;81257140;81047634;209506;
18.01.2019;15:02:10;81257190;81047803;209387;
18.01.2019;15:03:14;81257253;81047936;209317;
18.01.2019;15:04:11;81257304;81048119;209185;
18.01.2019;15:05:12;81257369;81048285;209084;
18.01.2019;15:06:11;81257446;81048451;208995;
18.01.2019;15:07:13;81257514;81048582;208932;
18.01.2019;15:08:10;81257603;81048702;208901;
18.01.2019;15:09:10;81257670;81048857;208813;
18.01.2019;15:10:11;81257752;81049013;208739;
18.01.2019;15:11:13;81257836;81049175;208661;
18.01.2019;15:12:10;81257903;81049315;208588;
18.01.2019;15:13:13;81257999;81049496;208503;
18.01.2019;15:14:14;81258069;81049672;208397;
18.01.2019;15:15:11;81258140;81049822;208318;
18.01.2019;15:16:14;81258205;81049982;208223;
18.01.2019;15:17:14;81258289;81050153;208136;
18.01.2019;15:18:11;81258370;81050299;208071;
18.01.2019;15:19:13;81258438;81050468;207970;
18.01.2019;15:20:17;81258533;81050618;207915;
18.01.2019;15:21:14;81258593;81050770;207823;
18.01.2019;15:22:14;81258680;81050917;207763;
18.01.2019;15:23:17;81258752;81051095;207657;
18.01.2019;15:24:14;81258826;81051249;207577;
18.01.2019;15:25:15;81258891;81051399;207492;
18.01.2019;15:26:16;81258954;81051547;207407;
18.01.2019;15:27:14;81259015;81051704;207311;
18.01.2019;15:28:12;81259091;81051907;207184;
18.01.2019;15:29:11;81259160;81052061;207099;
18.01.2019;15:30:12;81259228;81052251;206977;
18.01.2019;15:31:11;81259304;81052387;206917;
18.01.2019;15:32:11;81259379;81052531;206848;
18.01.2019;15:33:11;81259440;81052693;206747;
18.01.2019;15:34:10;81259517;81052858;206659;
18.01.2019;15:35:11;81259607;81053012;206595;
18.01.2019;15:36:10;81259688;81053160;206528;
18.01.2019;15:37:13;81259775;81053314;206461;
18.01.2019;15:38:12;81259843;81053480;206363;
18.01.2019;15:39:13;81259913;81053618;206295;
18.01.2019;15:40:10;81259978;81053783;206195;
18.01.2019;15:41:07;81260063;81053942;206121;
18.01.2019;15:42:08;81260123;81054073;206050;
18.01.2019;15:43:07;81260210;81054226;205984;
18.01.2019;15:44:08;81260278;81054375;205903;
18.01.2019;15:45:13;81260339;81054538;205801;
18.01.2019;15:46:11;81260398;81054706;205692;
18.01.2019;15:47:12;81260482;81054863;205619;
18.01.2019;15:48:14;81260563;81055032;205531;
18.01.2019;15:49:16;81260656;81055232;205424;
18.01.2019;15:50:14;81260734;81055417;205317;
18.01.2019;15:51:17;81260799;81055595;205204;
18.01.2019;15:52:14;81260870;81055752;205118;
18.01.2019;15:53:14;81260922;81055926;204996;
18.01.2019;15:54:17;81261002;81056137;204865;
18.01.2019;15:55:15;81261076;81056288;204788;
18.01.2019;15:56:16;81261149;81056475;204674;
18.01.2019;15:57:13;81261211;81056623;204588;
18.01.2019;15:58:14;81261289;81056801;204488;
18.01.2019;15:59:17;81261383;81056988;204395;
18.01.2019;16:00:17;81261468;81057159;204309;
18.01.2019;16:01:10;81261528;81057308;204220;
18.01.2019;16:02:05;81261607;81057487;204120;
18.01.2019;16:03:05;81261669;81057673;203996;
18.01.2019;16:04:07;81261751;81057845;203906;
18.01.2019;16:05:04;81261810;81058015;203795;
18.01.2019;16:06:08;81261903;81058177;203726;
18.01.2019;16:07:05;81261963;81058346;203617;
18.01.2019;16:08:05;81262032;81058503;203529;
18.01.2019;16:09:05;81262104;81058698;203406;
18.01.2019;16:10:07;81262187;81058834;203353;
18.01.2019;16:11:05;81262262;81059013;203249;
18.01.2019;16:12:05;81262354;81059156;203198;
18.01.2019;16:13:05;81262445;81059361;203084;
18.01.2019;16:14:05;81262531;81059526;203005;
18.01.2019;16:15:05;81262614;81059700;202914;
18.01.2019;16:16:05;81262700;81059876;202824;
18.01.2019;16:17:07;81262777;81060040;202737;
18.01.2019;16:18:04;81262843;81060172;202671;
18.01.2019;16:19:05;81262885;81060328;202557;
18.01.2019;16:20:05;81262953;81060484;202469;
18.01.2019;16:21:05;81263022;81060620;202402;
18.01.2019;16:22:08;81263085;81060792;202293;
18.01.2019;16:23:04;81263135;81060930;202205;
18.01.2019;16:24:05;81263199;81061099;202100;
18.01.2019;16:25:05;81263272;81061253;202019;
18.01.2019;16:26:05;81263315;81061422;201893;
18.01.2019;16:27:05;81263375;81061562;201813;
18.01.2019;16:28:08;81263456;81061715;201741;
18.01.2019;16:29:05;81263510;81061850;201660;
18.01.2019;16:30:06;81263586;81062017;201569;
18.01.2019;16:31:04;81263648;81062159;201489;
18.01.2019;16:32:04;81263722;81062329;201393;
18.01.2019;16:33:06;81263793;81062469;201324;
18.01.2019;16:34:05;81263851;81062602;201249;
18.01.2019;16:35:05;81263921;81062755;201166;
18.01.2019;16:36:08;81264008;81062917;201091;
18.01.2019;16:37:07;81264076;81063068;201008;
18.01.2019;16:38:05;81264151;81063249;200902;
18.01.2019;16:39:06;81264225;81063415;200810;
18.01.2019;16:40:05;81264304;81063581;200723;
18.01.2019;16:41:06;81264394;81063737;200657;
18.01.2019;16:42:04;81264477;81063884;200593;
18.01.2019;16:43:05;81264554;81064066;200488;
18.01.2019;16:44:37;81264640;81064299;200341;
18.01.2019;16:45:05;81264721;81064358;200363;
18.01.2019;16:46:04;81264810;81064505;200305;
18.01.2019;16:47:04;81264890;81064688;200202;
18.01.2019;16:48:04;81264965;81064838;200127;
18.01.2019;16:49:05;81265039;81064994;200045;
18.01.2019;16:50:05;81265127;81065154;199973;
18.01.2019;16:51:04;81265210;81065353;199857;
18.01.2019;16:52:07;81265329;81065558;199771;
18.01.2019;16:53:05;81265414;81065700;199714;
18.01.2019;16:54:05;81265509;81065880;199629;
18.01.2019;16:55:05;81265590;81066022;199568;
18.01.2019;16:56:07;81265674;81066169;199505;
18.01.2019;16:57:05;81265763;81066332;199431;
18.01.2019;16:58:06;81265851;81066503;199348;
18.01.2019;16:59:05;81265940;81066670;199270;
18.01.2019;17:00:05;81266020;81066826;199194;
18.01.2019;17:01:05;81266102;81066967;199135;
18.01.2019;17:02:05;81266191;81067118;199073;
18.01.2019;17:03:07;81266283;81067293;198990;
18.01.2019;17:04:05;81266379;81067451;198928;
18.01.2019;17:05:04;81266469;81067630;198839;
18.01.2019;17:06:09;81266574;81067821;198753;
18.01.2019;17:07:08;81266647;81067985;198662;
18.01.2019;17:08:06;81266695;81068160;198535;
18.01.2019;17:09:06;81266782;81068362;198420;
18.01.2019;17:10:04;81266871;81068530;198341;
18.01.2019;17:11:05;81266962;81068686;198276;
18.01.2019;17:12:05;81267040;81068830;198210;
18.01.2019;17:13:05;81267127;81069011;198116;
18.01.2019;17:14:05;81267217;81069176;198041;
18.01.2019;17:15:08;81267305;81069349;197956;
18.01.2019;17:16:05;81267400;81069504;197896;
18.01.2019;17:17:06;81267498;81069672;197826;
18.01.2019;17:18:05;81267565;81069847;197718;
18.01.2019;17:19:04;81267656;81070007;197649;
18.01.2019;17:20:04;81267726;81070172;197554;
18.01.2019;17:21:05;81267818;81070335;197483;
18.01.2019;17:22:04;81267900;81070503;197397;
18.01.2019;17:23:07;81267999;81070667;197332;
18.01.2019;17:24:05;81268089;81070830;197259;
18.01.2019;17:25:04;81268178;81070987;197191;
18.01.2019;17:26:04;81268258;81071153;197105;
18.01.2019;17:27:05;81268348;81071328;197020;
18.01.2019;17:28:05;81268416;81071493;196923;
18.01.2019;17:29:05;81268516;81071629;196887;
18.01.2019;17:30:07;81268587;81071780;196807;
18.01.2019;17:31:05;81268653;81071945;196708;
18.01.2019;17:32:05;81268714;81072090;196624;
18.01.2019;17:33:05;81268815;81072249;196566;
18.01.2019;17:34:04;81268883;81072428;196455;
18.01.2019;17:35:04;81268954;81072573;196381;
18.01.2019;17:36:05;81269054;81072737;196317;
18.01.2019;17:37:05;81269139;81072873;196266;
18.01.2019;17:38:08;81269222;81073026;196196;
18.01.2019;17:39:07;81269325;81073205;196120;
18.01.2019;17:40:05;81269402;81073368;196034;
18.01.2019;17:41:06;81269480;81073504;195976;
18.01.2019;17:42:05;81269558;81073652;195906;
18.01.2019;17:43:05;81269622;81073785;195837;
18.01.2019;17:44:05;81269714;81073932;195782;
18.01.2019;17:45:05;81269792;81074069;195723;
18.01.2019;17:46:05;81269868;81074202;195666;
18.01.2019;17:47:05;81269952;81074362;195590;
18.01.2019;17:48:05;81270041;81074522;195519;
18.01.2019;17:49:06;81270128;81074662;195466;
18.01.2019;17:50:05;81270228;81074782;195446;
18.01.2019;17:51:05;81270310;81074936;195374;
18.01.2019;17:52:04;81270396;81075119;195277;
18.01.2019;17:53:07;81270501;81075277;195224;
18.01.2019;17:54:04;81270590;81075421;195169;
18.01.2019;17:55:04;81270654;81075553;195101;
18.01.2019;17:56:04;81270729;81075698;195031;
18.01.2019;17:57:05;81270832;81075854;194978;
18.01.2019;17:58:05;81270917;81075979;194938;
18.01.2019;17:59:05;81271009;81076108;194901;
18.01.2019;18:00:05;81271080;81076259;194821;
18.01.2019;18:01:06;81271167;81076407;194760;
18.01.2019;18:02:04;81271254;81076542;194712;
18.01.2019;18:03:05;81271350;81076677;194673;
18.01.2019;18:04:05;81271403;81076822;194581;
18.01.2019;18:05:05;81271472;81076951;194521;
18.01.2019;18:06:04;81271556;81077113;194443;
18.01.2019;18:07:04;81271653;81077255;194398;
18.01.2019;18:08:05;81271737;81077396;194341;
18.01.2019;18:09:06;81271829;81077542;194287;
18.01.2019;18:10:05;81271915;81077658;194257;
18.01.2019;18:11:04;81272004;81077793;194211;
18.01.2019;18:12:04;81272083;81077910;194173;
18.01.2019;18:13:04;81272187;81078046;194141;
18.01.2019;18:14:04;81272289;81078184;194105;
18.01.2019;18:15:04;81272357;81078284;194073;
18.01.2019;18:16:08;81272451;81078431;194020;
18.01.2019;18:17:05;81272536;81078563;193973;
18.01.2019;18:18:08;81272630;81078703;193927;
18.01.2019;18:19:04;81272723;81078834;193889;
18.01.2019;18:20:04;81272812;81078994;193818;
18.01.2019;18:21:04;81272899;81079110;193789;
18.01.2019;18:22:05;81273006;81079256;193750;
18.01.2019;18:23:05;81273087;81079413;193674;
18.01.2019;18:24:05;81273165;81079549;193616;
18.01.2019;18:25:05;81273254;81079643;193611;
18.01.2019;18:26:05;81273318;81079755;193563;
18.01.2019;18:27:04;81273374;81079846;193528;
18.01.2019;18:28:04;81273435;81079943;193492;
18.01.2019;18:29:04;81273514;81080060;193454;
18.01.2019;18:30:05;81273579;81080204;193375;
18.01.2019;18:31:05;81273646;81080319;193327;
18.01.2019;18:32:06;81273723;81080420;193303;
18.01.2019;18:33:04;81273789;81080540;193249;
18.01.2019;18:34:04;81273869;81080664;193205;
18.01.2019;18:35:05;81273926;81080763;193163;
18.01.2019;18:36:05;81273987;81080871;193116;
18.01.2019;18:37:05;81274054;81080976;193078;
18.01.2019;18:38:05;81274106;81081079;193027;
18.01.2019;18:39:07;81274178;81081207;192971;
18.01.2019;18:40:05;81274274;81081315;192959;
18.01.2019;18:41:07;81274353;81081419;192934;
18.01.2019;18:42:05;81274367;81081463;192904;
18.01.2019;18:43:05;81274438;81081583;192855;
18.01.2019;18:44:05;81274507;81081691;192816;
18.01.2019;18:45:05;81274580;81081800;192780;
18.01.2019;18:46:05;81274654;81081924;192730;
18.01.2019;18:47:05;81274740;81082027;192713;
18.01.2019;18:48:05;81274834;81082131;192703;
18.01.2019;18:49:07;81274920;81082254;192666;
18.01.2019;18:50:04;81274994;81082334;192660;
18.01.2019;18:51:04;81275084;81082430;192654;
18.01.2019;18:52:05;81275172;81082543;192629;
18.01.2019;18:53:05;81275254;81082630;192624;
18.01.2019;18:54:05;81275330;81082756;192574;
18.01.2019;18:55:05;81275420;81082857;192563;
18.01.2019;18:56:05;81275502;81082972;192530;
18.01.2019;18:57:06;81275589;81083091;192498;
18.01.2019;18:58:04;81275652;81083208;192444;
18.01.2019;18:59:05;81275728;81083340;192388;
18.01.2019;19:00:05;81275809;81083429;192380;
18.01.2019;19:01:05;81275888;81083514;192374;
18.01.2019;19:02:05;81275985;81083634;192351;
18.01.2019;19:03:05;81276067;81083731;192336;
18.01.2019;19:04:05;81276150;81083859;192291;
18.01.2019;19:05:06;81276259;81083984;192275;
18.01.2019;19:06:05;81276355;81084071;192284;
18.01.2019;19:07:05;81276422;81084190;192232;
18.01.2019;19:08:05;81276527;81084305;192222;
18.01.2019;19:09:06;81276613;81084419;192194;
18.01.2019;19:10:04;81276686;81084517;192169;
18.01.2019;19:11:04;81276772;81084629;192143;
18.01.2019;19:12:05;81276854;81084741;192113;
18.01.2019;19:13:07;81276940;81084843;192097;
18.01.2019;19:14:04;81277034;81084934;192100;
18.01.2019;19:15:04;81277097;81085059;192038;
18.01.2019;19:16:05;81277175;81085176;191999;
18.01.2019;19:17:05;81277256;81085272;191984;
18.01.2019;19:18:05;81277333;81085383;191950;
18.01.2019;19:19:05;81277421;81085492;191929;
18.01.2019;19:20:05;81277532;81085596;191936;
18.01.2019;19:21:05;81277553;81085667;191886;
18.01.2019;19:22:05;81277544;81085768;191776;
18.01.2019;19:23:04;81277568;81085869;191699;
18.01.2019;19:24:04;81277615;81085969;191646;
18.01.2019;19:25:05;81277635;81086074;191561;
18.01.2019;19:26:05;81277705;81086183;191522;
18.01.2019;19:27:05;81277751;81086267;191484;
18.01.2019;19:28:08;81277801;81086345;191456;
18.01.2019;19:29:05;81277851;81086451;191400;
18.01.2019;19:30:05;81277885;81086540;191345;
18.01.2019;19:31:05;81277928;81086627;191301;
18.01.2019;19:32:10;81277990;81086726;191264;
18.01.2019;19:33:04;81278059;81086809;191250;
18.01.2019;19:34:05;81278095;81086917;191178;
18.01.2019;19:35:05;81278184;81087008;191176;
18.01.2019;19:36:09;81278257;81087112;191145;
18.01.2019;19:37:04;81278322;81087199;191123;
18.01.2019;19:38:05;81278379;81087315;191064;
18.01.2019;19:39:04;81278435;81087407;191028;
18.01.2019;19:40:04;81278524;81087476;191048;
18.01.2019;19:41:05;81278608;81087551;191057;
18.01.2019;19:42:05;81278683;81087640;191043;
18.01.2019;19:43:05;81278763;81087719;191044;
18.01.2019;19:44:07;81278831;81087801;191030;
18.01.2019;19:45:05;81278887;81087886;191001;
18.01.2019;19:46:04;81278956;81087965;190991;
18.01.2019;19:47:04;81279026;81088062;190964;
18.01.2019;19:48:05;81279084;81088137;190947;
18.01.2019;19:49:05;81279129;81088229;190900;
18.01.2019;19:50:05;81279183;81088325;190858;
18.01.2019;19:51:04;81279245;81088414;190831;
18.01.2019;19:52:06;81279317;81088485;190832;
18.01.2019;19:53:05;81279388;81088542;190846;
18.01.2019;19:54:04;81279443;81088629;190814;
18.01.2019;19:55:04;81279502;81088702;190800;
18.01.2019;19:56:04;81279568;81088774;190794;
18.01.2019;19:57:05;81279628;81088868;190760;
18.01.2019;19:58:05;81279684;81088946;190738;
18.01.2019;19:59:05;81279754;81089010;190744;
18.01.2019;20:00:05;81279833;81089090;190743;
18.01.2019;20:01:05;81279894;81089171;190723;
18.01.2019;20:02:05;81278497;81089256;189241;
18.01.2019;20:03:07;81278575;81089337;189238;
18.01.2019;20:04:04;81278649;81089410;189239;
18.01.2019;20:05:04;81278719;81095041;183678;
18.01.2019;20:06:06;81278769;81095097;183672;
18.01.2019;20:07:06;81278819;81095149;183670;
18.01.2019;20:08:05;81278896;81095240;183656;
18.01.2019;20:09:05;81278943;81095310;183633;
18.01.2019;20:10:07;81278981;81095366;183615;
18.01.2019;20:11:04;81279049;81095439;183610;
18.01.2019;20:12:04;81279125;81095500;183625;
18.01.2019;20:13:05;81279190;81095550;183640;
18.01.2019;20:14:05;81279266;81095623;183643;
18.01.2019;20:15:05;81279343;81095689;183654;
18.01.2019;20:16:05;81279428;81095773;183655;
18.01.2019;20:17:05;81279506;81095824;183682;
18.01.2019;20:18:06;81279565;81095896;183669;
18.01.2019;20:19:04;81279644;81095934;183710;
18.01.2019;20:20:04;81279679;81095994;183685;
18.01.2019;20:21:05;81279715;81096063;183652;
18.01.2019;20:22:05;81279751;81096098;183653;
18.01.2019;20:23:05;81279811;81096147;183664;
18.01.2019;20:24:05;81279852;81096191;183661;
18.01.2019;20:25:08;81279899;81096250;183649;
18.01.2019;20:26:05;81279943;81096279;183664;
18.01.2019;20:27:05;81279991;81096335;183656;
18.01.2019;20:28:05;81280017;81096378;183639;
18.01.2019;20:29:05;81280078;81096420;183658;
18.01.2019;20:30:05;81280147;81096477;183670;
18.01.2019;20:31:04;81280222;81096514;183708;
18.01.2019;20:32:04;81280284;81096566;183718;
18.01.2019;20:33:07;81280349;81096607;183742;
18.01.2019;20:34:05;81280413;81096662;183751;
18.01.2019;20:35:05;81280472;81096719;183753;
18.01.2019;20:36:05;81280514;81096773;183741;
18.01.2019;20:37:05;81280576;81096834;183742;
18.01.2019;20:38:05;81280625;81096902;183723;
18.01.2019;20:39:06;81280690;81096953;183737;
18.01.2019;20:40:07;81280741;81097010;183731;
18.01.2019;20:41:05;81280796;81097068;183728;
18.01.2019;20:42:05;81280855;81097117;183738;
18.01.2019;20:43:05;81280939;81097162;183777;
18.01.2019;20:44:05;81280991;81097222;183769;
18.01.2019;20:45:05;81281064;81097261;183803;
18.01.2019;20:46:05;81281119;81097305;183814;
18.01.2019;20:47:05;81281193;81097364;183829;
18.01.2019;20:48:07;81281281;81097431;183850;
18.01.2019;20:49:05;81281346;81097480;183866;
18.01.2019;20:50:05;81281415;81097530;183885;
18.01.2019;20:51:05;81281490;81097581;183909;
18.01.2019;20:52:05;81281571;81097632;183939;
18.01.2019;20:53:04;81281646;81097696;183950;
18.01.2019;20:54:05;81281727;81097729;183998;
18.01.2019;20:55:05;81281802;81097782;184020;
18.01.2019;20:56:06;81281871;81097839;184032;
18.01.2019;20:57:05;81281928;81097877;184051;
18.01.2019;20:58:05;81281996;81097915;184081;
18.01.2019;20:59:05;81282061;81097969;184092;
18.01.2019;21:00:05;81282137;81098022;184115;
18.01.2019;21:01:05;81282194;81098073;184121;
18.01.2019;21:02:08;81282272;81098130;184142;
18.01.2019;21:05:04;81282522;81098299;184223;
18.01.2019;21:06:04;81282591;81098351;184240;
18.01.2019;21:07:04;81282669;81098401;184268;
18.01.2019;21:08:05;81282744;81098465;184279;
18.01.2019;21:09:08;81282825;81098536;184289;
18.01.2019;21:10:05;81282905;81098589;184316;
18.01.2019;21:11:05;81282993;81098627;184366;
18.01.2019;21:12:05;81283063;81098674;184389;
18.01.2019;21:13:05;81283147;81098724;184423;
18.01.2019;21:14:05;81283214;81098780;184434;
18.01.2019;21:15:05;81283311;81098827;184484;
18.01.2019;21:16:06;81283392;81098869;184523;
18.01.2019;21:17:05;81283476;81098915;184561;
18.01.2019;21:18:05;81283544;81098955;184589;
18.01.2019;21:19:05;81283623;81099007;184616;
18.01.2019;21:20:05;81283677;81099057;184620;
18.01.2019;21:21:10;81283747;81099102;184645;
18.01.2019;21:22:05;81283834;81099148;184686;
18.01.2019;21:23:05;81283914;81099183;184731;
18.01.2019;21:24:07;81284017;81099236;184781;
18.01.2019;21:25:05;81284078;81099287;184791;
18.01.2019;21:26:05;81284162;81099333;184829;
18.01.2019;21:27:05;81284227;81099387;184840;
18.01.2019;21:28:05;81284290;81099430;184860;
18.01.2019;21:29:05;81284353;81099469;184884;
18.01.2019;21:30:05;81284406;81099505;184901;
18.01.2019;21:31:05;81284478;81099537;184941;
18.01.2019;21:32:05;81284564;81099582;184982;
18.01.2019;21:33:05;81284655;81099615;185040;
18.01.2019;21:34:05;81284742;81099657;185085;
18.01.2019;21:35:06;81284818;81099700;185118;
18.01.2019;21:36:05;81284901;81099741;185160;
18.01.2019;21:37:05;81284966;81099793;185173;
18.01.2019;21:38:04;81285046;81099845;185201;
18.01.2019;21:39:06;81285131;81099891;185240;
18.01.2019;21:40:05;81285200;81099928;185272;
18.01.2019;21:41:05;81285287;81099971;185316;
18.01.2019;21:42:05;81285379;81100006;185373;
18.01.2019;21:43:07;81285477;81100058;185419;
18.01.2019;21:44:05;81285551;81100091;185460;
18.01.2019;21:45:04;81285624;81100141;185483;
18.01.2019;21:46:04;81285708;81100175;185533;
18.01.2019;21:47:04;81285790;81100210;185580;
18.01.2019;21:48:04;81285867;81100237;185630;
18.01.2019;21:49:04;81285943;81100279;185664;
18.01.2019;21:50:05;81286028;81100321;185707;
18.01.2019;21:51:08;81286096;81100373;185723;
18.01.2019;21:52:05;81286099;81100349;185750;
18.01.2019;21:53:05;81286170;81100390;185780;
18.01.2019;21:54:05;81286242;81100423;185819;
18.01.2019;21:55:06;81286331;81100457;185874;
18.01.2019;21:56:04;81286406;81100496;185910;
18.01.2019;21:57:04;81286476;81100546;185930;
18.01.2019;21:58:04;81286569;81100589;185980;
18.01.2019;21:59:07;81286638;81100620;186018;
18.01.2019;22:00:04;81286741;81100647;186094;
18.01.2019;22:01:04;81286825;81100689;186136;
18.01.2019;22:02:04;81286889;81100733;186156;
18.01.2019;22:03:05;81286987;81100768;186219;
18.01.2019;22:04:05;81287062;81100796;186266;
18.01.2019;22:05:05;81287131;81100837;186294;
18.01.2019;22:06:08;81287215;81100878;186337;
18.01.2019;22:07:05;81287301;81100900;186401;
18.01.2019;22:08:04;81287371;81100929;186442;
18.01.2019;22:09:04;81287453;81100967;186486;
18.01.2019;22:10:04;81287547;81101021;186526;
18.01.2019;22:11:04;81287638;81101059;186579;
18.01.2019;22:12:04;81287728;81101100;186628;
18.01.2019;22:13:06;81287839;81101131;186708;
18.01.2019;22:14:04;81287935;81101174;186761;
18.01.2019;22:15:05;81288005;81101210;186795;
18.01.2019;22:16:04;81288105;81101242;186863;
18.01.2019;22:17:05;81288175;81101267;186908;
18.01.2019;22:18:05;81288262;81101304;186958;
18.01.2019;22:19:05;81288331;81101322;187009;
18.01.2019;22:20:07;81288415;81101337;187078;
18.01.2019;22:21:05;81288484;81101370;187114;
18.01.2019;22:22:04;81288555;81101391;187164;
18.01.2019;22:23:04;81288652;81101431;187221;
18.01.2019;22:24:04;81288727;81101458;187269;
18.01.2019;22:25:04;81288810;81101470;187340;
18.01.2019;22:26:05;81288903;81101497;187406;
18.01.2019;22:27:08;81288993;81101520;187473;
18.01.2019;22:28:05;81289072;81101553;187519;
18.01.2019;22:29:05;81289156;81101575;187581;
18.01.2019;22:30:04;81289225;81101600;187625;
18.01.2019;22:31:04;81289311;81101631;187680;
18.01.2019;22:32:05;81289379;81101669;187710;
18.01.2019;22:33:05;81289477;81101691;187786;
18.01.2019;22:34:05;81289578;81101713;187865;
18.01.2019;22:35:06;81289691;81101737;187954;
18.01.2019;22:36:05;81289786;81101758;188028;
18.01.2019;22:37:04;81289863;81101784;188079;
18.01.2019;22:38:04;81289933;81101798;188135;
18.01.2019;22:39:06;81290018;81101820;188198;
18.01.2019;22:40:05;81290093;81101836;188257;
18.01.2019;22:41:04;81290180;81101871;188309;
18.01.2019;22:42:07;81290242;81101901;188341;
18.01.2019;22:43:05;81290340;81101926;188414;
18.01.2019;22:44:05;81290421;81101962;188459;
18.01.2019;22:45:05;81290507;81101983;188524;
18.01.2019;22:46:05;81290600;81102011;188589;
18.01.2019;22:47:04;81290698;81102033;188665;
18.01.2019;22:48:04;81290769;81102068;188701;
18.01.2019;22:49:05;81290859;81102111;188748;
18.01.2019;22:50:07;81290943;81102126;188817;
18.01.2019;22:51:05;81291016;81102144;188872;
18.01.2019;22:52:04;81291101;81102187;188914;
18.01.2019;22:53:04;81291201;81102222;188979;
18.01.2019;22:54:04;81291284;81102250;189034;
18.01.2019;22:55:04;81291371;81102273;189098;
18.01.2019;22:56:05;81291442;81102291;189151;
18.01.2019;22:57:05;81291528;81102318;189210;
18.01.2019;22:58:07;81291604;81102347;189257;
18.01.2019;22:59:04;81291686;81102382;189304;
18.01.2019;23:00:05;81291774;81102412;189362;
18.01.2019;23:01:05;81291861;81102453;189408;
18.01.2019;23:02:05;81291941;81102492;189449;
18.01.2019;23:03:04;81292044;81102541;189503;
18.01.2019;23:04:04;81292130;81102577;189553;
18.01.2019;23:05:05;81292204;81102609;189595;
18.01.2019;23:06:08;81292275;81102635;189640;
18.01.2019;23:07:05;81292355;81102665;189690;
18.01.2019;23:08:05;81292430;81102695;189735;
18.01.2019;23:09:07;81292516;81102720;189796;
18.01.2019;23:10:05;81292593;81102752;189841;
18.01.2019;23:11:04;81292671;81102787;189884;
18.01.2019;23:12:04;81292751;81102811;189940;
18.01.2019;23:13:05;81292849;81102849;190000;
18.01.2019;23:14:04;81292922;81102861;190061;
18.01.2019;23:15:08;81292998;81102894;190104;
18.01.2019;23:16:05;81293069;81102925;190144;
18.01.2019;23:17:05;81293179;81102944;190235;
18.01.2019;23:18:05;81293271;81102965;190306;
18.01.2019;23:19:04;81293354;81103008;190346;
18.01.2019;23:20:04;81293438;81103036;190402;
18.01.2019;23:21:05;81293527;81103060;190467;
18.01.2019;23:22:06;81293606;81103092;190514;
18.01.2019;23:23:05;81293671;81103124;190547;
18.01.2019;23:24:05;81293775;81103160;190615;
18.01.2019;23:25:05;81293886;81103184;190702;
18.01.2019;23:26:05;81293958;81103217;190741;
18.01.2019;23:27:04;81294040;81103247;190793;
18.01.2019;23:28:05;81294128;81103260;190868;
18.01.2019;23:29:05;81294204;81103276;190928;
18.01.2019;23:30:07;81294270;81103310;190960;
18.01.2019;23:31:04;81294360;81103324;191036;
18.01.2019;23:32:05;81294440;81103355;191085;
18.01.2019;23:33:05;81294513;81103375;191138;
18.01.2019;23:34:05;81294594;81103401;191193;
18.01.2019;23:35:04;81294653;81103419;191234;
18.01.2019;23:36:04;81294736;81103448;191288;
18.01.2019;23:37:06;81294811;81103476;191335;
18.01.2019;23:38:05;81294893;81103505;191388;
18.01.2019;23:39:05;81294958;81103526;191432;
18.01.2019;23:40:04;81295046;81103544;191502;
18.01.2019;23:41:04;81295127;81103572;191555;
18.01.2019;23:42:04;81295199;81103595;191604;
18.01.2019;23:43:05;81295270;81103614;191656;
18.01.2019;23:44:05;81295347;81103632;191715;
18.01.2019;23:45:07;81295418;81103653;191765;
18.01.2019;23:46:05;81295483;81103673;191810;
18.01.2019;23:47:05;81295546;81103698;191848;
18.01.2019;23:48:05;81295622;81103725;191897;
18.01.2019;23:49:04;81295697;81103753;191944;
18.01.2019;23:50:04;81295775;81103772;192003;
18.01.2019;23:51:05;81295847;81103792;192055;
18.01.2019;23:52:08;81295932;81103817;192115;
18.01.2019;23:53:05;81295991;81103844;192147;
18.01.2019;23:54:04;81296078;81103867;192211;
18.01.2019;23:55:05;81296161;81103889;192272;
18.01.2019;23:56:05;81296235;81103925;192310;
18.01.2019;23:57:04;81296302;81103940;192362;
18.01.2019;23:58:04;81296394;81103964;192430;
18.01.2019;23:59:05;81296480;81103978;192502;
19.01.2019;00:00:10;81296559;81103998;192561;
19.01.2019;00:01:07;81296637;81104024;192613;
19.01.2019;00:02:09;81296709;81104044;192665;
19.01.2019;00:03:10;81296794;81104066;192728;
19.01.2019;00:04:12;81296870;81104088;192782;
19.01.2019;00:05:08;81296946;81104114;192832;
19.01.2019;00:06:09;81297024;81104139;192885;
19.01.2019;00:07:10;81297099;81104157;192942;
19.01.2019;00:08:11;81297167;81104181;192986;
19.01.2019;00:09:13;81297250;81104200;193050;
19.01.2019;00:10:10;81297309;81104219;193090;
19.01.2019;00:11:11;81297383;81104241;193142;
19.01.2019;00:12:10;81297439;81104253;193186;
19.01.2019;00:13:13;81297489;81104268;193221;
19.01.2019;00:14:09;81297553;81104285;193268;
19.01.2019;00:15:11;81297623;81104309;193314;
19.01.2019;00:16:10;81297679;81104333;193346;
19.01.2019;00:17:11;81297733;81104342;193391;
19.01.2019;00:18:12;81297797;81104361;193436;
19.01.2019;00:19:08;81297850;81104382;193468;
19.01.2019;00:20:25;81297915;81104414;193501;
19.01.2019;00:21:11;81297975;81104425;193550;
19.01.2019;00:22:14;81298022;81104448;193574;
19.01.2019;00:23:09;81298094;81104464;193630;
19.01.2019;00:24:14;81298157;81104483;193674;
19.01.2019;00:25:12;81298222;81104506;193716;
19.01.2019;00:26:19;81298281;81104527;193754;
19.01.2019;00:27:16;81298331;81104559;193772;
19.01.2019;00:28:20;81298413;81104584;193829;
19.01.2019;00:29:20;81298478;81104598;193880;
19.01.2019;00:30:18;81298535;81104613;193922;
19.01.2019;00:31:24;81298609;81104638;193971;
19.01.2019;00:32:22;81298667;81104658;194009;
19.01.2019;00:33:25;81298744;81104679;194065;
19.01.2019;00:34:22;81298813;81104703;194110;
19.01.2019;00:35:30;81298890;81104722;194168;
19.01.2019;00:36:28;81298971;81104745;194226;
19.01.2019;00:37:32;81299053;81104772;194281;
19.01.2019;00:38:33;81299128;81104795;194333;
19.01.2019;00:39:33;81299208;81104813;194395;
19.01.2019;00:40:33;81299277;81104835;194442;
19.01.2019;00:41:31;81299346;81104855;194491;
19.01.2019;00:42:33;81299436;81104876;194560;
19.01.2019;00:43:31;81299504;81104898;194606;
19.01.2019;00:44:36;81299573;81104922;194651;
19.01.2019;00:45:35;81299647;81104943;194704;
19.01.2019;00:46:36;81299714;81104965;194749;
19.01.2019;00:47:37;81299800;81104998;194802;
19.01.2019;00:48:33;81299853;81105020;194833;
19.01.2019;00:49:37;81299909;81105033;194876;
19.01.2019;00:50:34;81299968;81105051;194917;
19.01.2019;00:51:37;81300043;81105073;194970;
19.01.2019;00:52:37;81300092;81105082;195010;
19.01.2019;00:53:37;81300162;81105107;195055;
19.01.2019;00:54:37;81300243;81105131;195112;
19.01.2019;00:55:39;81300308;81105155;195153;
19.01.2019;00:56:31;81300389;81105170;195219;
19.01.2019;00:57:36;81300492;81105196;195296;
19.01.2019;00:58:33;81300566;81105216;195350;
19.01.2019;00:59:30;81300642;81105236;195406;
19.01.2019;01:00:28;81300707;81105258;195449;
19.01.2019;01:01:21;81300766;81105282;195484;
19.01.2019;01:02:19;81300841;81105306;195535;
19.01.2019;01:03:11;81300904;81105338;195566;
19.01.2019;01:04:05;81300975;81105351;195624;
19.01.2019;01:05:04;81301055;81105381;195674;
19.01.2019;01:06:04;81301140;81105405;195735;
19.01.2019;01:07:05;81301224;81105429;195795;
19.01.2019;01:08:07;81301299;81105463;195836;
19.01.2019;01:09:10;81301377;81105499;195878;
19.01.2019;01:10:24;81301473;81105524;195949;
19.01.2019;01:11:19;81301523;81105554;195969;
19.01.2019;01:12:08;81301586;81105580;196006;
19.01.2019;01:13:04;81301652;81105601;196051;
19.01.2019;01:14:05;81301728;81105633;196095;
19.01.2019;01:15:05;81301802;81105657;196145;
19.01.2019;01:16:05;81301866;81105687;196179;
19.01.2019;01:17:05;81301941;81105713;196228;
19.01.2019;01:18:04;81302036;81105736;196300;
19.01.2019;01:19:05;81302115;81105773;196342;
19.01.2019;01:20:05;81302191;81105800;196391;
19.01.2019;01:21:04;81302256;81105827;196429;
19.01.2019;01:22:04;81302323;81105849;196474;
19.01.2019;01:23:05;81302404;81105882;196522;
19.01.2019;01:24:04;81302472;81105913;196559;
19.01.2019;01:25:04;81302545;81105943;196602;
19.01.2019;01:26:05;81302618;81105978;196640;
19.01.2019;01:27:10;81302692;81106006;196686;
19.01.2019;01:28:05;81302762;81106017;196745;
19.01.2019;01:29:04;81302844;81106050;196794;
19.01.2019;01:30:04;81302906;81106084;196822;
19.01.2019;01:31:04;81302974;81106113;196861;
19.01.2019;01:32:05;81303052;81106138;196914;
19.01.2019;01:33:05;81303133;81106174;196959;
19.01.2019;01:34:04;81303204;81106209;196995;
19.01.2019;01:35:05;81303278;81106245;197033;
19.01.2019;01:36:04;81303347;81106269;197078;
19.01.2019;01:37:04;81303407;81106300;197107;
19.01.2019;01:38:05;81303505;81106334;197171;
19.01.2019;01:39:06;81303595;81106364;197231;
19.01.2019;01:40:04;81303681;81106392;197289;
19.01.2019;01:41:05;81303757;81106426;197331;
19.01.2019;01:42:05;81303818;81106461;197357;
19.01.2019;01:43:04;81303882;81106488;197394;
19.01.2019;01:44:04;81303952;81106527;197425;
19.01.2019;01:45:05;81304011;81106559;197452;
19.01.2019;01:46:05;81304085;81106595;197490;
19.01.2019;01:47:04;81304155;81106633;197522;
19.01.2019;01:48:04;81304232;81106680;197552;
19.01.2019;01:49:05;81304308;81106718;197590;
19.01.2019;01:50:05;81304388;81106760;197628;
19.01.2019;01:51:05;81304472;81106797;197675;
19.01.2019;01:52:04;81304553;81106832;197721;
19.01.2019;01:53:05;81304621;81106857;197764;
19.01.2019;01:54:05;81304688;81106900;197788;
19.01.2019;01:55:05;81304776;81106947;197829;
19.01.2019;01:56:05;81304833;81106990;197843;
19.01.2019;01:57:05;81304938;81107030;197908;
19.01.2019;01:58:04;81305032;81107068;197964;
19.01.2019;01:59:04;81305109;81107116;197993;
19.01.2019;02:00:05;81305189;81107159;198030;
19.01.2019;02:01:05;81305283;81107211;198072;
19.01.2019;02:02:05;81305382;81107266;198116;
19.01.2019;02:03:05;81305437;81107311;198126;
19.01.2019;02:04:04;81305542;81107355;198187;
19.01.2019;02:05:04;81305601;81107402;198199;
19.01.2019;02:06:05;81305688;81107450;198238;
19.01.2019;02:07:04;81305743;81107505;198238;
19.01.2019;02:08:04;81305817;81107560;198257;
19.01.2019;02:09:05;81305902;81107612;198290;
19.01.2019;02:10:05;81305976;81107658;198318;
19.01.2019;02:11:04;81306041;81107714;198327;
19.01.2019;02:12:05;81306123;81107792;198331;
19.01.2019;02:13:05;81306183;81107868;198315;
19.01.2019;02:14:04;81306238;81107929;198309;
19.01.2019;02:15:04;81306283;81107970;198313;
19.01.2019;02:16:05;81306354;81108010;198344;
19.01.2019;02:17:05;81306389;81108066;198323;
19.01.2019;02:18:04;81306428;81108113;198315;
19.01.2019;02:19:04;81306486;81108170;198316;
19.01.2019;02:20:05;81306533;81108235;198298;
19.01.2019;02:21:05;81306597;81108300;198297;
19.01.2019;02:22:05;81306634;81108346;198288;
19.01.2019;02:23:05;81306681;81108397;198284;
19.01.2019;02:24:04;81306724;81108455;198269;
19.01.2019;02:25:05;81306783;81108520;198263;
19.01.2019;02:26:05;81306828;81108571;198257;
19.01.2019;02:27:04;81306899;81108628;198271;
19.01.2019;02:28:04;81306962;81108701;198261;
19.01.2019;02:29:05;81307014;81108767;198247;
19.01.2019;02:30:04;81307089;81108840;198249;
19.01.2019;02:31:04;81307167;81108906;198261;
19.01.2019;02:32:05;81307222;81108979;198243;
19.01.2019;02:33:04;81307284;81109055;198229;
19.01.2019;02:34:04;81307348;81109110;198238;
19.01.2019;02:35:05;81307408;81109170;198238;
19.01.2019;02:36:04;81307481;81109224;198257;
19.01.2019;02:37:04;81307549;81109288;198261;
19.01.2019;02:38:05;81307628;81109341;198287;
19.01.2019;02:39:06;81307699;81109389;198310;
19.01.2019;02:40:04;81307755;81109449;198306;
19.01.2019;02:41:05;81307832;81109510;198322;
19.01.2019;02:42:04;81307895;81109571;198324;
19.01.2019;02:43:04;81307970;81109644;198326;
19.01.2019;02:44:05;81308039;81109721;198318;
19.01.2019;02:45:04;81308109;81109790;198319;
19.01.2019;02:46:04;81308183;81109876;198307;
19.01.2019;02:47:05;81308265;81109957;198308;
19.01.2019;02:48:04;81308328;81110018;198310;
19.01.2019;02:49:05;81308400;81110095;198305;
19.01.2019;02:50:05;81308478;81110165;198313;
19.01.2019;02:51:04;81308545;81110239;198306;
19.01.2019;02:52:04;81308600;81110307;198293;
19.01.2019;02:53:05;81308671;81110376;198295;
19.01.2019;02:54:05;81308717;81110446;198271;
19.01.2019;02:55:05;81308786;81110539;198247;
19.01.2019;02:56:04;81308879;81110633;198246;
19.01.2019;02:57:05;81308943;81110722;198221;
19.01.2019;02:58:04;81309015;81110807;198208;
19.01.2019;02:59:04;81309085;81110895;198190;
19.01.2019;03:00:05;81309177;81110981;198196;
19.01.2019;03:01:04;81309250;81111062;198188;
19.01.2019;03:02:04;81309323;81111147;198176;
19.01.2019;03:03:05;81309397;81111231;198166;
19.01.2019;03:04:05;81309467;81111311;198156;
19.01.2019;03:05:04;81309536;81111383;198153;
19.01.2019;03:06:04;81309603;81111478;198125;
19.01.2019;03:07:05;81309658;81111571;198087;
19.01.2019;03:08:04;81309716;81111669;198047;
19.01.2019;03:09:06;81309791;81111764;198027;
19.01.2019;03:10:05;81309866;81111845;198021;
19.01.2019;03:11:04;81309926;81111952;197974;
19.01.2019;03:12:04;81309987;81112036;197951;
19.01.2019;03:13:05;81310051;81112152;197899;
19.01.2019;03:14:05;81310130;81112243;197887;
19.01.2019;03:15:04;81310210;81112344;197866;
19.01.2019;03:16:04;81310289;81112438;197851;
19.01.2019;03:17:05;81310354;81112548;197806;
19.01.2019;03:18:05;81310434;81112639;197795;
19.01.2019;03:19:04;81310497;81112729;197768;
19.01.2019;03:20:04;81310547;81112816;197731;
19.01.2019;03:21:05;81310622;81112899;197723;
19.01.2019;03:22:05;81310703;81112986;197717;
19.01.2019;03:23:04;81310769;81113077;197692;
19.01.2019;03:24:05;81310834;81113193;197641;
19.01.2019;03:25:04;81310902;81113299;197603;
19.01.2019;03:26:04;81310986;81113377;197609;
19.01.2019;03:27:05;81311069;81113490;197579;
19.01.2019;03:28:05;81311149;81113591;197558;
19.01.2019;03:29:04;81311233;81113669;197564;
19.01.2019;03:30:04;81311318;81113782;197536;
19.01.2019;03:31:05;81311398;81113875;197523;
19.01.2019;03:32:05;81311465;81113984;197481;
19.01.2019;03:33:04;81311526;81114099;197427;
19.01.2019;03:34:05;81311588;81114202;197386;
19.01.2019;03:35:05;81311644;81114307;197337;
19.01.2019;03:36:04;81311712;81114414;197298;
19.01.2019;03:37:05;81311787;81114510;197277;
19.01.2019;03:38:04;81311866;81114607;197259;
19.01.2019;03:39:06;81311939;81114691;197248;
19.01.2019;03:40:05;81312003;81114805;197198;
19.01.2019;03:41:04;81312077;81114922;197155;
19.01.2019;03:42:04;81312147;81115019;197128;
19.01.2019;03:43:05;81312220;81115102;197118;
19.01.2019;03:44:05;81312295;81115181;197114;
19.01.2019;03:45:04;81312368;81115308;197060;
19.01.2019;03:46:05;81312432;81115431;197001;
19.01.2019;03:47:05;81312531;81115531;197000;
19.01.2019;03:48:04;81312597;81115657;196940;
19.01.2019;03:49:05;81312689;81115771;196918;
19.01.2019;03:50:04;81312738;81115836;196902;
19.01.2019;03:51:04;81312799;81115920;196879;
19.01.2019;03:52:05;81312880;81116035;196845;
19.01.2019;03:53:04;81312962;81116135;196827;
19.01.2019;03:54:04;81313036;81116213;196823;
19.01.2019;03:55:05;81313132;81116331;196801;
19.01.2019;03:56:04;81313208;81116441;196767;
19.01.2019;03:57:05;81313284;81116571;196713;
19.01.2019;03:58:04;81313373;81116668;196705;
19.01.2019;03:59:04;81313446;81116776;196670;
19.01.2019;04:00:05;81313526;81116897;196629;
19.01.2019;04:01:04;81313601;81116999;196602;
19.01.2019;04:02:05;81313665;81117137;196528;
19.01.2019;04:03:05;81313718;81117240;196478;
19.01.2019;04:04:04;81313797;81117342;196455;
19.01.2019;04:05:05;81313877;81117462;196415;
19.01.2019;04:06:04;81313938;81117570;196368;
19.01.2019;04:07:04;81314016;81117666;196350;
19.01.2019;04:08:05;81314084;81117790;196294;
19.01.2019;04:09:04;81314175;81117909;196266;
19.01.2019;04:10:04;81314252;81118009;196243;
19.01.2019;04:11:05;81314348;81118120;196228;
19.01.2019;04:12:05;81314434;81118242;196192;
19.01.2019;04:13:04;81314514;81118339;196175;
19.01.2019;04:14:05;81314602;81118443;196159;
19.01.2019;04:15:05;81314668;81118557;196111;
19.01.2019;04:16:04;81314724;81118679;196045;
19.01.2019;04:17:05;81314762;81118788;195974;
19.01.2019;04:18:05;81314808;81118869;195939;
19.01.2019;04:19:04;81314875;81118989;195886;
19.01.2019;04:20:04;81314923;81119105;195818;
19.01.2019;04:21:04;81314972;81119223;195749;
19.01.2019;04:22:04;81315031;81119330;195701;
19.01.2019;04:23:05;81315097;81119455;195642;
19.01.2019;04:24:05;81315157;81119580;195577;
19.01.2019;04:25:04;81315214;81119710;195504;
19.01.2019;04:26:05;81315249;81119824;195425;
19.01.2019;04:27:04;81315316;81119938;195378;
19.01.2019;04:28:04;81315378;81120062;195316;
19.01.2019;04:29:05;81315453;81120173;195280;
19.01.2019;04:30:05;81315513;81120266;195247;
19.01.2019;04:31:04;81315575;81120356;195219;
19.01.2019;04:32:04;81315645;81120470;195175;
19.01.2019;04:33:05;81315729;81120595;195134;
19.01.2019;04:34:04;81315782;81120709;195073;
19.01.2019;04:35:04;81315853;81120815;195038;
19.01.2019;04:36:04;81315937;81120933;195004;
19.01.2019;04:37:04;81316017;81121047;194970;
19.01.2019;04:38:05;81316099;81121145;194954;
19.01.2019;04:39:06;81316173;81121257;194916;
19.01.2019;04:40:04;81316248;81121373;194875;
19.01.2019;04:41:05;81316313;81121500;194813;
19.01.2019;04:42:04;81316382;81121629;194753;
19.01.2019;04:43:04;81316452;81121738;194714;
19.01.2019;04:44:05;81316537;81121867;194670;
19.01.2019;04:45:05;81316619;81121990;194629;
19.01.2019;04:46:05;81316692;81122094;194598;
19.01.2019;04:47:04;81316762;81122212;194550;
19.01.2019;04:48:05;81316811;81122337;194474;
19.01.2019;04:49:05;81316889;81122467;194422;
19.01.2019;04:50:04;81316966;81122589;194377;
19.01.2019;04:51:04;81317059;81122715;194344;
19.01.2019;04:52:05;81317118;81122832;194286;
19.01.2019;04:53:04;81317202;81122946;194256;
19.01.2019;04:54:04;81317288;81123052;194236;
19.01.2019;04:55:05;81317350;81123163;194187;
19.01.2019;04:56:05;81317415;81123295;194120;
19.01.2019;04:57:04;81317492;81123438;194054;
19.01.2019;04:58:04;81317562;81123557;194005;
19.01.2019;04:59:05;81317660;81123680;193980;
19.01.2019;05:00:04;81317730;81123791;193939;
19.01.2019;05:01:04;81317800;81123917;193883;
19.01.2019;05:02:05;81317880;81124047;193833;
19.01.2019;05:03:04;81317962;81124181;193781;
19.01.2019;05:04:05;81318033;81124323;193710;
19.01.2019;05:05:05;81318105;81124450;193655;
19.01.2019;05:06:04;81318178;81124561;193617;
19.01.2019;05:07:04;81318260;81124678;193582;
19.01.2019;05:08:05;81318344;81124794;193550;
19.01.2019;05:09:06;81318421;81124908;193513;
19.01.2019;05:10:04;81318478;81125020;193458;
19.01.2019;05:11:05;81318559;81125153;193406;
19.01.2019;05:12:04;81318627;81125253;193374;
19.01.2019;05:13:04;81318696;81125366;193330;
19.01.2019;05:14:05;81318782;81125501;193281;
19.01.2019;05:15:04;81318867;81125626;193241;
19.01.2019;05:16:04;81318938;81125757;193181;
19.01.2019;05:17:05;81319035;81125903;193132;
19.01.2019;05:18:05;81319116;81126028;193088;
19.01.2019;05:19:04;81319181;81126157;193024;
19.01.2019;05:20:04;81319254;81126304;192950;
19.01.2019;05:21:05;81319333;81126416;192917;
19.01.2019;05:22:05;81319415;81126532;192883;
19.01.2019;05:23:04;81319482;81126679;192803;
19.01.2019;05:24:05;81319571;81126806;192765;
19.01.2019;05:25:04;81319654;81126935;192719;
19.01.2019;05:26:04;81319746;81127062;192684;
19.01.2019;05:27:05;81319807;81127175;192632;
19.01.2019;05:28:05;81319874;81127296;192578;
19.01.2019;05:29:04;81319939;81127436;192503;
19.01.2019;05:30:04;81320033;81127554;192479;
19.01.2019;05:31:05;81320097;81127668;192429;
19.01.2019;05:32:10;81320171;81127798;192373;
19.01.2019;05:33:04;81320242;81127915;192327;
19.01.2019;05:34:05;81320304;81128055;192249;
19.01.2019;05:35:05;81320386;81128171;192215;
19.01.2019;05:36:04;81320450;81128302;192148;
19.01.2019;05:37:04;81320517;81128425;192092;
19.01.2019;05:38:05;81320601;81128551;192050;
19.01.2019;05:39:05;81320678;81128673;192005;
19.01.2019;05:40:05;81320755;81128773;191982;
19.01.2019;05:41:04;81320816;81128886;191930;
19.01.2019;05:42:05;81320877;81128993;191884;
19.01.2019;05:43:05;81320946;81129108;191838;
19.01.2019;05:44:04;81321000;81129265;191735;
19.01.2019;05:45:04;81321075;81129388;191687;
19.01.2019;05:46:05;81321155;81129519;191636;
19.01.2019;05:47:05;81321214;81129644;191570;
19.01.2019;05:48:04;81321289;81129774;191515;
19.01.2019;05:49:05;81321361;81129875;191486;
19.01.2019;05:50:05;81321425;81130032;191393;
19.01.2019;05:51:04;81321496;81130145;191351;
19.01.2019;05:52:04;81321579;81130247;191332;
19.01.2019;05:53:05;81321654;81130387;191267;
19.01.2019;05:54:05;81321730;81130511;191219;
19.01.2019;05:55:04;81321790;81130644;191146;
19.01.2019;05:56:04;81321861;81130767;191094;
19.01.2019;05:57:05;81321929;81130905;191024;
19.01.2019;05:58:04;81322009;81131013;190996;
19.01.2019;05:59:04;81322081;81131139;190942;
19.01.2019;06:00:05;81322153;81131254;190899;
19.01.2019;06:01:04;81322230;81131350;190880;
19.01.2019;06:02:04;81322299;81131463;190836;
19.01.2019;06:03:05;81322347;81131593;190754;
19.01.2019;06:04:04;81322409;81131731;190678;
19.01.2019;06:05:04;81322465;81131859;190606;
19.01.2019;06:06:05;81322545;81131986;190559;
19.01.2019;06:07:04;81322606;81132133;190473;
19.01.2019;06:08:04;81322668;81132267;190401;
19.01.2019;06:09:05;81322743;81132414;190329;
19.01.2019;06:10:05;81322814;81132554;190260;
19.01.2019;06:11:04;81322895;81132672;190223;
19.01.2019;06:12:04;81322960;81132814;190146;
19.01.2019;06:13:05;81322995;81132919;190076;
19.01.2019;06:14:04;81323044;81133041;190003;
19.01.2019;06:15:04;81323106;81133136;189970;
19.01.2019;06:16:05;81323148;81133282;189866;
19.01.2019;06:17:04;81323204;81133392;189812;
19.01.2019;06:18:04;81323251;81133499;189752;
19.01.2019;06:19:05;81323310;81133636;189674;
19.01.2019;06:20:04;81323354;81133759;189595;
19.01.2019;06:21:07;81323401;81133863;189538;
19.01.2019;06:22:04;81323443;81133999;189444;
19.01.2019;06:23:05;81323495;81134130;189365;
19.01.2019;06:24:04;81323545;81134262;189283;
19.01.2019;06:25:07;81323588;81134375;189213;
19.01.2019;06:26:04;81323647;81134498;189149;
19.01.2019;06:27:04;81323712;81134632;189080;
19.01.2019;06:28:05;81323764;81134737;189027;
19.01.2019;06:29:04;81323821;81134864;188957;
19.01.2019;06:30:04;81323875;81135000;188875;
19.01.2019;06:31:05;81323931;81135116;188815;
19.01.2019;06:32:04;81323970;81135227;188743;
19.01.2019;06:33:04;81324038;81135352;188686;
19.01.2019;06:34:05;81324102;81135462;188640;
19.01.2019;06:35:04;81324140;81135614;188526;
19.01.2019;06:36:04;81324216;81135749;188467;
19.01.2019;06:37:05;81324255;81135872;188383;
19.01.2019;06:38:04;81324316;81135991;188325;
19.01.2019;06:39:06;81324373;81136127;188246;
19.01.2019;06:40:05;81324441;81136244;188197;
19.01.2019;06:41:04;81324487;81136366;188121;
19.01.2019;06:42:04;81324547;81136495;188052;
19.01.2019;06:43:05;81324619;81136618;188001;
19.01.2019;06:44:04;81324672;81136740;187932;
19.01.2019;06:45:04;81324735;81136867;187868;
19.01.2019;06:46:05;81324791;81136986;187805;
19.01.2019;06:47:04;81324868;81137121;187747;
19.01.2019;06:48:05;81324945;81137254;187691;
19.01.2019;06:49:04;81324999;81137397;187602;
19.01.2019;06:50:04;81325051;81137504;187547;
19.01.2019;06:51:05;81325088;81137611;187477;
19.01.2019;06:52:05;81325150;81137733;187417;
19.01.2019;06:53:04;81325215;81137857;187358;
19.01.2019;06:54:05;81325269;81137998;187271;
19.01.2019;06:55:05;81325322;81138110;187212;
19.01.2019;06:56:04;81325386;81138238;187148;
19.01.2019;06:57:05;81325443;81138367;187076;
19.01.2019;06:58:05;81325487;81138505;186982;
19.01.2019;06:59:04;81325547;81138605;186942;
19.01.2019;07:00:05;81325600;81138743;186857;
19.01.2019;07:01:04;81325647;81138863;186784;
19.01.2019;07:02:05;81325714;81139000;186714;
19.01.2019;07:03:04;81325777;81139128;186649;
19.01.2019;07:04:04;81325853;81139284;186569;
19.01.2019;07:05:05;81325910;81139412;186498;
19.01.2019;07:06:04;81325964;81139530;186434;
19.01.2019;07:07:04;81326016;81139685;186331;
19.01.2019;07:08:05;81326078;81139809;186269;
19.01.2019;07:09:05;81326138;81139959;186179;
19.01.2019;07:10:04;81326195;81140091;186104;
19.01.2019;07:11:04;81326242;81140243;185999;
19.01.2019;07:12:05;81326293;81140390;185903;
19.01.2019;07:13:05;81326343;81140546;185797;
19.01.2019;07:14:04;81326390;81140688;185702;
19.01.2019;07:15:04;81326444;81140834;185610;
19.01.2019;07:16:05;81326501;81140973;185528;
19.01.2019;07:17:05;81326551;81141095;185456;
19.01.2019;07:18:04;81326621;81141223;185398;
19.01.2019;07:19:04;81326684;81141360;185324;
19.01.2019;07:20:05;81326732;81141512;185220;
19.01.2019;07:21:04;81326810;81141652;185158;
19.01.2019;07:22:04;81326852;81141808;185044;
19.01.2019;07:23:05;81326906;81141943;184963;
19.01.2019;07:24:05;81326979;81142087;184892;
19.01.2019;07:25:04;81327039;81142209;184830;
19.01.2019;07:26:04;81327101;81142305;184796;
19.01.2019;07:27:05;81327152;81142428;184724;
19.01.2019;07:28:04;81327206;81142578;184628;
19.01.2019;07:29:04;81327271;81142714;184557;
19.01.2019;07:30:05;81327318;81142857;184461;
19.01.2019;07:31:05;81327376;81142992;184384;
19.01.2019;07:32:04;81327434;81143104;184330;
19.01.2019;07:33:04;81327495;81143234;184261;
19.01.2019;07:34:05;81327545;81143372;184173;
19.01.2019;07:35:04;81327593;81143468;184125;
19.01.2019;07:36:04;81327648;81143609;184039;
19.01.2019;07:37:05;81327704;81143755;183949;
19.01.2019;07:38:05;81327755;81143899;183856;
19.01.2019;07:39:06;81327811;81144054;183757;
19.01.2019;07:40:05;81327839;81144192;183647;
19.01.2019;07:41:05;81327891;81144318;183573;
19.01.2019;07:42:04;81327944;81144461;183483;
19.01.2019;07:43:04;81328006;81144600;183406;
19.01.2019;07:44:05;81328075;81144750;183325;
19.01.2019;07:45:05;81328134;81144902;183232;
19.01.2019;07:46:04;81328189;81145015;183174;
19.01.2019;07:47:04;81328249;81145151;183098;
19.01.2019;07:48:04;81328299;81145317;182982;
19.01.2019;07:49:05;81328349;81145439;182910;
19.01.2019;07:50:04;81328409;81145566;182843;
19.01.2019;07:51:04;81328444;81145703;182741;
19.01.2019;07:52:05;81328489;81145828;182661;
19.01.2019;07:53:05;81328537;81145955;182582;
19.01.2019;07:54:04;81328594;81146058;182536;
19.01.2019;07:55:04;81328657;81146157;182500;
19.01.2019;07:56:05;81328706;81146295;182411;
19.01.2019;07:57:05;81328767;81146420;182347;
19.01.2019;07:58:04;81328819;81146561;182258;
19.01.2019;07:59:04;81328881;81146696;182185;
19.01.2019;08:00:04;81328925;81146838;182087;
19.01.2019;08:01:05;81328991;81146975;182016;
19.01.2019;08:02:04;81329042;81147128;181914;
19.01.2019;08:03:04;81329110;81147283;181827;
19.01.2019;08:04:05;81329164;81147437;181727;
19.01.2019;08:05:05;81329220;81147579;181641;
19.01.2019;08:06:04;81329270;81147712;181558;
19.01.2019;08:07:04;81329318;81147854;181464;
19.01.2019;08:08:05;81329364;81148001;181363;
19.01.2019;08:09:05;81329416;81148118;181298;
19.01.2019;08:10:05;81329448;81148239;181209;
19.01.2019;08:11:05;81329475;81148338;181137;
19.01.2019;08:12:04;81329531;81148480;181051;
19.01.2019;08:13:04;81329557;81148614;180943;
19.01.2019;08:14:05;81329590;81148747;180843;
19.01.2019;08:15:04;81329642;81148910;180732;
19.01.2019;08:16:04;81329666;81149042;180624;
19.01.2019;08:17:05;81329694;81149167;180527;
19.01.2019;08:18:05;81329727;81149301;180426;
19.01.2019;08:19:04;81329746;81149422;180324;
19.01.2019;08:20:04;81329775;81149542;180233;
19.01.2019;08:21:05;81329808;81149672;180136;
19.01.2019;08:22:04;81329846;81149790;180056;
19.01.2019;08:23:04;81329876;81149919;179957;
19.01.2019;08:24:04;81329906;81150051;179855;
19.01.2019;08:25:05;81329947;81150200;179747;
19.01.2019;08:26:04;81329990;81150338;179652;
19.01.2019;08:27:04;81330045;81150486;179559;
19.01.2019;08:28:05;81330090;81150588;179502;
19.01.2019;08:29:04;81330135;81150719;179416;
19.01.2019;08:30:04;81330185;81150846;179339;
19.01.2019;08:31:05;81330243;81150967;179276;
19.01.2019;08:32:05;81330291;81151089;179202;
19.01.2019;08:33:04;81330343;81151222;179121;
19.01.2019;08:34:04;81330392;81151358;179034;
19.01.2019;08:35:05;81330454;81151522;178932;
19.01.2019;08:36:05;81330516;81151657;178859;
19.01.2019;08:37:04;81330565;81151772;178793;
19.01.2019;08:38:04;81330636;81151910;178726;
19.01.2019;08:39:07;81330700;81152077;178623;
19.01.2019;08:40:05;81330754;81152202;178552;
19.01.2019;08:41:04;81330811;81152357;178454;
19.01.2019;08:42:04;81330841;81152489;178352;
19.01.2019;08:43:05;81330889;81152635;178254;
19.01.2019;08:44:05;81330939;81152766;178173;
19.01.2019;08:45:05;81331006;81152892;178114;
19.01.2019;08:46:04;81331058;81153016;178042;
19.01.2019;08:47:05;81331111;81153142;177969;
19.01.2019;08:48:05;81331165;81153279;177886;
19.01.2019;08:49:04;81331211;81153420;177791;
19.01.2019;08:50:05;81331271;81153558;177713;
19.01.2019;08:51:05;81331345;81153672;177673;
19.01.2019;08:52:04;81331407;81153808;177599;
19.01.2019;08:53:04;81331443;81153953;177490;
19.01.2019;08:54:05;81331484;81154090;177394;
19.01.2019;08:55:05;81331540;81154240;177300;
19.01.2019;08:56:04;81331586;81154371;177215;
19.01.2019;08:57:05;81331637;81154501;177136;
19.01.2019;08:58:05;81331689;81154638;177051;
19.01.2019;08:59:04;81331739;81154785;176954;
19.01.2019;09:00:05;81331789;81154922;176867;
19.01.2019;09:01:05;81331842;81155063;176779;
19.01.2019;09:02:04;81331898;81155210;176688;
19.01.2019;09:03:04;81331958;81155358;176600;
19.01.2019;09:04:04;81332009;81155515;176494;
19.01.2019;09:05:05;81332065;81155664;176401;
19.01.2019;09:06:05;81332120;81155771;176349;
19.01.2019;09:07:05;81332168;81155895;176273;
19.01.2019;09:08:04;81332237;81156019;176218;
19.01.2019;09:09:06;81332282;81156163;176119;
19.01.2019;09:10:05;81332348;81156287;176061;
19.01.2019;09:11:05;81332392;81156444;175948;
19.01.2019;09:12:04;81332440;81156590;175850;
19.01.2019;09:13:04;81332492;81156732;175760;
19.01.2019;09:14:05;81332535;81156894;175641;
19.01.2019;09:15:05;81332587;81157048;175539;
19.01.2019;09:16:04;81332644;81157193;175451;
19.01.2019;09:17:04;81332704;81157317;175387;
19.01.2019;09:18:04;81332759;81157454;175305;
19.01.2019;09:19:04;81332814;81157603;175211;
19.01.2019;09:20:05;81332871;81157775;175096;
19.01.2019;09:21:05;81332928;81157926;175002;
19.01.2019;09:22:04;81332972;81158057;174915;
19.01.2019;09:23:05;81333022;81158194;174828;
19.01.2019;09:24:04;81333089;81158344;174745;
19.01.2019;09:25:04;81333130;81158493;174637;
19.01.2019;09:26:05;81333197;81158659;174538;
19.01.2019;09:27:05;81333241;81158803;174438;
19.01.2019;09:28:05;81333290;81158946;174344;
19.01.2019;09:29:04;81333347;81159095;174252;
19.01.2019;09:30:04;81333399;81159238;174161;
19.01.2019;09:31:05;81333456;81159385;174071;
19.01.2019;09:32:05;81333509;81159535;173974;
19.01.2019;09:33:04;81333572;81159681;173891;
19.01.2019;09:34:04;81333611;81159826;173785;
19.01.2019;09:35:04;81333658;81159961;173697;
19.01.2019;09:36:05;81333709;81160126;173583;
19.01.2019;09:37:05;81333751;81160282;173469;
19.01.2019;09:38:04;81333805;81160440;173365;
19.01.2019;09:39:06;81333852;81160574;173278;
19.01.2019;09:40:05;81333909;81160709;173200;
19.01.2019;09:41:05;81333978;81160852;173126;
19.01.2019;09:42:05;81334018;81161007;173011;
19.01.2019;09:43:04;81334073;81161131;172942;
19.01.2019;09:44:05;81334132;81161245;172887;
19.01.2019;09:45:04;81334178;81161368;172810;
19.01.2019;09:46:04;81334242;81161512;172730;
19.01.2019;09:47:04;81334312;81161666;172646;
19.01.2019;09:48:04;81334348;81161795;172553;
19.01.2019;09:49:05;81334395;81161945;172450;
19.01.2019;09:50:05;81334424;81162066;172358;
19.01.2019;09:51:04;81334484;81162213;172271;
19.01.2019;09:52:05;81334536;81162354;172182;
19.01.2019;09:53:05;81334588;81162497;172091;
19.01.2019;09:54:05;81334644;81162653;171991;
19.01.2019;09:55:04;81334714;81162790;171924;
19.01.2019;09:56:04;81334762;81162935;171827;
19.01.2019;09:57:05;81334819;81163074;171745;
19.01.2019;09:58:05;81334872;81163225;171647;
19.01.2019;09:59:05;81334931;81163388;171543;
19.01.2019;10:00:04;81334990;81163522;171468;
19.01.2019;10:01:04;81335054;81163667;171387;
19.01.2019;10:02:04;81335114;81163829;171285;
19.01.2019;10:03:04;81335179;81163970;171209;
19.01.2019;10:04:06;81335236;81164113;171123;
19.01.2019;10:05:05;81335300;81164272;171028;
19.01.2019;10:06:04;81335359;81164426;170933;
19.01.2019;10:07:04;81335421;81164581;170840;
19.01.2019;10:08:05;81335465;81164735;170730;
19.01.2019;10:09:06;81335527;81164895;170632;
19.01.2019;10:10:04;81335575;81165049;170526;
19.01.2019;10:11:05;81335623;81165205;170418;
19.01.2019;10:12:04;81335680;81165374;170306;
19.01.2019;10:13:04;81335732;81165530;170202;
19.01.2019;10:14:05;81335795;81165688;170107;
19.01.2019;10:15:05;81335847;81165827;170020;
19.01.2019;10:16:04;81335900;81165963;169937;
19.01.2019;10:17:05;81335952;81166102;169850;
19.01.2019;10:18:05;81335994;81166247;169747;
19.01.2019;10:19:05;81336037;81166408;169629;
19.01.2019;10:20:05;81336093;81166541;169552;
19.01.2019;10:21:04;81336110;81166665;169445;
19.01.2019;10:22:04;81336145;81166772;169373;
19.01.2019;10:23:05;81336184;81166897;169287;
19.01.2019;10:24:05;81336227;81167029;169198;
19.01.2019;10:25:04;81336294;81167153;169141;
19.01.2019;10:26:04;81336348;81167297;169051;
19.01.2019;10:27:05;81336387;81167448;168939;
19.01.2019;10:28:05;81336437;81167569;168868;
19.01.2019;10:29:04;81336485;81167689;168796;
19.01.2019;10:30:05;81336520;81167832;168688;
19.01.2019;10:31:05;81336575;81167982;168593;
19.01.2019;10:32:05;81336624;81168133;168491;
19.01.2019;10:33:04;81336673;81168281;168392;
19.01.2019;10:34:04;81336715;81168412;168303;
19.01.2019;10:35:05;81336767;81168556;168211;
19.01.2019;10:36:05;81336829;81168688;168141;
19.01.2019;10:37:05;81336891;81168816;168075;
19.01.2019;10:38:05;81336951;81168963;167988;
19.01.2019;10:39:06;81337008;81169124;167884;
19.01.2019;10:40:05;81337061;81169253;167808;
19.01.2019;10:41:04;81337126;81169345;167781;
19.01.2019;10:42:04;81337194;81169462;167732;
19.01.2019;10:43:04;81337261;81169593;167668;
19.01.2019;10:44:05;81337333;81169729;167604;
19.01.2019;10:45:04;81337398;81169851;167547;
19.01.2019;10:46:05;81337460;81169985;167475;
19.01.2019;10:47:05;81337497;81170115;167382;
19.01.2019;10:48:05;81337556;81170265;167291;
19.01.2019;10:49:05;81337608;81170390;167218;
19.01.2019;10:50:05;81337675;81170545;167130;
19.01.2019;10:51:04;81337728;81170686;167042;
19.01.2019;10:52:04;81337791;81170832;166959;
19.01.2019;10:53:05;81337852;81170970;166882;
19.01.2019;10:54:05;81337908;81171113;166795;
19.01.2019;10:55:06;81337963;81171235;166728;
19.01.2019;10:56:04;81338029;81171348;166681;
19.01.2019;10:57:04;81338084;81171462;166622;
19.01.2019;10:58:05;81338142;81171577;166565;
19.01.2019;10:59:05;81338226;81171706;166520;
19.01.2019;11:00:05;81338279;81171823;166456;
19.01.2019;11:01:04;81338334;81171967;166367;
19.01.2019;11:02:04;81338391;81172114;166277;
19.01.2019;11:03:05;81338452;81172269;166183;
19.01.2019;11:04:05;81338515;81172400;166115;
19.01.2019;11:05:05;81338556;81172540;166016;
19.01.2019;11:06:05;81338609;81172664;165945;
19.01.2019;11:07:05;81338669;81172825;165844;
19.01.2019;11:08:05;81338739;81172986;165753;
19.01.2019;11:09:06;81338798;81173151;165647;
19.01.2019;11:10:05;81338870;81173273;165597;
19.01.2019;11:11:05;81338944;81173433;165511;
19.01.2019;11:12:05;81339018;81173566;165452;
19.01.2019;11:13:04;81339084;81173708;165376;
19.01.2019;11:14:04;81339143;81173812;165331;
19.01.2019;11:15:04;81339209;81173953;165256;
19.01.2019;11:16:05;81339295;81174095;165200;
19.01.2019;11:17:05;81339354;81174231;165123;
19.01.2019;11:18:05;81339432;81174381;165051;
19.01.2019;11:19:05;81339514;81174531;164983;
19.01.2019;11:20:04;81339562;81174661;164901;
19.01.2019;11:21:04;81339634;81174813;164821;
19.01.2019;11:22:05;81339698;81174966;164732;
19.01.2019;11:23:05;81339758;81175085;164673;
19.01.2019;11:24:05;81339819;81175209;164610;
19.01.2019;11:25:05;81339897;81175333;164564;
19.01.2019;11:26:05;81339960;81175467;164493;
19.01.2019;11:27:05;81340025;81175608;164417;
19.01.2019;11:28:05;81340063;81175753;164310;
19.01.2019;11:29:04;81340121;81175881;164240;
19.01.2019;11:30:04;81340189;81176010;164179;
19.01.2019;11:31:05;81340252;81176170;164082;
19.01.2019;11:32:05;81340314;81176310;164004;
19.01.2019;11:33:04;81340369;81176457;163912;
19.01.2019;11:34:04;81340443;81176608;163835;
19.01.2019;11:35:04;81340504;81176752;163752;
19.01.2019;11:36:04;81340566;81176898;163668;
19.01.2019;11:37:04;81340644;81177025;163619;
19.01.2019;11:38:05;81340701;81177174;163527;
19.01.2019;11:39:07;81340774;81177312;163462;
19.01.2019;11:40:05;81340855;81177456;163399;
19.01.2019;11:41:05;81340926;81177576;163350;
19.01.2019;11:42:05;81340982;81177719;163263;
19.01.2019;11:43:05;81341043;81177845;163198;
19.01.2019;11:44:05;81341108;81177984;163124;
19.01.2019;11:45:05;81341174;81178129;163045;
19.01.2019;11:46:05;81341245;81178285;162960;
19.01.2019;11:47:04;81341308;81178445;162863;
19.01.2019;11:48:04;81341363;81178604;162759;
19.01.2019;11:49:05;81341420;81178758;162662;
19.01.2019;11:50:05;81341474;81178911;162563;
19.01.2019;11:51:05;81341536;81179054;162482;
19.01.2019;11:52:05;81341586;81179219;162367;
19.01.2019;11:53:05;81341662;81179359;162303;
19.01.2019;11:54:05;81341720;81179519;162201;
19.01.2019;11:55:05;81341803;81179654;162149;
19.01.2019;11:56:05;81341852;81179778;162074;
19.01.2019;11:57:05;81341912;81179925;161987;
19.01.2019;11:58:05;81341987;81180076;161911;
19.01.2019;11:59:05;81342063;81180225;161838;
19.01.2019;12:00:04;81342124;81180362;161762;
19.01.2019;12:01:05;81342199;81180527;161672;
19.01.2019;12:02:04;81342264;81180671;161593;
19.01.2019;12:03:04;81342328;81180806;161522;
19.01.2019;12:04:04;81342389;81180949;161440;
19.01.2019;12:05:04;81342427;81181071;161356;
19.01.2019;12:06:04;81342494;81181191;161303;
19.01.2019;12:07:05;81342532;81181311;161221;
19.01.2019;12:08:05;81342563;81181455;161108;
19.01.2019;12:09:05;81342626;81181575;161051;
19.01.2019;12:10:05;81342702;81181684;161018;
19.01.2019;12:11:05;81342745;81181784;160961;
19.01.2019;12:12:05;81342805;81181897;160908;
19.01.2019;12:13:07;81342859;81182013;160846;
19.01.2019;12:14:04;81342906;81182107;160799;
19.01.2019;12:15:05;81342932;81182236;160696;
19.01.2019;12:16:04;81342977;81182345;160632;
19.01.2019;12:17:04;81343061;81182478;160583;
19.01.2019;12:18:04;81343112;81182598;160514;
19.01.2019;12:19:04;81343167;81182726;160441;
19.01.2019;12:20:05;81343223;81182848;160375;
19.01.2019;12:21:06;81343286;81182985;160301;
19.01.2019;12:22:04;81343350;81183122;160228;
19.01.2019;12:23:04;81343410;81183255;160155;
19.01.2019;12:24:04;81343483;81183400;160083;
19.01.2019;12:25:04;81343546;81183529;160017;
19.01.2019;12:26:04;81343623;81183652;159971;
19.01.2019;12:27:04;81343693;81183739;159954;
19.01.2019;12:28:05;81343765;81183867;159898;
19.01.2019;12:29:05;81343832;81183999;159833;
19.01.2019;12:30:05;81343918;81184142;159776;
19.01.2019;12:31:11;81343982;81184308;159674;
19.01.2019;12:32:05;81344060;81184430;159630;
19.01.2019;12:33:06;81344140;81184586;159554;
19.01.2019;12:34:06;81344209;81184730;159479;
19.01.2019;12:35:09;81344255;81184885;159370;
19.01.2019;12:36:05;81344321;81185000;159321;
19.01.2019;12:37:05;81344403;81185153;159250;
19.01.2019;12:38:05;81344479;81185292;159187;
19.01.2019;12:39:05;81344540;81185432;159108;
19.01.2019;12:40:05;81344598;81185592;159006;
19.01.2019;12:41:05;81344666;81185734;158932;
19.01.2019;12:42:05;81344721;81185881;158840;
19.01.2019;12:43:05;81344792;81186023;158769;
19.01.2019;12:44:05;81344843;81186169;158674;
19.01.2019;12:45:04;81344920;81186305;158615;
19.01.2019;12:46:04;81344956;81186436;158520;
19.01.2019;12:47:04;81345023;81186572;158451;
19.01.2019;12:48:05;81345082;81186729;158353;
19.01.2019;12:49:04;81345164;81186854;158310;
19.01.2019;12:50:05;81345235;81186998;158237;
19.01.2019;12:51:04;81345306;81187145;158161;
19.01.2019;12:52:05;81345379;81187284;158095;
19.01.2019;12:53:05;81345458;81187436;158022;
19.01.2019;12:54:05;81345515;81187562;157953;
19.01.2019;12:55:05;81345583;81187694;157889;
19.01.2019;12:56:05;81345647;81187822;157825;
19.01.2019;12:57:05;81345707;81187979;157728;
19.01.2019;12:58:05;81345774;81188115;157659;
19.01.2019;12:59:05;81345833;81188248;157585;
19.01.2019;13:00:05;81345920;81188404;157516;
19.01.2019;13:01:05;81345994;81188554;157440;
19.01.2019;13:02:05;81346060;81188692;157368;
19.01.2019;13:03:04;81346123;81188845;157278;
19.01.2019;13:04:04;81346196;81188974;157222;
19.01.2019;13:05:05;81346260;81189092;157168;
19.01.2019;13:06:05;81346327;81189249;157078;
19.01.2019;13:07:05;81346397;81189390;157007;
19.01.2019;13:08:05;81346462;81189542;156920;
19.01.2019;13:09:04;81346536;81189668;156868;
19.01.2019;13:10:04;81346595;81189823;156772;
19.01.2019;13:11:05;81346648;81189999;156649;
19.01.2019;13:12:04;81346715;81190126;156589;
19.01.2019;13:13:05;81346771;81190288;156483;
19.01.2019;13:14:05;81346827;81190446;156381;
19.01.2019;13:15:04;81346884;81190607;156277;
19.01.2019;13:16:04;81346955;81190738;156217;
19.01.2019;13:17:05;81347024;81190864;156160;
19.01.2019;13:18:05;81347106;81191037;156069;
19.01.2019;13:19:04;81347178;81191183;155995;
19.01.2019;13:20:04;81347257;81191307;155950;
19.01.2019;13:21:04;81347327;81191472;155855;
19.01.2019;13:22:05;81347376;81191601;155775;
19.01.2019;13:23:05;81347441;81191760;155681;
19.01.2019;13:24:05;81347522;81191902;155620;
19.01.2019;13:25:04;81347613;81192045;155568;
19.01.2019;13:26:04;81347681;81192200;155481;
19.01.2019;13:27:05;81347751;81192351;155400;
19.01.2019;13:28:05;81347827;81192489;155338;
19.01.2019;13:29:05;81347895;81192656;155239;
19.01.2019;13:30:04;81347945;81192803;155142;
19.01.2019;13:31:05;81348017;81192938;155079;
19.01.2019;13:32:05;81348084;81193085;154999;
19.01.2019;13:33:04;81348157;81193227;154930;
19.01.2019;13:34:04;81348225;81193383;154842;
19.01.2019;13:35:05;81348295;81193542;154753;
19.01.2019;13:36:05;81348361;81193692;154669;
19.01.2019;13:37:05;81348419;81193852;154567;
19.01.2019;13:38:05;81348488;81194004;154484;
19.01.2019;13:39:06;81348551;81194165;154386;
19.01.2019;13:40:04;81348614;81194314;154300;
19.01.2019;13:41:05;81348701;81194453;154248;
19.01.2019;13:42:05;81348781;81194620;154161;
19.01.2019;13:43:06;81348851;81194763;154088;
19.01.2019;13:44:04;81348936;81194898;154038;
19.01.2019;13:45:04;81349011;81195053;153958;
19.01.2019;13:46:04;81349086;81195195;153891;
19.01.2019;13:47:04;81349155;81195326;153829;
19.01.2019;13:48:05;81349212;81195500;153712;
19.01.2019;13:49:05;81349299;81195645;153654;
19.01.2019;13:50:05;81349389;81195785;153604;
19.01.2019;13:51:04;81349461;81195961;153500;
19.01.2019;13:52:04;81349547;81196088;153459;
19.01.2019;13:53:05;81349623;81196256;153367;
19.01.2019;13:54:05;81349689;81196391;153298;
19.01.2019;13:55:04;81349764;81196521;153243;
19.01.2019;13:56:04;81349847;81196691;153156;
19.01.2019;13:57:04;81349928;81196875;153053;
19.01.2019;13:58:05;81349998;81197039;152959;
19.01.2019;13:59:05;81350066;81197192;152874;
19.01.2019;14:00:05;81350140;81197332;152808;
19.01.2019;14:01:05;81350209;81197452;152757;
19.01.2019;14:02:04;81350310;81197607;152703;
19.01.2019;14:03:04;81350389;81197712;152677;
19.01.2019;14:04:05;81350458;81197853;152605;
19.01.2019;14:05:05;81350546;81197998;152548;
19.01.2019;14:06:04;81350625;81198144;152481;
19.01.2019;14:07:04;81350690;81198289;152401;
19.01.2019;14:08:05;81350754;81198434;152320;
19.01.2019;14:09:06;81350834;81198557;152277;
19.01.2019;14:10:05;81350890;81198684;152206;
19.01.2019;14:11:05;81350966;81198852;152114;
19.01.2019;14:12:04;81351043;81199006;152037;
19.01.2019;14:13:04;81351087;81199178;151909;
19.01.2019;14:14:05;81351134;81199335;151799;
19.01.2019;14:15:04;81351159;81199451;151708;
19.01.2019;14:16:04;81351180;81199573;151607;
19.01.2019;14:17:06;81351246;81199712;151534;
19.01.2019;14:18:05;81351272;81199844;151428;
19.01.2019;14:19:04;81351306;81200002;151304;
19.01.2019;14:20:05;81351351;81200113;151238;
19.01.2019;14:21:05;81351407;81200231;151176;
19.01.2019;14:22:04;81351457;81200392;151065;
19.01.2019;14:23:04;81351525;81200562;150963;
19.01.2019;14:24:04;81351600;81200725;150875;
19.01.2019;14:25:05;81351650;81200867;150783;
19.01.2019;14:26:04;81351718;81201008;150710;
19.01.2019;14:27:04;81351786;81201158;150628;
19.01.2019;14:28:05;81351872;81201315;150557;
19.01.2019;14:29:05;81351952;81201492;150460;
19.01.2019;14:30:04;81352038;81201637;150401;
19.01.2019;14:31:04;81352108;81201810;150298;
19.01.2019;14:32:05;81352185;81201964;150221;
19.01.2019;14:33:05;81352268;81202114;150154;
19.01.2019;14:34:04;81352366;81202253;150113;
19.01.2019;14:35:04;81352451;81202408;150043;
19.01.2019;14:36:04;81352551;81202583;149968;
19.01.2019;14:37:05;81352624;81202766;149858;
19.01.2019;14:38:05;81352702;81202910;149792;
19.01.2019;14:39:06;81352767;81203093;149674;
19.01.2019;14:40:11;81352843;81203260;149583;
19.01.2019;14:41:05;81352930;81203420;149510;
19.01.2019;14:42:05;81353002;81203586;149416;
19.01.2019;14:43:04;81353089;81203755;149334;
19.01.2019;14:44:04;81353171;81203898;149273;
19.01.2019;14:45:05;81353258;81204088;149170;
19.01.2019;14:46:05;81353329;81204238;149091;
19.01.2019;14:47:05;81353425;81204420;149005;
19.01.2019;14:48:04;81353517;81204571;148946;
19.01.2019;14:49:04;81353607;81204748;148859;
19.01.2019;14:50:05;81353706;81204915;148791;
19.01.2019;14:51:05;81353801;81205079;148722;
19.01.2019;14:52:04;81353896;81205239;148657;
19.01.2019;14:53:04;81353987;81205415;148572;
19.01.2019;14:54:05;81354071;81205599;148472;
19.01.2019;14:55:05;81354146;81205782;148364;
19.01.2019;14:56:04;81354238;81205955;148283;
19.01.2019;14:57:05;81354303;81206105;148198;
19.01.2019;14:58:05;81354392;81206264;148128;
19.01.2019;14:59:05;81354486;81206413;148073;
19.01.2019;15:00:07;81354571;81206594;147977;
19.01.2019;15:01:07;81354643;81206784;147859;
19.01.2019;15:02:08;81354732;81206936;147796;
19.01.2019;15:03:07;81354831;81207070;147761;
19.01.2019;15:04:07;81354897;81207222;147675;
19.01.2019;15:05:07;81355000;81207389;147611;
19.01.2019;15:06:07;81355081;81207557;147524;
19.01.2019;15:07:08;81355170;81207730;147440;
19.01.2019;15:08:07;81355259;81207882;147377;
19.01.2019;15:09:08;81355360;81208029;147331;
19.01.2019;15:10:07;81355436;81208209;147227;
19.01.2019;15:11:07;81355507;81208402;147105;
19.01.2019;15:12:07;81355579;81208578;147001;
19.01.2019;15:13:07;81355673;81208738;146935;
19.01.2019;15:14:08;81355779;81208915;146864;
19.01.2019;15:15:08;81355842;81209082;146760;
19.01.2019;15:16:07;81355930;81209255;146675;
19.01.2019;15:17:08;81356026;81209434;146592;
19.01.2019;15:18:07;81356104;81209626;146478;
19.01.2019;15:19:08;81356195;81209835;146360;
19.01.2019;15:20:07;81356268;81209994;146274;
19.01.2019;15:21:12;81356359;81210166;146193;
19.01.2019;15:22:07;81356426;81210331;146095;
19.01.2019;15:23:07;81356509;81210519;145990;
19.01.2019;15:24:07;81356615;81210685;145930;
19.01.2019;15:25:07;81356716;81210847;145869;
19.01.2019;15:26:07;81356782;81211034;145748;
19.01.2019;15:27:11;81356890;81211228;145662;
19.01.2019;15:28:13;81356993;81211397;145596;
19.01.2019;15:29:08;81357063;81211580;145483;
19.01.2019;15:30:09;81357161;81211745;145416;
19.01.2019;15:31:10;81357255;81211936;145319;
19.01.2019;15:32:09;81357341;81212088;145253;
19.01.2019;15:33:08;81357438;81212244;145194;
19.01.2019;15:34:08;81357510;81212436;145074;
19.01.2019;15:35:08;81357596;81212621;144975;
19.01.2019;15:36:09;81357702;81212799;144903;
19.01.2019;15:37:09;81357790;81212971;144819;
19.01.2019;15:38:10;81357875;81213119;144756;
19.01.2019;15:39:12;81357967;81213291;144676;
19.01.2019;15:40:08;81358056;81213461;144595;
19.01.2019;15:41:15;81358154;81213632;144522;
19.01.2019;15:42:08;81358237;81213795;144442;
19.01.2019;15:43:14;81358358;81213970;144388;
19.01.2019;15:44:09;81358443;81214113;144330;
19.01.2019;15:45:08;81358538;81214282;144256;
19.01.2019;15:46:08;81358639;81214462;144177;
19.01.2019;15:47:08;81358734;81214650;144084;
19.01.2019;15:48:07;81358842;81214835;144007;
19.01.2019;15:49:07;81358929;81214991;143938;
19.01.2019;15:51:14;81359121;81215378;143743;
19.01.2019;15:52:11;81359217;81215535;143682;
19.01.2019;15:53:10;81359303;81215738;143565;
19.01.2019;15:54:13;81359412;81215934;143478;
19.01.2019;15:55:08;81359506;81216105;143401;
19.01.2019;15:56:08;81359594;81216277;143317;
19.01.2019;15:57:07;81359680;81216461;143219;
19.01.2019;15:58:08;81359765;81216635;143130;
19.01.2019;15:59:07;81359865;81216816;143049;
19.01.2019;16:00:05;81359951;81216972;142979;
19.01.2019;16:01:05;81360043;81217186;142857;
19.01.2019;16:02:04;81360118;81217354;142764;
19.01.2019;16:03:04;81360213;81217526;142687;
19.01.2019;16:04:05;81360310;81217727;142583;
19.01.2019;16:05:05;81360395;81217902;142493;
19.01.2019;16:06:05;81360483;81218056;142427;
19.01.2019;16:07:04;81360567;81218227;142340;
19.01.2019;16:08:04;81360659;81218397;142262;
19.01.2019;16:09:07;81360758;81218556;142202;
19.01.2019;16:10:04;81360844;81218733;142111;
19.01.2019;16:11:04;81360941;81218890;142051;
19.01.2019;16:12:04;81361045;81219047;141998;
19.01.2019;16:13:05;81361152;81219205;141947;
19.01.2019;16:14:05;81361232;81219410;141822;
19.01.2019;16:15:04;81361335;81219581;141754;
19.01.2019;16:16:05;81361422;81219762;141660;
19.01.2019;16:17:05;81361521;81219911;141610;
19.01.2019;16:18:05;81361594;81220081;141513;
19.01.2019;16:19:04;81361695;81220252;141443;
19.01.2019;16:20:04;81361774;81220405;141369;
19.01.2019;16:21:14;81361862;81220595;141267;
19.01.2019;16:22:05;81361946;81220735;141211;
19.01.2019;16:23:05;81362020;81220958;141062;
19.01.2019;16:24:04;81362112;81221103;141009;
19.01.2019;16:25:04;81362189;81221266;140923;
19.01.2019;16:26:05;81362279;81221420;140859;
19.01.2019;16:27:05;81362385;81221620;140765;
19.01.2019;16:28:05;81362460;81221792;140668;
19.01.2019;16:29:04;81362542;81221944;140598;
19.01.2019;16:30:04;81362632;81222103;140529;
19.01.2019;16:31:04;81362719;81222288;140431;
19.01.2019;16:32:04;81362836;81222445;140391;
19.01.2019;16:33:05;81362940;81222619;140321;
19.01.2019;16:34:05;81363026;81222764;140262;
19.01.2019;16:35:04;81363104;81222921;140183;
19.01.2019;16:36:04;81363182;81223063;140119;
19.01.2019;16:37:05;81363273;81223217;140056;
19.01.2019;16:38:05;81363366;81223394;139972;
19.01.2019;16:39:07;81363450;81223570;139880;
19.01.2019;17:06:42;81366289;81228477;137812;
19.01.2019;17:07:06;81366328;81228539;137789;
19.01.2019;17:08:08;81366418;81228696;137722;
19.01.2019;17:09:10;81366530;81228872;137658;
19.01.2019;17:10:05;81366624;81229054;137570;
19.01.2019;17:11:05;81366738;81229233;137505;
19.01.2019;17:12:05;81366846;81229393;137453;
19.01.2019;17:13:05;81366925;81229548;137377;
19.01.2019;17:14:05;81367014;81229733;137281;
19.01.2019;17:15:05;81367108;81229883;137225;
19.01.2019;17:16:05;81367218;81230052;137166;
19.01.2019;17:17:05;81367318;81230209;137109;
19.01.2019;17:18:04;81367429;81230387;137042;
19.01.2019;17:19:04;81367549;81230564;136985;
19.01.2019;17:20:05;81367678;81230733;136945;
19.01.2019;17:22:14;81367896;81231133;136763;
19.01.2019;17:23:04;81367972;81231288;136684;
19.01.2019;17:24:05;81368084;81231492;136592;
19.01.2019;17:25:05;81368206;81231624;136582;
19.01.2019;17:26:05;81368288;81231805;136483;
19.01.2019;17:27:05;81368390;81232007;136383;
19.01.2019;17:28:05;81368504;81232182;136322;
19.01.2019;17:29:05;81368612;81232337;136275;
19.01.2019;17:30:04;81368729;81232485;136244;
19.01.2019;17:31:04;81368844;81232649;136195;
19.01.2019;17:32:05;81368960;81232809;136151;
19.01.2019;17:33:05;81369062;81232958;136104;
19.01.2019;17:34:05;81369151;81233137;136014;
19.01.2019;17:35:04;81369240;81233286;135954;
19.01.2019;17:36:04;81369335;81233457;135878;
19.01.2019;17:37:05;81369468;81233618;135850;
19.01.2019;17:38:04;81369565;81233796;135769;
19.01.2019;17:39:06;81369665;81233960;135705;
19.01.2019;17:40:05;81369785;81234125;135660;
19.01.2019;17:41:05;81369889;81234305;135584;
19.01.2019;17:42:05;81369980;81234467;135513;
19.01.2019;17:43:04;81370094;81234644;135450;
19.01.2019;17:44:04;81370206;81234807;135399;
19.01.2019;17:45:05;81370293;81234992;135301;
19.01.2019;17:46:05;81370404;81235170;135234;
19.01.2019;17:47:05;81370531;81235355;135176;
19.01.2019;17:48:05;81370647;81235527;135120;
19.01.2019;17:49:05;81370763;81235701;135062;
19.01.2019;17:50:05;81370867;81235872;134995;
19.01.2019;17:51:05;81370983;81236010;134973;
19.01.2019;17:52:05;81371092;81236190;134902;
19.01.2019;17:53:05;81371209;81236366;134843;
19.01.2019;17:54:05;81371326;81236559;134767;
19.01.2019;17:55:04;81371434;81236744;134690;
19.01.2019;17:56:04;81371552;81236936;134616;
19.01.2019;17:57:05;81371635;81237107;134528;
19.01.2019;17:58:05;81371715;81237247;134468;
19.01.2019;17:59:05;81371830;81237409;134421;
19.01.2019;18:00:04;81371953;81237567;134386;
19.01.2019;18:01:05;81372038;81237726;134312;
19.01.2019;18:02:05;81372144;81237902;134242;
19.01.2019;18:03:05;81372272;81238047;134225;
19.01.2019;18:04:05;81372377;81238233;134144;
19.01.2019;18:05:05;81372469;81238378;134091;
19.01.2019;18:06:05;81372598;81238541;134057;
19.01.2019;18:07:05;81372708;81238721;133987;
19.01.2019;18:08:04;81372804;81238889;133915;
19.01.2019;18:09:04;81372917;81239059;133858;
19.01.2019;18:10:04;81373041;81239219;133822;
19.01.2019;18:11:05;81373159;81239399;133760;
19.01.2019;18:12:05;81373275;81239567;133708;
19.01.2019;18:13:05;81373386;81239734;133652;
19.01.2019;18:14:04;81373485;81239881;133604;
19.01.2019;18:15:04;81373592;81240029;133563;
19.01.2019;18:16:04;81373694;81240189;133505;
19.01.2019;18:17:04;81373790;81240336;133454;
19.01.2019;18:18:04;81373877;81240477;133400;
19.01.2019;18:19:05;81373981;81240596;133385;
19.01.2019;18:20:05;81374065;81240730;133335;
19.01.2019;18:21:05;81374163;81240887;133276;
19.01.2019;18:22:05;81374270;81241024;133246;
19.01.2019;18:23:04;81374349;81241163;133186;
19.01.2019;18:24:04;81374426;81241273;133153;
19.01.2019;18:25:04;81374518;81241394;133124;
19.01.2019;18:26:07;81374596;81241545;133051;
19.01.2019;18:27:04;81374690;81241663;133027;
19.01.2019;18:28:05;81374786;81241822;132964;
19.01.2019;18:29:05;81374908;81241967;132941;
19.01.2019;18:30:14;81375016;81242095;132921;
19.01.2019;18:31:05;81375103;81242224;132879;
19.01.2019;18:32:04;81375195;81242364;132831;
19.01.2019;18:33:04;81375274;81242502;132772;
19.01.2019;18:34:05;81375377;81242642;132735;
19.01.2019;18:35:08;81375474;81242792;132682;
19.01.2019;18:36:05;81375559;81242925;132634;
19.01.2019;18:37:05;81375650;81243042;132608;
19.01.2019;18:38:04;81375759;81243159;132600;
19.01.2019;18:39:06;81375875;81243286;132589;
19.01.2019;18:40:05;81375989;81243423;132566;
19.01.2019;18:41:05;81376090;81243571;132519;
19.01.2019;18:42:05;81376189;81243729;132460;
19.01.2019;18:43:05;81376279;81243870;132409;
19.01.2019;18:44:07;81376403;81244004;132399;
19.01.2019;18:45:04;81376527;81244136;132391;
19.01.2019;18:46:04;81376624;81244254;132370;
19.01.2019;18:47:05;81376645;81244328;132317;
19.01.2019;18:48:05;81376745;81244460;132285;
19.01.2019;18:49:05;81376859;81244591;132268;
19.01.2019;18:50:05;81376965;81244718;132247;
19.01.2019;18:51:04;81377085;81244843;132242;
19.01.2019;18:52:04;81377187;81244975;132212;
19.01.2019;18:53:07;81377311;81245128;132183;
19.01.2019;18:54:05;81377434;81245244;132190;
19.01.2019;18:55:05;81377549;81245373;132176;
19.01.2019;18:56:05;81377652;81245494;132158;
19.01.2019;18:57:05;81377751;81245625;132126;
19.01.2019;18:58:05;81377862;81245760;132102;
19.01.2019;18:59:04;81377969;81245891;132078;
19.01.2019;19:00:04;81378068;81246024;132044;
19.01.2019;19:01:04;81378169;81246126;132043;
19.01.2019;19:02:06;81378289;81246267;132022;
19.01.2019;19:03:05;81378407;81246419;131988;
19.01.2019;19:04:04;81378518;81246567;131951;
19.01.2019;19:05:05;81378630;81246679;131951;
19.01.2019;19:06:04;81378719;81246791;131928;
19.01.2019;19:07:04;81378811;81246899;131912;
19.01.2019;19:08:04;81378939;81247026;131913;
19.01.2019;19:09:05;81379082;81247148;131934;
19.01.2019;19:10:05;81379206;81247274;131932;
19.01.2019;19:11:04;81379328;81247397;131931;
19.01.2019;19:12:08;81379470;81247548;131922;
19.01.2019;19:13:05;81379591;81247683;131908;
19.01.2019;19:14:05;81379711;81247787;131924;
19.01.2019;19:15:04;81379836;81247900;131936;
19.01.2019;19:16:06;81379957;81248000;131957;
19.01.2019;19:17:05;81380040;81248143;131897;
19.01.2019;19:18:05;81380137;81248226;131911;
19.01.2019;19:19:05;81380276;81248363;131913;
19.01.2019;19:20:05;81380381;81248494;131887;
19.01.2019;19:21:08;81380506;81248599;131907;
19.01.2019;19:22:04;81380645;81248688;131957;
19.01.2019;19:23:05;81380786;81248780;132006;
19.01.2019;19:24:05;81380904;81248890;132014;
19.01.2019;19:25:05;81381034;81248991;132043;
19.01.2019;19:26:05;81381166;81249103;132063;
19.01.2019;19:27:05;81381299;81249198;132101;
19.01.2019;19:28:05;81381435;81249315;132120;
19.01.2019;19:29:05;81381560;81249417;132143;
19.01.2019;19:30:07;81381695;81249533;132162;
19.01.2019;19:31:04;81381818;81249636;132182;
19.01.2019;19:32:05;81381915;81249740;132175;
19.01.2019;19:33:04;81382072;81249834;132238;
19.01.2019;19:34:04;81382190;81249941;132249;
19.01.2019;19:35:05;81382293;81250044;132249;
19.01.2019;19:36:04;81382403;81250138;132265;
19.01.2019;19:37:04;81382528;81250236;132292;
19.01.2019;19:38:05;81382640;81250348;132292;
19.01.2019;19:39:08;81382756;81250458;132298;
19.01.2019;19:40:10;81382886;81250562;132324;
19.01.2019;19:41:05;81383033;81250642;132391;
19.01.2019;19:42:05;81383024;81250732;132292;
19.01.2019;19:43:12;81383105;81250832;132273;
19.01.2019;19:44:05;81383179;81250916;132263;
19.01.2019;19:45:05;81383264;81251006;132258;
19.01.2019;19:46:05;81383364;81251096;132268;
19.01.2019;19:47:05;81383436;81251199;132237;
19.01.2019;19:48:05;81383532;81251283;132249;
19.01.2019;19:49:07;81383622;81251381;132241;
19.01.2019;19:50:10;81383717;81251473;132244;
19.01.2019;19:51:05;81383807;81251568;132239;
19.01.2019;19:53:06;81383980;81251761;132219;
19.01.2019;19:54:05;81384047;81251841;132206;
19.01.2019;19:55:05;81384153;81251929;132224;
19.01.2019;19:56:05;81384276;81252035;132241;
19.01.2019;19:57:07;81384376;81252124;132252;
19.01.2019;19:58:06;81384475;81252215;132260;
19.01.2019;19:59:11;81383326;81252333;130993;
19.01.2019;20:00:05;81383387;81257990;125397;
19.01.2019;20:01:05;81383502;81258079;125423;
19.01.2019;20:02:05;81383582;81258164;125418;
19.01.2019;20:03:04;81383685;81258257;125428;
19.01.2019;20:04:05;81383780;81258344;125436;
19.01.2019;20:05:04;81383874;81258426;125448;
19.01.2019;20:06:05;81383969;81258502;125467;
19.01.2019;20:07:07;81384059;81258592;125467;
19.01.2019;20:08:06;81384143;81258684;125459;
19.01.2019;20:09:05;81384248;81258754;125494;
19.01.2019;20:10:05;81384327;81258826;125501;
19.01.2019;20:11:05;81384414;81258935;125479;
19.01.2019;20:12:05;81384522;81259005;125517;
19.01.2019;20:13:12;81384621;81259096;125525;
19.01.2019;20:14:05;81384745;81259184;125561;
19.01.2019;20:15:05;81384824;81259250;125574;
19.01.2019;20:16:08;81384921;81259331;125590;
19.01.2019;20:17:05;81385010;81259399;125611;
19.01.2019;20:18:04;81385099;81259469;125630;
19.01.2019;20:19:09;81385191;81259544;125647;
19.01.2019;20:20:05;81385279;81259605;125674;
19.01.2019;20:21:06;81385366;81259667;125699;
19.01.2019;20:22:05;81385445;81259720;125725;
19.01.2019;20:23:05;81385509;81259778;125731;
19.01.2019;20:24:05;81385597;81259847;125750;
19.01.2019;20:25:08;81385690;81259913;125777;
19.01.2019;20:26:06;81385789;81259972;125817;
19.01.2019;20:27:05;81385869;81260015;125854;
19.01.2019;20:28:06;81385979;81260083;125896;
19.01.2019;20:29:08;81386045;81260135;125910;
19.01.2019;20:30:05;81386158;81260198;125960;
19.01.2019;20:31:05;81386257;81260265;125992;
19.01.2019;20:32:05;81386343;81260351;125992;
19.01.2019;20:33:06;81386443;81260393;126050;
19.01.2019;20:34:14;81386545;81260440;126105;
19.01.2019;20:35:05;81386642;81260488;126154;
19.01.2019;20:36:07;81386720;81260539;126181;
19.01.2019;20:37:04;81386814;81260587;126227;
19.01.2019;20:38:05;81386906;81260650;126256;
19.01.2019;20:39:09;81387036;81260713;126323;
19.01.2019;20:40:05;81387154;81260764;126390;
19.01.2019;20:41:04;81387263;81260829;126434;
19.01.2019;20:42:07;81387360;81260907;126453;
19.01.2019;20:43:05;81387464;81260958;126506;
19.01.2019;20:44:05;81387552;81260992;126560;
19.01.2019;20:45:05;81387663;81261061;126602;
19.01.2019;20:46:05;81387766;81261122;126644;
19.01.2019;20:47:05;81387877;81261194;126683;
19.01.2019;20:48:06;81387971;81261257;126714;
19.01.2019;20:49:05;81388071;81261331;126740;
19.01.2019;20:50:05;81388194;81261389;126805;
19.01.2019;20:51:06;81388294;81261446;126848;
19.01.2019;20:52:05;81388405;81261507;126898;
19.01.2019;20:53:09;81388504;81261569;126935;
19.01.2019;20:54:06;81388591;81261616;126975;
19.01.2019;20:55:05;81388720;81261659;127061;
19.01.2019;20:56:06;81388823;81261731;127092;
19.01.2019;20:57:05;81388957;81261792;127165;
19.01.2019;20:58:04;81389059;81261855;127204;
19.01.2019;20:59:05;81389161;81261941;127220;
19.01.2019;21:00:05;81389252;81261992;127260;
19.01.2019;21:01:05;81389359;81262043;127316;
19.01.2019;21:02:07;81389481;81262107;127374;
19.01.2019;21:03:07;81389590;81262179;127411;
19.01.2019;21:04:05;81389683;81262232;127451;
19.01.2019;21:05:05;81389801;81262288;127513;
19.01.2019;21:06:05;81389902;81262347;127555;
19.01.2019;21:07:06;81390017;81262388;127629;
19.01.2019;21:08:04;81390138;81262440;127698;
19.01.2019;21:10:05;81390381;81262545;127836;
19.01.2019;21:11:04;81390482;81262602;127880;
19.01.2019;21:12:04;81390585;81262653;127932;
19.01.2019;21:13:05;81390683;81262726;127957;
19.01.2019;21:14:05;81390824;81262784;128040;
19.01.2019;21:15:05;81390958;81262856;128102;
19.01.2019;21:16:05;81391094;81262893;128201;
19.01.2019;21:17:05;81391196;81262955;128241;
19.01.2019;21:18:05;81391324;81263027;128297;
19.01.2019;21:19:05;81391417;81263091;128326;
19.01.2019;21:20:05;81391518;81263151;128367;
19.01.2019;21:21:05;81391628;81263206;128422;
19.01.2019;21:22:05;81391738;81263265;128473;
19.01.2019;21:23:05;81391850;81263314;128536;
19.01.2019;21:24:05;81391962;81263374;128588;
19.01.2019;21:25:06;81392106;81263417;128689;
19.01.2019;21:26:06;81392236;81263464;128772;
19.01.2019;21:27:05;81392351;81263512;128839;
19.01.2019;21:28:05;81392470;81263571;128899;
19.01.2019;21:29:07;81392582;81263625;128957;
19.01.2019;21:30:06;81392698;81263677;129021;
19.01.2019;21:31:05;81392845;81263722;129123;
19.01.2019;21:32:05;81392960;81263768;129192;
19.01.2019;21:33:05;81393080;81263818;129262;
19.01.2019;21:34:08;81393198;81263881;129317;
19.01.2019;21:35:05;81393303;81263915;129388;
19.01.2019;21:36:05;81393422;81263968;129454;
19.01.2019;21:37:05;81393539;81264023;129516;
19.01.2019;21:38:05;81393678;81264068;129610;
19.01.2019;21:39:08;81393798;81264133;129665;
19.01.2019;21:40:05;81393912;81264185;129727;
19.01.2019;21:41:05;81394046;81264216;129830;
19.01.2019;21:42:05;81394177;81264281;129896;
19.01.2019;21:43:08;81394302;81264337;129965;
19.01.2019;21:44:06;81394390;81264378;130012;
19.01.2019;21:45:04;81394507;81264421;130086;
19.01.2019;21:46:04;81394654;81264460;130194;
19.01.2019;21:47:04;81394769;81264498;130271;
19.01.2019;21:48:05;81394892;81264543;130349;
19.01.2019;21:49:04;81395003;81264600;130403;
19.01.2019;21:50:05;81395131;81264647;130484;
19.01.2019;21:51:05;81395255;81264692;130563;
19.01.2019;21:52:08;81395383;81264729;130654;
19.01.2019;21:53:07;81395496;81264775;130721;
19.01.2019;21:54:05;81395507;81264771;130736;
19.01.2019;21:55:05;81395616;81264818;130798;
19.01.2019;21:56:05;81395738;81264846;130892;
19.01.2019;21:57:08;81395859;81264888;130971;
19.01.2019;21:58:04;81395982;81264927;131055;
19.01.2019;21:59:04;81396089;81264968;131121;
19.01.2019;22:00:05;81396203;81265022;131181;
19.01.2019;22:01:08;81396323;81265061;131262;
19.01.2019;22:02:05;81396432;81265114;131318;
19.01.2019;22:03:05;81396546;81265153;131393;
19.01.2019;22:04:06;81396662;81265201;131461;
19.01.2019;22:05:05;81396760;81265247;131513;
19.01.2019;22:06:05;81396841;81265282;131559;
19.01.2019;22:07:05;81396951;81265331;131620;
19.01.2019;22:08:04;81397044;81265364;131680;
19.01.2019;22:09:04;81397156;81265410;131746;
19.01.2019;22:10:07;81397258;81265455;131803;
19.01.2019;22:11:05;81397346;81265485;131861;
19.01.2019;22:12:07;81397445;81265524;131921;
19.01.2019;22:13:04;81397545;81265564;131981;
19.01.2019;22:14:10;81397649;81265603;132046;
19.01.2019;22:15:05;81397782;81265639;132143;
19.01.2019;22:16:05;81397897;81265674;132223;
19.01.2019;22:17:05;81397969;81265700;132269;
19.01.2019;22:18:07;81398072;81265732;132340;
19.01.2019;22:19:08;81398167;81265764;132403;
19.01.2019;22:20:11;81398261;81265798;132463;
19.01.2019;22:21:05;81398365;81265825;132540;
19.01.2019;22:22:06;81398461;81265857;132604;
19.01.2019;22:23:06;81398565;81265893;132672;
19.01.2019;22:24:04;81398652;81265918;132734;
19.01.2019;22:25:04;81398762;81265946;132816;
19.01.2019;22:26:04;81398868;81265960;132908;
19.01.2019;22:27:05;81398968;81265995;132973;
19.01.2019;22:28:08;81399042;81266017;133025;
19.01.2019;22:29:04;81399119;81266031;133088;
19.01.2019;22:30:04;81399233;81266071;133162;
19.01.2019;22:31:04;81399329;81266096;133233;
19.01.2019;22:32:05;81399441;81266127;133314;
19.01.2019;22:33:05;81399516;81266167;133349;
19.01.2019;22:34:05;81399603;81266198;133405;
19.01.2019;22:35:04;81399719;81266242;133477;
19.01.2019;22:36:05;81399820;81266284;133536;
19.01.2019;22:37:07;81399920;81266325;133595;
19.01.2019;22:38:07;81400030;81266360;133670;
19.01.2019;22:39:11;81400165;81266392;133773;
19.01.2019;22:40:04;81400263;81266413;133850;
19.01.2019;22:41:04;81400391;81266446;133945;
19.01.2019;22:42:05;81400496;81266476;134020;
19.01.2019;22:43:05;81400629;81266518;134111;
19.01.2019;22:44:11;81400739;81266539;134200;
19.01.2019;22:45:04;81400842;81266565;134277;
19.01.2019;22:46:13;81400947;81266589;134358;
19.01.2019;22:47:05;81401057;81266624;134433;
19.01.2019;22:48:04;81401168;81266667;134501;
19.01.2019;22:49:05;81401266;81266691;134575;
19.01.2019;22:50:04;81401370;81266729;134641;
19.01.2019;22:51:05;81401500;81266771;134729;
19.01.2019;22:52:05;81401624;81266806;134818;
19.01.2019;22:53:05;81401747;81266833;134914;
19.01.2019;22:54:04;81401861;81266860;135001;
19.01.2019;22:55:07;81401978;81266897;135081;
19.01.2019;22:56:11;81402110;81266942;135168;
19.01.2019;22:57:04;81402189;81266974;135215;
19.01.2019;22:58:04;81402297;81267014;135283;
19.01.2019;22:59:04;81402404;81267042;135362;
19.01.2019;23:00:05;81402511;81267078;135433;
19.01.2019;23:01:04;81402615;81267108;135507;
19.01.2019;23:02:04;81402710;81267139;135571;
19.01.2019;23:03:06;81402828;81267164;135664;
19.01.2019;23:04:06;81402938;81267195;135743;
19.01.2019;23:05:05;81403028;81267226;135802;
19.01.2019;23:06:05;81403120;81267254;135866;
19.01.2019;23:07:05;81403222;81267292;135930;
19.01.2019;23:08:04;81403330;81267327;136003;
19.01.2019;23:09:06;81403439;81267359;136080;
19.01.2019;23:10:11;81403542;81267398;136144;
19.01.2019;23:11:06;81403635;81267429;136206;
19.01.2019;23:12:06;81403734;81267458;136276;
19.01.2019;23:13:05;81403856;81267483;136373;
19.01.2019;23:14:06;81403980;81267508;136472;
19.01.2019;23:15:05;81404084;81267542;136542;
19.01.2019;23:16:04;81404195;81267578;136617;
19.01.2019;23:17:06;81404287;81267603;136684;
19.01.2019;23:18:06;81404404;81267640;136764;
19.01.2019;23:19:04;81404506;81267666;136840;
19.01.2019;23:20:04;81404612;81267697;136915;
19.01.2019;23:21:10;81404710;81267738;136972;
19.01.2019;23:22:06;81404807;81267757;137050;
19.01.2019;23:23:07;81404902;81267795;137107;
19.01.2019;23:24:06;81405003;81267824;137179;
19.01.2019;23:25:10;81405084;81267864;137220;
19.01.2019;23:26:11;81405187;81267885;137302;
19.01.2019;23:27:04;81405277;81267917;137360;
19.01.2019;23:28:05;81405379;81267942;137437;
19.01.2019;23:29:06;81405526;81267964;137562;
19.01.2019;23:30:10;81405633;81267986;137647;
19.01.2019;23:31:04;81405745;81268012;137733;
19.01.2019;23:32:08;81405856;81268049;137807;
19.01.2019;23:33:05;81405945;81268080;137865;
19.01.2019;23:34:11;81406047;81268112;137935;
19.01.2019;23:35:09;81406150;81268133;138017;
19.01.2019;23:36:05;81406246;81268161;138085;
19.01.2019;23:37:04;81406338;81268181;138157;
19.01.2019;23:38:13;81406464;81268213;138251;
19.01.2019;23:39:06;81406544;81268244;138300;
19.01.2019;23:40:05;81406644;81268271;138373;
19.01.2019;23:41:07;81406737;81268305;138432;
19.01.2019;23:42:06;81406844;81268326;138518;
19.01.2019;23:43:05;81406960;81268358;138602;
19.01.2019;23:44:09;81407080;81268400;138680;
19.01.2019;23:45:12;81407176;81268445;138731;
19.01.2019;23:46:05;81407273;81268477;138796;
19.01.2019;23:47:06;81407353;81268500;138853;
19.01.2019;23:48:05;81407453;81268527;138926;
19.01.2019;23:49:05;81407547;81268558;138989;
19.01.2019;23:50:05;81407651;81268589;139062;
19.01.2019;23:51:08;81407771;81268624;139147;
19.01.2019;23:52:05;81407849;81268649;139200;
19.01.2019;23:53:05;81407949;81268666;139283;
19.01.2019;23:54:04;81408058;81268688;139370;
19.01.2019;23:55:05;81408176;81268723;139453;
19.01.2019;23:56:06;81408288;81268754;139534;
19.01.2019;23:57:06;81408405;81268779;139626;
19.01.2019;23:58:06;81408515;81268816;139699;
19.01.2019;23:59:09;81408626;81268854;139772;
20.01.2019;00:00:07;81408738;81268883;139855;
20.01.2019;00:01:07;81408840;81268910;139930;
20.01.2019;00:02:07;81408914;81268946;139968;
20.01.2019;00:03:07;81408987;81268970;140017;
20.01.2019;00:04:08;81409066;81268994;140072;
20.01.2019;00:05:07;81409158;81269034;140124;
20.01.2019;00:06:08;81409255;81269062;140193;
20.01.2019;00:07:08;81409371;81269102;140269;
20.01.2019;00:08:09;81409474;81269130;140344;
20.01.2019;00:09:09;81409581;81269159;140422;
20.01.2019;00:10:07;81409673;81269188;140485;
20.01.2019;00:11:07;81409799;81269215;140584;
20.01.2019;00:12:07;81409881;81269238;140643;
20.01.2019;00:13:07;81409972;81269256;140716;
20.01.2019;00:14:08;81410061;81269287;140774;
20.01.2019;00:15:07;81410140;81269324;140816;
20.01.2019;00:16:07;81410226;81269346;140880;
20.01.2019;00:17:08;81410301;81269378;140923;
20.01.2019;00:18:07;81410384;81269410;140974;
20.01.2019;00:19:08;81410476;81269446;141030;
20.01.2019;00:20:07;81410574;81269471;141103;
20.01.2019;00:21:07;81410640;81269495;141145;
20.01.2019;00:22:07;81410694;81269509;141185;
20.01.2019;00:23:07;81410769;81269532;141237;
20.01.2019;00:24:08;81410868;81269560;141308;
20.01.2019;00:25:08;81410941;81269570;141371;
20.01.2019;00:26:07;81411004;81269590;141414;
20.01.2019;00:27:08;81411101;81269628;141473;
20.01.2019;00:28:07;81411177;81269640;141537;
20.01.2019;00:29:07;81411231;81269653;141578;
20.01.2019;00:30:08;81411306;81269680;141626;
20.01.2019;00:31:08;81411397;81269707;141690;
20.01.2019;00:32:07;81411466;81269716;141750;
20.01.2019;00:33:07;81411550;81269742;141808;
20.01.2019;00:34:08;81411616;81269780;141836;
20.01.2019;00:35:07;81411685;81269805;141880;
20.01.2019;00:36:08;81411780;81269837;141943;
20.01.2019;00:37:07;81411890;81269862;142028;
20.01.2019;00:38:07;81411982;81269880;142102;
20.01.2019;00:39:08;81412059;81269902;142157;
20.01.2019;00:40:07;81412146;81269936;142210;
20.01.2019;00:41:07;81412265;81269983;142282;
20.01.2019;00:42:08;81412353;81270005;142348;
20.01.2019;00:43:08;81412445;81270043;142402;
20.01.2019;00:44:08;81412550;81270080;142470;
20.01.2019;00:45:07;81412652;81270097;142555;
20.01.2019;00:46:08;81412787;81270121;142666;
20.01.2019;00:47:08;81412886;81270141;142745;
20.01.2019;00:48:08;81412973;81270162;142811;
20.01.2019;00:49:08;81413058;81270198;142860;
20.01.2019;00:50:12;81413181;81270216;142965;
20.01.2019;00:51:08;81413247;81270215;143032;
20.01.2019;00:52:08;81413337;81270254;143083;
20.01.2019;00:53:07;81413395;81270258;143137;
20.01.2019;00:54:07;81413490;81270280;143210;
20.01.2019;00:55:07;81413577;81270313;143264;
20.01.2019;00:56:08;81413653;81270342;143311;
20.01.2019;00:57:08;81413738;81270360;143378;
20.01.2019;00:58:08;81413847;81270398;143449;
20.01.2019;00:59:07;81413934;81270426;143508;
20.01.2019;01:00:06;81414026;81270449;143577;
20.01.2019;01:01:04;81414106;81270491;143615;
20.01.2019;01:02:05;81414230;81270525;143705;
20.01.2019;01:03:06;81414304;81270555;143749;
20.01.2019;01:04:04;81414382;81270585;143797;
20.01.2019;01:05:08;81414473;81270610;143863;
20.01.2019;01:06:05;81414554;81270646;143908;
20.01.2019;01:07:10;81414682;81270678;144004;
20.01.2019;01:08:12;81414761;81270702;144059;
20.01.2019;01:09:13;81414845;81270718;144127;
20.01.2019;01:10:06;81414928;81270751;144177;
20.01.2019;01:11:07;81415019;81270786;144233;
20.01.2019;01:12:11;81415137;81270818;144319;
20.01.2019;01:13:06;81415229;81270849;144380;
20.01.2019;01:14:05;81415336;81270874;144462;
20.01.2019;01:15:05;81415431;81270915;144516;
20.01.2019;01:16:05;81415531;81270945;144586;
20.01.2019;01:17:05;81415624;81270966;144658;
20.01.2019;01:18:04;81415700;81271001;144699;
20.01.2019;01:19:04;81415798;81271046;144752;
20.01.2019;01:20:05;81415922;81271080;144842;
20.01.2019;01:21:05;81416005;81271103;144902;
20.01.2019;01:22:05;81416090;81271127;144963;
20.01.2019;01:23:04;81416184;81271171;145013;
20.01.2019;01:24:04;81416260;81271194;145066;
20.01.2019;01:25:05;81416357;81271227;145130;
20.01.2019;01:26:04;81416428;81271246;145182;
20.01.2019;01:27:04;81416515;81271278;145237;
20.01.2019;01:28:05;81416609;81271310;145299;
20.01.2019;01:29:05;81416692;81271351;145341;
20.01.2019;01:30:05;81416768;81271392;145376;
20.01.2019;01:31:05;81416852;81271432;145420;
20.01.2019;01:32:04;81416952;81271465;145487;
20.01.2019;01:33:05;81417040;81271517;145523;
20.01.2019;01:34:05;81417142;81271574;145568;
20.01.2019;01:35:04;81417236;81271602;145634;
20.01.2019;01:36:05;81417335;81271631;145704;
20.01.2019;01:37:05;81417425;81271671;145754;
20.01.2019;01:38:04;81417517;81271709;145808;
20.01.2019;01:39:06;81417598;81271752;145846;
20.01.2019;01:40:05;81417705;81271794;145911;
20.01.2019;01:41:06;81417800;81271845;145955;
20.01.2019;01:42:04;81417883;81271884;145999;
20.01.2019;01:43:04;81417998;81271929;146069;
20.01.2019;01:44:04;81418094;81271966;146128;
20.01.2019;01:45:04;81418208;81272020;146188;
20.01.2019;01:46:05;81418310;81272075;146235;
20.01.2019;01:47:04;81418421;81272114;146307;
20.01.2019;01:48:05;81418542;81272152;146390;
20.01.2019;01:49:04;81418657;81272197;146460;
20.01.2019;01:50:04;81418770;81272244;146526;
20.01.2019;01:51:05;81418868;81272294;146574;
20.01.2019;01:52:05;81418972;81272339;146633;
20.01.2019;01:53:05;81419071;81272395;146676;
20.01.2019;01:54:05;81419175;81272444;146731;
20.01.2019;01:55:04;81419265;81272490;146775;
20.01.2019;01:56:04;81419359;81272546;146813;
20.01.2019;01:57:05;81419459;81272598;146861;
20.01.2019;01:58:04;81419550;81272649;146901;
20.01.2019;01:59:05;81419645;81272684;146961;
20.01.2019;02:00:04;81419737;81272732;147005;
20.01.2019;02:01:04;81419826;81272778;147048;
20.01.2019;02:02:05;81419916;81272835;147081;
20.01.2019;02:03:04;81420002;81272898;147104;
20.01.2019;02:04:04;81420086;81272953;147133;
20.01.2019;02:05:05;81420163;81273001;147162;
20.01.2019;02:06:05;81420262;81273064;147198;
20.01.2019;02:07:04;81420336;81273130;147206;
20.01.2019;02:08:04;81420412;81273172;147240;
20.01.2019;02:09:05;81420528;81273238;147290;
20.01.2019;02:10:04;81420621;81273299;147322;
20.01.2019;02:11:04;81420721;81273356;147365;
20.01.2019;02:12:05;81420816;81273428;147388;
20.01.2019;02:13:04;81420910;81273481;147429;
20.01.2019;02:14:04;81420995;81273515;147480;
20.01.2019;02:15:05;81421052;81273574;147478;
20.01.2019;02:16:04;81421131;81273635;147496;
20.01.2019;02:17:05;81421201;81273685;147516;
20.01.2019;02:18:04;81421302;81273730;147572;
20.01.2019;02:19:05;81421372;81273806;147566;
20.01.2019;02:20:05;81421470;81273856;147614;
20.01.2019;02:21:04;81421577;81273913;147664;
20.01.2019;02:22:05;81421666;81273975;147691;
20.01.2019;02:23:04;81421737;81274026;147711;
20.01.2019;02:24:04;81421804;81274077;147727;
20.01.2019;02:25:05;81421873;81274144;147729;
20.01.2019;02:26:04;81421935;81274221;147714;
20.01.2019;02:27:04;81422022;81274271;147751;
20.01.2019;02:28:05;81422114;81274322;147792;
20.01.2019;02:29:05;81422185;81274389;147796;
20.01.2019;02:30:04;81422244;81274448;147796;
20.01.2019;02:31:04;81422319;81274508;147811;
20.01.2019;02:32:05;81422402;81274574;147828;
20.01.2019;02:33:04;81422490;81274654;147836;
20.01.2019;02:34:05;81422563;81274703;147860;
20.01.2019;02:35:05;81422653;81274770;147883;
20.01.2019;02:36:04;81422760;81274841;147919;
20.01.2019;02:37:04;81422838;81274918;147920;
20.01.2019;02:38:05;81422925;81274981;147944;
20.01.2019;02:39:06;81422990;81275052;147938;
20.01.2019;02:40:05;81423077;81275120;147957;
20.01.2019;02:41:04;81423162;81275187;147975;
20.01.2019;02:42:20;81423268;81275281;147987;
20.01.2019;02:43:04;81423330;81275330;148000;
20.01.2019;02:44:05;81423418;81275410;148008;
20.01.2019;02:45:04;81423509;81275490;148019;
20.01.2019;02:46:05;81423608;81275561;148047;
20.01.2019;02:47:05;81423719;81275647;148072;
20.01.2019;02:48:04;81423805;81275720;148085;
20.01.2019;02:49:05;81423893;81275806;148087;
20.01.2019;02:50:04;81423996;81275887;148109;
20.01.2019;02:51:04;81424099;81275989;148110;
20.01.2019;02:52:05;81424185;81276087;148098;
20.01.2019;02:53:04;81424280;81276173;148107;
20.01.2019;02:54:04;81424385;81276249;148136;
20.01.2019;02:55:05;81424475;81276332;148143;
20.01.2019;02:56:04;81424556;81276432;148124;
20.01.2019;02:57:04;81424673;81276533;148140;
20.01.2019;02:58:05;81424766;81276645;148121;
20.01.2019;02:59:05;81424896;81276734;148162;
20.01.2019;03:00:04;81424982;81276823;148159;
20.01.2019;03:01:05;81425063;81276912;148151;
20.01.2019;03:02:05;81425157;81277013;148144;
20.01.2019;03:03:04;81425251;81277103;148148;
20.01.2019;03:04:05;81425328;81277195;148133;
20.01.2019;03:05:05;81425426;81277278;148148;
20.01.2019;03:06:05;81425527;81277381;148146;
20.01.2019;03:07:04;81425610;81277479;148131;
20.01.2019;03:08:05;81425700;81277582;148118;
20.01.2019;03:09:06;81425784;81277688;148096;
20.01.2019;03:10:04;81425899;81277784;148115;
20.01.2019;03:11:05;81426013;81277870;148143;
20.01.2019;03:12:04;81426103;81277979;148124;
20.01.2019;03:13:05;81426204;81278075;148129;
20.01.2019;03:14:05;81426296;81278192;148104;
20.01.2019;03:15:04;81426392;81278292;148100;
20.01.2019;03:16:05;81426511;81278398;148113;
20.01.2019;03:17:05;81426600;81278507;148093;
20.01.2019;03:18:05;81426678;81278638;148040;
20.01.2019;03:19:04;81426777;81278744;148033;
20.01.2019;03:20:04;81426891;81278856;148035;
20.01.2019;03:21:05;81426975;81278970;148005;
20.01.2019;03:22:04;81427069;81279062;148007;
20.01.2019;03:23:04;81427176;81279186;147990;
20.01.2019;03:24:05;81427284;81279309;147975;
20.01.2019;03:25:05;81427384;81279416;147968;
20.01.2019;03:26:05;81427463;81279548;147915;
20.01.2019;03:27:05;81427551;81279693;147858;
20.01.2019;03:28:04;81427631;81279799;147832;
20.01.2019;03:29:04;81427717;81279917;147800;
20.01.2019;03:30:04;81427811;81280022;147789;
20.01.2019;03:31:05;81427905;81280128;147777;
20.01.2019;03:32:05;81428000;81280261;147739;
20.01.2019;03:33:04;81428102;81280374;147728;
20.01.2019;03:34:04;81428183;81280486;147697;
20.01.2019;03:35:05;81428263;81280595;147668;
20.01.2019;03:36:04;81428337;81280700;147637;
20.01.2019;03:37:04;81428450;81280823;147627;
20.01.2019;03:38:05;81428548;81280946;147602;
20.01.2019;03:39:06;81428648;81281052;147596;
20.01.2019;03:40:04;81428726;81281167;147559;
20.01.2019;03:41:05;81428821;81281274;147547;
20.01.2019;03:42:04;81428886;81281396;147490;
20.01.2019;03:43:05;81428993;81281511;147482;
20.01.2019;03:44:04;81429089;81281626;147463;
20.01.2019;03:45:04;81429194;81281744;147450;
20.01.2019;03:46:05;81429274;81281858;147416;
20.01.2019;03:47:05;81429360;81281982;147378;
20.01.2019;03:48:04;81429448;81282113;147335;
20.01.2019;03:49:05;81429529;81282229;147300;
20.01.2019;03:50:05;81429655;81282348;147307;
20.01.2019;03:51:04;81429749;81282458;147291;
20.01.2019;03:52:04;81429846;81282564;147282;
20.01.2019;03:53:05;81429964;81282712;147252;
20.01.2019;03:54:04;81430034;81282841;147193;
20.01.2019;03:55:05;81430116;81282945;147171;
20.01.2019;03:56:05;81430198;81283071;147127;
20.01.2019;03:57:04;81430292;81283201;147091;
20.01.2019;03:58:04;81430384;81283343;147041;
20.01.2019;03:59:05;81430461;81283475;146986;
20.01.2019;04:00:04;81430568;81283615;146953;
20.01.2019;04:01:04;81430663;81283762;146901;
20.01.2019;04:02:05;81430754;81283916;146838;
20.01.2019;04:03:04;81430861;81284057;146804;
20.01.2019;04:04:04;81430948;81284208;146740;
20.01.2019;04:05:05;81431038;81284351;146687;
20.01.2019;04:06:04;81431129;81284499;146630;
20.01.2019;04:07:05;81431202;81284619;146583;
20.01.2019;04:08:04;81431283;81284753;146530;
20.01.2019;04:09:04;81431383;81284877;146506;
20.01.2019;04:10:05;81431473;81285036;146437;
20.01.2019;04:11:05;81431570;81285148;146422;
20.01.2019;04:12:05;81431665;81285292;146373;
20.01.2019;04:13:05;81431734;81285437;146297;
20.01.2019;04:14:05;81431772;81285586;146186;
20.01.2019;04:15:04;81431855;81285727;146128;
20.01.2019;04:16:05;81431908;81285861;146047;
20.01.2019;04:17:05;81431985;81285984;146001;
20.01.2019;04:18:04;81432082;81286123;145959;
20.01.2019;04:19:04;81432143;81286251;145892;
20.01.2019;04:20:05;81432199;81286377;145822;
20.01.2019;04:21:04;81432258;81286507;145751;
20.01.2019;04:22:04;81432320;81286652;145668;
20.01.2019;04:23:05;81432397;81286781;145616;
20.01.2019;04:24:04;81432443;81286941;145502;
20.01.2019;04:25:04;81432501;81287077;145424;
20.01.2019;04:26:05;81432537;81287216;145321;
20.01.2019;04:27:04;81432619;81287338;145281;
20.01.2019;04:28:04;81432704;81287468;145236;
20.01.2019;04:29:05;81432772;81287614;145158;
20.01.2019;04:30:05;81432848;81287762;145086;
20.01.2019;04:31:04;81432927;81287886;145041;
20.01.2019;04:32:04;81433007;81288016;144991;
20.01.2019;04:33:05;81433088;81288150;144938;
20.01.2019;04:34:05;81433165;81288276;144889;
20.01.2019;04:35:04;81433264;81288409;144855;
20.01.2019;04:36:04;81433349;81288542;144807;
20.01.2019;04:37:05;81433448;81288674;144774;
20.01.2019;04:38:04;81433534;81288844;144690;
20.01.2019;04:39:04;81433640;81288986;144654;
20.01.2019;04:40:05;81433736;81289132;144604;
20.01.2019;04:41:04;81433815;81289289;144526;
20.01.2019;04:42:04;81433922;81289443;144479;
20.01.2019;04:43:05;81434035;81289578;144457;
20.01.2019;04:44:04;81434125;81289737;144388;
20.01.2019;04:45:04;81434222;81289865;144357;
20.01.2019;04:46:05;81434330;81290011;144319;
20.01.2019;04:47:04;81434433;81290163;144270;
20.01.2019;04:48:04;81434515;81290306;144209;
20.01.2019;04:49:05;81434604;81290480;144124;
20.01.2019;04:50:04;81434682;81290644;144038;
20.01.2019;04:51:04;81434768;81290778;143990;
20.01.2019;04:52:05;81434870;81290891;143979;
20.01.2019;04:53:04;81434962;81291027;143935;
20.01.2019;04:54:04;81435055;81291183;143872;
20.01.2019;04:55:05;81435155;81291346;143809;
20.01.2019;04:56:04;81435249;81291469;143780;
20.01.2019;04:57:05;81435367;81291602;143765;
20.01.2019;04:58:04;81435463;81291761;143702;
20.01.2019;04:59:04;81435556;81291898;143658;
20.01.2019;05:00:05;81435653;81292029;143624;
20.01.2019;05:01:04;81435728;81292172;143556;
20.01.2019;05:02:04;81435803;81292325;143478;
20.01.2019;05:03:05;81435914;81292491;143423;
20.01.2019;05:04:04;81435994;81292658;143336;
20.01.2019;05:05:04;81436085;81292805;143280;
20.01.2019;05:06:05;81436179;81292978;143201;
20.01.2019;05:07:04;81436289;81293146;143143;
20.01.2019;05:08:04;81436356;81293293;143063;
20.01.2019;05:09:05;81436452;81293459;142993;
20.01.2019;05:10:05;81436546;81293608;142938;
20.01.2019;05:11:04;81436663;81293741;142922;
20.01.2019;05:12:05;81436759;81293905;142854;
20.01.2019;05:13:05;81436842;81294052;142790;
20.01.2019;05:14:04;81436934;81294187;142747;
20.01.2019;05:15:04;81437029;81294336;142693;
20.01.2019;05:16:05;81437127;81294483;142644;
20.01.2019;05:17:05;81437219;81294640;142579;
20.01.2019;05:18:04;81437298;81294766;142532;
20.01.2019;05:19:05;81437395;81294905;142490;
20.01.2019;05:20:04;81437502;81295088;142414;
20.01.2019;05:21:04;81437587;81295263;142324;
20.01.2019;05:22:05;81437670;81295405;142265;
20.01.2019;05:23:05;81437761;81295555;142206;
20.01.2019;05:24:05;81437854;81295695;142159;
20.01.2019;05:25:04;81437938;81295867;142071;
20.01.2019;05:26:04;81438012;81296035;141977;
20.01.2019;05:27:04;81438088;81296176;141912;
20.01.2019;05:28:04;81438176;81296329;141847;
20.01.2019;05:29:04;81438267;81296478;141789;
20.01.2019;05:30:05;81438359;81296631;141728;
20.01.2019;05:31:04;81438465;81296788;141677;
20.01.2019;05:32:05;81438562;81296929;141633;
20.01.2019;05:33:04;81438659;81297098;141561;
20.01.2019;05:34:04;81438745;81297251;141494;
20.01.2019;05:35:05;81438860;81297418;141442;
20.01.2019;05:36:04;81438931;81297593;141338;
20.01.2019;05:37:05;81439034;81297741;141293;
20.01.2019;05:38:05;81439114;81297885;141229;
20.01.2019;05:39:04;81439206;81298044;141162;
20.01.2019;05:40:04;81439303;81298190;141113;
20.01.2019;05:41:05;81439422;81298346;141076;
20.01.2019;05:42:05;81439497;81298505;140992;
20.01.2019;05:43:04;81439579;81298656;140923;
20.01.2019;05:44:05;81439670;81298851;140819;
20.01.2019;05:45:04;81439762;81299017;140745;
20.01.2019;05:46:05;81439857;81299170;140687;
20.01.2019;05:47:05;81439933;81299330;140603;
20.01.2019;05:48:04;81440026;81299495;140531;
20.01.2019;05:49:04;81440109;81299665;140444;
20.01.2019;05:50:05;81440171;81299827;140344;
20.01.2019;05:51:04;81440266;81299975;140291;
20.01.2019;05:52:05;81440358;81300145;140213;
20.01.2019;05:53:05;81440440;81300310;140130;
20.01.2019;05:54:05;81440546;81300465;140081;
20.01.2019;05:55:04;81440644;81300619;140025;
20.01.2019;05:56:04;81440737;81300776;139961;
20.01.2019;05:57:05;81440845;81300918;139927;
20.01.2019;05:58:05;81440941;81301103;139838;
20.01.2019;05:59:05;81441037;81301274;139763;
20.01.2019;06:00:04;81441141;81301436;139705;
20.01.2019;06:01:04;81441232;81301605;139627;
20.01.2019;06:02:05;81441314;81301761;139553;
20.01.2019;06:03:04;81441421;81301921;139500;
20.01.2019;06:04:04;81441498;81302102;139396;
20.01.2019;06:05:05;81441588;81302288;139300;
20.01.2019;06:06:04;81441668;81302449;139219;
20.01.2019;06:07:04;81441743;81302606;139137;
20.01.2019;06:08:05;81441833;81302796;139037;
20.01.2019;06:09:04;81441917;81302963;138954;
20.01.2019;06:10:04;81442023;81303116;138907;
20.01.2019;06:11:05;81442118;81303275;138843;
20.01.2019;06:12:04;81442189;81303415;138774;
20.01.2019;06:13:04;81442261;81303557;138704;
20.01.2019;06:14:05;81442320;81303726;138594;
20.01.2019;06:15:05;81442360;81303890;138470;
20.01.2019;06:16:05;81442429;81304053;138376;
20.01.2019;06:17:05;81442504;81304223;138281;
20.01.2019;06:18:05;81442554;81304382;138172;
20.01.2019;06:19:04;81442649;81304552;138097;
20.01.2019;06:20:04;81442723;81304719;138004;
20.01.2019;06:21:05;81442810;81304903;137907;
20.01.2019;06:22:04;81442909;81305073;137836;
20.01.2019;06:23:04;81443022;81305236;137786;
20.01.2019;06:24:05;81443084;81305419;137665;
20.01.2019;06:25:07;81443153;81305588;137565;
20.01.2019;06:26:05;81443240;81305747;137493;
20.01.2019;06:27:04;81443326;81305921;137405;
20.01.2019;06:28:04;81443405;81306089;137316;
20.01.2019;06:29:05;81443461;81306269;137192;
20.01.2019;06:30:04;81443549;81306444;137105;
20.01.2019;06:31:05;81443600;81306619;136981;
20.01.2019;06:32:04;81443665;81306799;136866;
20.01.2019;06:33:04;81443732;81306983;136749;
20.01.2019;06:34:05;81443817;81307146;136671;
20.01.2019;06:35:05;81443881;81307312;136569;
20.01.2019;06:36:05;81443959;81307476;136483;
20.01.2019;06:37:04;81444038;81307656;136382;
20.01.2019;06:38:04;81444142;81307834;136308;
20.01.2019;06:39:06;81444239;81308030;136209;
20.01.2019;06:40:04;81444328;81308173;136155;
20.01.2019;06:41:05;81444403;81308355;136048;
20.01.2019;06:42:04;81444486;81308511;135975;
20.01.2019;06:43:04;81444576;81308698;135878;
20.01.2019;06:44:05;81444651;81308871;135780;
20.01.2019;06:45:04;81444717;81309036;135681;
20.01.2019;06:46:04;81444798;81309211;135587;
20.01.2019;06:47:08;81444882;81309365;135517;
20.01.2019;06:48:04;81444983;81309515;135468;
20.01.2019;06:49:04;81445074;81309670;135404;
20.01.2019;06:50:05;81445174;81309853;135321;
20.01.2019;06:51:04;81445269;81310029;135240;
20.01.2019;06:52:04;81445350;81310206;135144;
20.01.2019;06:53:05;81445430;81310408;135022;
20.01.2019;06:54:04;81445432;81310561;134871;
20.01.2019;06:55:04;81445522;81310729;134793;
20.01.2019;06:56:05;81445604;81310895;134709;
20.01.2019;06:57:05;81445713;81311077;134636;
20.01.2019;06:58:04;81445810;81311236;134574;
20.01.2019;06:59:05;81445899;81311429;134470;
20.01.2019;07:00:05;81445982;81311584;134398;
20.01.2019;07:01:04;81446061;81311785;134276;
20.01.2019;07:02:04;81446148;81311966;134182;
20.01.2019;07:03:08;81446233;81312147;134086;
20.01.2019;07:04:04;81446311;81312341;133970;
20.01.2019;07:05:05;81446399;81312510;133889;
20.01.2019;07:06:04;81446485;81312709;133776;
20.01.2019;07:07:04;81446575;81312890;133685;
20.01.2019;07:08:05;81446658;81313073;133585;
20.01.2019;07:09:04;81446748;81313210;133538;
20.01.2019;07:10:04;81446821;81313404;133417;
20.01.2019;07:11:05;81446921;81313617;133304;
20.01.2019;07:12:04;81447017;81313790;133227;
20.01.2019;07:13:04;81447114;81313960;133154;
20.01.2019;07:14:05;81447210;81314172;133038;
20.01.2019;07:15:05;81447311;81314363;132948;
20.01.2019;07:16:05;81447395;81314538;132857;
20.01.2019;07:17:05;81447492;81314717;132775;
20.01.2019;07:18:04;81447556;81314904;132652;
20.01.2019;07:19:04;81447628;81315093;132535;
20.01.2019;07:20:05;81447715;81315295;132420;
20.01.2019;07:21:04;81447799;81315489;132310;
20.01.2019;07:22:04;81447863;81315697;132166;
20.01.2019;07:23:05;81447947;81315858;132089;
20.01.2019;07:24:05;81448033;81316070;131963;
20.01.2019;07:25:04;81448130;81316271;131859;
20.01.2019;07:26:05;81448213;81316459;131754;
20.01.2019;07:27:04;81448294;81316635;131659;
20.01.2019;07:28:04;81448383;81316816;131567;
20.01.2019;07:29:05;81448473;81316992;131481;
20.01.2019;07:30:05;81448560;81317147;131413;
20.01.2019;07:31:05;81448629;81317338;131291;
20.01.2019;07:32:05;81448700;81317512;131188;
20.01.2019;07:33:05;81448796;81317677;131119;
20.01.2019;07:34:05;81448866;81317868;130998;
20.01.2019;07:35:04;81448942;81318018;130924;
20.01.2019;07:36:04;81449034;81318188;130846;
20.01.2019;07:37:05;81449114;81318382;130732;
20.01.2019;07:38:04;81449183;81318583;130600;
20.01.2019;07:39:04;81449281;81318758;130523;
20.01.2019;07:40:05;81449363;81318925;130438;
20.01.2019;07:41:05;81449451;81319098;130353;
20.01.2019;07:42:04;81449532;81319266;130266;
20.01.2019;07:43:05;81449622;81319439;130183;
20.01.2019;07:44:04;81449698;81319619;130079;
20.01.2019;07:45:04;81449775;81319796;129979;
20.01.2019;07:46:05;81449853;81319967;129886;
20.01.2019;07:47:04;81449943;81320139;129804;
20.01.2019;07:48:04;81450025;81320299;129726;
20.01.2019;07:49:05;81450112;81320478;129634;
20.01.2019;07:50:05;81450205;81320662;129543;
20.01.2019;07:51:04;81450269;81320870;129399;
20.01.2019;07:52:04;81450341;81321024;129317;
20.01.2019;07:53:05;81450391;81321196;129195;
20.01.2019;07:54:04;81450465;81321371;129094;
20.01.2019;07:55:04;81450516;81321551;128965;
20.01.2019;07:56:05;81450585;81321713;128872;
20.01.2019;07:57:04;81450646;81321893;128753;
20.01.2019;07:58:05;81450724;81322044;128680;
20.01.2019;07:59:05;81450782;81322215;128567;
20.01.2019;08:00:04;81450845;81322380;128465;
20.01.2019;08:01:04;81450919;81322538;128381;
20.01.2019;08:02:05;81450986;81322720;128266;
20.01.2019;08:03:04;81451040;81322899;128141;
20.01.2019;08:04:05;81451107;81323087;128020;
20.01.2019;08:05:04;81451188;81323291;127897;
20.01.2019;08:06:04;81451267;81323461;127806;
20.01.2019;08:07:05;81451357;81323638;127719;
20.01.2019;08:08:05;81451426;81323803;127623;
20.01.2019;08:09:07;81451494;81324000;127494;
20.01.2019;08:10:05;81451571;81324162;127409;
20.01.2019;08:11:05;81451638;81324336;127302;
20.01.2019;08:12:05;81451716;81324506;127210;
20.01.2019;08:13:04;81451773;81324673;127100;
20.01.2019;08:14:04;81451833;81324808;127025;
20.01.2019;08:15:05;81451907;81324963;126944;
20.01.2019;08:16:04;81451946;81325111;126835;
20.01.2019;08:17:05;81452031;81325286;126745;
20.01.2019;08:18:05;81452096;81325442;126654;
20.01.2019;08:19:04;81452162;81325620;126542;
20.01.2019;08:20:04;81452217;81325790;126427;
20.01.2019;08:21:05;81452285;81325985;126300;
20.01.2019;08:22:04;81452334;81326129;126205;
20.01.2019;08:23:04;81452394;81326285;126109;
20.01.2019;08:24:06;81452480;81326439;126041;
20.01.2019;08:25:05;81452512;81326605;125907;
20.01.2019;08:26:05;81452572;81326756;125816;
20.01.2019;08:27:06;81452638;81326906;125732;
20.01.2019;08:28:12;81452679;81327088;125591;
20.01.2019;08:29:06;81452731;81327250;125481;
20.01.2019;08:30:06;81452784;81327423;125361;
20.01.2019;08:31:06;81452852;81327561;125291;
20.01.2019;08:32:12;81452908;81327742;125166;
20.01.2019;08:33:04;81452962;81327870;125092;
20.01.2019;08:34:04;81453004;81328018;124986;
20.01.2019;08:35:07;81453071;81328206;124865;
20.01.2019;08:36:06;81453121;81328376;124745;
20.01.2019;08:37:06;81453177;81328555;124622;
20.01.2019;08:38:04;81453242;81328709;124533;
20.01.2019;08:39:04;81453316;81328857;124459;
20.01.2019;08:40:05;81453393;81329038;124355;
20.01.2019;08:41:06;81453465;81329204;124261;
20.01.2019;08:42:06;81453535;81329368;124167;
20.01.2019;08:43:06;81453620;81329525;124095;
20.01.2019;08:44:12;81453705;81329719;123986;
20.01.2019;08:45:07;81453769;81329870;123899;
20.01.2019;08:46:13;81453827;81330065;123762;
20.01.2019;08:47:04;81453908;81330194;123714;
20.01.2019;08:48:05;81453977;81330367;123610;
20.01.2019;08:49:06;81454033;81330561;123472;
20.01.2019;08:50:05;81454117;81330733;123384;
20.01.2019;08:51:05;81454195;81330907;123288;
20.01.2019;08:52:06;81454277;81331092;123185;
20.01.2019;08:53:06;81454353;81331268;123085;
20.01.2019;08:54:05;81454423;81331418;123005;
20.01.2019;08:55:04;81454487;81331599;122888;
20.01.2019;08:56:04;81454569;81331768;122801;
20.01.2019;08:57:05;81454633;81331944;122689;
20.01.2019;08:58:04;81454709;81332116;122593;
20.01.2019;08:59:05;81454781;81332294;122487;
20.01.2019;09:00:05;81454858;81332456;122402;
20.01.2019;09:01:05;81454928;81332625;122303;
20.01.2019;09:02:04;81455022;81332819;122203;
20.01.2019;09:03:04;81455107;81332997;122110;
20.01.2019;09:04:05;81455179;81333176;122003;
20.01.2019;09:05:04;81455261;81333329;121932;
20.01.2019;09:06:04;81455351;81333499;121852;
20.01.2019;09:07:10;81455401;81333666;121735;
20.01.2019;09:08:04;81455451;81333829;121622;
20.01.2019;09:09:04;81455537;81333997;121540;
20.01.2019;09:10:04;81455612;81334160;121452;
20.01.2019;09:11:05;81455678;81334355;121323;
20.01.2019;09:12:05;81455747;81334530;121217;
20.01.2019;09:13:04;81455818;81334717;121101;
20.01.2019;09:14:05;81455894;81334903;120991;
20.01.2019;09:15:05;81455964;81335094;120870;
20.01.2019;09:16:06;81456041;81335264;120777;
20.01.2019;09:17:04;81456100;81335443;120657;
20.01.2019;09:18:04;81456152;81335598;120554;
20.01.2019;09:19:05;81456225;81335764;120461;
20.01.2019;09:20:04;81456316;81335913;120403;
20.01.2019;09:21:05;81456425;81336087;120338;
20.01.2019;09:22:05;81456504;81336275;120229;
20.01.2019;09:23:04;81456570;81336419;120151;
20.01.2019;09:24:05;81456635;81336589;120046;
20.01.2019;09:25:05;81456721;81336762;119959;
20.01.2019;09:26:04;81456798;81336914;119884;
20.01.2019;09:27:04;81456876;81337058;119818;
20.01.2019;09:28:05;81456958;81337223;119735;
20.01.2019;09:29:04;81457052;81337383;119669;
20.01.2019;09:30:05;81457126;81337551;119575;
20.01.2019;09:31:05;81457194;81337734;119460;
20.01.2019;09:32:05;81457276;81337914;119362;
20.01.2019;09:33:05;81457357;81338070;119287;
20.01.2019;09:34:05;81457439;81338246;119193;
20.01.2019;09:35:04;81457515;81338419;119096;
20.01.2019;09:36:04;81457575;81338572;119003;
20.01.2019;09:37:05;81457620;81338786;118834;
20.01.2019;09:38:04;81457688;81338956;118732;
20.01.2019;09:39:04;81457743;81339145;118598;
20.01.2019;09:40:04;81457818;81339322;118496;
20.01.2019;09:41:05;81457899;81339495;118404;
20.01.2019;09:42:05;81457960;81339664;118296;
20.01.2019;09:43:04;81458030;81339826;118204;
20.01.2019;09:44:04;81458028;81339961;118067;
20.01.2019;09:45:05;81458078;81340110;117968;
20.01.2019;09:46:05;81458165;81340284;117881;
20.01.2019;09:47:05;81458243;81340472;117771;
20.01.2019;09:48:05;81458318;81340642;117676;
20.01.2019;09:49:05;81458397;81340796;117601;
20.01.2019;09:50:04;81458472;81340949;117523;
20.01.2019;09:51:05;81458537;81341129;117408;
20.01.2019;09:52:04;81458603;81341321;117282;
20.01.2019;09:53:04;81458689;81341490;117199;
20.01.2019;09:54:06;81458764;81341675;117089;
20.01.2019;09:55:05;81458842;81341838;117004;
20.01.2019;09:56:06;81458911;81342016;116895;
20.01.2019;09:57:04;81458972;81342172;116800;
20.01.2019;09:58:04;81459030;81342323;116707;
20.01.2019;09:59:06;81459092;81342493;116599;
20.01.2019;10:00:06;81459160;81342631;116529;
20.01.2019;10:01:05;81459223;81342816;116407;
20.01.2019;10:02:05;81459293;81342992;116301;
20.01.2019;10:03:06;81459375;81343163;116212;
20.01.2019;10:04:11;81459448;81343358;116090;
20.01.2019;10:05:06;81459521;81343532;115989;
20.01.2019;10:06:05;81459607;81343710;115897;
20.01.2019;10:07:06;81459691;81343858;115833;
20.01.2019;10:08:06;81459759;81344011;115748;
20.01.2019;10:09:07;81459811;81344177;115634;
20.01.2019;10:10:04;81459878;81344355;115523;
20.01.2019;10:11:04;81459929;81344514;115415;
20.01.2019;10:12:05;81459996;81344689;115307;
20.01.2019;10:13:05;81460044;81344849;115195;
20.01.2019;10:14:05;81460095;81344994;115101;
20.01.2019;10:15:04;81460143;81345150;114993;
20.01.2019;10:16:05;81460202;81345288;114914;
20.01.2019;10:17:05;81460271;81345419;114852;
20.01.2019;10:18:04;81460322;81345562;114760;
20.01.2019;10:19:04;81460380;81345735;114645;
20.01.2019;10:20:04;81460462;81345893;114569;
20.01.2019;10:21:06;81460522;81346069;114453;
20.01.2019;10:22:04;81460566;81346229;114337;
20.01.2019;10:23:04;81460622;81346389;114233;
20.01.2019;10:24:04;81460676;81346561;114115;
20.01.2019;10:25:05;81460741;81346717;114024;
20.01.2019;10:26:05;81460800;81346856;113944;
20.01.2019;10:27:05;81460851;81347013;113838;
20.01.2019;10:28:04;81460919;81347208;113711;
20.01.2019;10:29:04;81460971;81347380;113591;
20.01.2019;10:30:05;81461020;81347559;113461;
20.01.2019;10:31:05;81461086;81347707;113379;
20.01.2019;10:32:04;81461164;81347906;113258;
20.01.2019;10:33:05;81461238;81348087;113151;
20.01.2019;10:34:05;81461327;81348252;113075;
20.01.2019;10:35:05;81461390;81348426;112964;
20.01.2019;10:36:05;81461469;81348614;112855;
20.01.2019;10:37:06;81461559;81348762;112797;
20.01.2019;10:38:07;81461638;81348952;112686;
20.01.2019;10:39:09;81461718;81349160;112558;
20.01.2019;10:40:08;81461781;81349327;112454;
20.01.2019;10:41:04;81461868;81349499;112369;
20.01.2019;10:42:14;81461923;81349726;112197;
20.01.2019;10:43:04;81461997;81349857;112140;
20.01.2019;10:44:05;81462086;81350045;112041;
20.01.2019;10:45:05;81462159;81350224;111935;
20.01.2019;10:46:06;81462234;81350386;111848;
20.01.2019;10:47:04;81462305;81350548;111757;
20.01.2019;10:48:06;81462380;81350707;111673;
20.01.2019;10:49:06;81462434;81350858;111576;
20.01.2019;10:50:05;81462516;81351030;111486;
20.01.2019;10:51:05;81462585;81351207;111378;
20.01.2019;10:52:05;81462658;81351387;111271;
20.01.2019;10:53:06;81462717;81351570;111147;
20.01.2019;10:54:05;81462782;81351753;111029;
20.01.2019;10:55:05;81462868;81351927;110941;
20.01.2019;10:56:09;81462935;81352078;110857;
20.01.2019;10:57:04;81463001;81352211;110790;
20.01.2019;10:58:05;81463073;81352410;110663;
20.01.2019;10:59:05;81463151;81352598;110553;
20.01.2019;11:00:04;81463206;81352763;110443;
20.01.2019;11:01:04;81463277;81352933;110344;
20.01.2019;11:02:05;81463360;81353124;110236;
20.01.2019;11:03:05;81463430;81353283;110147;
20.01.2019;11:04:05;81463517;81353448;110069;
20.01.2019;11:05:04;81463600;81353612;109988;
20.01.2019;11:06:04;81463679;81353782;109897;
20.01.2019;11:07:05;81463752;81353948;109804;
20.01.2019;11:08:05;81463828;81354101;109727;
20.01.2019;11:09:07;81463900;81354280;109620;
20.01.2019;11:10:05;81463968;81354428;109540;
20.01.2019;11:11:05;81464043;81354598;109445;
20.01.2019;11:12:05;81464122;81354768;109354;
20.01.2019;11:13:04;81464190;81354938;109252;
20.01.2019;11:14:04;81464272;81355086;109186;
20.01.2019;11:15:05;81464340;81355247;109093;
20.01.2019;11:16:05;81464430;81355432;108998;
20.01.2019;11:17:05;81464490;81355579;108911;
20.01.2019;11:18:04;81464551;81355750;108801;
20.01.2019;11:19:04;81464636;81355908;108728;
20.01.2019;11:20:05;81464714;81356073;108641;
20.01.2019;11:21:05;81464792;81356246;108546;
20.01.2019;11:22:04;81464851;81356418;108433;
20.01.2019;11:23:05;81464919;81356581;108338;
20.01.2019;11:24:05;81464992;81356751;108241;
20.01.2019;11:25:05;81465066;81356914;108152;
20.01.2019;11:26:04;81465129;81357102;108027;
20.01.2019;11:27:05;81465213;81357267;107946;
20.01.2019;11:28:05;81465280;81357445;107835;
20.01.2019;11:29:05;81465342;81357582;107760;
20.01.2019;11:30:05;81465407;81357740;107667;
20.01.2019;11:31:05;81465498;81357917;107581;
20.01.2019;11:32:04;81465565;81358070;107495;
20.01.2019;11:33:04;81465646;81358243;107403;
20.01.2019;11:34:05;81465732;81358387;107345;
20.01.2019;11:35:05;81465813;81358556;107257;
20.01.2019;11:36:04;81465911;81358716;107195;
20.01.2019;11:37:04;81465993;81358888;107105;
20.01.2019;11:38:05;81466071;81359053;107018;
20.01.2019;11:39:05;81466150;81359211;106939;
20.01.2019;11:40:04;81466222;81359376;106846;
20.01.2019;11:41:05;81466293;81359543;106750;
20.01.2019;11:42:05;81466365;81359709;106656;
20.01.2019;11:43:04;81466457;81359893;106564;
20.01.2019;11:44:05;81466555;81360047;106508;
20.01.2019;11:45:05;81466619;81360190;106429;
20.01.2019;11:46:05;81466682;81360358;106324;
20.01.2019;11:47:05;81466767;81360515;106252;
20.01.2019;11:48:05;81466825;81360664;106161;
20.01.2019;11:49:05;81466889;81360801;106088;
20.01.2019;11:50:05;81466950;81360948;106002;
20.01.2019;11:51:05;81467034;81361120;105914;
20.01.2019;11:52:04;81467134;81361257;105877;
20.01.2019;11:53:04;81467232;81361380;105852;
20.01.2019;11:54:05;81467320;81361549;105771;
20.01.2019;11:55:04;81467401;81361733;105668;
20.01.2019;11:56:04;81467476;81361904;105572;
20.01.2019;11:57:04;81467562;81362097;105465;
20.01.2019;11:58:05;81467637;81362257;105380;
20.01.2019;11:59:05;81467716;81362429;105287;
20.01.2019;12:00:05;81467793;81362591;105202;
20.01.2019;12:01:05;81467858;81362731;105127;
20.01.2019;12:02:05;81467930;81362919;105011;
20.01.2019;12:03:05;81468012;81363099;104913;
20.01.2019;12:04:04;81468100;81363291;104809;
20.01.2019;12:05:05;81468180;81363434;104746;
20.01.2019;12:06:05;81468265;81363615;104650;
20.01.2019;12:07:04;81468304;81363760;104544;
20.01.2019;12:08:04;81468342;81363909;104433;
20.01.2019;12:09:05;81468371;81364027;104344;
20.01.2019;12:10:05;81468412;81364191;104221;
20.01.2019;12:11:04;81468466;81364319;104147;
20.01.2019;12:12:04;81468511;81364451;104060;
20.01.2019;12:13:05;81468558;81364576;103982;
20.01.2019;12:14:05;81468607;81364705;103902;
20.01.2019;12:15:05;81468649;81364868;103781;
20.01.2019;12:16:05;81468690;81365015;103675;
20.01.2019;12:17:05;81468777;81365139;103638;
20.01.2019;12:18:07;81468835;81365270;103565;
20.01.2019;12:19:04;81468903;81365454;103449;
20.01.2019;12:20:04;81468959;81365616;103343;
20.01.2019;12:21:05;81469031;81365795;103236;
20.01.2019;12:22:05;81469073;81365956;103117;
20.01.2019;12:23:04;81469156;81366094;103062;
20.01.2019;12:24:04;81469234;81366241;102993;
20.01.2019;12:25:05;81469327;81366408;102919;
20.01.2019;12:26:04;81469433;81366569;102864;
20.01.2019;12:27:06;81469519;81366739;102780;
20.01.2019;12:28:05;81469597;81366882;102715;
20.01.2019;12:29:05;81469694;81367031;102663;
20.01.2019;12:30:05;81469778;81367178;102600;
20.01.2019;12:31:04;81469854;81367353;102501;
20.01.2019;12:32:04;81469930;81367518;102412;
20.01.2019;12:33:04;81469999;81367696;102303;
20.01.2019;12:34:05;81470094;81367850;102244;
20.01.2019;12:35:05;81470159;81368051;102108;
20.01.2019;12:36:05;81470256;81368236;102020;
20.01.2019;12:37:04;81470345;81368417;101928;
20.01.2019;12:38:05;81470451;81368579;101872;
20.01.2019;12:39:05;81470534;81368709;101825;
20.01.2019;12:40:04;81470632;81368884;101748;
20.01.2019;12:41:04;81470720;81369052;101668;
20.01.2019;12:42:05;81470829;81369238;101591;
20.01.2019;12:43:05;81470906;81369411;101495;
20.01.2019;12:44:04;81471011;81369565;101446;
20.01.2019;12:45:04;81471095;81369707;101388;
20.01.2019;12:46:05;81471206;81369858;101348;
20.01.2019;12:47:05;81471289;81370011;101278;
20.01.2019;12:48:05;81471381;81370147;101234;
20.01.2019;12:49:04;81471476;81370298;101178;
20.01.2019;12:50:04;81471559;81370470;101089;
20.01.2019;12:51:05;81471640;81370634;101006;
20.01.2019;12:52:04;81471753;81370803;100950;
20.01.2019;12:53:04;81471873;81370952;100921;
20.01.2019;12:54:04;81471974;81371110;100864;
20.01.2019;12:55:04;81472095;81371296;100799;
20.01.2019;12:56:05;81472187;81371490;100697;
20.01.2019;12:57:05;81472295;81371647;100648;
20.01.2019;12:58:04;81472390;81371826;100564;
20.01.2019;12:59:05;81472518;81371975;100543;
20.01.2019;13:00:05;81472627;81372144;100483;
20.01.2019;13:01:05;81472746;81372309;100437;
20.01.2019;13:02:05;81472852;81372455;100397;
20.01.2019;13:03:05;81472955;81372641;100314;
20.01.2019;13:04:05;81473063;81372812;100251;
20.01.2019;13:05:04;81473166;81372987;100179;
20.01.2019;13:06:04;81473254;81373156;100098;
20.01.2019;13:07:05;81473370;81373299;100071;
20.01.2019;13:08:05;81473495;81373455;100040;
20.01.2019;13:09:04;81473628;81373645;99983;
20.01.2019;13:10:04;81473715;81373823;99892;
20.01.2019;13:11:04;81473827;81373989;99838;
20.01.2019;13:12:05;81473939;81374158;99781;
20.01.2019;13:13:05;81474064;81374331;99733;
20.01.2019;13:14:05;81474176;81374508;99668;
20.01.2019;13:15:04;81474304;81374682;99622;
20.01.2019;13:16:05;81474430;81374869;99561;
20.01.2019;13:17:05;81474562;81375054;99508;
20.01.2019;13:18:04;81474675;81375225;99450;
20.01.2019;13:19:04;81474785;81375419;99366;
20.01.2019;13:20:05;81474902;81375605;99297;
20.01.2019;13:21:04;81475014;81375775;99239;
20.01.2019;13:22:04;81475137;81375948;99189;
20.01.2019;13:23:05;81475261;81376126;99135;
20.01.2019;13:24:05;81475395;81376283;99112;
20.01.2019;13:25:05;81475520;81376430;99090;
20.01.2019;13:26:05;81475648;81376588;99060;
20.01.2019;13:27:04;81475745;81376777;98968;
20.01.2019;13:28:04;81475866;81376940;98926;
20.01.2019;13:29:04;81475973;81377121;98852;
20.01.2019;13:30:05;81476093;81377298;98795;
20.01.2019;13:31:05;81476207;81377485;98722;
20.01.2019;13:32:05;81476343;81377637;98706;
20.01.2019;13:33:04;81476467;81377782;98685;
20.01.2019;13:34:04;81476583;81377934;98649;
20.01.2019;13:35:05;81476686;81378062;98624;
20.01.2019;13:36:04;81476787;81378190;98597;
20.01.2019;13:37:05;81476910;81378340;98570;
20.01.2019;13:38:05;81477028;81378479;98549;
20.01.2019;13:39:05;81477139;81378645;98494;
20.01.2019;13:40:05;81477274;81378799;98475;
20.01.2019;13:41:04;81477416;81378944;98472;
20.01.2019;13:42:05;81477563;81379111;98452;
20.01.2019;13:43:04;81477677;81379276;98401;
20.01.2019;13:44:05;81477801;81379456;98345;
20.01.2019;13:45:05;81477939;81379624;98315;
20.01.2019;13:46:04;81478068;81379801;98267;
20.01.2019;13:47:04;81478210;81379966;98244;
20.01.2019;13:48:04;81478329;81380132;98197;
20.01.2019;13:49:05;81478453;81380314;98139;
20.01.2019;13:50:05;81478581;81380472;98109;
20.01.2019;13:51:05;81478727;81380656;98071;
20.01.2019;13:52:04;81478847;81380834;98013;
20.01.2019;13:53:14;81478987;81381017;97970;
20.01.2019;13:54:07;81479128;81381183;97945;
20.01.2019;13:55:07;81479256;81381342;97914;
20.01.2019;13:56:05;81479381;81381538;97843;
20.01.2019;13:57:05;81479516;81381708;97808;
20.01.2019;13:58:05;81479633;81381878;97755;
20.01.2019;13:59:04;81479740;81382055;97685;
20.01.2019;14:00:05;81479863;81382221;97642;
20.01.2019;14:01:05;81479975;81382372;97603;
20.01.2019;14:02:05;81480107;81382542;97565;
20.01.2019;14:03:04;81480281;81382715;97566;
20.01.2019;14:04:04;81480407;81382885;97522;
20.01.2019;14:05:06;81480516;81383045;97471;
20.01.2019;14:06:05;81480638;81383255;97383;
20.01.2019;14:07:05;81480780;81383437;97343;
20.01.2019;14:08:05;81480922;81383600;97322;
20.01.2019;14:09:05;81481058;81383762;97296;
20.01.2019;14:10:05;81481175;81383959;97216;
20.01.2019;14:11:05;81481306;81384130;97176;
20.01.2019;14:12:05;81481411;81384303;97108;
20.01.2019;14:13:05;81481556;81384449;97107;
20.01.2019;14:14:04;81481708;81384595;97113;
20.01.2019;14:15:04;81481815;81384772;97043;
20.01.2019;14:16:06;81481922;81384948;96974;
20.01.2019;14:17:05;81482044;81385136;96908;
20.01.2019;14:18:05;81482131;81385315;96816;
20.01.2019;14:19:05;81482215;81385450;96765;
20.01.2019;14:20:05;81482321;81385602;96719;
20.01.2019;14:21:05;81482424;81385738;96686;
20.01.2019;14:22:05;81482534;81385905;96629;
20.01.2019;14:23:05;81482651;81386079;96572;
20.01.2019;14:24:05;81482730;81386224;96506;
20.01.2019;14:25:05;81482844;81386372;96472;
20.01.2019;14:26:06;81482980;81386570;96410;
20.01.2019;14:27:08;81483076;81386715;96361;
20.01.2019;14:28:04;81483207;81386877;96330;
20.01.2019;14:29:05;81483320;81387070;96250;
20.01.2019;14:30:05;81483445;81387217;96228;
20.01.2019;14:31:05;81483581;81387404;96177;
20.01.2019;14:32:05;81483739;81387580;96159;
20.01.2019;14:33:05;81483868;81387738;96130;
20.01.2019;14:34:05;81483979;81387888;96091;
20.01.2019;14:35:08;81484110;81388072;96038;
20.01.2019;14:36:06;81484232;81388236;95996;
20.01.2019;14:37:05;81484364;81388397;95967;
20.01.2019;14:38:04;81484508;81388593;95915;
20.01.2019;14:39:06;81484645;81388776;95869;
20.01.2019;14:40:04;81484770;81388980;95790;
20.01.2019;14:41:13;81484912;81389156;95756;
20.01.2019;14:42:05;81485075;81389317;95758;
20.01.2019;14:43:05;81485195;81389468;95727;
20.01.2019;14:44:08;81485339;81389687;95652;
20.01.2019;14:45:05;81485493;81389858;95635;
20.01.2019;14:46:05;81485625;81390055;95570;
20.01.2019;14:47:04;81485777;81390228;95549;
20.01.2019;14:48:05;81485956;81390415;95541;
20.01.2019;14:49:05;81486081;81390608;95473;
20.01.2019;14:50:05;81486202;81390800;95402;
20.01.2019;14:51:05;81486351;81390985;95366;
20.01.2019;14:52:04;81486501;81391175;95326;
20.01.2019;14:53:07;81486636;81391358;95278;
20.01.2019;14:54:05;81486773;81391530;95243;
20.01.2019;14:55:05;81486927;81391719;95208;
20.01.2019;14:56:05;81487102;81391922;95180;
20.01.2019;14:57:05;81487239;81392093;95146;
20.01.2019;14:58:05;81487408;81392286;95122;
20.01.2019;14:59:04;81487563;81392487;95076;
20.01.2019;15:00:07;81487710;81392695;95015;
20.01.2019;15:01:07;81487858;81392905;94953;
20.01.2019;15:02:09;81488041;81393102;94939;
20.01.2019;15:03:07;81488184;81393272;94912;
20.01.2019;15:04:09;81488319;81393504;94815;
20.01.2019;15:05:11;81488485;81393680;94805;
20.01.2019;15:06:11;81488606;81393878;94728;
20.01.2019;15:07:13;81488786;81394052;94734;
20.01.2019;15:08:08;81488929;81394226;94703;
20.01.2019;15:09:10;81489074;81394459;94615;
20.01.2019;15:10:11;81489229;81394653;94576;
20.01.2019;15:11:10;81489374;81394854;94520;
20.01.2019;15:12:12;81489519;81395042;94477;
20.01.2019;15:13:10;81489660;81395231;94429;
20.01.2019;15:14:11;81489821;81395410;94411;
20.01.2019;15:15:12;81489964;81395620;94344;
20.01.2019;15:16:11;81490114;81395829;94285;
20.01.2019;15:17:14;81490295;81396024;94271;
20.01.2019;15:18:10;81490444;81396183;94261;
20.01.2019;15:19:11;81490605;81396407;94198;
20.01.2019;15:20:10;81490750;81396567;94183;
20.01.2019;15:21:11;81490924;81396742;94182;
20.01.2019;15:22:11;81491038;81396923;94115;
20.01.2019;15:23:11;81491195;81397129;94066;
20.01.2019;15:24:11;81491330;81397305;94025;
20.01.2019;15:25:10;81491470;81397482;93988;
20.01.2019;15:26:13;81491624;81397743;93881;
20.01.2019;15:27:10;81491774;81397916;93858;
20.01.2019;15:28:11;81491934;81398104;93830;
20.01.2019;15:29:10;81492101;81398313;93788;
20.01.2019;15:30:10;81492254;81398517;93737;
20.01.2019;15:31:13;81492411;81398702;93709;
20.01.2019;15:32:11;81492552;81398887;93665;
20.01.2019;15:33:11;81492720;81399070;93650;
20.01.2019;15:34:11;81492880;81399256;93624;
20.01.2019;15:35:13;81493025;81399462;93563;
20.01.2019;15:36:12;81493182;81399629;93553;
20.01.2019;15:37:11;81493354;81399839;93515;
20.01.2019;15:38:10;81493534;81400041;93493;
20.01.2019;15:39:10;81493702;81400265;93437;
20.01.2019;15:40:14;81493880;81400489;93391;
20.01.2019;15:41:10;81494011;81400689;93322;
20.01.2019;15:42:11;81494163;81400857;93306;
20.01.2019;15:43:11;81494321;81401058;93263;
20.01.2019;15:44:13;81494498;81401262;93236;
20.01.2019;15:45:10;81494639;81401457;93182;
20.01.2019;15:46:10;81494809;81401648;93161;
20.01.2019;15:47:10;81495001;81401830;93171;
20.01.2019;15:48:12;81495183;81402069;93114;
20.01.2019;15:49:16;81495354;81402277;93077;
20.01.2019;15:50:14;81495525;81402459;93066;
20.01.2019;15:51:14;81495695;81402643;93052;
20.01.2019;15:52:16;81495851;81402850;93001;
20.01.2019;15:53:13;81496016;81403035;92981;
20.01.2019;15:54:14;81496185;81403239;92946;
20.01.2019;15:55:16;81496353;81403433;92920;
20.01.2019;15:56:17;81496534;81403620;92914;
20.01.2019;15:57:16;81496700;81403796;92904;
20.01.2019;15:58:17;81496910;81403970;92940;
20.01.2019;15:59:14;81497076;81404147;92929;
20.01.2019;16:01:07;81497394;81404503;92891;
20.01.2019;16:02:05;81497551;81404716;92835;
20.01.2019;16:03:05;81497722;81404910;92812;
20.01.2019;16:04:05;81497889;81405076;92813;
20.01.2019;16:05:05;81498070;81405281;92789;
20.01.2019;16:06:04;81498229;81405441;92788;
20.01.2019;16:07:05;81498427;81405652;92775;
20.01.2019;16:08:05;81498604;81405879;92725;
20.01.2019;16:09:05;81498743;81406051;92692;
20.01.2019;16:10:05;81498938;81406276;92662;
20.01.2019;16:11:05;81499101;81406442;92659;
20.01.2019;16:12:04;81499287;81406634;92653;
20.01.2019;16:13:04;81499483;81406838;92645;
20.01.2019;16:14:05;81499618;81406993;92625;
20.01.2019;16:15:05;81499795;81407177;92618;
20.01.2019;16:16:07;81499964;81407387;92577;
20.01.2019;16:17:05;81500117;81407541;92576;
20.01.2019;16:18:04;81500260;81407715;92545;
20.01.2019;16:19:04;81500389;81407890;92499;
20.01.2019;16:20:05;81500501;81408074;92427;
20.01.2019;16:21:05;81500633;81408225;92408;
20.01.2019;16:22:05;81500787;81408360;92427;
20.01.2019;16:23:05;81500962;81408561;92401;
20.01.2019;16:24:05;81501122;81408727;92395;
20.01.2019;16:25:07;81501245;81408924;92321;
20.01.2019;16:26:04;81501397;81409079;92318;
20.01.2019;16:27:05;81501549;81409286;92263;
20.01.2019;16:28:05;81501700;81409451;92249;
20.01.2019;16:29:05;81501840;81409617;92223;
20.01.2019;16:30:05;81502012;81409769;92243;
20.01.2019;16:31:05;81502167;81409921;92246;
20.01.2019;16:32:05;81502341;81410101;92240;
20.01.2019;16:33:05;81502484;81410292;92192;
20.01.2019;16:34:07;81502659;81410479;92180;
20.01.2019;16:35:04;81502821;81410667;92154;
20.01.2019;16:36:04;81503000;81410825;92175;
20.01.2019;16:37:05;81503204;81411031;92173;
20.01.2019;16:38:05;81503387;81411238;92149;
20.01.2019;16:39:07;81503566;81411445;92121;
20.01.2019;16:40:05;81503743;81411638;92105;
20.01.2019;16:41:05;81503943;81411830;92113;
20.01.2019;16:42:05;81504150;81412017;92133;
20.01.2019;16:43:07;81504290;81412222;92068;
20.01.2019;16:44:05;81504470;81412403;92067;
20.01.2019;16:45:04;81504650;81412621;92029;
20.01.2019;16:46:05;81504795;81412800;91995;
20.01.2019;16:47:04;81505000;81412994;92006;
20.01.2019;16:48:04;81505187;81413179;92008;
20.01.2019;16:49:04;81505390;81413375;92015;
20.01.2019;16:50:05;81505578;81413548;92030;
20.01.2019;16:51:05;81505777;81413782;91995;
20.01.2019;16:52:08;81505986;81413974;92012;
20.01.2019;16:53:05;81506182;81414176;92006;
20.01.2019;16:54:04;81506393;81414365;92028;
20.01.2019;16:55:04;81506571;81414546;92025;
20.01.2019;16:56:05;81506754;81414732;92022;
20.01.2019;16:57:05;81506939;81414915;92024;
20.01.2019;16:58:05;81507113;81415118;91995;
20.01.2019;16:59:05;81507286;81415317;91969;
20.01.2019;17:00:06;81507471;81415508;91963;
20.01.2019;17:01:05;81507675;81415702;91973;
20.01.2019;17:02:05;81507878;81415925;91953;
20.01.2019;17:03:04;81508055;81416097;91958;
20.01.2019;17:04:04;81508240;81416305;91935;
20.01.2019;17:05:05;81508430;81416518;91912;
20.01.2019;17:06:05;81508634;81416717;91917;
20.01.2019;17:07:05;81508817;81416900;91917;
20.01.2019;17:08:05;81508989;81417099;91890;
20.01.2019;17:09:05;81509181;81417281;91900;
20.01.2019;17:10:04;81509355;81417460;91895;
20.01.2019;17:11:05;81509555;81417637;91918;
20.01.2019;17:12:05;81509753;81417827;91926;
20.01.2019;17:13:04;81509946;81418013;91933;
20.01.2019;17:14:04;81510150;81418224;91926;
20.01.2019;17:15:04;81510349;81418392;91957;
20.01.2019;17:16:06;81510549;81418571;91978;
20.01.2019;17:17:04;81510738;81418792;91946;
20.01.2019;17:18:04;81510941;81418994;91947;
20.01.2019;17:19:07;81511129;81419171;91958;
20.01.2019;17:20:05;81511322;81419354;91968;
20.01.2019;17:21:05;81511539;81419544;91995;
20.01.2019;17:22:05;81511739;81419726;92013;
20.01.2019;17:23:05;81511882;81419903;91979;
20.01.2019;17:24:05;81512098;81420117;91981;
20.01.2019;17:25:05;81512320;81420308;92012;
20.01.2019;17:26:05;81512492;81420489;92003;
20.01.2019;17:27:05;81512679;81420655;92024;
20.01.2019;17:28:06;81512887;81420847;92040;
20.01.2019;17:29:05;81513091;81421047;92044;
20.01.2019;17:30:05;81513273;81421259;92014;
20.01.2019;17:31:05;81513473;81421443;92030;
20.01.2019;17:32:05;81513668;81421619;92049;
20.01.2019;17:33:05;81513872;81421837;92035;
20.01.2019;17:34:06;81514066;81422009;92057;
20.01.2019;17:35:05;81514233;81422211;92022;
20.01.2019;17:36:06;81514411;81422422;91989;
20.01.2019;17:37:04;81514616;81422580;92036;
20.01.2019;17:38:04;81514828;81422755;92073;
20.01.2019;17:39:06;81515047;81422931;92116;
20.01.2019;17:40:04;81515270;81423140;92130;
20.01.2019;17:41:04;81515455;81423304;92151;
20.01.2019;17:42:05;81515682;81423500;92182;
20.01.2019;17:43:06;81515896;81423676;92220;
20.01.2019;17:44:05;81516107;81423878;92229;
20.01.2019;17:45:07;81516314;81424068;92246;
20.01.2019;17:46:05;81516492;81424248;92244;
20.01.2019;17:47:05;81516694;81424427;92267;
20.01.2019;17:48:05;81516910;81424574;92336;
20.01.2019;17:49:04;81517108;81424765;92343;
20.01.2019;17:50:05;81517294;81424964;92330;
20.01.2019;17:51:05;81517476;81425130;92346;
20.01.2019;17:52:05;81517678;81425329;92349;
20.01.2019;17:53:05;81517881;81425486;92395;
20.01.2019;17:54:07;81518120;81425696;92424;
20.01.2019;17:55:05;81518350;81425871;92479;
20.01.2019;17:56:05;81518554;81426090;92464;
20.01.2019;17:57:05;81518751;81426267;92484;
20.01.2019;17:58:05;81518934;81426448;92486;
20.01.2019;17:59:05;81519102;81426597;92505;
20.01.2019;18:00:04;81519288;81426769;92519;
20.01.2019;18:01:05;81519512;81426934;92578;
20.01.2019;18:02:06;81519696;81427120;92576;
20.01.2019;18:03:05;81519906;81427306;92600;
20.01.2019;18:04:04;81520108;81427483;92625;
20.01.2019;18:05:10;81520341;81427662;92679;
20.01.2019;18:06:05;81520549;81427831;92718;
20.01.2019;18:07:06;81520783;81427983;92800;
20.01.2019;18:08:05;81520981;81428168;92813;
20.01.2019;18:09:07;81521196;81428327;92869;
20.01.2019;18:10:04;81521406;81428501;92905;
20.01.2019;18:11:07;81521615;81428654;92961;
20.01.2019;18:12:04;81521822;81428829;92993;
20.01.2019;18:13:05;81522048;81429031;93017;
20.01.2019;18:14:05;81522256;81429179;93077;
20.01.2019;18:15:05;81522457;81429363;93094;
20.01.2019;18:16:05;81522642;81429519;93123;
20.01.2019;18:17:06;81522820;81429686;93134;
20.01.2019;18:18:05;81523027;81429840;93187;
20.01.2019;18:19:06;81523245;81430013;93232;
20.01.2019;18:20:04;81523442;81430191;93251;
20.01.2019;18:21:04;81523646;81430370;93276;
20.01.2019;18:22:05;81523842;81430549;93293;
20.01.2019;18:23:04;81524050;81430723;93327;
20.01.2019;18:24:06;81524286;81430872;93414;
20.01.2019;18:25:04;81524448;81431033;93415;
20.01.2019;18:26:05;81524628;81431194;93434;
20.01.2019;18:27:05;81524791;81431324;93467;
20.01.2019;18:28:07;81524940;81431469;93471;
20.01.2019;18:29:05;81525092;81431574;93518;
20.01.2019;18:30:04;81525270;81431700;93570;
20.01.2019;18:31:04;81525417;81431847;93570;
20.01.2019;18:32:05;81525588;81431983;93605;
20.01.2019;18:33:05;81525744;81432096;93648;
20.01.2019;18:34:05;81525893;81432220;93673;
20.01.2019;18:35:05;81526030;81432334;93696;
20.01.2019;18:36:05;81526162;81432431;93731;
20.01.2019;18:37:08;81526328;81432581;93747;
20.01.2019;18:38:05;81526484;81432713;93771;
20.01.2019;18:39:05;81526651;81432846;93805;
20.01.2019;18:40:11;81526759;81432909;93850;
20.01.2019;18:41:04;81526950;81433017;93933;
20.01.2019;18:42:04;81527125;81433135;93990;
20.01.2019;18:43:05;81527297;81433267;94030;
20.01.2019;18:44:04;81527446;81433404;94042;
20.01.2019;18:45:07;81527633;81433530;94103;
20.01.2019;18:46:05;81527782;81433644;94138;
20.01.2019;18:47:05;81527887;81433776;94111;
20.01.2019;18:48:05;81527997;81433890;94107;
20.01.2019;18:49:05;81528156;81434032;94124;
20.01.2019;18:50:04;81528345;81434143;94202;
20.01.2019;18:51:04;81528484;81434279;94205;
20.01.2019;18:52:05;81528618;81434421;94197;
20.01.2019;18:53:08;81528753;81434582;94171;
20.01.2019;18:54:05;81528882;81434694;94188;
20.01.2019;18:55:06;81529041;81434825;94216;
20.01.2019;18:56:04;81529195;81434961;94234;
20.01.2019;18:57:04;81529342;81435085;94257;
20.01.2019;18:58:04;81529510;81435211;94299;
20.01.2019;18:59:04;81529668;81435318;94350;
20.01.2019;19:00:06;81529842;81435466;94376;
20.01.2019;19:01:05;81529987;81435599;94388;
20.01.2019;19:02:05;81530128;81435750;94378;
20.01.2019;19:03:05;81530300;81435870;94430;
20.01.2019;19:04:05;81530480;81436000;94480;
20.01.2019;19:05:04;81530657;81436143;94514;
20.01.2019;19:06:04;81530813;81436280;94533;
20.01.2019;19:07:05;81530975;81436431;94544;
20.01.2019;19:08:05;81531134;81436524;94610;
20.01.2019;19:09:04;81531316;81436636;94680;
20.01.2019;19:10:06;81531492;81436798;94694;
20.01.2019;19:11:04;81531663;81436908;94755;
20.01.2019;19:12:05;81531883;81437040;94843;
20.01.2019;19:13:05;81532029;81437179;94850;
20.01.2019;19:14:05;81532216;81437305;94911;
20.01.2019;19:15:05;81532383;81437433;94950;
20.01.2019;19:16:05;81532570;81437528;95042;
20.01.2019;19:17:05;81532745;81437654;95091;
20.01.2019;19:18:08;81532969;81437766;95203;
20.01.2019;19:19:05;81533151;81437878;95273;
20.01.2019;19:20:04;81533338;81438012;95326;
20.01.2019;19:21:05;81533509;81438145;95364;
20.01.2019;19:22:05;81533686;81438260;95426;
20.01.2019;19:23:05;81533892;81438360;95532;
20.01.2019;19:24:05;81534028;81438479;95549;
20.01.2019;19:25:05;81534206;81438586;95620;
20.01.2019;19:26:06;81534382;81438695;95687;
20.01.2019;19:27:04;81534551;81438826;95725;
20.01.2019;19:28:04;81534714;81438947;95767;
20.01.2019;19:29:05;81534911;81439084;95827;
20.01.2019;19:30:05;81535070;81439209;95861;
20.01.2019;19:31:05;81535252;81439306;95946;
20.01.2019;19:32:05;81535450;81439416;96034;
20.01.2019;19:33:05;81535601;81439540;96061;
20.01.2019;19:34:05;81535777;81439651;96126;
20.01.2019;19:35:05;81535967;81439782;96185;
20.01.2019;19:36:04;81536155;81439888;96267;
20.01.2019;19:37:04;81536340;81439984;96356;
20.01.2019;19:38:40;81536598;81440145;96453;
20.01.2019;19:39:15;81536691;81440218;96473;
20.01.2019;19:41:16;81537088;81440441;96647;
20.01.2019;19:42:10;81537243;81440524;96719;
20.01.2019;19:43:25;81537483;81440633;96850;
20.01.2019;19:44:05;81537588;81440713;96875;
20.01.2019;19:45:12;81537803;81440837;96966;
20.01.2019;19:46:12;81538046;81440949;97097;
20.01.2019;19:47:05;81538309;81441049;97260;
20.01.2019;19:48:09;81538620;81441148;97472;
20.01.2019;19:49:05;81538906;81441233;97673;
20.01.2019;19:50:07;81539238;81441319;97919;
20.01.2019;19:51:11;81539558;81441414;98144;
20.01.2019;19:52:11;81539832;81441501;98331;
20.01.2019;19:53:04;81540106;81441594;98512;
20.01.2019;19:54:05;81540396;81441686;98710;
20.01.2019;19:55:04;81540699;81449451;91248;
20.01.2019;19:56:05;81540982;81449558;91424;
20.01.2019;19:57:05;81538198;81449649;88549;
20.01.2019;19:58:05;81538518;81449742;88776;
20.01.2019;19:59:04;81538799;81449842;88957;
20.01.2019;20:00:04;81539094;81449943;89151;
20.01.2019;20:01:05;81539426;81450024;89402;
20.01.2019;20:02:05;81539705;81450113;89592;
20.01.2019;20:03:06;81539969;81450217;89752;
20.01.2019;20:04:06;81540258;81450311;89947;
20.01.2019;20:05:04;81540558;81450394;90164;
20.01.2019;20:06:05;81540856;81450485;90371;
20.01.2019;20:07:04;81541178;81450579;90599;
20.01.2019;20:08:05;81541497;81450677;90820;
20.01.2019;20:09:07;81541827;81450778;91049;
20.01.2019;20:10:05;81542110;81450856;91254;
20.01.2019;20:11:07;81542424;81450951;91473;
20.01.2019;20:12:04;81542702;81451025;91677;
20.01.2019;20:13:05;81543005;81451121;91884;
20.01.2019;20:14:05;81543276;81451177;92099;
20.01.2019;20:15:04;81543546;81451232;92314;
20.01.2019;20:16:07;81543824;81451288;92536;
20.01.2019;20:17:06;81544095;81451346;92749;
20.01.2019;20:18:04;81544355;81451412;92943;
20.01.2019;20:19:08;81544579;81451470;93109;
20.01.2019;20:20:05;81544777;81451529;93248;
20.01.2019;20:21:05;81544991;81451565;93426;
20.01.2019;20:22:05;81545196;81451621;93575;
20.01.2019;20:23:05;81545423;81451696;93727;
20.01.2019;20:24:05;81545623;81451732;93891;
20.01.2019;20:25:04;81545865;81451782;94083;
20.01.2019;20:26:04;81546118;81451855;94263;
20.01.2019;20:27:05;81546372;81451923;94449;
20.01.2019;20:28:05;81546649;81451995;94654;
20.01.2019;20:29:05;81546885;81452066;94819;
20.01.2019;20:30:05;81547117;81452118;94999;
20.01.2019;20:31:04;81547375;81452173;95202;
20.01.2019;20:32:07;81547608;81452233;95375;
20.01.2019;20:33:04;81547864;81452281;95583;
20.01.2019;20:34:04;81548064;81452342;95722;
20.01.2019;20:35:05;81548297;81452414;95883;
20.01.2019;20:36:05;81548559;81452467;96092;
20.01.2019;20:37:05;81548858;81452543;96315;
20.01.2019;20:38:04;81549112;81452601;96511;
20.01.2019;20:39:06;81549391;81452662;96729;
20.01.2019;20:40:05;81549635;81452734;96901;
20.01.2019;20:41:05;81549894;81452792;97102;
20.01.2019;20:42:04;81550152;81452848;97304;
20.01.2019;20:43:05;81550375;81452920;97455;
20.01.2019;20:44:05;81550612;81452974;97638;
20.01.2019;20:45:06;81550858;81453038;97820;
20.01.2019;20:46:04;81551127;81453085;98042;
20.01.2019;20:47:04;81551412;81453156;98256;
20.01.2019;20:48:11;81551695;81453233;98462;
20.01.2019;20:49:08;81551934;81453303;98631;
20.01.2019;20:50:05;81552172;81453376;98796;
20.01.2019;20:51:06;81552421;81453439;98982;
20.01.2019;20:52:05;81552680;81453497;99183;
20.01.2019;20:53:04;81552933;81453573;99360;
20.01.2019;20:54:05;81553202;81453638;99564;
20.01.2019;20:55:05;81553474;81453691;99783;
20.01.2019;20:56:11;81553729;81453774;99955;
20.01.2019;20:57:09;81553994;81453839;100155;
20.01.2019;20:58:04;81554236;81453910;100326;
20.01.2019;20:59:05;81554502;81453963;100539;
20.01.2019;21:00:07;81554790;81454035;100755;
20.01.2019;21:01:05;81555043;81454097;100946;
20.01.2019;21:02:06;81555315;81454167;101148;
20.01.2019;21:03:05;81555554;81454254;101300;
20.01.2019;21:04:05;81555826;81454322;101504;
20.01.2019;21:05:09;81556079;81454394;101685;
20.01.2019;21:06:05;81556282;81454456;101826;
20.01.2019;21:07:05;81556535;81454511;102024;
20.01.2019;21:08:05;81556793;81454566;102227;
20.01.2019;21:09:05;81557029;81454639;102390;
20.01.2019;21:10:05;81557256;81454689;102567;
20.01.2019;21:11:05;81557492;81454766;102726;
20.01.2019;21:12:05;81557742;81454825;102917;
20.01.2019;21:13:07;81557974;81454895;103079;
20.01.2019;21:14:05;81558216;81454963;103253;
20.01.2019;21:15:05;81558464;81455011;103453;
20.01.2019;21:16:05;81558723;81455052;103671;
20.01.2019;21:17:06;81558923;81455115;103808;
20.01.2019;21:18:05;81559151;81455184;103967;
20.01.2019;21:19:04;81559366;81455234;104132;
20.01.2019;21:20:05;81559578;81455277;104301;
20.01.2019;21:21:05;81559830;81455350;104480;
20.01.2019;21:22:07;81560068;81455409;104659;
20.01.2019;21:23:05;81560252;81455451;104801;
20.01.2019;21:24:04;81560471;81455515;104956;
20.01.2019;21:25:09;81560720;81455574;105146;
20.01.2019;21:26:04;81560920;81455624;105296;
20.01.2019;21:27:04;81561120;81455689;105431;
20.01.2019;21:28:05;81561352;81455745;105607;
20.01.2019;21:29:05;81561592;81455795;105797;
20.01.2019;21:30:08;81561829;81455821;106008;
20.01.2019;21:31:05;81562021;81455876;106145;
20.01.2019;21:32:05;81562235;81455927;106308;
20.01.2019;21:33:04;81562431;81455984;106447;
20.01.2019;21:34:04;81562630;81456033;106597;
20.01.2019;21:35:05;81562872;81456079;106793;
20.01.2019;21:36:05;81563110;81456128;106982;
20.01.2019;21:37:05;81563315;81456183;107132;
20.01.2019;21:38:06;81563555;81456241;107314;
20.01.2019;21:39:05;81563783;81456281;107502;
20.01.2019;21:40:04;81564033;81456328;107705;
20.01.2019;21:41:04;81564199;81456313;107886;
20.01.2019;21:42:05;81564400;81456355;108045;
20.01.2019;21:43:05;81564591;81456405;108186;
20.01.2019;21:44:05;81564813;81456462;108351;
20.01.2019;21:45:04;81565046;81456511;108535;
20.01.2019;21:46:06;81565287;81456559;108728;
20.01.2019;21:47:08;81565522;81456595;108927;
20.01.2019;21:48:05;81565780;81456664;109116;
20.01.2019;21:49:05;81565999;81456720;109279;
20.01.2019;21:50:05;81566205;81456779;109426;
20.01.2019;21:51:04;81566429;81456826;109603;
20.01.2019;21:52:04;81566626;81456880;109746;
20.01.2019;21:53:05;81566846;81456905;109941;
20.01.2019;21:54:05;81567085;81456954;110131;
20.01.2019;21:55:08;81567303;81457000;110303;
20.01.2019;21:56:06;81567543;81457054;110489;
20.01.2019;21:57:05;81567770;81457097;110673;
20.01.2019;21:58:04;81567968;81457151;110817;
20.01.2019;21:59:04;81568161;81457198;110963;
20.01.2019;22:00:05;81568370;81457255;111115;
20.01.2019;22:01:05;81568551;81457296;111255;
20.01.2019;22:02:10;81568782;81457321;111461;
20.01.2019;22:03:08;81568980;81457361;111619;
20.01.2019;22:04:05;81569166;81457414;111752;
20.01.2019;22:05:05;81569365;81457471;111894;
20.01.2019;22:06:05;81569567;81457514;112053;
20.01.2019;22:07:06;81569792;81457562;112230;
20.01.2019;22:08:04;81569980;81457601;112379;
20.01.2019;22:09:04;81570171;81457642;112529;
20.01.2019;22:10:04;81570381;81457669;112712;
20.01.2019;22:11:07;81570608;81457711;112897;
20.01.2019;22:12:05;81570849;81457764;113085;
20.01.2019;22:13:05;81571017;81457814;113203;
20.01.2019;22:14:05;81571214;81457841;113373;
20.01.2019;22:15:04;81571374;81457887;113487;
20.01.2019;22:16:04;81571516;81457904;113612;
20.01.2019;22:17:04;81571657;81457923;113734;
20.01.2019;22:18:04;81571795;81457937;113858;
20.01.2019;22:19:04;81571912;81457945;113967;
20.01.2019;22:20:08;81571998;81457967;114031;
20.01.2019;22:21:05;81572092;81457978;114114;
20.01.2019;22:22:05;81572203;81457987;114216;
20.01.2019;22:23:05;81572312;81458026;114286;
20.01.2019;22:24:04;81572413;81458040;114373;
20.01.2019;22:25:05;81572564;81458077;114487;
20.01.2019;22:26:05;81572674;81458098;114576;
20.01.2019;22:27:06;81572803;81458130;114673;
20.01.2019;22:28:07;81572933;81458168;114765;
20.01.2019;22:29:05;81573093;81458193;114900;
20.01.2019;22:30:05;81573189;81458222;114967;
20.01.2019;22:31:04;81573303;81458259;115044;
20.01.2019;22:32:05;81573457;81458289;115168;
20.01.2019;22:33:05;81573600;81458321;115279;
20.01.2019;22:34:04;81573764;81458350;115414;
20.01.2019;22:35:04;81573900;81458378;115522;
20.01.2019;22:36:04;81574041;81458392;115649;
20.01.2019;22:37:07;81574153;81458426;115727;
20.01.2019;22:38:04;81574290;81458449;115841;
20.01.2019;22:39:04;81574465;81458481;115984;
20.01.2019;22:40:04;81574637;81458510;116127;
20.01.2019;22:41:04;81574844;81458529;116315;
20.01.2019;22:42:04;81574973;81458560;116413;
20.01.2019;22:43:04;81575116;81458597;116519;
20.01.2019;22:44:05;81575281;81458630;116651;
20.01.2019;22:45:07;81575457;81458673;116784;
20.01.2019;22:46:04;81575631;81458699;116932;
20.01.2019;22:47:04;81575849;81458729;117120;
20.01.2019;22:48:05;81576047;81458759;117288;
20.01.2019;22:49:05;81576242;81458781;117461;
20.01.2019;22:50:04;81576433;81458814;117619;
20.01.2019;22:51:04;81576624;81458856;117768;
20.01.2019;22:52:06;81576812;81458895;117917;
20.01.2019;22:53:05;81576991;81458937;118054;
20.01.2019;22:54:06;81577192;81458972;118220;
20.01.2019;22:55:05;81577368;81458996;118372;
20.01.2019;22:56:04;81577554;81459024;118530;
20.01.2019;22:57:05;81577733;81459045;118688;
20.01.2019;22:58:05;81577918;81459087;118831;
20.01.2019;22:59:05;81578107;81459114;118993;
20.01.2019;23:00:05;81578286;81459144;119142;
20.01.2019;23:01:04;81578470;81459179;119291;
20.01.2019;23:02:06;81578661;81459213;119448;
20.01.2019;23:03:04;81578874;81459243;119631;
20.01.2019;23:04:04;81579050;81459281;119769;
20.01.2019;23:05:05;81579210;81459317;119893;
20.01.2019;23:06:05;81579384;81459355;120029;
20.01.2019;23:07:05;81579533;81459391;120142;
20.01.2019;23:08:06;81579700;81459418;120282;
20.01.2019;23:09:05;81579905;81459454;120451;
20.01.2019;23:10:05;81580082;81459494;120588;
20.01.2019;23:11:07;81580261;81459517;120744;
20.01.2019;23:12:04;81580448;81459540;120908;
20.01.2019;23:13:05;81580638;81459568;121070;
20.01.2019;23:14:04;81580824;81459610;121214;
20.01.2019;23:15:05;81580995;81459629;121366;
20.01.2019;23:16:05;81581186;81459657;121529;
20.01.2019;23:17:04;81581370;81459687;121683;
20.01.2019;23:18:04;81581533;81459729;121804;
20.01.2019;23:19:07;81581745;81459756;121989;
20.01.2019;23:20:05;81581917;81459786;122131;
20.01.2019;23:21:05;81582093;81459816;122277;
20.01.2019;23:22:06;81582253;81459852;122401;
20.01.2019;23:23:05;81582404;81459894;122510;
20.01.2019;23:24:05;81582550;81459931;122619;
20.01.2019;23:25:05;81582736;81459963;122773;
20.01.2019;23:26:05;81582888;81460008;122880;
20.01.2019;23:27:05;81583062;81460028;123034;
20.01.2019;23:28:06;81583252;81460052;123200;
20.01.2019;23:29:04;81583411;81460086;123325;
20.01.2019;23:30:05;81583591;81460111;123480;
20.01.2019;23:31:04;81583739;81460129;123610;
20.01.2019;23:32:05;81583912;81460162;123750;
20.01.2019;23:33:04;81584090;81460183;123907;
20.01.2019;23:34:05;81584259;81460197;124062;
20.01.2019;23:35:05;81584402;81460231;124171;
20.01.2019;23:36:05;81584596;81460259;124337;
20.01.2019;23:37:05;81584724;81460297;124427;
20.01.2019;23:38:05;81584895;81460325;124570;
20.01.2019;23:39:05;81585047;81460349;124698;
20.01.2019;23:40:04;81585224;81460389;124835;
20.01.2019;23:42:04;81585557;81460434;125123;
20.01.2019;23:43:05;81585706;81460464;125242;
20.01.2019;23:44:05;81585912;81460497;125415;
20.01.2019;23:45:05;81586086;81460516;125570;
20.01.2019;23:46:04;81586235;81460550;125685;
20.01.2019;23:47:04;81586401;81460582;125819;
20.01.2019;23:48:04;81586559;81460607;125952;
20.01.2019;23:49:05;81586719;81460634;126085;
20.01.2019;23:50:04;81586869;81460652;126217;
20.01.2019;23:51:05;81587026;81460683;126343;
20.01.2019;23:52:04;81587224;81460714;126510;
20.01.2019;23:53:05;81587392;81460749;126643;
20.01.2019;23:54:05;81587554;81460782;126772;
20.01.2019;23:55:04;81587702;81460803;126899;
20.01.2019;23:56:04;81587865;81460817;127048;
20.01.2019;23:57:05;81588014;81460849;127165;
20.01.2019;23:58:04;81588155;81460874;127281;
20.01.2019;23:59:05;81588309;81460904;127405;
21.01.2019;00:00:07;81588479;81460923;127556;
21.01.2019;00:01:08;81588625;81460951;127674;
21.01.2019;00:02:08;81588792;81460988;127804;
21.01.2019;00:03:08;81588956;81461008;127948;
21.01.2019;00:04:08;81589111;81461046;128065;
21.01.2019;00:05:08;81589246;81461083;128163;
21.01.2019;00:06:09;81589400;81461114;128286;
21.01.2019;00:07:08;81589545;81461148;128397;
21.01.2019;00:08:08;81589674;81461174;128500;
21.01.2019;00:09:08;81589806;81461198;128608;
21.01.2019;00:10:07;81589927;81461225;128702;
21.01.2019;00:11:07;81589996;81461252;128744;
21.01.2019;00:12:08;81590051;81461269;128782;
21.01.2019;00:13:07;81590143;81461290;128853;
21.01.2019;00:14:07;81590241;81461309;128932;
21.01.2019;00:15:07;81590374;81461333;129041;
21.01.2019;00:16:07;81590461;81461364;129097;
21.01.2019;00:17:08;81590530;81461386;129144;
21.01.2019;00:18:07;81590578;81461408;129170;
21.01.2019;00:19:08;81590646;81461412;129234;
21.01.2019;00:20:07;81590735;81461426;129309;
21.01.2019;00:21:07;81590813;81461465;129348;
21.01.2019;00:22:07;81590903;81461478;129425;
21.01.2019;00:23:08;81591011;81461509;129502;
21.01.2019;00:24:08;81591074;81461527;129547;
21.01.2019;00:25:07;81591146;81461546;129600;
21.01.2019;00:26:07;81591212;81461571;129641;
21.01.2019;00:27:07;81591279;81461585;129694;
21.01.2019;00:28:08;81591341;81461615;129726;
21.01.2019;00:29:08;81591421;81461646;129775;
21.01.2019;00:30:07;81591522;81461654;129868;
21.01.2019;00:31:07;81591628;81461680;129948;
21.01.2019;00:32:07;81591732;81461699;130033;
21.01.2019;00:33:08;81591833;81461722;130111;
21.01.2019;00:34:07;81591937;81461756;130181;
21.01.2019;00:35:08;81592029;81461790;130239;
21.01.2019;00:36:07;81592134;81461812;130322;
21.01.2019;00:37:08;81592242;81461846;130396;
21.01.2019;00:38:08;81592342;81461867;130475;
21.01.2019;00:39:08;81592480;81461904;130576;
21.01.2019;00:40:08;81592604;81461936;130668;
21.01.2019;00:41:08;81592718;81461964;130754;
21.01.2019;00:42:14;81592834;81461954;130880;
21.01.2019;00:43:12;81592965;81461974;130991;
21.01.2019;00:44:11;81593090;81462012;131078;
21.01.2019;00:45:14;81593261;81462037;131224;
21.01.2019;00:46:11;81593386;81462058;131328;
21.01.2019;00:47:17;81593519;81462084;131435;
21.01.2019;00:48:13;81593624;81462108;131516;
21.01.2019;00:49:13;81593734;81462143;131591;
21.01.2019;00:50:12;81593841;81462171;131670;
21.01.2019;00:51:12;81593972;81462196;131776;
21.01.2019;00:52:11;81594108;81462223;131885;
21.01.2019;00:53:10;81594254;81462250;132004;
21.01.2019;00:54:11;81594383;81462289;132094;
21.01.2019;00:55:10;81594514;81462314;132200;
21.01.2019;00:56:10;81594654;81462353;132301;
21.01.2019;00:57:07;81594783;81462381;132402;
21.01.2019;00:58:08;81594909;81462409;132500;
21.01.2019;01:00:03;81595150;81462477;132673;
21.01.2019;01:01:04;81595269;81462497;132772;
21.01.2019;01:02:05;81595392;81462507;132885;
21.01.2019;01:03:04;81595513;81462531;132982;
21.01.2019;01:04:04;81595648;81462557;133091;
21.01.2019;01:05:05;81595785;81462583;133202;
21.01.2019;01:06:05;81595923;81462620;133303;
21.01.2019;01:07:04;81596062;81462660;133402;
21.01.2019;01:08:05;81596199;81462687;133512;
21.01.2019;01:09:05;81596320;81462715;133605;
21.01.2019;01:10:05;81596434;81462757;133677;
21.01.2019;01:11:04;81596549;81462799;133750;
21.01.2019;01:12:04;81596664;81462816;133848;
21.01.2019;01:13:05;81596794;81462851;133943;
21.01.2019;01:14:05;81596915;81462889;134026;
21.01.2019;01:15:05;81597031;81462912;134119;
21.01.2019;01:16:04;81597127;81462947;134180;
21.01.2019;01:17:04;81597247;81462985;134262;
21.01.2019;01:18:05;81597384;81463020;134364;
21.01.2019;01:19:05;81597510;81463057;134453;
21.01.2019;01:20:04;81597637;81463098;134539;
21.01.2019;01:21:04;81597758;81463148;134610;
21.01.2019;01:22:04;81597885;81463184;134701;
21.01.2019;01:23:04;81598015;81463225;134790;
21.01.2019;01:24:04;81598139;81463263;134876;
21.01.2019;01:25:05;81598276;81463293;134983;
21.01.2019;01:26:04;81598404;81463330;135074;
21.01.2019;01:27:05;81598535;81463368;135167;
21.01.2019;01:28:05;81598626;81463407;135219;
21.01.2019;01:29:04;81598745;81463449;135296;
21.01.2019;01:30:10;81598845;81463492;135353;
21.01.2019;01:31:04;81598974;81463522;135452;
21.01.2019;01:32:04;81599100;81463575;135525;
21.01.2019;01:33:05;81599206;81463607;135599;
21.01.2019;01:34:04;81599329;81463640;135689;
21.01.2019;01:35:05;81599439;81463675;135764;
21.01.2019;01:36:05;81599558;81463702;135856;
21.01.2019;01:37:05;81599676;81463741;135935;
21.01.2019;01:38:05;81599827;81463794;136033;
21.01.2019;01:39:06;81599946;81463829;136117;
21.01.2019;01:40:04;81600043;81463869;136174;
21.01.2019;01:41:05;81600160;81463913;136247;
21.01.2019;01:42:04;81600269;81463965;136304;
21.01.2019;01:43:04;81600376;81464015;136361;
21.01.2019;01:44:05;81600495;81464049;136446;
21.01.2019;01:45:04;81600619;81464094;136525;
21.01.2019;01:46:05;81600734;81464147;136587;
21.01.2019;01:47:05;81600850;81464197;136653;
21.01.2019;01:48:04;81600988;81464241;136747;
21.01.2019;01:49:05;81601108;81464287;136821;
21.01.2019;01:50:05;81601234;81464346;136888;
21.01.2019;01:51:04;81601355;81464397;136958;
21.01.2019;01:52:04;81601476;81464445;137031;
21.01.2019;01:53:05;81601596;81464485;137111;
21.01.2019;01:54:04;81601714;81464559;137155;
21.01.2019;01:55:04;81601832;81464612;137220;
21.01.2019;01:56:05;81601956;81464660;137296;
21.01.2019;01:57:04;81602063;81464705;137358;
21.01.2019;01:58:04;81602179;81464755;137424;
21.01.2019;01:59:05;81602278;81464807;137471;
21.01.2019;02:00:05;81602393;81464865;137528;
21.01.2019;02:01:04;81602506;81464912;137594;
21.01.2019;02:02:04;81602640;81464974;137666;
21.01.2019;02:03:05;81602758;81465015;137743;
21.01.2019;02:04:04;81602879;81465077;137802;
21.01.2019;02:05:04;81602991;81465134;137857;
21.01.2019;02:06:05;81603127;81465192;137935;
21.01.2019;02:07:04;81603249;81465243;138006;
21.01.2019;02:08:04;81603381;81465315;138066;
21.01.2019;02:09:05;81603482;81465370;138112;
21.01.2019;02:10:05;81603620;81465431;138189;
21.01.2019;02:11:04;81603749;81465474;138275;
21.01.2019;02:12:10;81603831;81465537;138294;
21.01.2019;02:13:05;81603942;81465590;138352;
21.01.2019;02:14:04;81604055;81465653;138402;
21.01.2019;02:15:05;81604164;81465705;138459;
21.01.2019;02:16:05;81604256;81465757;138499;
21.01.2019;02:17:05;81604326;81465817;138509;
21.01.2019;02:18:05;81604419;81465874;138545;
21.01.2019;02:19:05;81604525;81465946;138579;
21.01.2019;02:20:05;81604612;81466001;138611;
21.01.2019;02:21:04;81604654;81466068;138586;
21.01.2019;02:22:04;81604727;81466124;138603;
21.01.2019;02:23:05;81604810;81466182;138628;
21.01.2019;02:24:09;81604865;81466247;138618;
21.01.2019;02:25:04;81604930;81466295;138635;
21.01.2019;02:26:05;81605010;81466351;138659;
21.01.2019;02:27:04;81605095;81466416;138679;
21.01.2019;02:28:05;81605183;81466487;138696;
21.01.2019;02:29:05;81605253;81466563;138690;
21.01.2019;02:30:04;81605351;81466621;138730;
21.01.2019;02:31:04;81605443;81466681;138762;
21.01.2019;02:32:05;81605501;81466752;138749;
21.01.2019;02:33:04;81605589;81466815;138774;
21.01.2019;02:34:05;81605664;81466883;138781;
21.01.2019;02:35:05;81605732;81466943;138789;
21.01.2019;02:36:04;81605827;81467014;138813;
21.01.2019;02:37:04;81605927;81467079;138848;
21.01.2019;02:38:05;81606010;81467164;138846;
21.01.2019;02:39:05;81606120;81467245;138875;
21.01.2019;02:40:05;81606213;81467310;138903;
21.01.2019;02:41:04;81606332;81467375;138957;
21.01.2019;02:42:05;81606447;81467455;138992;
21.01.2019;02:43:05;81606553;81467531;139022;
21.01.2019;02:44:04;81606675;81467594;139081;
21.01.2019;02:45:04;81606810;81467662;139148;
21.01.2019;02:46:04;81606920;81467742;139178;
21.01.2019;02:47:04;81607038;81467808;139230;
21.01.2019;02:48:05;81607162;81467892;139270;
21.01.2019;02:49:04;81607265;81467978;139287;
21.01.2019;02:50:04;81607379;81468054;139325;
21.01.2019;02:51:05;81607504;81468139;139365;
21.01.2019;02:52:04;81607635;81468213;139422;
21.01.2019;02:53:05;81607772;81468315;139457;
21.01.2019;02:54:05;81607921;81468400;139521;
21.01.2019;02:55:05;81608023;81468465;139558;
21.01.2019;02:56:05;81608135;81468554;139581;
21.01.2019;02:57:05;81608265;81468654;139611;
21.01.2019;02:58:04;81608377;81468745;139632;
21.01.2019;02:59:04;81608507;81468842;139665;
21.01.2019;03:00:05;81608591;81468929;139662;
21.01.2019;03:01:04;81608780;81469023;139757;
21.01.2019;03:02:04;81608882;81469102;139780;
21.01.2019;03:03:05;81609005;81469200;139805;
21.01.2019;03:04:04;81609122;81469277;139845;
21.01.2019;03:05:05;81609239;81469342;139897;
21.01.2019;03:06:05;81609356;81469436;139920;
21.01.2019;03:07:04;81609469;81469523;139946;
21.01.2019;03:08:05;81609587;81469611;139976;
21.01.2019;03:09:05;81609688;81469706;139982;
21.01.2019;03:10:04;81609809;81469803;140006;
21.01.2019;03:11:05;81609932;81469902;140030;
21.01.2019;03:12:05;81610048;81470000;140048;
21.01.2019;03:13:05;81610176;81470109;140067;
21.01.2019;03:14:05;81610308;81470221;140087;
21.01.2019;03:15:05;81610431;81470331;140100;
21.01.2019;03:16:04;81610554;81470420;140134;
21.01.2019;03:17:05;81610685;81470506;140179;
21.01.2019;03:18:05;81610827;81470614;140213;
21.01.2019;03:19:04;81610950;81470702;140248;
21.01.2019;03:20:04;81611074;81470794;140280;
21.01.2019;03:21:05;81611234;81470899;140335;
21.01.2019;03:22:04;81611370;81471000;140370;
21.01.2019;03:23:04;81611489;81471081;140408;
21.01.2019;03:24:05;81611603;81471190;140413;
21.01.2019;03:25:05;81611725;81471291;140434;
21.01.2019;03:26:05;81611842;81471376;140466;
21.01.2019;03:27:04;81611964;81471483;140481;
21.01.2019;03:28:05;81612081;81471605;140476;
21.01.2019;03:29:05;81612195;81471693;140502;
21.01.2019;03:30:04;81612313;81471809;140504;
21.01.2019;03:31:05;81612424;81471917;140507;
21.01.2019;03:32:05;81612537;81472007;140530;
21.01.2019;03:33:04;81612641;81472100;140541;
21.01.2019;03:34:05;81612752;81472194;140558;
21.01.2019;03:35:04;81612857;81472293;140564;
21.01.2019;03:36:04;81612964;81472393;140571;
21.01.2019;03:37:05;81613058;81472502;140556;
21.01.2019;03:38:04;81613157;81472594;140563;
21.01.2019;03:39:05;81613271;81472691;140580;
21.01.2019;03:40:04;81613397;81472792;140605;
21.01.2019;03:41:04;81613502;81472893;140609;
21.01.2019;03:42:05;81613629;81472999;140630;
21.01.2019;03:43:04;81613747;81473108;140639;
21.01.2019;03:44:05;81613870;81473221;140649;
21.01.2019;03:45:04;81613959;81473317;140642;
21.01.2019;03:46:04;81614074;81473406;140668;
21.01.2019;03:47:05;81614189;81473515;140674;
21.01.2019;03:48:04;81614296;81473607;140689;
21.01.2019;03:49:04;81614392;81473728;140664;
21.01.2019;03:50:05;81614539;81473863;140676;
21.01.2019;03:51:05;81614660;81473959;140701;
21.01.2019;03:52:05;81614722;81474038;140684;
21.01.2019;03:53:05;81614832;81474148;140684;
21.01.2019;03:54:04;81614901;81474247;140654;
21.01.2019;03:55:05;81615014;81474350;140664;
21.01.2019;03:56:04;81615109;81474455;140654;
21.01.2019;03:57:04;81615210;81474567;140643;
21.01.2019;03:58:05;81615352;81474669;140683;
21.01.2019;03:59:04;81615460;81474750;140710;
21.01.2019;04:00:05;81615577;81474846;140731;
21.01.2019;04:01:05;81615707;81474965;140742;
21.01.2019;04:02:04;81615814;81475076;140738;
21.01.2019;04:03:05;81615923;81475180;140743;
21.01.2019;04:04:04;81616025;81475307;140718;
21.01.2019;04:05:04;81616144;81475410;140734;
21.01.2019;04:06:05;81616251;81475520;140731;
21.01.2019;04:07:04;81616365;81475636;140729;
21.01.2019;04:08:04;81616480;81475746;140734;
21.01.2019;04:09:05;81616591;81475851;140740;
21.01.2019;04:10:04;81616703;81475961;140742;
21.01.2019;04:11:05;81616809;81476074;140735;
21.01.2019;04:12:05;81616883;81476176;140707;
21.01.2019;04:13:05;81616949;81476293;140656;
21.01.2019;04:14:04;81616999;81476401;140598;
21.01.2019;04:15:04;81617088;81476492;140596;
21.01.2019;04:16:05;81617157;81476604;140553;
21.01.2019;04:17:04;81617243;81476704;140539;
21.01.2019;04:18:04;81617293;81476806;140487;
21.01.2019;04:19:05;81617395;81476911;140484;
21.01.2019;04:20:05;81617492;81477010;140482;
21.01.2019;04:21:04;81617597;81477120;140477;
21.01.2019;04:22:05;81617678;81477251;140427;
21.01.2019;04:23:05;81617787;81477354;140433;
21.01.2019;04:24:04;81617884;81477447;140437;
21.01.2019;04:25:04;81617965;81477536;140429;
21.01.2019;04:26:05;81618077;81477655;140422;
21.01.2019;04:27:04;81618189;81477772;140417;
21.01.2019;04:28:04;81618270;81477902;140368;
21.01.2019;04:29:05;81618370;81478017;140353;
21.01.2019;04:30:04;81618488;81478107;140381;
21.01.2019;04:31:04;81618610;81478199;140411;
21.01.2019;04:32:04;81618717;81478322;140395;
21.01.2019;04:33:04;81618833;81478431;140402;
21.01.2019;04:34:04;81618950;81478535;140415;
21.01.2019;04:35:05;81619055;81478661;140394;
21.01.2019;04:36:04;81619173;81478777;140396;
21.01.2019;04:37:05;81619299;81478869;140430;
21.01.2019;04:38:04;81619415;81479001;140414;
21.01.2019;04:39:07;81619540;81479120;140420;
21.01.2019;04:40:04;81619649;81479220;140429;
21.01.2019;04:41:04;81619762;81479352;140410;
21.01.2019;04:42:05;81619876;81479480;140396;
21.01.2019;04:43:04;81620005;81479614;140391;
21.01.2019;04:44:05;81620108;81479733;140375;
21.01.2019;04:45:04;81620210;81479849;140361;
21.01.2019;04:46:04;81620319;81479938;140381;
21.01.2019;04:47:04;81620447;81480029;140418;
21.01.2019;04:48:05;81620556;81480132;140424;
21.01.2019;04:49:05;81620668;81480259;140409;
21.01.2019;04:50:04;81620767;81480371;140396;
21.01.2019;04:51:04;81620896;81480475;140421;
21.01.2019;04:52:05;81620997;81480575;140422;
21.01.2019;04:53:04;81621131;81480683;140448;
21.01.2019;04:54:04;81621280;81480790;140490;
21.01.2019;04:55:05;81621391;81480911;140480;
21.01.2019;04:56:04;81621500;81481018;140482;
21.01.2019;04:57:04;81621620;81481128;140492;
21.01.2019;04:58:05;81621725;81481238;140487;
21.01.2019;04:59:05;81621855;81481337;140518;
21.01.2019;05:00:04;81621980;81481430;140550;
21.01.2019;05:01:04;81622101;81481533;140568;
21.01.2019;05:02:05;81622220;81481635;140585;
21.01.2019;05:03:04;81622352;81481742;140610;
21.01.2019;05:04:04;81622463;81481888;140575;
21.01.2019;05:05:05;81622558;81481991;140567;
21.01.2019;05:06:04;81622693;81482095;140598;
21.01.2019;05:07:04;81622819;81482227;140592;
21.01.2019;05:08:05;81622930;81482347;140583;
21.01.2019;05:09:07;81623050;81482471;140579;
21.01.2019;05:10:05;81623175;81482568;140607;
21.01.2019;05:11:05;81623290;81482687;140603;
21.01.2019;05:12:04;81623395;81482797;140598;
21.01.2019;05:13:05;81623491;81482914;140577;
21.01.2019;05:14:04;81623604;81483042;140562;
21.01.2019;05:15:04;81623723;81483176;140547;
21.01.2019;05:16:05;81623842;81483301;140541;
21.01.2019;05:17:04;81623943;81483415;140528;
21.01.2019;05:18:04;81624043;81483532;140511;
21.01.2019;05:19:05;81624160;81483651;140509;
21.01.2019;05:20:04;81624288;81483774;140514;
21.01.2019;05:21:04;81624393;81483887;140506;
21.01.2019;05:22:05;81624517;81484012;140505;
21.01.2019;05:23:04;81624608;81484116;140492;
21.01.2019;05:24:05;81624713;81484221;140492;
21.01.2019;05:25:04;81624818;81484338;140480;
21.01.2019;05:26:04;81624958;81484451;140507;
21.01.2019;05:27:05;81625077;81484574;140503;
21.01.2019;05:28:04;81625174;81484686;140488;
21.01.2019;05:29:04;81625290;81484812;140478;
21.01.2019;05:30:04;81625385;81484898;140487;
21.01.2019;05:31:05;81625491;81485014;140477;
21.01.2019;05:32:04;81625601;81485112;140489;
21.01.2019;05:33:04;81625712;81485201;140511;
21.01.2019;05:34:05;81625828;81485326;140502;
21.01.2019;05:35:04;81625932;81485440;140492;
21.01.2019;05:36:05;81626062;81485555;140507;
21.01.2019;05:37:04;81626186;81485663;140523;
21.01.2019;05:38:04;81626295;81485785;140510;
21.01.2019;05:39:06;81626400;81485912;140488;
21.01.2019;05:40:05;81626502;81486030;140472;
21.01.2019;05:41:04;81626609;81486164;140445;
21.01.2019;05:42:04;81626705;81486297;140408;
21.01.2019;05:43:05;81626806;81486445;140361;
21.01.2019;05:44:05;81626914;81486546;140368;
21.01.2019;05:45:05;81627029;81486664;140365;
21.01.2019;05:46:05;81627136;81486769;140367;
21.01.2019;05:47:04;81627233;81486888;140345;
21.01.2019;05:48:05;81627346;81487005;140341;
21.01.2019;05:49:05;81627451;81487124;140327;
21.01.2019;05:50:04;81627547;81487236;140311;
21.01.2019;05:51:05;81627669;81487342;140327;
21.01.2019;05:52:04;81627769;81487442;140327;
21.01.2019;05:53:04;81627891;81487569;140322;
21.01.2019;05:54:05;81628005;81487698;140307;
21.01.2019;05:55:09;81628122;81487842;140280;
21.01.2019;05:56:05;81628230;81487947;140283;
21.01.2019;05:57:05;81628366;81488064;140302;
21.01.2019;05:58:05;81628481;81488180;140301;
21.01.2019;05:59:05;81628595;81488299;140296;
21.01.2019;06:00:05;81628698;81488402;140296;
21.01.2019;06:01:04;81628791;81488503;140288;
21.01.2019;06:02:04;81628905;81488609;140296;
21.01.2019;06:03:05;81629007;81488711;140296;
21.01.2019;06:04:05;81629109;81488837;140272;
21.01.2019;06:05:06;81629221;81488967;140254;
21.01.2019;06:06:04;81629330;81489087;140243;
21.01.2019;06:07:04;81629418;81489195;140223;
21.01.2019;06:08:05;81629505;81489287;140218;
21.01.2019;06:09:04;81629574;81489396;140178;
21.01.2019;06:10:04;81629660;81489497;140163;
21.01.2019;06:11:05;81629742;81489616;140126;
21.01.2019;06:12:04;81629842;81489711;140131;
21.01.2019;06:13:05;81629914;81489831;140083;
21.01.2019;06:14:05;81630022;81489925;140097;
21.01.2019;06:15:04;81630124;81490046;140078;
21.01.2019;06:16:05;81630201;81490166;140035;
21.01.2019;06:17:05;81630301;81490275;140026;
21.01.2019;06:18:05;81630374;81490403;139971;
21.01.2019;06:19:04;81630452;81490514;139938;
21.01.2019;06:20:04;81630552;81490640;139912;
21.01.2019;06:21:05;81630615;81490739;139876;
21.01.2019;06:22:04;81630678;81490867;139811;
21.01.2019;06:23:04;81630733;81490996;139737;
21.01.2019;06:24:05;81630814;81491106;139708;
21.01.2019;06:25:07;81630907;81491237;139670;
21.01.2019;06:26:05;81630998;81491311;139687;
21.01.2019;06:27:04;81631092;81491411;139681;
21.01.2019;06:28:05;81631204;81491515;139689;
21.01.2019;06:29:05;81631284;81491640;139644;
21.01.2019;06:30:04;81631408;81491758;139650;
21.01.2019;06:31:04;81631505;81491851;139654;
21.01.2019;06:32:04;81631615;81491991;139624;
21.01.2019;06:33:05;81631730;81492112;139618;
21.01.2019;06:34:04;81631831;81492235;139596;
21.01.2019;06:35:04;81631966;81492361;139605;
21.01.2019;06:36:05;81632083;81492488;139595;
21.01.2019;06:37:04;81632171;81492617;139554;
21.01.2019;06:38:05;81632268;81492709;139559;
21.01.2019;06:39:05;81632357;81492830;139527;
21.01.2019;06:40:05;81632483;81492956;139527;
21.01.2019;06:41:04;81632585;81493076;139509;
21.01.2019;06:42:04;81632692;81493198;139494;
21.01.2019;06:43:05;81632801;81493299;139502;
21.01.2019;06:44:05;81632920;81493408;139512;
21.01.2019;06:45:04;81633016;81493542;139474;
21.01.2019;06:46:04;81633118;81493673;139445;
21.01.2019;06:47:04;81633218;81493792;139426;
21.01.2019;06:48:05;81633319;81493909;139410;
21.01.2019;06:49:05;81633408;81494023;139385;
21.01.2019;06:50:05;81633492;81494138;139354;
21.01.2019;06:51:04;81633588;81494269;139319;
21.01.2019;06:52:04;81633692;81494392;139300;
21.01.2019;06:53:05;81633796;81494520;139276;
21.01.2019;06:54:05;81633848;81494632;139216;
21.01.2019;06:55:04;81633938;81494719;139219;
21.01.2019;06:56:04;81634022;81494872;139150;
21.01.2019;06:57:05;81634100;81495028;139072;
21.01.2019;06:58:05;81634198;81495159;139039;
21.01.2019;06:59:04;81634289;81495291;138998;
21.01.2019;07:00:04;81634394;81495446;138948;
21.01.2019;07:01:04;81634477;81495596;138881;
21.01.2019;07:02:04;81634578;81495725;138853;
21.01.2019;07:03:05;81634683;81495876;138807;
21.01.2019;07:04:05;81634757;81495999;138758;
21.01.2019;07:05:04;81634846;81496135;138711;
21.01.2019;07:06:04;81634956;81496253;138703;
21.01.2019;07:07:04;81635056;81496391;138665;
21.01.2019;07:08:05;81635142;81496526;138616;
21.01.2019;07:09:05;81635234;81496677;138557;
21.01.2019;07:10:05;81635344;81496799;138545;
21.01.2019;07:11:05;81635435;81496920;138515;
21.01.2019;07:12:05;81635537;81497057;138480;
21.01.2019;07:13:05;81635647;81497180;138467;
21.01.2019;07:14:04;81635745;81497305;138440;
21.01.2019;07:15:04;81635845;81497423;138422;
21.01.2019;07:16:05;81635952;81497541;138411;
21.01.2019;07:17:05;81636068;81497697;138371;
21.01.2019;07:18:05;81636161;81497835;138326;
21.01.2019;07:19:06;81636265;81497942;138323;
21.01.2019;07:20:05;81636363;81498091;138272;
21.01.2019;07:21:04;81636462;81498234;138228;
21.01.2019;07:22:05;81636566;81498367;138199;
21.01.2019;07:23:05;81636667;81498506;138161;
21.01.2019;07:24:04;81636759;81498622;138137;
21.01.2019;07:25:04;81636848;81498750;138098;
21.01.2019;07:26:05;81636941;81498875;138066;
21.01.2019;07:27:05;81637049;81499017;138032;
21.01.2019;07:28:04;81637155;81499156;137999;
21.01.2019;07:29:04;81637233;81499305;137928;
21.01.2019;07:30:05;81637332;81499443;137889;
21.01.2019;07:31:04;81637432;81499569;137863;
21.01.2019;07:32:04;81637513;81499688;137825;
21.01.2019;07:33:05;81637604;81499815;137789;
21.01.2019;07:34:04;81637707;81499981;137726;
21.01.2019;07:35:04;81637805;81500116;137689;
21.01.2019;07:36:04;81637925;81500248;137677;
21.01.2019;07:37:04;81638022;81500366;137656;
21.01.2019;07:38:04;81638116;81500505;137611;
21.01.2019;07:39:05;81638230;81500632;137598;
21.01.2019;07:40:05;81638320;81500766;137554;
21.01.2019;07:41:05;81638407;81500896;137511;
21.01.2019;07:42:04;81638500;81501020;137480;
21.01.2019;07:43:05;81638623;81501136;137487;
21.01.2019;07:44:05;81638701;81501242;137459;
21.01.2019;07:45:04;81638803;81501365;137438;
21.01.2019;07:46:09;81638910;81501500;137410;
21.01.2019;07:47:05;81638995;81501604;137391;
21.01.2019;07:48:05;81639100;81501756;137344;
21.01.2019;07:49:05;81639202;81501896;137306;
21.01.2019;07:50:05;81639286;81502018;137268;
21.01.2019;07:51:04;81639383;81502161;137222;
21.01.2019;07:52:05;81639502;81502293;137209;
21.01.2019;07:53:05;81639605;81502427;137178;
21.01.2019;07:54:05;81639683;81502539;137144;
21.01.2019;07:55:04;81639769;81502694;137075;
21.01.2019;07:56:05;81639883;81502811;137072;
21.01.2019;07:57:04;81639971;81502915;137056;
21.01.2019;07:58:04;81640064;81503071;136993;
21.01.2019;07:59:05;81640164;81503191;136973;
21.01.2019;08:00:04;81640257;81503312;136945;
21.01.2019;08:01:05;81640360;81503442;136918;
21.01.2019;08:02:04;81640440;81503568;136872;
21.01.2019;08:03:04;81640507;81503702;136805;
21.01.2019;08:04:05;81640601;81503828;136773;
21.01.2019;08:05:04;81640689;81503956;136733;
21.01.2019;08:06:04;81640771;81504083;136688;
21.01.2019;08:07:05;81640839;81504208;136631;
21.01.2019;08:08:04;81640914;81504344;136570;
21.01.2019;08:09:06;81640998;81504479;136519;
21.01.2019;08:10:05;81641070;81504612;136458;
21.01.2019;08:11:04;81641148;81504731;136417;
21.01.2019;08:12:04;81641216;81504836;136380;
21.01.2019;08:13:05;81641281;81504969;136312;
21.01.2019;08:14:04;81641352;81505093;136259;
21.01.2019;08:15:04;81641419;81505228;136191;
21.01.2019;08:16:05;81641488;81505347;136141;
21.01.2019;08:17:05;81641591;81505455;136136;
21.01.2019;08:18:04;81641672;81505580;136092;
21.01.2019;08:19:04;81641741;81505699;136042;
21.01.2019;08:20:05;81641830;81505813;136017;
21.01.2019;08:21:04;81641924;81505932;135992;
21.01.2019;08:22:04;81641988;81506088;135900;
21.01.2019;08:23:05;81642054;81506222;135832;
21.01.2019;08:24:04;81642125;81506356;135769;
21.01.2019;08:25:04;81642199;81506461;135738;
21.01.2019;08:26:05;81642298;81506596;135702;
21.01.2019;08:27:04;81642396;81506720;135676;
21.01.2019;08:28:04;81642505;81506833;135672;
21.01.2019;08:29:05;81642617;81506946;135671;
21.01.2019;08:30:05;81642725;81507079;135646;
21.01.2019;08:31:04;81642836;81507208;135628;
21.01.2019;08:32:04;81642955;81507335;135620;
21.01.2019;08:33:05;81643064;81507472;135592;
21.01.2019;08:34:04;81643173;81507598;135575;
21.01.2019;08:35:04;81643252;81507725;135527;
21.01.2019;08:36:05;81643344;81507854;135490;
21.01.2019;08:37:05;81643443;81507989;135454;
21.01.2019;08:38:04;81643543;81508117;135426;
21.01.2019;08:39:04;81643648;81508238;135410;
21.01.2019;08:40:05;81643751;81508369;135382;
21.01.2019;08:41:05;81643848;81508523;135325;
21.01.2019;08:42:04;81643946;81508649;135297;
21.01.2019;08:43:04;81644030;81508767;135263;
21.01.2019;08:44:05;81644132;81508918;135214;
21.01.2019;08:45:04;81644228;81509050;135178;
21.01.2019;08:46:04;81644321;81509150;135171;
21.01.2019;08:47:05;81644444;81509277;135167;
21.01.2019;08:48:04;81644538;81509423;135115;
21.01.2019;08:49:04;81644649;81509566;135083;
21.01.2019;08:50:04;81644744;81509726;135018;
21.01.2019;08:51:04;81644823;81509856;134967;
21.01.2019;08:52:05;81644910;81509969;134941;
21.01.2019;08:53:04;81645002;81510107;134895;
21.01.2019;08:54:04;81645088;81510242;134846;
21.01.2019;08:55:05;81645179;81510376;134803;
21.01.2019;08:56:04;81645258;81510539;134719;
21.01.2019;08:57:04;81645360;81510662;134698;
21.01.2019;08:58:05;81645454;81510793;134661;
21.01.2019;08:59:05;81645560;81510951;134609;
21.01.2019;09:00:04;81645650;81511084;134566;
21.01.2019;09:01:04;81645756;81511230;134526;
21.01.2019;09:02:05;81645861;81511401;134460;
21.01.2019;09:03:05;81645956;81511553;134403;
21.01.2019;09:04:04;81646069;81511689;134380;
21.01.2019;09:05:04;81646156;81511819;134337;
21.01.2019;09:06:05;81646256;81511938;134318;
21.01.2019;09:07:09;81646372;81512072;134300;
21.01.2019;09:08:04;81646467;81512211;134256;
21.01.2019;09:09:05;81646569;81512374;134195;
21.01.2019;09:10:04;81646683;81512517;134166;
21.01.2019;09:11:05;81646786;81512661;134125;
21.01.2019;09:12:05;81646882;81512779;134103;
21.01.2019;09:13:05;81646984;81512895;134089;
21.01.2019;09:14:04;81647076;81513028;134048;
21.01.2019;09:15:04;81647170;81513157;134013;
21.01.2019;09:16:05;81647263;81513299;133964;
21.01.2019;09:17:05;81647356;81513437;133919;
21.01.2019;09:18:04;81647461;81513575;133886;
21.01.2019;09:19:04;81647562;81513725;133837;
21.01.2019;09:20:05;81647668;81513890;133778;
21.01.2019;09:21:04;81647761;81514027;133734;
21.01.2019;09:22:04;81647861;81514176;133685;
21.01.2019;09:23:05;81647956;81514293;133663;
21.01.2019;09:24:05;81648040;81514447;133593;
21.01.2019;09:25:04;81648126;81514576;133550;
21.01.2019;09:26:05;81648224;81514711;133513;
21.01.2019;09:27:05;81648307;81514837;133470;
21.01.2019;09:28:05;81648404;81514984;133420;
21.01.2019;09:29:05;81648474;81515117;133357;
21.01.2019;09:30:05;81648558;81515240;133318;
21.01.2019;09:31:05;81648647;81515385;133262;
21.01.2019;09:32:04;81648731;81515522;133209;
21.01.2019;09:33:04;81648814;81515665;133149;
21.01.2019;09:34:05;81648880;81515798;133082;
21.01.2019;09:35:04;81648992;81515921;133071;
21.01.2019;09:36:04;81649083;81516030;133053;
21.01.2019;09:37:05;81649157;81516159;132998;
21.01.2019;09:38:04;81649238;81516262;132976;
21.01.2019;09:39:05;81649311;81516358;132953;
21.01.2019;09:40:05;81649401;81516486;132915;
21.01.2019;09:41:04;81649492;81516617;132875;
21.01.2019;09:42:05;81649571;81516780;132791;
21.01.2019;09:43:05;81649645;81516915;132730;
21.01.2019;09:44:04;81649711;81517022;132689;
21.01.2019;09:45:05;81649794;81517155;132639;
21.01.2019;09:46:05;81649828;81517222;132606;
21.01.2019;09:47:04;81649898;81517322;132576;
21.01.2019;09:48:04;81649970;81517445;132525;
21.01.2019;09:49:05;81650073;81517583;132490;
21.01.2019;09:50:05;81650154;81517694;132460;
21.01.2019;09:51:04;81650233;81517820;132413;
21.01.2019;09:52:05;81650327;81517971;132356;
21.01.2019;09:53:04;81650417;81518103;132314;
21.01.2019;09:54:05;81650483;81518230;132253;
21.01.2019;09:55:05;81650566;81518372;132194;
21.01.2019;09:56:04;81650657;81518504;132153;
21.01.2019;09:57:05;81650733;81518630;132103;
21.01.2019;09:58:04;81650807;81518773;132034;
21.01.2019;09:59:04;81650878;81518902;131976;
21.01.2019;10:00:05;81650944;81519041;131903;
21.01.2019;10:01:05;81651022;81519158;131864;
21.01.2019;10:02:05;81651102;81519296;131806;
21.01.2019;10:03:05;81651156;81519429;131727;
21.01.2019;10:04:05;81651224;81519576;131648;
21.01.2019;10:05:04;81651295;81519708;131587;
21.01.2019;10:06:04;81651374;81519833;131541;
21.01.2019;10:07:04;81651451;81519972;131479;
21.01.2019;10:08:11;81651522;81520115;131407;
21.01.2019;10:09:06;81651601;81520260;131341;
21.01.2019;10:10:05;81651668;81520377;131291;
21.01.2019;10:11:05;81651728;81520468;131260;
21.01.2019;10:12:04;81651769;81520594;131175;
21.01.2019;10:13:05;81651809;81520726;131083;
21.01.2019;10:14:05;81651857;81520857;131000;
21.01.2019;10:15:04;81651884;81520970;130914;
21.01.2019;10:16:04;81651943;81521091;130852;
21.01.2019;10:17:05;81652008;81521231;130777;
21.01.2019;10:18:05;81652055;81521330;130725;
21.01.2019;10:19:04;81652126;81521447;130679;
21.01.2019;10:20:04;81652163;81521568;130595;
21.01.2019;10:21:05;81652227;81521663;130564;
21.01.2019;10:22:05;81652267;81521760;130507;
21.01.2019;10:23:05;81652326;81521889;130437;
21.01.2019;10:24:05;81652411;81522009;130402;
21.01.2019;10:25:04;81652485;81522131;130354;
21.01.2019;10:26:04;81652564;81522245;130319;
21.01.2019;10:27:05;81652635;81522402;130233;
21.01.2019;10:28:04;81652703;81522545;130158;
21.01.2019;10:29:10;81652775;81522688;130087;
21.01.2019;10:30:05;81652835;81522824;130011;
21.01.2019;10:31:04;81652897;81522974;129923;
21.01.2019;10:32:04;81652967;81523107;129860;
21.01.2019;10:33:05;81653029;81523265;129764;
21.01.2019;10:34:05;81653097;81523395;129702;
21.01.2019;10:35:04;81653180;81523525;129655;
21.01.2019;10:36:04;81653249;81523682;129567;
21.01.2019;10:37:05;81653326;81523832;129494;
21.01.2019;10:38:04;81653416;81523986;129430;
21.01.2019;10:39:05;81653491;81524112;129379;
21.01.2019;10:40:05;81653564;81524267;129297;
21.01.2019;10:41:05;81653647;81524407;129240;
21.01.2019;10:42:04;81653709;81524561;129148;
21.01.2019;10:43:05;81653811;81524688;129123;
21.01.2019;10:44:05;81653893;81524846;129047;
21.01.2019;10:45:05;81653978;81525005;128973;
21.01.2019;10:46:05;81654063;81525166;128897;
21.01.2019;10:47:05;81654158;81525304;128854;
21.01.2019;10:48:05;81654228;81525454;128774;
21.01.2019;10:49:04;81654306;81525589;128717;
21.01.2019;10:50:04;81654381;81525739;128642;
21.01.2019;10:51:05;81654475;81525895;128580;
21.01.2019;10:52:04;81654523;81526036;128487;
21.01.2019;10:53:05;81654600;81526185;128415;
21.01.2019;10:54:05;81654685;81526305;128380;
21.01.2019;10:55:04;81654765;81526473;128292;
21.01.2019;10:56:04;81654850;81526599;128251;
21.01.2019;10:57:05;81654944;81526727;128217;
21.01.2019;10:58:05;81655004;81526858;128146;
21.01.2019;10:59:05;81655089;81527008;128081;
21.01.2019;11:00:04;81655165;81527175;127990;
21.01.2019;11:01:04;81655239;81527322;127917;
21.01.2019;11:02:05;81655318;81527472;127846;
21.01.2019;11:03:05;81655390;81527624;127766;
21.01.2019;11:04:05;81655463;81527779;127684;
21.01.2019;11:05:05;81655535;81527949;127586;
21.01.2019;11:06:04;81655606;81528097;127509;
21.01.2019;11:07:04;81655679;81528245;127434;
21.01.2019;11:08:05;81655755;81528406;127349;
21.01.2019;11:09:06;81655819;81528600;127219;
21.01.2019;11:10:04;81655884;81528763;127121;
21.01.2019;11:11:04;81655964;81528914;127050;
21.01.2019;11:12:05;81656027;81529077;126950;
21.01.2019;11:13:05;81656109;81529164;126945;
21.01.2019;11:14:04;81656200;81529314;126886;
21.01.2019;11:15:04;81656282;81529455;126827;
21.01.2019;11:16:05;81656366;81529620;126746;
21.01.2019;11:17:04;81656439;81529741;126698;
21.01.2019;11:18:04;81656510;81529898;126612;
21.01.2019;11:19:05;81656594;81530037;126557;
21.01.2019;11:20:05;81656665;81530189;126476;
21.01.2019;11:21:05;81656752;81530315;126437;
21.01.2019;11:22:04;81656831;81530459;126372;
21.01.2019;11:23:04;81656901;81530613;126288;
21.01.2019;11:24:05;81656952;81530768;126184;
21.01.2019;11:25:05;81657026;81530928;126098;
21.01.2019;11:26:05;81657103;81531075;126028;
21.01.2019;11:27:04;81657168;81531233;125935;
21.01.2019;11:28:05;81657251;81531380;125871;
21.01.2019;11:29:05;81657340;81531532;125808;
21.01.2019;11:30:04;81657416;81531689;125727;
21.01.2019;11:31:04;81657496;81531828;125668;
21.01.2019;11:32:04;81657578;81531962;125616;
21.01.2019;11:33:05;81657630;81532080;125550;
21.01.2019;11:34:04;81657714;81532208;125506;
21.01.2019;11:35:04;81657776;81532343;125433;
21.01.2019;11:36:05;81657864;81532485;125379;
21.01.2019;11:37:05;81657949;81532612;125337;
21.01.2019;11:38:05;81658024;81532776;125248;
21.01.2019;11:39:05;81658089;81532925;125164;
21.01.2019;11:40:04;81658174;81533062;125112;
21.01.2019;11:41:05;81658247;81533214;125033;
21.01.2019;11:42:05;81658324;81533358;124966;
21.01.2019;11:43:04;81658384;81533512;124872;
21.01.2019;11:44:05;81658457;81533647;124810;
21.01.2019;11:45:05;81658541;81533794;124747;
21.01.2019;11:46:04;81658624;81533954;124670;
21.01.2019;11:47:04;81658704;81534104;124600;
21.01.2019;11:48:05;81658796;81534247;124549;
21.01.2019;11:49:04;81658873;81534403;124470;
21.01.2019;11:50:04;81658960;81534558;124402;
21.01.2019;11:51:05;81659023;81534716;124307;
21.01.2019;11:52:04;81659097;81534880;124217;
21.01.2019;11:53:05;81659189;81535021;124168;
21.01.2019;11:54:04;81659245;81535176;124069;
21.01.2019;11:55:05;81659315;81535314;124001;
21.01.2019;11:56:04;81659394;81535456;123938;
21.01.2019;11:57:05;81659470;81535626;123844;
21.01.2019;11:58:05;81659546;81535785;123761;
21.01.2019;11:59:05;81659621;81535949;123672;
21.01.2019;12:00:04;81659692;81536107;123585;
21.01.2019;12:01:05;81659783;81536264;123519;
21.01.2019;12:02:05;81659859;81536409;123450;
21.01.2019;12:03:05;81659947;81536536;123411;
21.01.2019;12:04:04;81660018;81536669;123349;
21.01.2019;12:05:04;81660077;81536812;123265;
21.01.2019;12:06:05;81660170;81536983;123187;
21.01.2019;12:07:04;81660214;81537097;123117;
21.01.2019;12:08:05;81660236;81537206;123030;
21.01.2019;12:09:06;81660256;81537273;122983;
21.01.2019;12:10:05;81660286;81537397;122889;
21.01.2019;12:11:04;81660321;81537505;122816;
21.01.2019;12:12:04;81660366;81537623;122743;
21.01.2019;12:13:05;81660399;81537760;122639;
21.01.2019;12:14:05;81660431;81537865;122566;
21.01.2019;12:15:04;81660461;81538004;122457;
21.01.2019;12:16:04;81660514;81538148;122366;
21.01.2019;12:17:05;81660582;81538269;122313;
21.01.2019;12:18:05;81660642;81538403;122239;
21.01.2019;12:19:04;81660703;81538531;122172;
21.01.2019;12:20:05;81660784;81538677;122107;
21.01.2019;12:21:05;81660856;81538813;122043;
21.01.2019;12:22:04;81660930;81538999;121931;
21.01.2019;12:23:05;81661025;81539173;121852;
21.01.2019;12:24:05;81661122;81539334;121788;
21.01.2019;12:25:04;81661224;81539487;121737;
21.01.2019;12:26:04;81661301;81539659;121642;
21.01.2019;12:27:05;81661380;81539801;121579;
21.01.2019;12:28:04;81661472;81539971;121501;
21.01.2019;12:29:04;81661550;81540113;121437;
21.01.2019;12:30:05;81661625;81540274;121351;
21.01.2019;12:31:04;81661702;81540412;121290;
21.01.2019;12:32:04;81661792;81540562;121230;
21.01.2019;12:33:05;81661873;81540704;121169;
21.01.2019;12:34:04;81661961;81540847;121114;
21.01.2019;12:35:05;81662036;81541008;121028;
21.01.2019;12:36:04;81662122;81541159;120963;
21.01.2019;12:37:04;81662211;81541316;120895;
21.01.2019;12:38:05;81662298;81541469;120829;
21.01.2019;12:39:06;81662366;81541644;120722;
21.01.2019;12:40:04;81662446;81541830;120616;
21.01.2019;12:41:05;81662517;81541992;120525;
21.01.2019;12:42:04;81662611;81542134;120477;
21.01.2019;12:43:04;81662702;81542291;120411;
21.01.2019;12:44:05;81662811;81542454;120357;
21.01.2019;12:45:04;81662887;81542599;120288;
21.01.2019;12:46:07;81662975;81542752;120223;
21.01.2019;12:47:04;81663064;81542924;120140;
21.01.2019;12:48:05;81663152;81543091;120061;
21.01.2019;12:49:05;81663233;81543253;119980;
21.01.2019;12:50:08;81663330;81543380;119950;
21.01.2019;12:51:04;81663394;81543528;119866;
21.01.2019;12:52:04;81663477;81543690;119787;
21.01.2019;12:53:05;81663558;81543848;119710;
21.01.2019;12:54:04;81663633;81544016;119617;
21.01.2019;12:55:05;81663718;81544188;119530;
21.01.2019;12:56:05;81663812;81544342;119470;
21.01.2019;12:57:04;81663920;81544506;119414;
21.01.2019;12:58:05;81663998;81544672;119326;
21.01.2019;12:59:05;81664091;81544818;119273;
21.01.2019;13:00:04;81664173;81544966;119207;
21.01.2019;13:01:04;81664245;81545131;119114;
21.01.2019;13:02:05;81664341;81545281;119060;
21.01.2019;13:03:05;81664434;81545463;118971;
21.01.2019;13:04:04;81664530;81545630;118900;
21.01.2019;13:05:05;81664624;81545795;118829;
21.01.2019;13:06:05;81664709;81545985;118724;
21.01.2019;13:07:04;81664797;81546125;118672;
21.01.2019;13:08:04;81664913;81546315;118598;
21.01.2019;13:09:05;81665028;81546494;118534;
21.01.2019;13:10:05;81665102;81546645;118457;
21.01.2019;13:11:05;81665194;81546846;118348;
21.01.2019;13:12:04;81665268;81546993;118275;
21.01.2019;13:13:05;81665382;81547172;118210;
21.01.2019;13:14:04;81665474;81547326;118148;
21.01.2019;13:15:04;81665575;81547486;118089;
21.01.2019;13:16:05;81665665;81547652;118013;
21.01.2019;13:17:05;81665790;81547839;117951;
21.01.2019;13:18:05;81665916;81548018;117898;
21.01.2019;13:19:04;81666033;81548211;117822;
21.01.2019;13:20:04;81666150;81548366;117784;
21.01.2019;13:21:05;81666241;81548510;117731;
21.01.2019;13:22:04;81666328;81548671;117657;
21.01.2019;13:23:05;81666420;81548833;117587;
21.01.2019;13:24:05;81666522;81549004;117518;
21.01.2019;13:25:04;81666634;81549188;117446;
21.01.2019;13:26:05;81666738;81549335;117403;
21.01.2019;13:27:04;81666841;81549483;117358;
21.01.2019;13:28:04;81666943;81549669;117274;
21.01.2019;13:29:05;81667050;81549861;117189;
21.01.2019;13:30:05;81667155;81550036;117119;
21.01.2019;13:31:06;81667264;81550213;117051;
21.01.2019;13:32:05;81667368;81550385;116983;
21.01.2019;13:33:04;81667478;81550554;116924;
21.01.2019;13:34:05;81667571;81550717;116854;
21.01.2019;13:35:05;81667677;81550884;116793;
21.01.2019;13:36:04;81667798;81551060;116738;
21.01.2019;13:37:04;81667906;81551213;116693;
21.01.2019;13:38:05;81668015;81551383;116632;
21.01.2019;13:39:05;81668128;81551552;116576;
21.01.2019;13:40:04;81668244;81551710;116534;
21.01.2019;13:41:04;81668336;81551884;116452;
21.01.2019;13:42:05;81668431;81552038;116393;
21.01.2019;13:43:04;81668545;81552195;116350;
21.01.2019;13:44:04;81668634;81552364;116270;
21.01.2019;13:45:05;81668740;81552554;116186;
21.01.2019;13:46:04;81668852;81552714;116138;
21.01.2019;13:47:04;81668960;81552865;116095;
21.01.2019;13:48:06;81669085;81553046;116039;
21.01.2019;13:49:04;81669209;81553206;116003;
21.01.2019;13:50:06;81669332;81553369;115963;
21.01.2019;13:51:06;81669445;81553537;115908;
21.01.2019;13:52:06;81669564;81553677;115887;
21.01.2019;13:53:05;81669664;81553846;115818;
21.01.2019;13:54:05;81669781;81554029;115752;
21.01.2019;13:55:10;81669905;81554187;115718;
21.01.2019;13:56:06;81670003;81554331;115672;
21.01.2019;13:57:05;81670105;81554494;115611;
21.01.2019;13:58:05;81670230;81554669;115561;
21.01.2019;13:59:05;81670349;81554858;115491;
21.01.2019;14:00:11;81670462;81555042;115420;
21.01.2019;14:01:05;81670569;81555172;115397;
21.01.2019;14:02:05;81670685;81555364;115321;
21.01.2019;14:03:05;81670794;81555552;115242;
21.01.2019;14:04:05;81670904;81555730;115174;
21.01.2019;14:05:04;81671021;81555899;115122;
21.01.2019;14:06:04;81671156;81556068;115088;
21.01.2019;14:07:04;81671266;81556238;115028;
21.01.2019;14:08:04;81671378;81556380;114998;
21.01.2019;14:09:05;81671461;81556515;114946;
21.01.2019;14:10:06;81671567;81556662;114905;
21.01.2019;14:11:05;81671676;81556812;114864;
21.01.2019;14:12:05;81671769;81556972;114797;
21.01.2019;14:13:05;81671870;81557125;114745;
21.01.2019;14:14:06;81671946;81557269;114677;
21.01.2019;14:15:05;81672051;81557414;114637;
21.01.2019;14:16:05;81672156;81557552;114604;
21.01.2019;14:17:05;81672260;81557682;114578;
21.01.2019;14:18:05;81672330;81557833;114497;
21.01.2019;14:19:06;81672423;81557986;114437;
21.01.2019;14:20:05;81672512;81558154;114358;
21.01.2019;14:21:05;81672616;81558300;114316;
21.01.2019;14:22:05;81672738;81558466;114272;
21.01.2019;14:23:04;81672842;81558660;114182;
21.01.2019;14:24:05;81672940;81558839;114101;
21.01.2019;14:25:05;81673032;81559021;114011;
21.01.2019;14:26:06;81673139;81559223;113916;
21.01.2019;14:27:04;81673259;81559399;113860;
21.01.2019;14:28:04;81673378;81559585;113793;
21.01.2019;14:29:10;81673505;81559807;113698;
21.01.2019;14:30:06;81673629;81559981;113648;
21.01.2019;14:31:05;81673722;81560145;113577;
21.01.2019;14:32:04;81673841;81560323;113518;
21.01.2019;14:33:05;81673964;81560499;113465;
21.01.2019;14:34:11;81674085;81560682;113403;
21.01.2019;14:35:04;81674209;81560854;113355;
21.01.2019;14:36:04;81674329;81561023;113306;
21.01.2019;14:37:06;81674442;81561165;113277;
21.01.2019;14:38:04;81674548;81561337;113211;
21.01.2019;14:39:07;81674670;81561530;113140;
21.01.2019;14:40:04;81674779;81561695;113084;
21.01.2019;14:41:04;81674875;81561900;112975;
21.01.2019;14:42:05;81674991;81562075;112916;
21.01.2019;14:43:04;81675103;81562259;112844;
21.01.2019;14:44:04;81675264;81562460;112804;
21.01.2019;14:45:05;81675410;81562623;112787;
21.01.2019;14:46:05;81675552;81562820;112732;
21.01.2019;14:47:06;81675682;81563005;112677;
21.01.2019;14:48:04;81675824;81563172;112652;
21.01.2019;14:49:04;81675967;81563350;112617;
21.01.2019;14:50:05;81676077;81563553;112524;
21.01.2019;14:51:04;81676216;81563724;112492;
21.01.2019;14:52:04;81676332;81563914;112418;
21.01.2019;14:53:04;81676494;81564147;112347;
21.01.2019;14:54:05;81676629;81564333;112296;
21.01.2019;14:55:04;81676758;81564525;112233;
21.01.2019;14:56:04;81676869;81564699;112170;
21.01.2019;14:57:05;81677000;81564883;112117;
21.01.2019;14:58:04;81677122;81565069;112053;
21.01.2019;14:59:05;81677236;81565269;111967;
21.01.2019;15:00:07;81677366;81565460;111906;
21.01.2019;15:01:10;81677466;81565646;111820;
21.01.2019;15:02:08;81677580;81565845;111735;
21.01.2019;15:03:07;81677710;81566009;111701;
21.01.2019;15:04:08;81677824;81566196;111628;
21.01.2019;15:05:08;81677934;81566354;111580;
21.01.2019;15:06:07;81678045;81566528;111517;
21.01.2019;15:07:07;81678168;81566720;111448;
21.01.2019;15:08:07;81678296;81566891;111405;
21.01.2019;15:09:07;81678416;81567065;111351;
21.01.2019;15:10:08;81678523;81567249;111274;
21.01.2019;15:11:13;81678652;81567459;111193;
21.01.2019;15:12:07;81678788;81567638;111150;
21.01.2019;15:13:08;81678922;81567840;111082;
21.01.2019;15:14:07;81679026;81568022;111004;
21.01.2019;15:15:12;81679141;81568235;110906;
21.01.2019;15:16:08;81679264;81568398;110866;
21.01.2019;15:17:07;81679402;81568584;110818;
21.01.2019;15:18:07;81679559;81568756;110803;
21.01.2019;15:19:07;81679682;81568938;110744;
21.01.2019;15:20:08;81679797;81569125;110672;
21.01.2019;15:21:08;81679922;81569306;110616;
21.01.2019;15:22:08;81680064;81569495;110569;
21.01.2019;15:23:07;81680192;81569679;110513;
21.01.2019;15:24:08;81680321;81569879;110442;
21.01.2019;15:25:07;81680444;81570114;110330;
21.01.2019;15:26:09;81680598;81570323;110275;
21.01.2019;15:27:09;81680729;81570518;110211;
21.01.2019;15:28:07;81680868;81570722;110146;
21.01.2019;15:29:07;81681001;81570909;110092;
21.01.2019;15:30:07;81681108;81571093;110015;
21.01.2019;15:31:08;81681238;81571265;109973;
21.01.2019;15:32:08;81681397;81571454;109943;
21.01.2019;15:33:08;81681535;81571629;109906;
21.01.2019;15:34:08;81681699;81571843;109856;
21.01.2019;15:35:08;81681817;81572024;109793;
21.01.2019;15:36:08;81681960;81572205;109755;
21.01.2019;15:37:08;81682088;81572418;109670;
21.01.2019;15:38:07;81682217;81572623;109594;
21.01.2019;15:39:07;81682358;81572776;109582;
21.01.2019;15:40:08;81682494;81572961;109533;
21.01.2019;15:41:08;81682611;81573154;109457;
21.01.2019;15:42:07;81682742;81573349;109393;
21.01.2019;15:43:07;81682894;81573553;109341;
21.01.2019;15:44:08;81683033;81573753;109280;
21.01.2019;15:45:08;81683177;81573945;109232;
21.01.2019;15:46:07;81683310;81574132;109178;
21.01.2019;15:47:07;81683441;81574338;109103;
21.01.2019;15:48:07;81683572;81574532;109040;
21.01.2019;15:49:07;81683723;81574710;109013;
21.01.2019;15:50:08;81683888;81574947;108941;
21.01.2019;15:51:07;81684045;81575143;108902;
21.01.2019;15:52:08;81684191;81575293;108898;
21.01.2019;15:53:08;81684346;81575483;108863;
21.01.2019;15:54:07;81684480;81575677;108803;
21.01.2019;15:55:07;81684605;81575841;108764;
21.01.2019;15:56:07;81684748;81576010;108738;
21.01.2019;15:57:08;81684725;81576045;108680;
21.01.2019;15:58:07;81684514;81575953;108561;
21.01.2019;15:59:07;81684571;81576072;108499;
21.01.2019;16:00:04;81684695;81576265;108430;
21.01.2019;16:01:05;81684814;81576466;108348;
21.01.2019;16:02:05;81684946;81576641;108305;
21.01.2019;16:03:04;81685088;81576834;108254;
21.01.2019;16:04:04;81685224;81577021;108203;
21.01.2019;16:05:05;81685371;81577220;108151;
21.01.2019;16:06:04;81685505;81577413;108092;
21.01.2019;16:07:04;81685631;81577609;108022;
21.01.2019;16:08:04;81685779;81577783;107996;
21.01.2019;16:09:06;81685922;81577999;107923;
21.01.2019;16:10:04;81686059;81578160;107899;
21.01.2019;16:11:05;81686204;81578357;107847;
21.01.2019;16:12:04;81686354;81578553;107801;
21.01.2019;16:13:04;81686501;81578772;107729;
21.01.2019;16:14:05;81686672;81578961;107711;
21.01.2019;16:15:05;81686799;81579121;107678;
21.01.2019;16:16:04;81686927;81579325;107602;
21.01.2019;16:17:05;81687057;81579507;107550;
21.01.2019;16:18:05;81687184;81579676;107508;
21.01.2019;16:19:04;81687318;81579870;107448;
21.01.2019;16:20:04;81687471;81580046;107425;
21.01.2019;16:21:07;81687625;81580213;107412;
21.01.2019;16:22:05;81687750;81580377;107373;
21.01.2019;16:23:04;81687875;81580537;107338;
21.01.2019;16:24:05;81687976;81580686;107290;
21.01.2019;16:25:05;81688091;81580896;107195;
21.01.2019;16:26:04;81688193;81581096;107097;
21.01.2019;16:27:04;81688303;81581277;107026;
21.01.2019;16:28:05;81688400;81581464;106936;
21.01.2019;16:29:04;81688515;81581640;106875;
21.01.2019;16:30:04;81688627;81581816;106811;
21.01.2019;16:31:06;81688773;81581986;106787;
21.01.2019;16:32:06;81688881;81582186;106695;
21.01.2019;16:33:05;81688992;81582362;106630;
21.01.2019;16:34:04;81689130;81582549;106581;
21.01.2019;16:35:04;81689261;81582748;106513;
21.01.2019;16:36:04;81689371;81582928;106443;
21.01.2019;16:37:05;81689526;81583127;106399;
21.01.2019;16:38:04;81689649;81583296;106353;
21.01.2019;16:39:06;81689797;81583490;106307;
21.01.2019;16:40:04;81689928;81583672;106256;
21.01.2019;16:41:04;81690107;81583825;106282;
21.01.2019;16:42:05;81690250;81583989;106261;
21.01.2019;16:43:04;81690408;81584173;106235;
21.01.2019;16:44:05;81690558;81584352;106206;
21.01.2019;16:45:06;81690691;81584565;106126;
21.01.2019;16:46:05;81690833;81584752;106081;
21.01.2019;16:47:05;81690978;81584953;106025;
21.01.2019;16:48:04;81691113;81585136;105977;
21.01.2019;16:49:04;81691280;81585338;105942;
21.01.2019;16:50:05;81691428;81585529;105899;
21.01.2019;16:51:05;81691580;81585720;105860;
21.01.2019;16:52:04;81691711;81585913;105798;
21.01.2019;16:53:04;81691854;81586093;105761;
21.01.2019;16:54:05;81691993;81586311;105682;
21.01.2019;16:55:05;81692137;81586516;105621;
21.01.2019;16:56:05;81692311;81586703;105608;
21.01.2019;16:57:04;81692489;81586864;105625;
21.01.2019;16:58:04;81692667;81587044;105623;
21.01.2019;16:59:05;81692860;81587220;105640;
21.01.2019;17:00:05;81693023;81587410;105613;
21.01.2019;17:01:04;81693187;81587586;105601;
21.01.2019;17:02:04;81693339;81587785;105554;
21.01.2019;17:03:05;81693486;81587951;105535;
21.01.2019;17:04:05;81693654;81588156;105498;
21.01.2019;17:05:05;81693857;81588327;105530;
21.01.2019;17:06:05;81694041;81588514;105527;
21.01.2019;17:07:04;81694190;81588702;105488;
21.01.2019;17:08:05;81694333;81588876;105457;
21.01.2019;17:09:05;81694498;81589070;105428;
21.01.2019;17:10:05;81694638;81589237;105401;
21.01.2019;17:11:04;81694809;81589415;105394;
21.01.2019;17:12:06;81694988;81589608;105380;
21.01.2019;17:13:05;81695148;81589763;105385;
21.01.2019;17:14:05;81695280;81589963;105317;
21.01.2019;17:15:04;81695435;81590150;105285;
21.01.2019;17:16:04;81695563;81590353;105210;
21.01.2019;17:17:05;81695749;81590562;105187;
21.01.2019;17:18:05;81695937;81590782;105155;
21.01.2019;17:19:05;81696119;81591006;105113;
21.01.2019;17:20:04;81696253;81591189;105064;
21.01.2019;17:21:04;81696442;81591391;105051;
21.01.2019;17:22:05;81696607;81591587;105020;
21.01.2019;17:23:05;81696777;81591766;105011;
21.01.2019;17:24:04;81696964;81591964;105000;
21.01.2019;17:25:04;81697143;81592159;104984;
21.01.2019;17:26:04;81697323;81592369;104954;
21.01.2019;17:27:05;81697510;81592571;104939;
21.01.2019;17:28:05;81697670;81592794;104876;
21.01.2019;17:29:06;81697841;81592964;104877;
21.01.2019;17:30:04;81698010;81593125;104885;
21.01.2019;17:31:04;81698193;81593323;104870;
21.01.2019;17:32:04;81698342;81593506;104836;
21.01.2019;17:33:04;81698493;81593691;104802;
21.01.2019;17:34:05;81698671;81593871;104800;
21.01.2019;17:35:05;81698866;81594069;104797;
21.01.2019;17:36:04;81699040;81594255;104785;
21.01.2019;17:37:04;81699189;81594451;104738;
21.01.2019;17:38:05;81699364;81594637;104727;
21.01.2019;17:39:07;81699553;81594838;104715;
21.01.2019;17:40:05;81699703;81594998;104705;
21.01.2019;17:41:05;81699871;81595187;104684;
21.01.2019;17:42:05;81700056;81595351;104705;
21.01.2019;17:43:05;81700260;81595526;104734;
21.01.2019;17:44:05;81700416;81595701;104715;
21.01.2019;17:45:05;81700572;81595875;104697;
21.01.2019;17:46:05;81700766;81596066;104700;
21.01.2019;17:47:05;81700935;81596243;104692;
21.01.2019;17:48:05;81701101;81596387;104714;
21.01.2019;17:49:05;81701260;81596583;104677;
21.01.2019;17:50:04;81701413;81596751;104662;
21.01.2019;17:51:04;81701567;81596915;104652;
21.01.2019;17:52:05;81701745;81597094;104651;
21.01.2019;17:53:05;81701911;81597268;104643;
21.01.2019;17:54:05;81702047;81597404;104643;
21.01.2019;17:55:05;81702215;81597568;104647;
21.01.2019;17:56:04;81702383;81597757;104626;
21.01.2019;17:57:04;81702535;81597942;104593;
21.01.2019;17:58:05;81702704;81598116;104588;
21.01.2019;17:59:05;81702896;81598296;104600;
21.01.2019;18:00:05;81703061;81598475;104586;
21.01.2019;18:01:05;81703245;81598652;104593;
21.01.2019;18:02:05;81703433;81598835;104598;
21.01.2019;18:03:04;81703598;81599010;104588;
21.01.2019;18:04:05;81703780;81599172;104608;
21.01.2019;18:05:05;81703940;81599324;104616;
21.01.2019;18:06:04;81704143;81599483;104660;
21.01.2019;18:07:04;81704324;81599672;104652;
21.01.2019;18:08:05;81704455;81599837;104618;
21.01.2019;18:09:07;81704655;81600042;104613;
21.01.2019;18:10:05;81704861;81600182;104679;
21.01.2019;18:11:05;81705061;81600342;104719;
21.01.2019;18:12:05;81705230;81600504;104726;
21.01.2019;18:13:04;81705401;81600682;104719;
21.01.2019;18:14:04;81705568;81600847;104721;
21.01.2019;18:15:05;81705752;81601044;104708;
21.01.2019;18:16:05;81705951;81601230;104721;
21.01.2019;18:17:05;81706142;81601378;104764;
21.01.2019;18:18:05;81706313;81601550;104763;
21.01.2019;18:19:05;81706499;81601691;104808;
21.01.2019;18:20:05;81706675;81601853;104822;
21.01.2019;18:21:04;81706879;81602008;104871;
21.01.2019;18:22:04;81707065;81602162;104903;
21.01.2019;18:23:04;81707207;81602300;104907;
21.01.2019;18:24:04;81707367;81602437;104930;
21.01.2019;18:25:04;81707574;81602589;104985;
21.01.2019;18:26:05;81707749;81602698;105051;
21.01.2019;18:27:05;81707904;81602831;105073;
21.01.2019;18:28:04;81708072;81602986;105086;
21.01.2019;18:29:05;81708212;81603128;105084;
21.01.2019;18:30:05;81708380;81603285;105095;
21.01.2019;18:31:05;81708563;81603416;105147;
21.01.2019;18:32:04;81708714;81603534;105180;
21.01.2019;18:33:04;81708885;81603695;105190;
21.01.2019;18:34:05;81709041;81603842;105199;
21.01.2019;18:35:05;81709217;81603963;105254;
21.01.2019;18:36:05;81709359;81604137;105222;
21.01.2019;18:37:05;81709560;81604270;105290;
21.01.2019;18:38:04;81709736;81604379;105357;
21.01.2019;18:39:05;81709889;81604523;105366;
21.01.2019;18:40:05;81710050;81604657;105393;
21.01.2019;18:41:05;81710230;81604763;105467;
21.01.2019;18:42:04;81710403;81604907;105496;
21.01.2019;18:43:04;81710537;81605045;105492;
21.01.2019;18:44:04;81710703;81605167;105536;
21.01.2019;18:45:05;81710871;81605327;105544;
21.01.2019;18:46:05;81710993;81605436;105557;
21.01.2019;18:47:05;81711159;81605559;105600;
21.01.2019;18:48:04;81711353;81605664;105689;
21.01.2019;18:49:05;81711481;81605755;105726;
21.01.2019;18:50:05;81711654;81605876;105778;
21.01.2019;18:51:05;81711826;81605983;105843;
21.01.2019;18:52:05;81711961;81606102;105859;
21.01.2019;18:53:05;81712151;81606231;105920;
21.01.2019;18:55:05;81712554;81606499;106055;
21.01.2019;18:56:05;81712750;81606637;106113;
21.01.2019;18:57:05;81712936;81606757;106179;
21.01.2019;18:58:05;81713101;81606919;106182;
21.01.2019;18:59:05;81713304;81607053;106251;
21.01.2019;19:00:05;81713498;81607159;106339;
21.01.2019;19:01:05;81713665;81607289;106376;
21.01.2019;19:02:04;81713843;81607392;106451;
21.01.2019;19:03:04;81714005;81607528;106477;
21.01.2019;19:04:05;81714207;81607643;106564;
21.01.2019;19:05:05;81714370;81607787;106583;
21.01.2019;19:06:05;81714553;81607919;106634;
21.01.2019;19:07:05;81714746;81608059;106687;
21.01.2019;19:08:05;81714939;81608202;106737;
21.01.2019;19:09:05;81715130;81608304;106826;
21.01.2019;19:10:05;81715317;81608442;106875;
21.01.2019;19:11:05;81715477;81608551;106926;
21.01.2019;19:12:06;81715579;81608697;106882;
21.01.2019;19:13:05;81715691;81608821;106870;
21.01.2019;19:14:07;81715844;81608937;106907;
21.01.2019;19:15:04;81715974;81609032;106942;
21.01.2019;19:16:04;81716122;81609134;106988;
21.01.2019;19:17:05;81716294;81609255;107039;
21.01.2019;19:18:05;81716447;81609398;107049;
21.01.2019;19:19:05;81716598;81609505;107093;
21.01.2019;19:20:04;81716762;81609596;107166;
21.01.2019;19:21:05;81716921;81609710;107211;
21.01.2019;19:22:06;81717064;81609834;107230;
21.01.2019;19:23:04;81717238;81609933;107305;
21.01.2019;19:24:04;81717399;81610050;107349;
21.01.2019;19:25:05;81717562;81610165;107397;
21.01.2019;19:26:05;81717717;81610275;107442;
21.01.2019;19:27:05;81717872;81610385;107487;
21.01.2019;19:28:07;81718033;81610509;107524;
21.01.2019;19:29:05;81718204;81610613;107591;
21.01.2019;19:30:05;81718347;81610755;107592;
21.01.2019;19:31:05;81718527;81610864;107663;
21.01.2019;19:32:05;81718696;81610974;107722;
21.01.2019;19:33:04;81718877;81611075;107802;
21.01.2019;19:34:04;81719037;81611177;107860;
21.01.2019;19:35:04;81719207;81611263;107944;
21.01.2019;19:36:05;81719411;81611365;108046;
21.01.2019;19:37:05;81719562;81611498;108064;
21.01.2019;19:38:05;81719763;81611591;108172;
21.01.2019;19:39:05;81719935;81611689;108246;
21.01.2019;19:40:05;81720081;81611794;108287;
21.01.2019;19:41:05;81720242;81611912;108330;
21.01.2019;19:42:11;81720448;81612022;108426;
21.01.2019;19:43:05;81720609;81612116;108493;
21.01.2019;19:44:05;81720820;81612197;108623;
21.01.2019;19:45:04;81721012;81612265;108747;
21.01.2019;19:46:04;81721192;81612370;108822;
21.01.2019;19:47:04;81721370;81612454;108916;
21.01.2019;19:48:05;81721555;81612527;109028;
21.01.2019;19:49:05;81721756;81612628;109128;
21.01.2019;19:50:06;81721950;81612722;109228;
21.01.2019;19:51:05;81722120;81612814;109306;
21.01.2019;19:52:04;81722298;81612890;109408;
21.01.2019;19:53:08;81722489;81612977;109512;
21.01.2019;19:54:06;81722659;81613078;109581;
21.01.2019;19:55:05;81722862;81613175;109687;
21.01.2019;19:56:04;81723057;81613277;109780;
21.01.2019;19:57:05;81723253;81613358;109895;
21.01.2019;19:58:04;81723450;81613443;110007;
21.01.2019;19:59:05;81723644;81613533;110111;
21.01.2019;20:00:07;81723837;81613630;110207;
21.01.2019;20:01:05;81724056;81613715;110341;
21.01.2019;20:02:05;81724252;81613810;110442;
21.01.2019;20:03:06;81724412;81613924;110488;
21.01.2019;20:04:05;81724589;81620726;103863;
21.01.2019;20:05:05;81724786;81620815;103971;
21.01.2019;20:06:06;81727643;81620905;106738;
21.01.2019;20:07:05;81727830;81620978;106852;
21.01.2019;20:08:07;81728023;81621060;106963;
21.01.2019;20:09:06;81728203;81621149;107054;
21.01.2019;20:10:04;81728405;81621233;107172;
21.01.2019;20:11:04;81728623;81621338;107285;
21.01.2019;20:12:07;81728829;81621414;107415;
21.01.2019;20:13:04;81729016;81621502;107514;
21.01.2019;20:14:04;81729224;81621595;107629;
21.01.2019;20:16:06;81729589;81621753;107836;
21.01.2019;20:17:04;81729743;81621808;107935;
21.01.2019;20:18:04;81729904;81621865;108039;
21.01.2019;20:19:05;81730071;81621939;108132;
21.01.2019;20:20:05;81730235;81622003;108232;
21.01.2019;20:21:05;81730393;81622079;108314;
21.01.2019;20:22:05;81730527;81622140;108387;
21.01.2019;20:23:08;81730681;81622191;108490;
21.01.2019;20:24:05;81730833;81622251;108582;
21.01.2019;20:25:10;81731006;81622309;108697;
21.01.2019;20:26:05;81731141;81622369;108772;
21.01.2019;20:27:05;81731318;81622421;108897;
21.01.2019;20:28:05;81731463;81622490;108973;
21.01.2019;20:29:05;81731611;81622570;109041;
21.01.2019;20:30:05;81731767;81622639;109128;
21.01.2019;20:31:07;81731970;81622722;109248;
21.01.2019;20:32:05;81732099;81622794;109305;
21.01.2019;20:33:05;81732269;81622864;109405;
21.01.2019;20:34:05;81732417;81622920;109497;
21.01.2019;20:35:04;81732599;81622969;109630;
21.01.2019;20:36:04;81732766;81623037;109729;
21.01.2019;20:37:04;81732878;81623094;109784;
21.01.2019;20:38:05;81733042;81623154;109888;
21.01.2019;20:39:09;81733215;81623201;110014;
21.01.2019;20:40:11;81733345;81623262;110083;
21.01.2019;20:41:04;81733474;81623313;110161;
21.01.2019;20:42:04;81733634;81623363;110271;
21.01.2019;20:43:04;81733778;81623446;110332;
21.01.2019;20:44:06;81733943;81623504;110439;
21.01.2019;20:45:05;81734094;81623554;110540;
21.01.2019;20:46:05;81734229;81623617;110612;
21.01.2019;20:47:04;81734371;81623662;110709;
21.01.2019;20:48:05;81734533;81623706;110827;
21.01.2019;20:49:04;81734705;81623759;110946;
21.01.2019;20:50:04;81734875;81623815;111060;
21.01.2019;20:51:05;81735061;81623890;111171;
21.01.2019;20:52:04;81735251;81623963;111288;
21.01.2019;20:53:04;81735443;81624023;111420;
21.01.2019;20:54:05;81735617;81624075;111542;
21.01.2019;20:55:07;81735812;81624156;111656;
21.01.2019;20:56:05;81735969;81624222;111747;
21.01.2019;20:57:05;81736140;81624289;111851;
21.01.2019;20:58:05;81736303;81624359;111944;
21.01.2019;20:59:05;81736482;81624420;112062;
21.01.2019;21:00:05;81736640;81624478;112162;
21.01.2019;21:01:05;81736813;81624545;112268;
21.01.2019;21:02:05;81736986;81624616;112370;
21.01.2019;21:03:07;81737162;81624672;112490;
21.01.2019;21:04:04;81737317;81624722;112595;
21.01.2019;21:05:05;81737504;81624780;112724;
21.01.2019;21:06:05;81737657;81624839;112818;
21.01.2019;21:07:04;81737824;81624891;112933;
21.01.2019;21:08:04;81737996;81624953;113043;
21.01.2019;21:09:04;81738169;81625013;113156;
21.01.2019;21:10:05;81738325;81625084;113241;
21.01.2019;21:11:06;81738512;81625157;113355;
21.01.2019;21:12:04;81738664;81625204;113460;
21.01.2019;21:13:05;81738836;81625271;113565;
21.01.2019;21:14:05;81738975;81625319;113656;
21.01.2019;21:15:05;81739152;81625370;113782;
21.01.2019;21:16:08;81739301;81625420;113881;
21.01.2019;21:17:05;81739437;81625457;113980;
21.01.2019;21:18:05;81739636;81625508;114128;
21.01.2019;21:19:08;81739825;81625562;114263;
21.01.2019;21:20:05;81740006;81625609;114397;
21.01.2019;21:21:05;81740164;81625655;114509;
21.01.2019;21:22:05;81740332;81625701;114631;
21.01.2019;21:23:05;81740502;81625754;114748;
21.01.2019;21:24:05;81740669;81625807;114862;
21.01.2019;21:25:04;81740826;81625857;114969;
21.01.2019;21:26:05;81740988;81625894;115094;
21.01.2019;21:27:06;81741141;81625957;115184;
21.01.2019;21:28:05;81741312;81626012;115300;
21.01.2019;21:29:05;81741505;81626062;115443;
21.01.2019;21:30:05;81741695;81626123;115572;
21.01.2019;21:31:05;81741858;81626157;115701;
21.01.2019;21:32:05;81742045;81626214;115831;
21.01.2019;21:33:05;81742174;81626268;115906;
21.01.2019;21:34:05;81742272;81626324;115948;
21.01.2019;21:35:07;81742425;81626372;116053;
21.01.2019;21:36:05;81742572;81626424;116148;
21.01.2019;21:37:05;81742725;81626477;116248;
21.01.2019;21:38:05;81742860;81626514;116346;
21.01.2019;21:39:05;81742995;81626561;116434;
21.01.2019;21:40:04;81743124;81626601;116523;
21.01.2019;21:41:05;81743261;81626646;116615;
21.01.2019;21:42:05;81743398;81626697;116701;
21.01.2019;21:43:05;81743558;81626739;116819;
21.01.2019;21:44:05;81743714;81626782;116932;
21.01.2019;21:45:06;81743855;81626846;117009;
21.01.2019;21:46:05;81743999;81626895;117104;
21.01.2019;21:47:05;81744160;81626935;117225;
21.01.2019;21:48:05;81744307;81626989;117318;
21.01.2019;21:49:05;81744451;81627026;117425;
21.01.2019;21:50:04;81744612;81627060;117552;
21.01.2019;21:51:07;81744798;81627111;117687;
21.01.2019;21:52:04;81744956;81627143;117813;
21.01.2019;21:53:04;81745119;81627185;117934;
21.01.2019;21:54:05;81745277;81627234;118043;
21.01.2019;21:55:05;81745447;81627279;118168;
21.01.2019;21:56:05;81745592;81627327;118265;
21.01.2019;21:57:04;81745740;81627375;118365;
21.01.2019;21:58:05;81745850;81627391;118459;
21.01.2019;21:59:05;81745978;81627437;118541;
21.01.2019;22:00:05;81746153;81627478;118675;
21.01.2019;22:01:05;81746244;81627503;118741;
21.01.2019;22:02:05;81746389;81627537;118852;
21.01.2019;22:03:05;81746548;81627570;118978;
21.01.2019;22:04:05;81746671;81627601;119070;
21.01.2019;22:05:05;81746879;81627644;119235;
21.01.2019;22:06:05;81747024;81627688;119336;
21.01.2019;22:07:08;81747181;81627729;119452;
21.01.2019;22:08:05;81747324;81627776;119548;
21.01.2019;22:09:09;81747466;81627835;119631;
21.01.2019;22:10:05;81747630;81627879;119751;
21.01.2019;22:11:05;81747765;81627925;119840;
21.01.2019;22:12:05;81747940;81627963;119977;
21.01.2019;22:13:05;81748063;81628012;120051;
21.01.2019;22:14:06;81748252;81628051;120201;
21.01.2019;22:15:05;81748421;81628109;120312;
21.01.2019;22:16:05;81748555;81628158;120397;
21.01.2019;22:17:05;81748674;81628185;120489;
21.01.2019;22:18:06;81748797;81628226;120571;
21.01.2019;22:19:05;81748939;81628261;120678;
21.01.2019;22:20:05;81749079;81628300;120779;
21.01.2019;22:21:05;81749172;81628319;120853;
21.01.2019;22:22:05;81749297;81628351;120946;
21.01.2019;22:23:07;81749382;81628377;121005;
21.01.2019;22:24:04;81749493;81628402;121091;
21.01.2019;22:25:04;81749569;81628431;121138;
21.01.2019;22:26:05;81749644;81628467;121177;
21.01.2019;22:27:04;81749779;81628508;121271;
21.01.2019;22:28:04;81749874;81628530;121344;
21.01.2019;22:29:04;81749985;81628548;121437;
21.01.2019;22:30:04;81750087;81628581;121506;
21.01.2019;22:31:08;81750207;81628598;121609;
21.01.2019;22:32:05;81750307;81628631;121676;
21.01.2019;22:33:05;81750403;81628663;121740;
21.01.2019;22:34:05;81750519;81628701;121818;
21.01.2019;22:35:06;81750651;81628728;121923;
21.01.2019;22:36:05;81750784;81628763;122021;
21.01.2019;22:37:05;81750891;81628780;122111;
21.01.2019;22:38:05;81750998;81628810;122188;
21.01.2019;22:39:07;81751119;81628848;122271;
21.01.2019;22:40:05;81751263;81628873;122390;
21.01.2019;22:41:05;81751405;81628900;122505;
21.01.2019;22:42:05;81751537;81628932;122605;
21.01.2019;22:43:05;81751673;81628966;122707;
21.01.2019;22:44:05;81751785;81628983;122802;
21.01.2019;22:45:04;81751918;81629016;122902;
21.01.2019;22:46:06;81752077;81629057;123020;
21.01.2019;22:47:05;81752249;81629086;123163;
21.01.2019;22:48:05;81752376;81629124;123252;
21.01.2019;22:49:05;81752518;81629152;123366;
21.01.2019;22:50:05;81752672;81629197;123475;
21.01.2019;22:51:05;81752829;81629231;123598;
21.01.2019;22:52:04;81752983;81629259;123724;
21.01.2019;22:53:05;81753158;81629291;123867;
21.01.2019;22:54:04;81753310;81629319;123991;
21.01.2019;22:55:05;81753457;81629362;124095;
21.01.2019;22:56:04;81753647;81629394;124253;
21.01.2019;22:57:04;81753972;81629428;124544;
21.01.2019;22:58:05;81754204;81629463;124741;
21.01.2019;22:59:05;81754381;81629498;124883;
21.01.2019;23:00:04;81754550;81629545;125005;
21.01.2019;23:01:04;81754690;81629575;125115;
21.01.2019;23:02:06;81754825;81629616;125209;
21.01.2019;23:03:05;81755003;81629661;125342;
21.01.2019;23:04:04;81755189;81629685;125504;
21.01.2019;23:05:05;81755350;81629713;125637;
21.01.2019;23:06:05;81755543;81629755;125788;
21.01.2019;23:07:05;81755723;81629785;125938;
21.01.2019;23:08:05;81755874;81629811;126063;
21.01.2019;23:09:06;81756032;81629845;126187;
21.01.2019;23:10:04;81756195;81629872;126323;
21.01.2019;23:11:05;81756354;81629897;126457;
21.01.2019;23:12:05;81756477;81629926;126551;
21.01.2019;23:13:04;81756681;81629960;126721;
21.01.2019;23:14:04;81756846;81630005;126841;
21.01.2019;23:15:05;81757062;81630053;127009;
21.01.2019;23:16:05;81757258;81630089;127169;
21.01.2019;23:17:05;81757460;81630117;127343;
21.01.2019;23:18:05;81757646;81630147;127499;
21.01.2019;23:19:04;81757828;81630181;127647;
21.01.2019;23:20:07;81758033;81630231;127802;
21.01.2019;23:21:05;81758242;81630256;127986;
21.01.2019;23:22:05;81758434;81630280;128154;
21.01.2019;23:23:05;81758650;81630315;128335;
21.01.2019;23:24:05;81758850;81630349;128501;
21.01.2019;23:25:04;81759055;81630387;128668;
21.01.2019;23:26:04;81759271;81630425;128846;
21.01.2019;23:27:05;81759452;81630441;129011;
21.01.2019;23:28:04;81759680;81630473;129207;
21.01.2019;23:29:05;81759890;81630509;129381;
21.01.2019;23:30:04;81760133;81630537;129596;
21.01.2019;23:31:04;81760325;81630568;129757;
21.01.2019;23:32:05;81760505;81630603;129902;
21.01.2019;23:33:05;81760726;81630637;130089;
21.01.2019;23:34:05;81760920;81630664;130256;
21.01.2019;23:35:04;81761116;81630708;130408;
21.01.2019;23:36:04;81761309;81630735;130574;
21.01.2019;23:37:05;81761498;81630762;130736;
21.01.2019;23:38:05;81761702;81630792;130910;
21.01.2019;23:39:06;81761915;81630827;131088;
21.01.2019;23:40:05;81762102;81630858;131244;
21.01.2019;23:41:05;81762316;81630894;131422;
21.01.2019;23:42:05;81762521;81630935;131586;
21.01.2019;23:43:05;81762774;81630972;131802;
21.01.2019;23:44:04;81762999;81631001;131998;
21.01.2019;23:45:05;81763214;81631025;132189;
21.01.2019;23:46:05;81763422;81631062;132360;
21.01.2019;23:47:05;81763635;81631095;132540;
21.01.2019;23:48:04;81763815;81631110;132705;
21.01.2019;23:49:04;81764003;81631138;132865;
21.01.2019;23:50:05;81764217;81631176;133041;
21.01.2019;23:51:04;81764437;81631205;133232;
21.01.2019;23:52:04;81764661;81631236;133425;
21.01.2019;23:53:05;81764880;81631267;133613;
21.01.2019;23:54:04;81765114;81631288;133826;
21.01.2019;23:55:04;81765357;81631313;134044;
21.01.2019;23:56:05;81765584;81631329;134255;
21.01.2019;23:57:05;81765800;81631373;134427;
21.01.2019;23:58:04;81766020;81631412;134608;
21.01.2019;23:59:04;81766214;81631444;134770;
22.01.2019;00:00:07;81766420;81631463;134957;
22.01.2019;00:01:08;81766642;81631491;135151;
22.01.2019;00:02:08;81766845;81631516;135329;
22.01.2019;00:03:07;81767045;81631551;135494;
22.01.2019;00:04:08;81767264;81631585;135679;
22.01.2019;00:05:08;81767513;81631612;135901;
22.01.2019;00:06:08;81767798;81631639;136159;
22.01.2019;00:07:07;81768027;81631678;136349;
22.01.2019;00:08:07;81768270;81631705;136565;
22.01.2019;00:09:07;81768533;81631744;136789;
22.01.2019;00:10:08;81768804;81631760;137044;
22.01.2019;00:11:08;81769129;81631798;137331;
22.01.2019;00:12:08;81769476;81631828;137648;
22.01.2019;00:13:13;81769843;81631886;137957;
22.01.2019;00:14:08;81770116;81631922;138194;
22.01.2019;00:15:06;81770411;81631967;138444;
22.01.2019;00:16:07;81770700;81632008;138692;
22.01.2019;00:17:08;81770980;81632038;138942;
22.01.2019;00:18:07;81771179;81632053;139126;
22.01.2019;00:19:08;81771370;81632066;139304;
22.01.2019;00:20:09;81771550;81632087;139463;
22.01.2019;00:21:11;81771759;81632122;139637;
22.01.2019;00:22:09;81771945;81632145;139800;
22.01.2019;00:23:08;81772164;81632177;139987;
22.01.2019;00:24:09;81772381;81632199;140182;
22.01.2019;00:25:10;81772554;81632226;140328;
22.01.2019;00:26:10;81772799;81632250;140549;
22.01.2019;00:27:08;81773029;81632268;140761;
22.01.2019;00:28:07;81773275;81632293;140982;
22.01.2019;00:29:08;81773526;81632311;141215;
22.01.2019;00:30:07;81773720;81632334;141386;
22.01.2019;00:31:07;81773960;81632364;141596;
22.01.2019;00:32:08;81774192;81632391;141801;
22.01.2019;00:33:07;81774404;81632441;141963;
22.01.2019;00:34:08;81774674;81632468;142206;
22.01.2019;00:35:08;81774914;81632508;142406;
22.01.2019;00:36:07;81775128;81632542;142586;
22.01.2019;00:37:08;81775372;81632562;142810;
22.01.2019;00:38:08;81775643;81632590;143053;
22.01.2019;00:39:08;81775856;81632629;143227;
22.01.2019;00:40:07;81776037;81632655;143382;
22.01.2019;00:41:07;81776252;81632693;143559;
22.01.2019;00:42:07;81776418;81632709;143709;
22.01.2019;00:43:07;81776620;81632734;143886;
22.01.2019;00:44:07;81776782;81632771;144011;
22.01.2019;00:45:08;81776987;81632803;144184;
22.01.2019;00:46:08;81777191;81632839;144352;
22.01.2019;00:47:07;81777421;81632871;144550;
22.01.2019;00:48:10;81777653;81632897;144756;
22.01.2019;00:49:10;81777863;81632939;144924;
22.01.2019;00:50:09;81778139;81632988;145151;
22.01.2019;00:51:07;81778353;81633018;145335;
22.01.2019;00:52:07;81778568;81633048;145520;
22.01.2019;00:53:07;81778778;81633076;145702;
22.01.2019;00:54:08;81779004;81633116;145888;
22.01.2019;00:55:07;81779212;81633153;146059;
22.01.2019;00:56:08;81779443;81633188;146255;
22.01.2019;00:57:07;81779690;81633222;146468;
22.01.2019;00:58:08;81779945;81633256;146689;
22.01.2019;00:59:06;81780173;81633278;146895;
22.01.2019;01:00:05;81780364;81633311;147053;
22.01.2019;01:01:05;81780583;81633344;147239;
22.01.2019;01:02:10;81780797;81633380;147417;
22.01.2019;01:03:04;81781010;81633412;147598;
22.01.2019;01:04:04;81781241;81633446;147795;
22.01.2019;01:05:04;81781496;81633502;147994;
22.01.2019;01:06:04;81781744;81633529;148215;
22.01.2019;01:07:05;81781951;81633571;148380;
22.01.2019;01:08:04;81782174;81633601;148573;
22.01.2019;01:09:06;81782369;81633644;148725;
22.01.2019;01:10:05;81782558;81633675;148883;
22.01.2019;01:11:05;81782800;81633712;149088;
22.01.2019;01:12:05;81783039;81633753;149286;
22.01.2019;01:13:09;81783244;81633802;149442;
22.01.2019;01:14:04;81783440;81633840;149600;
22.01.2019;01:15:04;81783635;81633873;149762;
22.01.2019;01:16:05;81783812;81633913;149899;
22.01.2019;01:17:05;81784003;81633947;150056;
22.01.2019;01:18:05;81784177;81633993;150184;
22.01.2019;01:19:04;81784377;81634022;150355;
22.01.2019;01:20:04;81784583;81634051;150532;
22.01.2019;01:21:05;81784773;81634086;150687;
22.01.2019;01:22:04;81784954;81634113;150841;
22.01.2019;01:23:04;81785156;81634150;151006;
22.01.2019;01:24:05;81785357;81634192;151165;
22.01.2019;01:25:05;81785551;81634248;151303;
22.01.2019;01:26:05;81785757;81634290;151467;
22.01.2019;01:27:04;81785972;81634319;151653;
22.01.2019;01:28:04;81786198;81634351;151847;
22.01.2019;01:29:05;81786375;81634395;151980;
22.01.2019;01:30:05;81786579;81634434;152145;
22.01.2019;01:31:04;81786788;81634467;152321;
22.01.2019;01:32:05;81786973;81634515;152458;
22.01.2019;01:33:05;81787164;81634543;152621;
22.01.2019;01:34:04;81787369;81634581;152788;
22.01.2019;01:35:04;81787580;81634618;152962;
22.01.2019;01:36:05;81787771;81634666;153105;
22.01.2019;01:37:05;81787942;81634702;153240;
22.01.2019;01:38:04;81788121;81634755;153366;
22.01.2019;01:39:06;81788303;81634795;153508;
22.01.2019;01:40:05;81788479;81634840;153639;
22.01.2019;01:41:05;81788698;81634873;153825;
22.01.2019;01:42:04;81788890;81634916;153974;
22.01.2019;01:43:04;81789069;81634954;154115;
22.01.2019;01:44:05;81789244;81635008;154236;
22.01.2019;01:45:04;81789409;81635049;154360;
22.01.2019;01:46:04;81789624;81635109;154515;
22.01.2019;01:47:05;81789803;81635147;154656;
22.01.2019;01:48:05;81789975;81635186;154789;
22.01.2019;01:49:04;81790163;81635231;154932;
22.01.2019;01:50:04;81790338;81635262;155076;
22.01.2019;01:51:05;81790532;81635303;155229;
22.01.2019;01:52:04;81790718;81635357;155361;
22.01.2019;01:53:05;81790936;81635403;155533;
22.01.2019;01:54:05;81791130;81635461;155669;
22.01.2019;01:55:04;81791287;81635531;155756;
22.01.2019;01:56:04;81791442;81635580;155862;
22.01.2019;01:57:05;81791638;81635627;156011;
22.01.2019;01:58:04;81791847;81635690;156157;
22.01.2019;01:59:04;81792041;81635732;156309;
22.01.2019;02:00:05;81792194;81635794;156400;
22.01.2019;02:01:04;81792352;81635850;156502;
22.01.2019;02:02:04;81792553;81635915;156638;
22.01.2019;02:03:05;81792775;81635975;156800;
22.01.2019;02:04:04;81792945;81636020;156925;
22.01.2019;02:05:04;81793166;81636091;157075;
22.01.2019;02:06:05;81793336;81636161;157175;
22.01.2019;02:07:05;81793486;81636228;157258;
22.01.2019;02:08:05;81793662;81636294;157368;
22.01.2019;02:09:07;81793853;81636354;157499;
22.01.2019;02:10:04;81794018;81636399;157619;
22.01.2019;02:11:04;81794216;81636468;157748;
22.01.2019;02:12:05;81794411;81636523;157888;
22.01.2019;02:13:05;81794582;81636587;157995;
22.01.2019;02:14:04;81794763;81636636;158127;
22.01.2019;02:15:05;81794939;81636687;158252;
22.01.2019;02:16:05;81795109;81636756;158353;
22.01.2019;02:17:04;81795244;81636815;158429;
22.01.2019;02:18:04;81795358;81636888;158470;
22.01.2019;02:19:05;81795477;81636944;158533;
22.01.2019;02:20:04;81795591;81636981;158610;
22.01.2019;02:21:04;81795704;81637039;158665;
22.01.2019;02:22:04;81795820;81637108;158712;
22.01.2019;02:23:04;81795919;81637166;158753;
22.01.2019;02:24:05;81796041;81637224;158817;
22.01.2019;02:25:04;81796129;81637277;158852;
22.01.2019;02:26:04;81796275;81637343;158932;
22.01.2019;02:27:05;81796375;81637422;158953;
22.01.2019;02:28:04;81796463;81637486;158977;
22.01.2019;02:29:04;81796560;81637530;159030;
22.01.2019;02:30:05;81796668;81637588;159080;
22.01.2019;02:31:04;81796784;81637649;159135;
22.01.2019;02:32:04;81796893;81637725;159168;
22.01.2019;02:33:05;81796996;81637802;159194;
22.01.2019;02:34:04;81797129;81637872;159257;
22.01.2019;02:35:04;81797221;81637964;159257;
22.01.2019;02:36:05;81797352;81638056;159296;
22.01.2019;02:37:04;81797504;81638125;159379;
22.01.2019;02:38:04;81797641;81638210;159431;
22.01.2019;02:39:06;81797806;81638282;159524;
22.01.2019;02:40:04;81797944;81638364;159580;
22.01.2019;02:41:05;81798069;81638455;159614;
22.01.2019;02:42:04;81798206;81638524;159682;
22.01.2019;02:43:04;81798342;81638610;159732;
22.01.2019;02:44:05;81798475;81638699;159776;
22.01.2019;02:45:04;81798657;81638771;159886;
22.01.2019;02:46:04;81798805;81638851;159954;
22.01.2019;02:47:04;81798971;81638944;160027;
22.01.2019;02:48:05;81799130;81639040;160090;
22.01.2019;02:49:05;81799304;81639134;160170;
22.01.2019;02:50:04;81799481;81639216;160265;
22.01.2019;02:51:04;81799665;81639289;160376;
22.01.2019;02:52:05;81799842;81639365;160477;
22.01.2019;02:53:04;81799995;81639444;160551;
22.01.2019;02:54:04;81800187;81639521;160666;
22.01.2019;02:55:05;81800353;81639616;160737;
22.01.2019;02:56:04;81800500;81639703;160797;
22.01.2019;02:57:04;81800698;81639787;160911;
22.01.2019;02:58:05;81800861;81639863;160998;
22.01.2019;02:59:05;81801018;81639942;161076;
22.01.2019;03:00:04;81801185;81640040;161145;
22.01.2019;03:01:04;81801347;81640134;161213;
22.01.2019;03:02:04;81801536;81640223;161313;
22.01.2019;03:03:04;81801707;81640333;161374;
22.01.2019;03:04:05;81801898;81640426;161472;
22.01.2019;03:05:04;81802066;81640538;161528;
22.01.2019;03:06:04;81802243;81640634;161609;
22.01.2019;03:07:05;81802422;81640719;161703;
22.01.2019;03:08:04;81802587;81640831;161756;
22.01.2019;03:09:04;81802751;81640926;161825;
22.01.2019;03:10:05;81802949;81641034;161915;
22.01.2019;03:11:05;81803110;81641134;161976;
22.01.2019;03:12:04;81803288;81641232;162056;
22.01.2019;03:13:05;81803446;81641347;162099;
22.01.2019;03:14:05;81803604;81641447;162157;
22.01.2019;03:15:05;81803769;81641520;162249;
22.01.2019;03:16:10;81803946;81641632;162314;
22.01.2019;03:17:05;81804110;81641738;162372;
22.01.2019;03:18:04;81804269;81641854;162415;
22.01.2019;03:19:04;81804437;81641950;162487;
22.01.2019;03:20:05;81804617;81642034;162583;
22.01.2019;03:21:04;81804787;81642136;162651;
22.01.2019;03:22:04;81804928;81642259;162669;
22.01.2019;03:23:05;81805100;81642358;162742;
22.01.2019;03:24:04;81805238;81642455;162783;
22.01.2019;03:25:04;81805409;81642572;162837;
22.01.2019;03:26:05;81805570;81642666;162904;
22.01.2019;03:27:04;81805712;81642767;162945;
22.01.2019;03:28:04;81805857;81642859;162998;
22.01.2019;03:29:05;81806022;81642961;163061;
22.01.2019;03:30:05;81806172;81643058;163114;
22.01.2019;03:31:04;81806342;81643188;163154;
22.01.2019;03:32:05;81806490;81643277;163213;
22.01.2019;03:33:04;81806658;81643371;163287;
22.01.2019;03:34:04;81806813;81643482;163331;
22.01.2019;03:35:05;81806970;81643633;163337;
22.01.2019;03:36:04;81807145;81643739;163406;
22.01.2019;03:37:04;81807321;81643830;163491;
22.01.2019;03:38:05;81807480;81643937;163543;
22.01.2019;03:39:05;81807649;81644046;163603;
22.01.2019;03:40:04;81807810;81644148;163662;
22.01.2019;03:41:06;81807976;81644272;163704;
22.01.2019;03:42:04;81808159;81644376;163783;
22.01.2019;03:43:04;81808308;81644476;163832;
22.01.2019;03:44:04;81808483;81644591;163892;
22.01.2019;03:45:05;81808638;81644736;163902;
22.01.2019;03:46:04;81808822;81644842;163980;
22.01.2019;03:47:04;81808947;81644916;164031;
22.01.2019;03:48:05;81809097;81645030;164067;
22.01.2019;03:49:04;81809280;81645150;164130;
22.01.2019;03:50:04;81809449;81645281;164168;
22.01.2019;03:51:05;81809663;81645375;164288;
22.01.2019;03:52:04;81809816;81645490;164326;
22.01.2019;03:53:05;81809968;81645624;164344;
22.01.2019;03:54:04;81810136;81645727;164409;
22.01.2019;03:55:04;81810314;81645849;164465;
22.01.2019;03:56:05;81810463;81645968;164495;
22.01.2019;03:57:05;81810634;81646075;164559;
22.01.2019;03:58:04;81810784;81646194;164590;
22.01.2019;03:59:04;81810970;81646315;164655;
22.01.2019;04:00:05;81811150;81646427;164723;
22.01.2019;04:01:04;81811320;81646536;164784;
22.01.2019;04:02:04;81811480;81646662;164818;
22.01.2019;04:03:05;81811646;81646785;164861;
22.01.2019;04:04:05;81811817;81646902;164915;
22.01.2019;04:05:05;81811995;81647036;164959;
22.01.2019;04:06:04;81812169;81647154;165015;
22.01.2019;04:07:04;81812348;81647269;165079;
22.01.2019;04:08:05;81812529;81647377;165152;
22.01.2019;04:09:04;81812679;81647522;165157;
22.01.2019;04:10:04;81812827;81647640;165187;
22.01.2019;04:11:05;81812973;81647784;165189;
22.01.2019;04:12:04;81813124;81647915;165209;
22.01.2019;04:13:04;81813289;81648026;165263;
22.01.2019;04:14:05;81813419;81648131;165288;
22.01.2019;04:15:05;81813530;81648241;165289;
22.01.2019;04:16:04;81813665;81648383;165282;
22.01.2019;04:17:04;81813772;81648500;165272;
22.01.2019;04:18:04;81813881;81648627;165254;
22.01.2019;04:19:05;81813966;81648757;165209;
22.01.2019;04:20:05;81814076;81648845;165231;
22.01.2019;04:21:04;81814185;81648958;165227;
22.01.2019;04:22:04;81814296;81649074;165222;
22.01.2019;04:23:05;81814427;81649181;165246;
22.01.2019;04:24:05;81814500;81649313;165187;
22.01.2019;04:25:04;81814625;81649418;165207;
22.01.2019;04:26:04;81814765;81649528;165237;
22.01.2019;04:27:05;81814886;81649648;165238;
22.01.2019;04:28:04;81815013;81649764;165249;
22.01.2019;04:29:04;81815155;81649886;165269;
22.01.2019;04:30:05;81815282;81649993;165289;
22.01.2019;04:31:04;81815413;81650133;165280;
22.01.2019;04:32:04;81815530;81650253;165277;
22.01.2019;04:33:05;81815676;81650368;165308;
22.01.2019;04:34:04;81815821;81650490;165331;
22.01.2019;04:35:04;81815938;81650608;165330;
22.01.2019;04:36:05;81816084;81650729;165355;
22.01.2019;04:37:05;81816233;81650846;165387;
22.01.2019;04:38:04;81816368;81650950;165418;
22.01.2019;04:39:06;81816530;81651099;165431;
22.01.2019;04:40:05;81816642;81651218;165424;
22.01.2019;04:41:04;81816823;81651308;165515;
22.01.2019;04:42:04;81817005;81651411;165594;
22.01.2019;04:43:04;81817160;81651527;165633;
22.01.2019;04:44:04;81817291;81651637;165654;
22.01.2019;04:45:05;81817470;81651758;165712;
22.01.2019;04:46:04;81817642;81651876;165766;
22.01.2019;04:47:04;81817772;81651995;165777;
22.01.2019;04:48:05;81817929;81652097;165832;
22.01.2019;04:49:05;81818096;81652221;165875;
22.01.2019;04:50:04;81818260;81652331;165929;
22.01.2019;04:51:05;81818428;81652436;165992;
22.01.2019;04:52:05;81818590;81652575;166015;
22.01.2019;04:53:04;81818729;81652701;166028;
22.01.2019;04:54:05;81818880;81652840;166040;
22.01.2019;04:55:05;81819058;81652972;166086;
22.01.2019;04:56:04;81819216;81653096;166120;
22.01.2019;04:57:05;81819376;81653214;166162;
22.01.2019;04:58:05;81819556;81653340;166216;
22.01.2019;04:59:04;81819714;81653462;166252;
22.01.2019;05:00:05;81819859;81653597;166262;
22.01.2019;05:01:05;81819997;81653732;166265;
22.01.2019;05:02:05;81820139;81653856;166283;
22.01.2019;05:03:04;81820280;81653976;166304;
22.01.2019;05:04:05;81820427;81654096;166331;
22.01.2019;05:05:04;81820565;81654234;166331;
22.01.2019;05:06:04;81820745;81654383;166362;
22.01.2019;05:07:05;81820897;81654503;166394;
22.01.2019;05:08:05;81821041;81654635;166406;
22.01.2019;05:09:05;81821184;81654771;166413;
22.01.2019;05:10:04;81821330;81654917;166413;
22.01.2019;05:11:04;81821488;81655072;166416;
22.01.2019;05:12:05;81821651;81655220;166431;
22.01.2019;05:13:05;81821796;81655321;166475;
22.01.2019;05:14:05;81821973;81655481;166492;
22.01.2019;05:15:05;81822121;81655622;166499;
22.01.2019;05:16:05;81822264;81655752;166512;
22.01.2019;05:17:04;81822404;81655861;166543;
22.01.2019;05:18:04;81822546;81656001;166545;
22.01.2019;05:19:05;81822696;81656143;166553;
22.01.2019;05:20:04;81822858;81656281;166577;
22.01.2019;05:21:04;81823020;81656397;166623;
22.01.2019;05:22:05;81823181;81656553;166628;
22.01.2019;05:23:04;81823323;81656676;166647;
22.01.2019;05:24:04;81823480;81656815;166665;
22.01.2019;05:25:05;81823648;81656940;166708;
22.01.2019;05:26:04;81823792;81657066;166726;
22.01.2019;05:27:04;81823928;81657200;166728;
22.01.2019;05:28:05;81824086;81657310;166776;
22.01.2019;05:29:04;81824239;81657450;166789;
22.01.2019;05:30:04;81824372;81657584;166788;
22.01.2019;05:31:04;81824515;81657718;166797;
22.01.2019;05:32:05;81824653;81657880;166773;
22.01.2019;05:33:05;81824780;81658022;166758;
22.01.2019;05:34:05;81824924;81658153;166771;
22.01.2019;05:35:05;81825057;81658286;166771;
22.01.2019;05:36:05;81825189;81658433;166756;
22.01.2019;05:37:04;81825351;81658573;166778;
22.01.2019;05:38:05;81825508;81658721;166787;
22.01.2019;05:39:06;81825696;81658851;166845;
22.01.2019;05:40:05;81825857;81658957;166900;
22.01.2019;05:41:05;81825978;81659084;166894;
22.01.2019;05:42:04;81826125;81659203;166922;
22.01.2019;05:43:04;81826284;81659334;166950;
22.01.2019;05:44:05;81826444;81659437;167007;
22.01.2019;05:45:04;81826589;81659540;167049;
22.01.2019;05:46:04;81826742;81659705;167037;
22.01.2019;05:47:05;81826852;81659842;167010;
22.01.2019;05:48:05;81827029;81659968;167061;
22.01.2019;05:49:04;81827170;81660120;167050;
22.01.2019;05:50:04;81827304;81660225;167079;
22.01.2019;05:51:05;81827446;81660363;167083;
22.01.2019;05:52:04;81827597;81660489;167108;
22.01.2019;05:53:04;81827732;81660622;167110;
22.01.2019;05:54:04;81827870;81660772;167098;
22.01.2019;05:55:05;81828000;81660919;167081;
22.01.2019;05:56:05;81828133;81661066;167067;
22.01.2019;05:57:05;81828278;81661184;167094;
22.01.2019;05:58:04;81828424;81661302;167122;
22.01.2019;05:59:04;81828577;81661445;167132;
22.01.2019;06:00:05;81828740;81661595;167145;
22.01.2019;06:01:04;81828862;81661746;167116;
22.01.2019;06:02:04;81829022;81661900;167122;
22.01.2019;06:03:05;81829160;81662019;167141;
22.01.2019;06:04:04;81829308;81662157;167151;
22.01.2019;06:05:04;81829474;81662283;167191;
22.01.2019;06:06:05;81829613;81662428;167185;
22.01.2019;06:07:04;81829781;81662555;167226;
22.01.2019;06:08:05;81829931;81662699;167232;
22.01.2019;06:09:06;81830075;81662833;167242;
22.01.2019;06:10:04;81830237;81662944;167293;
22.01.2019;06:11:05;81830365;81663065;167300;
22.01.2019;06:12:04;81830461;81663188;167273;
22.01.2019;06:13:04;81830562;81663288;167274;
22.01.2019;06:14:05;81830643;81663417;167226;
22.01.2019;06:15:04;81830740;81663534;167206;
22.01.2019;06:16:04;81830840;81663646;167194;
22.01.2019;06:17:05;81830927;81663776;167151;
22.01.2019;06:18:04;81831000;81663877;167123;
22.01.2019;06:19:04;81831077;81663985;167092;
22.01.2019;06:20:05;81831144;81664099;167045;
22.01.2019;06:21:05;81831225;81664199;167026;
22.01.2019;06:22:05;81831302;81664303;166999;
22.01.2019;06:23:05;81831377;81664457;166920;
22.01.2019;06:24:04;81831478;81664576;166902;
22.01.2019;06:25:07;81831573;81664704;166869;
22.01.2019;06:26:05;81831687;81664826;166861;
22.01.2019;06:27:05;81831786;81664948;166838;
22.01.2019;06:28:05;81831858;81665090;166768;
22.01.2019;06:29:05;81831959;81665218;166741;
22.01.2019;06:30:04;81832063;81665337;166726;
22.01.2019;06:31:05;81832136;81665479;166657;
22.01.2019;06:32:05;81832261;81665621;166640;
22.01.2019;06:33:04;81832361;81665741;166620;
22.01.2019;06:34:04;81832487;81665875;166612;
22.01.2019;06:35:05;81832602;81666006;166596;
22.01.2019;06:36:04;81832718;81666156;166562;
22.01.2019;06:37:04;81832841;81666288;166553;
22.01.2019;06:38:05;81832967;81666425;166542;
22.01.2019;06:39:05;81833063;81666547;166516;
22.01.2019;06:40:04;81833171;81666675;166496;
22.01.2019;06:41:04;81833286;81666807;166479;
22.01.2019;06:42:05;81833409;81666953;166456;
22.01.2019;06:43:04;81833467;81667018;166449;
22.01.2019;06:44:04;81833597;81667137;166460;
22.01.2019;06:45:05;81833740;81667264;166476;
22.01.2019;06:46:05;81833890;81667372;166518;
22.01.2019;06:47:05;81834059;81667448;166611;
22.01.2019;06:48:04;81834179;81667540;166639;
22.01.2019;06:49:05;81834303;81667618;166685;
22.01.2019;06:50:04;81834451;81667708;166743;
22.01.2019;06:51:04;81834583;81667810;166773;
22.01.2019;06:52:05;81834721;81667889;166832;
22.01.2019;06:53:05;81834851;81668010;166841;
22.01.2019;06:54:04;81834976;81668113;166863;
22.01.2019;06:55:04;81835108;81668193;166915;
22.01.2019;06:56:05;81835244;81668283;166961;
22.01.2019;06:57:04;81835351;81668407;166944;
22.01.2019;06:58:05;81835480;81668509;166971;
22.01.2019;06:59:05;81835604;81668624;166980;
22.01.2019;07:00:04;81835725;81668735;166990;
22.01.2019;07:01:04;81835880;81668834;167046;
22.01.2019;07:02:05;81836043;81668926;167117;
22.01.2019;07:03:04;81836153;81669045;167108;
22.01.2019;07:04:04;81836285;81669161;167124;
22.01.2019;07:05:05;81836404;81669271;167133;
22.01.2019;07:06:05;81836524;81669406;167118;
22.01.2019;07:07:05;81836629;81669513;167116;
22.01.2019;07:08:05;81836747;81669610;167137;
22.01.2019;07:09:04;81836848;81669729;167119;
22.01.2019;07:10:04;81836960;81669834;167126;
22.01.2019;07:11:05;81837081;81669948;167133;
22.01.2019;07:12:05;81837189;81670069;167120;
22.01.2019;07:13:04;81837313;81670185;167128;
22.01.2019;07:14:04;81837386;81670295;167091;
22.01.2019;07:15:05;81837510;81670456;167054;
22.01.2019;07:16:04;81837633;81670592;167041;
22.01.2019;07:17:05;81837758;81670723;167035;
22.01.2019;07:18:05;81837872;81670844;167028;
22.01.2019;07:19:05;81837974;81670968;167006;
22.01.2019;07:20:05;81838065;81671084;166981;
22.01.2019;07:21:05;81838192;81671173;167019;
22.01.2019;07:22:05;81838299;81671304;166995;
22.01.2019;07:23:05;81838405;81671435;166970;
22.01.2019;07:24:05;81838514;81671531;166983;
22.01.2019;07:25:05;81838611;81671624;166987;
22.01.2019;07:26:06;81838734;81671749;166985;
22.01.2019;07:27:04;81838845;81671881;166964;
22.01.2019;07:28:05;81838962;81671992;166970;
22.01.2019;07:29:16;81839077;81672136;166941;
22.01.2019;07:30:05;81839172;81672229;166943;
22.01.2019;07:31:05;81839266;81672372;166894;
22.01.2019;07:32:05;81839380;81672456;166924;
22.01.2019;07:33:04;81839492;81672566;166926;
22.01.2019;07:34:05;81839585;81672690;166895;
22.01.2019;07:35:05;81839691;81672796;166895;
22.01.2019;07:36:05;81839809;81672919;166890;
22.01.2019;07:37:04;81839934;81673033;166901;
22.01.2019;07:38:05;81840036;81673159;166877;
22.01.2019;07:39:05;81840150;81673280;166870;
22.01.2019;07:40:04;81840261;81673385;166876;
22.01.2019;07:41:04;81840363;81673510;166853;
22.01.2019;07:42:05;81840489;81673626;166863;
22.01.2019;07:43:05;81840598;81673751;166847;
22.01.2019;07:44:05;81840695;81673893;166802;
22.01.2019;07:45:04;81840807;81674007;166800;
22.01.2019;07:46:04;81840913;81674138;166775;
22.01.2019;07:47:05;81841018;81674246;166772;
22.01.2019;07:48:05;81841139;81674371;166768;
22.01.2019;07:49:04;81841234;81674503;166731;
22.01.2019;07:50:05;81841346;81674621;166725;
22.01.2019;07:51:05;81841474;81674735;166739;
22.01.2019;07:52:04;81841581;81674862;166719;
22.01.2019;07:53:04;81841665;81674996;166669;
22.01.2019;07:54:05;81841791;81675117;166674;
22.01.2019;07:55:04;81841907;81675246;166661;
22.01.2019;07:56:04;81841978;81675394;166584;
22.01.2019;07:57:05;81842067;81675520;166547;
22.01.2019;07:58:05;81842179;81675658;166521;
22.01.2019;07:59:04;81842272;81675797;166475;
22.01.2019;08:00:04;81842374;81675902;166472;
22.01.2019;08:01:05;81842483;81676022;166461;
22.01.2019;08:02:04;81842578;81676166;166412;
22.01.2019;08:03:04;81842660;81676287;166373;
22.01.2019;08:04:10;81842788;81676422;166366;
22.01.2019;08:05:05;81842882;81676548;166334;
22.01.2019;08:06:04;81842992;81676658;166334;
22.01.2019;08:07:04;81843084;81676764;166320;
22.01.2019;08:08:05;81843201;81676886;166315;
22.01.2019;08:09:06;81843293;81677016;166277;
22.01.2019;08:10:04;81843385;81677130;166255;
22.01.2019;08:11:05;81843457;81677290;166167;
22.01.2019;08:12:04;81843523;81677439;166084;
22.01.2019;08:13:04;81843594;81677553;166041;
22.01.2019;08:14:05;81843638;81677667;165971;
22.01.2019;08:15:05;81843695;81677791;165904;
22.01.2019;08:16:05;81843739;81677892;165847;
22.01.2019;08:17:04;81843789;81677991;165798;
22.01.2019;08:18:04;81843824;81678116;165708;
22.01.2019;08:19:05;81843856;81678225;165631;
22.01.2019;08:20:05;81843945;81678352;165593;
22.01.2019;08:21:04;81844000;81678474;165526;
22.01.2019;08:22:11;81844050;81678623;165427;
22.01.2019;08:23:05;81844123;81678715;165408;
22.01.2019;08:24:04;81844180;81678822;165358;
22.01.2019;08:25:05;81844260;81678937;165323;
22.01.2019;08:26:04;81844340;81679056;165284;
22.01.2019;08:27:05;81844417;81679184;165233;
22.01.2019;08:28:04;81844506;81679322;165184;
22.01.2019;08:29:04;81844585;81679456;165129;
22.01.2019;08:30:04;81844669;81679594;165075;
22.01.2019;08:31:05;81844755;81679698;165057;
22.01.2019;08:32:04;81844859;81679808;165051;
22.01.2019;08:33:04;81844942;81679954;164988;
22.01.2019;08:34:05;81845037;81680087;164950;
22.01.2019;08:35:05;81845122;81680224;164898;
22.01.2019;08:36:05;81845211;81680352;164859;
22.01.2019;08:37:04;81845315;81680471;164844;
22.01.2019;08:38:04;81845388;81680571;164817;
22.01.2019;08:39:07;81845468;81680717;164751;
22.01.2019;08:40:04;81845557;81680846;164711;
22.01.2019;08:41:05;81845664;81680955;164709;
22.01.2019;08:42:05;81845750;81681093;164657;
22.01.2019;08:43:04;81845858;81681217;164641;
22.01.2019;08:44:04;81845938;81681339;164599;
22.01.2019;08:45:05;81846019;81681459;164560;
22.01.2019;08:46:04;81846113;81681569;164544;
22.01.2019;08:47:04;81846187;81681693;164494;
22.01.2019;08:48:05;81846267;81681825;164442;
22.01.2019;08:49:04;81846369;81681936;164433;
22.01.2019;08:50:04;81846457;81682069;164388;
22.01.2019;08:51:05;81846557;81682215;164342;
22.01.2019;08:52:05;81846649;81682340;164309;
22.01.2019;08:53:05;81846740;81682478;164262;
22.01.2019;08:54:04;81846837;81682632;164205;
22.01.2019;08:55:05;81846943;81682765;164178;
22.01.2019;08:56:05;81847030;81682894;164136;
22.01.2019;08:57:04;81847114;81683040;164074;
22.01.2019;08:58:04;81847217;81683179;164038;
22.01.2019;08:59:05;81847310;81683325;163985;
22.01.2019;09:00:05;81847403;81683449;163954;
22.01.2019;09:01:05;81847514;81683573;163941;
22.01.2019;09:02:05;81847602;81683701;163901;
22.01.2019;09:03:05;81847700;81683822;163878;
22.01.2019;09:04:09;81847790;81683988;163802;
22.01.2019;09:05:05;81847885;81684108;163777;
22.01.2019;09:06:05;81847966;81684242;163724;
22.01.2019;09:07:05;81848062;81684366;163696;
22.01.2019;09:08:04;81848143;81684512;163631;
22.01.2019;09:09:04;81848221;81684621;163600;
22.01.2019;09:10:04;81848322;81684733;163589;
22.01.2019;09:11:04;81848411;81684884;163527;
22.01.2019;09:12:05;81848507;81685029;163478;
22.01.2019;09:13:05;81848591;81685148;163443;
22.01.2019;09:14:05;81848673;81685293;163380;
22.01.2019;09:15:04;81848763;81685413;163350;
22.01.2019;09:16:04;81848858;81685540;163318;
22.01.2019;09:17:04;81848941;81685658;163283;
22.01.2019;09:18:05;81849025;81685795;163230;
22.01.2019;09:19:05;81849106;81685896;163210;
22.01.2019;09:20:05;81849195;81686056;163139;
22.01.2019;09:21:05;81849276;81686179;163097;
22.01.2019;09:22:04;81849356;81686288;163068;
22.01.2019;09:23:04;81849449;81686404;163045;
22.01.2019;09:24:05;81849532;81686540;162992;
22.01.2019;09:25:04;81849625;81686681;162944;
22.01.2019;09:26:05;81849703;81686811;162892;
22.01.2019;09:27:05;81849790;81686939;162851;
22.01.2019;09:28:05;81849859;81687087;162772;
22.01.2019;09:29:05;81849974;81687211;162763;
22.01.2019;09:30:05;81850075;81687366;162709;
22.01.2019;09:31:05;81850154;81687493;162661;
22.01.2019;09:32:04;81850239;81687623;162616;
22.01.2019;09:33:05;81850317;81687759;162558;
22.01.2019;09:34:05;81850386;81687889;162497;
22.01.2019;09:35:05;81850451;81688043;162408;
22.01.2019;09:36:05;81850554;81688149;162405;
22.01.2019;09:37:05;81850624;81688292;162332;
22.01.2019;09:38:04;81850716;81688408;162308;
22.01.2019;09:39:05;81850790;81688541;162249;
22.01.2019;09:40:05;81850807;81688635;162172;
22.01.2019;09:41:05;81850889;81688761;162128;
22.01.2019;09:42:04;81850975;81688881;162094;
22.01.2019;09:43:04;81851043;81689005;162038;
22.01.2019;09:44:05;81851127;81689132;161995;
22.01.2019;09:45:05;81851214;81689282;161932;
22.01.2019;09:46:05;81851298;81689420;161878;
22.01.2019;09:47:05;81851373;81689592;161781;
22.01.2019;09:48:04;81851447;81689714;161733;
22.01.2019;09:49:04;81851518;81689857;161661;
22.01.2019;09:50:05;81851568;81690032;161536;
22.01.2019;09:51:05;81851629;81690151;161478;
22.01.2019;09:52:05;81851716;81690284;161432;
22.01.2019;09:53:04;81851791;81690403;161388;
22.01.2019;09:54:04;81851885;81690537;161348;
22.01.2019;09:55:05;81851979;81690649;161330;
22.01.2019;09:56:04;81852064;81690777;161287;
22.01.2019;09:57:04;81852142;81690921;161221;
22.01.2019;09:58:05;81852228;81691070;161158;
22.01.2019;09:59:05;81852301;81691201;161100;
22.01.2019;10:00:04;81852384;81691357;161027;
22.01.2019;10:01:05;81852446;81691522;160924;
22.01.2019;10:02:05;81852531;81691670;160861;
22.01.2019;10:03:04;81852593;81691787;160806;
22.01.2019;10:04:04;81852646;81691936;160710;
22.01.2019;10:05:04;81852728;81692070;160658;
22.01.2019;10:06:05;81852792;81692189;160603;
22.01.2019;10:07:05;81852856;81692338;160518;
22.01.2019;10:08:05;81852924;81692483;160441;
22.01.2019;10:09:06;81852991;81692619;160372;
22.01.2019;10:10:05;81853018;81692710;160308;
22.01.2019;10:11:04;81853099;81692847;160252;
22.01.2019;10:12:04;81853134;81692957;160177;
22.01.2019;10:13:05;81853153;81693081;160072;
22.01.2019;10:14:05;81853187;81693189;159998;
22.01.2019;10:15:04;81853209;81693308;159901;
22.01.2019;10:16:04;81853257;81693400;159857;
22.01.2019;10:17:05;81853310;81693535;159775;
22.01.2019;10:18:05;81853361;81693625;159736;
22.01.2019;10:19:05;81853428;81693773;159655;
22.01.2019;10:20:05;81853471;81693884;159587;
22.01.2019;10:21:04;81853494;81694009;159485;
22.01.2019;10:22:04;81853545;81694116;159429;
22.01.2019;10:23:05;81853601;81694239;159362;
22.01.2019;10:24:05;81853666;81694380;159286;
22.01.2019;10:25:05;81853714;81694513;159201;
22.01.2019;10:26:05;81853766;81694651;159115;
22.01.2019;10:27:04;81853820;81694807;159013;
22.01.2019;10:28:04;81853890;81694945;158945;
22.01.2019;10:29:05;81853974;81695073;158901;
22.01.2019;10:30:05;81854039;81695219;158820;
22.01.2019;10:31:05;81854115;81695335;158780;
22.01.2019;10:32:04;81854189;81695481;158708;
22.01.2019;10:33:05;81854265;81695614;158651;
22.01.2019;10:34:05;81854331;81695773;158558;
22.01.2019;10:35:05;81854406;81695892;158514;
22.01.2019;10:36:05;81854489;81696024;158465;
22.01.2019;10:37:04;81854560;81696170;158390;
22.01.2019;10:38:05;81854647;81696292;158355;
22.01.2019;10:39:05;81854700;81696442;158258;
22.01.2019;10:40:05;81854767;81696555;158212;
22.01.2019;10:41:05;81854834;81696690;158144;
22.01.2019;10:42:04;81854907;81696845;158062;
22.01.2019;10:43:04;81854998;81696979;158019;
22.01.2019;10:44:05;81855055;81697117;157938;
22.01.2019;10:45:05;81855125;81697269;157856;
22.01.2019;10:46:05;81855188;81697404;157784;
22.01.2019;10:47:05;81855256;81697531;157725;
22.01.2019;10:48:04;81855329;81697666;157663;
22.01.2019;10:49:05;81855410;81697798;157612;
22.01.2019;10:50:05;81855478;81697918;157560;
22.01.2019;10:51:04;81855547;81698038;157509;
22.01.2019;10:52:04;81855603;81698165;157438;
22.01.2019;10:53:05;81855681;81698297;157384;
22.01.2019;10:54:04;81855766;81698452;157314;
22.01.2019;10:55:04;81855843;81698611;157232;
22.01.2019;10:56:05;81855913;81698750;157163;
22.01.2019;10:57:05;81855975;81698885;157090;
22.01.2019;10:58:04;81856050;81699030;157020;
22.01.2019;10:59:04;81856111;81699186;156925;
22.01.2019;11:00:05;81856204;81699371;156833;
22.01.2019;11:01:04;81856291;81699501;156790;
22.01.2019;11:02:04;81856370;81699642;156728;
22.01.2019;11:03:04;81856456;81699766;156690;
22.01.2019;11:04:05;81856553;81699923;156630;
22.01.2019;11:05:05;81856613;81700034;156579;
22.01.2019;11:06:05;81856715;81700178;156537;
22.01.2019;11:07:05;81856797;81700316;156481;
22.01.2019;11:08:05;81856885;81700466;156419;
22.01.2019;11:09:05;81856964;81700623;156341;
22.01.2019;11:10:04;81857042;81700757;156285;
22.01.2019;11:11:04;81857128;81700889;156239;
22.01.2019;11:12:05;81857201;81701041;156160;
22.01.2019;11:13:05;81857268;81701186;156082;
22.01.2019;11:14:04;81857337;81701320;156017;
22.01.2019;11:15:05;81857414;81701460;155954;
22.01.2019;11:16:04;81857478;81701571;155907;
22.01.2019;11:17:10;81857560;81701720;155840;
22.01.2019;11:18:06;81857627;81701862;155765;
22.01.2019;11:19:04;81857702;81702001;155701;
22.01.2019;11:20:06;81857804;81702137;155667;
22.01.2019;11:21:06;81857892;81702302;155590;
22.01.2019;11:22:05;81857969;81702452;155517;
22.01.2019;11:23:06;81858069;81702611;155458;
22.01.2019;11:24:06;81858175;81702751;155424;
22.01.2019;11:25:06;81858265;81702914;155351;
22.01.2019;11:26:05;81858372;81703035;155337;
22.01.2019;11:27:05;81858470;81703197;155273;
22.01.2019;11:28:05;81858570;81703359;155211;
22.01.2019;11:29:05;81858658;81703502;155156;
22.01.2019;11:30:04;81858772;81703643;155129;
22.01.2019;11:31:10;81858892;81703791;155101;
22.01.2019;11:32:11;81858989;81703958;155031;
22.01.2019;11:33:04;81859099;81704085;155014;
22.01.2019;11:34:06;81859204;81704263;154941;
22.01.2019;11:35:05;81859307;81704429;154878;
22.01.2019;11:36:11;81859403;81704608;154795;
22.01.2019;11:37:05;81859510;81704726;154784;
22.01.2019;11:38:06;81859592;81704884;154708;
22.01.2019;11:39:05;81859689;81705003;154686;
22.01.2019;11:40:05;81859791;81705158;154633;
22.01.2019;11:41:05;81859883;81705307;154576;
22.01.2019;11:42:05;81859972;81705486;154486;
22.01.2019;11:43:06;81860063;81705636;154427;
22.01.2019;11:44:06;81860155;81705788;154367;
22.01.2019;11:45:07;81860259;81705957;154302;
22.01.2019;11:46:05;81860350;81706087;154263;
22.01.2019;11:47:04;81860467;81706212;154255;
22.01.2019;11:48:05;81860553;81706343;154210;
22.01.2019;11:49:05;81860653;81706468;154185;
22.01.2019;11:50:05;81860748;81706618;154130;
22.01.2019;11:51:04;81860864;81706785;154079;
22.01.2019;11:52:04;81860975;81706903;154072;
22.01.2019;11:53:05;81861070;81707058;154012;
22.01.2019;11:54:04;81861179;81707206;153973;
22.01.2019;11:55:04;81861289;81707356;153933;
22.01.2019;11:56:05;81861372;81707481;153891;
22.01.2019;11:57:05;81861455;81707610;153845;
22.01.2019;11:58:05;81861551;81707745;153806;
22.01.2019;11:59:05;81861647;81707902;153745;
22.01.2019;12:00:05;81861713;81708061;153652;
22.01.2019;12:01:04;81861828;81708201;153627;
22.01.2019;12:02:05;81861939;81708328;153611;
22.01.2019;12:03:05;81862041;81708486;153555;
22.01.2019;12:04:04;81862133;81708625;153508;
22.01.2019;12:05:04;81862219;81708782;153437;
22.01.2019;12:06:05;81862314;81708942;153372;
22.01.2019;12:07:04;81862409;81709067;153342;
22.01.2019;12:08:04;81862510;81709236;153274;
22.01.2019;12:09:05;81862578;81709349;153229;
22.01.2019;12:10:05;81862615;81709463;153152;
22.01.2019;12:11:04;81862673;81709583;153090;
22.01.2019;12:12:04;81862701;81709690;153011;
22.01.2019;12:13:05;81862781;81709813;152968;
22.01.2019;12:14:05;81862822;81709910;152912;
22.01.2019;12:15:04;81862844;81710044;152800;
22.01.2019;12:16:04;81862891;81710184;152707;
22.01.2019;12:17:05;81862951;81710337;152614;
22.01.2019;12:18:05;81863038;81710463;152575;
22.01.2019;12:19:05;81863135;81710592;152543;
22.01.2019;12:20:05;81863228;81710760;152468;
22.01.2019;12:21:08;81863310;81710924;152386;
22.01.2019;12:22:04;81863381;81711052;152329;
22.01.2019;12:23:04;81863489;81711216;152273;
22.01.2019;12:24:05;81863588;81711366;152222;
22.01.2019;12:25:05;81863681;81711537;152144;
22.01.2019;12:26:04;81863760;81711692;152068;
22.01.2019;12:27:04;81863850;81711851;151999;
22.01.2019;12:28:05;81863938;81712007;151931;
22.01.2019;12:29:05;81864020;81712154;151866;
22.01.2019;12:30:09;81864115;81712330;151785;
22.01.2019;12:31:04;81864195;81712469;151726;
22.01.2019;12:32:05;81864284;81712639;151645;
22.01.2019;12:33:04;81864378;81712784;151594;
22.01.2019;12:34:04;81864471;81712917;151554;
22.01.2019;12:35:05;81864572;81713072;151500;
22.01.2019;12:36:05;81864655;81713210;151445;
22.01.2019;12:37:05;81864753;81713345;151408;
22.01.2019;12:38:05;81864850;81713473;151377;
22.01.2019;12:39:04;81864965;81713600;151365;
22.01.2019;12:40:04;81865062;81713740;151322;
22.01.2019;12:41:05;81865162;81713909;151253;
22.01.2019;12:42:04;81865257;81714042;151215;
22.01.2019;12:43:04;81865366;81714199;151167;
22.01.2019;12:44:05;81865464;81714345;151119;
22.01.2019;12:45:04;81865582;81714498;151084;
22.01.2019;12:46:04;81865664;81714624;151040;
22.01.2019;12:47:05;81865763;81714767;150996;
22.01.2019;12:48:05;81865853;81714912;150941;
22.01.2019;12:49:05;81865945;81715047;150898;
22.01.2019;12:50:05;81866048;81715182;150866;
22.01.2019;12:51:05;81866132;81715340;150792;
22.01.2019;12:52:04;81866212;81715486;150726;
22.01.2019;12:53:04;81866343;81715637;150706;
22.01.2019;12:54:05;81866442;81715790;150652;
22.01.2019;12:55:05;81866554;81715930;150624;
22.01.2019;12:56:05;81866640;81716063;150577;
22.01.2019;12:57:04;81866744;81716232;150512;
22.01.2019;12:58:04;81866838;81716350;150488;
22.01.2019;12:59:05;81866918;81716507;150411;
22.01.2019;13:00:05;81867009;81716686;150323;
22.01.2019;13:01:05;81867136;81716825;150311;
22.01.2019;13:02:04;81867246;81716965;150281;
22.01.2019;13:03:04;81867343;81717115;150228;
22.01.2019;13:04:05;81867414;81717258;150156;
22.01.2019;13:05:04;81867503;81717399;150104;
22.01.2019;13:06:04;81867598;81717561;150037;
22.01.2019;13:07:04;81867699;81717714;149985;
22.01.2019;13:08:05;81867811;81717875;149936;
22.01.2019;13:09:05;81867910;81717995;149915;
22.01.2019;13:10:05;81868011;81718147;149864;
22.01.2019;13:11:05;81868118;81718284;149834;
22.01.2019;13:12:05;81868225;81718436;149789;
22.01.2019;13:13:05;81868334;81718601;149733;
22.01.2019;13:14:04;81868421;81718742;149679;
22.01.2019;13:15:04;81868513;81718914;149599;
22.01.2019;13:16:04;81868601;81719072;149529;
22.01.2019;13:17:05;81868717;81719222;149495;
22.01.2019;13:18:04;81868812;81719385;149427;
22.01.2019;13:19:04;81868919;81719521;149398;
22.01.2019;13:20:04;81869027;81719683;149344;
22.01.2019;13:21:05;81869126;81719850;149276;
22.01.2019;13:22:05;81869234;81719991;149243;
22.01.2019;13:23:05;81869314;81720168;149146;
22.01.2019;13:24:05;81869436;81720313;149123;
22.01.2019;13:25:05;81869558;81720461;149097;
22.01.2019;13:26:05;81869659;81720599;149060;
22.01.2019;13:27:05;81869741;81720759;148982;
22.01.2019;13:28:10;81869858;81720944;148914;
22.01.2019;13:29:05;81869936;81721103;148833;
22.01.2019;13:30:10;81870061;81721282;148779;
22.01.2019;13:31:05;81870157;81721392;148765;
22.01.2019;13:32:04;81870248;81721522;148726;
22.01.2019;13:33:04;81870347;81721682;148665;
22.01.2019;13:34:05;81870458;81721845;148613;
22.01.2019;13:35:05;81870569;81721990;148579;
22.01.2019;13:36:05;81870672;81722155;148517;
22.01.2019;13:37:05;81870772;81722295;148477;
22.01.2019;13:38:04;81870894;81722449;148445;
22.01.2019;13:39:05;81871011;81722600;148411;
22.01.2019;13:40:05;81871140;81722765;148375;
22.01.2019;13:41:05;81871242;81722909;148333;
22.01.2019;13:42:05;81871353;81723058;148295;
22.01.2019;13:43:04;81871467;81723216;148251;
22.01.2019;13:44:04;81871605;81723417;148188;
22.01.2019;13:45:05;81871698;81723546;148152;
22.01.2019;13:46:10;81871809;81723736;148073;
22.01.2019;13:47:04;81871924;81723873;148051;
22.01.2019;13:48:04;81872035;81724038;147997;
22.01.2019;13:49:05;81872132;81724174;147958;
22.01.2019;13:50:05;81872249;81724336;147913;
22.01.2019;13:51:05;81872364;81724495;147869;
22.01.2019;13:52:05;81872486;81724647;147839;
22.01.2019;13:53:05;81872606;81724810;147796;
22.01.2019;13:54:05;81872725;81724921;147804;
22.01.2019;13:55:05;81872846;81725101;147745;
22.01.2019;13:56:05;81872990;81725264;147726;
22.01.2019;13:57:06;81873121;81725441;147680;
22.01.2019;13:58:05;81873242;81725606;147636;
22.01.2019;13:59:08;81873361;81725758;147603;
22.01.2019;14:00:08;81873485;81725897;147588;
22.01.2019;14:01:05;81873595;81726056;147539;
22.01.2019;14:02:04;81873710;81726237;147473;
22.01.2019;14:03:05;81873835;81726396;147439;
22.01.2019;14:04:05;81873933;81726561;147372;
22.01.2019;14:05:05;81874046;81726735;147311;
22.01.2019;14:06:08;81874196;81726893;147303;
22.01.2019;14:07:05;81874300;81727044;147256;
22.01.2019;14:08:05;81874419;81727218;147201;
22.01.2019;14:09:06;81874562;81727383;147179;
22.01.2019;14:10:06;81874714;81727549;147165;
22.01.2019;14:11:05;81874832;81727697;147135;
22.01.2019;14:12:05;81874971;81727866;147105;
22.01.2019;14:13:04;81875082;81727999;147083;
22.01.2019;14:14:08;81875195;81728174;147021;
22.01.2019;14:15:05;81875321;81728335;146986;
22.01.2019;14:16:05;81875393;81728487;146906;
22.01.2019;14:17:05;81875479;81728611;146868;
22.01.2019;14:18:05;81875560;81728761;146799;
22.01.2019;14:19:07;81875642;81728879;146763;
22.01.2019;14:20:05;81875741;81729038;146703;
22.01.2019;14:21:06;81875855;81729188;146667;
22.01.2019;14:22:05;81875949;81729330;146619;
22.01.2019;14:23:04;81876056;81729474;146582;
22.01.2019;14:24:04;81876155;81729610;146545;
22.01.2019;14:25:06;81876258;81729778;146480;
22.01.2019;14:26:05;81876370;81729917;146453;
22.01.2019;14:27:04;81876468;81730076;146392;
22.01.2019;14:28:04;81876564;81730223;146341;
22.01.2019;14:29:07;81876694;81730389;146305;
22.01.2019;14:30:05;81876821;81730553;146268;
22.01.2019;14:31:05;81876929;81730724;146205;
22.01.2019;14:32:05;81877041;81730872;146169;
22.01.2019;14:33:05;81877156;81731059;146097;
22.01.2019;14:34:05;81877273;81731223;146050;
22.01.2019;14:35:04;81877410;81731408;146002;
22.01.2019;14:36:08;81877544;81731581;145963;
22.01.2019;14:37:05;81877649;81731720;145929;
22.01.2019;14:38:05;81877784;81731897;145887;
22.01.2019;14:39:05;81877908;81732094;145814;
22.01.2019;14:40:05;81878019;81732251;145768;
22.01.2019;14:41:05;81878140;81732430;145710;
22.01.2019;14:42:05;81878281;81732593;145688;
22.01.2019;14:43:05;81878413;81732765;145648;
22.01.2019;14:44:05;81878551;81732930;145621;
22.01.2019;14:45:04;81878688;81733073;145615;
22.01.2019;14:46:04;81878837;81733233;145604;
22.01.2019;14:47:06;81878977;81733389;145588;
22.01.2019;14:48:05;81879113;81733541;145572;
22.01.2019;14:49:05;81879236;81733718;145518;
22.01.2019;14:50:05;81879390;81733876;145514;
22.01.2019;14:51:08;81879561;81734044;145517;
22.01.2019;14:52:20;81879731;81734245;145486;
22.01.2019;14:54:04;81879961;81734563;145398;
22.01.2019;14:55:05;81880091;81734742;145349;
22.01.2019;14:56:05;81880205;81734889;145316;
22.01.2019;14:57:05;81880334;81735083;145251;
22.01.2019;14:58:07;81880465;81735261;145204;
22.01.2019;14:59:05;81880586;81735415;145171;
22.01.2019;15:00:07;81880733;81735574;145159;
22.01.2019;15:01:10;81880872;81735755;145117;
22.01.2019;15:02:10;81881017;81735944;145073;
22.01.2019;15:03:11;81881148;81736097;145051;
22.01.2019;15:04:11;81881284;81736274;145010;
22.01.2019;15:05:11;81881393;81736462;144931;
22.01.2019;15:06:11;81881518;81736644;144874;
22.01.2019;15:07:10;81881650;81736811;144839;
22.01.2019;15:08:13;81881772;81736995;144777;
22.01.2019;15:09:10;81881899;81737136;144763;
22.01.2019;15:10:10;81882037;81737292;144745;
22.01.2019;15:11:10;81882179;81737477;144702;
22.01.2019;15:12:13;81882341;81737684;144657;
22.01.2019;15:13:10;81882470;81737831;144639;
22.01.2019;15:14:10;81882583;81738003;144580;
22.01.2019;15:15:10;81882714;81738154;144560;
22.01.2019;15:16:10;81882851;81738315;144536;
22.01.2019;15:17:14;81882994;81738518;144476;
22.01.2019;15:18:11;81883115;81738710;144405;
22.01.2019;15:19:11;81883249;81738892;144357;
22.01.2019;15:20:11;81883386;81739059;144327;
22.01.2019;15:21:13;81883522;81739224;144298;
22.01.2019;15:22:10;81883661;81739398;144263;
22.01.2019;15:23:10;81883778;81739580;144198;
22.01.2019;15:24:11;81883926;81739782;144144;
22.01.2019;15:25:12;81884047;81739991;144056;
22.01.2019;15:26:12;81884192;81740179;144013;
22.01.2019;15:27:11;81884297;81740388;143909;
22.01.2019;15:28:10;81884425;81740553;143872;
22.01.2019;15:29:11;81884580;81740748;143832;
22.01.2019;15:30:14;81884725;81740931;143794;
22.01.2019;15:31:11;81884851;81741060;143791;
22.01.2019;15:32:11;81884969;81741248;143721;
22.01.2019;15:33:11;81885103;81741413;143690;
22.01.2019;15:34:13;81885239;81741603;143636;
22.01.2019;15:35:10;81885379;81741765;143614;
22.01.2019;15:36:11;81885518;81741947;143571;
22.01.2019;15:37:13;81885652;81742097;143555;
22.01.2019;15:38:20;81885800;81742296;143504;
22.01.2019;15:39:12;81885903;81742446;143457;
22.01.2019;15:40:12;81886038;81742629;143409;
22.01.2019;15:41:13;81886190;81742814;143376;
22.01.2019;15:42:11;81886312;81743010;143302;
22.01.2019;15:43:10;81886456;81743188;143268;
22.01.2019;15:44:11;81886584;81743354;143230;
22.01.2019;15:45:13;81886737;81743552;143185;
22.01.2019;15:46:11;81886883;81743752;143131;
22.01.2019;15:47:10;81887022;81743941;143081;
22.01.2019;15:48:12;81887151;81744127;143024;
22.01.2019;15:50:08;81887426;81744428;142998;
22.01.2019;15:51:08;81887550;81744605;142945;
22.01.2019;15:52:08;81887683;81744815;142868;
22.01.2019;15:53:08;81887832;81745010;142822;
22.01.2019;15:54:08;81887958;81745190;142768;
22.01.2019;15:55:10;81888113;81745389;142724;
22.01.2019;15:56:12;81888265;81745597;142668;
22.01.2019;15:57:08;81888422;81745743;142679;
22.01.2019;15:58:10;81888580;81745930;142650;
22.01.2019;15:59:10;81888711;81746134;142577;
22.01.2019;16:00:08;81888842;81746296;142546;
22.01.2019;16:01:08;81888979;81746497;142482;
22.01.2019;16:02:05;81889117;81746676;142441;
22.01.2019;16:03:05;81889255;81746870;142385;
22.01.2019;16:04:04;81889367;81747053;142314;
22.01.2019;16:05:05;81889518;81747230;142288;
22.01.2019;16:07:05;81889786;81747577;142209;
22.01.2019;16:08:05;81889933;81747772;142161;
22.01.2019;16:09:09;81890072;81747974;142098;
22.01.2019;16:10:05;81890191;81748144;142047;
22.01.2019;16:11:05;81890301;81748323;141978;
22.01.2019;16:12:04;81890449;81748493;141956;
22.01.2019;16:13:04;81890603;81748661;141942;
22.01.2019;16:14:04;81890745;81748857;141888;
22.01.2019;16:15:04;81890880;81749029;141851;
22.01.2019;16:16:07;81891024;81749223;141801;
22.01.2019;16:17:05;81891150;81749392;141758;
22.01.2019;16:18:05;81891280;81749548;141732;
22.01.2019;16:19:05;81891403;81749708;141695;
22.01.2019;16:20:05;81891550;81749872;141678;
22.01.2019;16:21:05;81891677;81750038;141639;
22.01.2019;16:22:05;81891796;81750242;141554;
22.01.2019;16:23:04;81891906;81750386;141520;
22.01.2019;16:24:07;81892002;81750547;141455;
22.01.2019;16:25:05;81892145;81750731;141414;
22.01.2019;16:26:05;81892267;81750916;141351;
22.01.2019;16:27:05;81892411;81751099;141312;
22.01.2019;16:28:05;81892531;81751259;141272;
22.01.2019;16:29:05;81892670;81751418;141252;
22.01.2019;16:30:05;81892804;81751604;141200;
22.01.2019;16:31:05;81892933;81751776;141157;
22.01.2019;16:32:07;81893079;81751954;141125;
22.01.2019;16:33:06;81893210;81752110;141100;
22.01.2019;16:34:06;81893378;81752300;141078;
22.01.2019;16:35:05;81893508;81752450;141058;
22.01.2019;16:36:04;81893639;81752601;141038;
22.01.2019;16:37:05;81893783;81752770;141013;
22.01.2019;16:38:04;81893907;81752968;140939;
22.01.2019;16:39:06;81894055;81753157;140898;
22.01.2019;16:40:04;81894171;81753322;140849;
22.01.2019;16:41:05;81894306;81753487;140819;
22.01.2019;16:42:04;81894434;81753660;140774;
22.01.2019;16:43:05;81894580;81753853;140727;
22.01.2019;16:44:13;81894725;81754052;140673;
22.01.2019;16:45:05;81894846;81754188;140658;
22.01.2019;16:46:05;81894976;81754365;140611;
22.01.2019;16:47:08;81895112;81754515;140597;
22.01.2019;16:48:05;81895248;81754678;140570;
22.01.2019;16:49:05;81895380;81754854;140526;
22.01.2019;16:50:04;81895528;81755002;140526;
22.01.2019;16:51:06;81895674;81755176;140498;
22.01.2019;16:52:05;81895807;81755356;140451;
22.01.2019;16:53:05;81895951;81755494;140457;
22.01.2019;16:54:08;81896085;81755666;140419;
22.01.2019;16:55:05;81896223;81755814;140409;
22.01.2019;16:56:05;81896377;81756028;140349;
22.01.2019;16:57:05;81896528;81756229;140299;
22.01.2019;16:58:05;81896657;81756403;140254;
22.01.2019;16:59:05;81896805;81756565;140240;
22.01.2019;17:00:05;81896957;81756767;140190;
22.01.2019;17:01:08;81897093;81756930;140163;
22.01.2019;17:02:04;81897218;81757123;140095;
22.01.2019;17:03:04;81897342;81757312;140030;
22.01.2019;17:04:05;81897505;81757504;140001;
22.01.2019;17:05:05;81897658;81757673;139985;
22.01.2019;17:06:04;81897820;81757844;139976;
22.01.2019;17:07:04;81897979;81757978;140001;
22.01.2019;17:08:08;81898144;81758156;139988;
22.01.2019;17:09:06;81898296;81758329;139967;
22.01.2019;17:10:04;81898445;81758509;139936;
22.01.2019;17:11:05;81898589;81758699;139890;
22.01.2019;17:12:05;81898723;81758871;139852;
22.01.2019;17:13:04;81898867;81759030;139837;
22.01.2019;17:14:04;81899031;81759233;139798;
22.01.2019;17:15:08;81899204;81759421;139783;
22.01.2019;17:16:04;81899353;81759578;139775;
22.01.2019;17:17:04;81899506;81759769;139737;
22.01.2019;17:18:04;81899607;81759962;139645;
22.01.2019;17:19:05;81899768;81760177;139591;
22.01.2019;17:20:05;81899911;81760378;139533;
22.01.2019;17:21:05;81900064;81760583;139481;
22.01.2019;17:22:05;81900226;81760759;139467;
22.01.2019;17:23:05;81900393;81760932;139461;
22.01.2019;17:24:04;81900534;81761110;139424;
22.01.2019;17:25:05;81900669;81761303;139366;
22.01.2019;17:26:05;81900817;81761480;139337;
22.01.2019;17:27:04;81900977;81761668;139309;
22.01.2019;17:28:05;81901119;81761884;139235;
22.01.2019;17:29:05;81901249;81762090;139159;
22.01.2019;17:30:07;81901391;81762289;139102;
22.01.2019;17:31:05;81901512;81762480;139032;
22.01.2019;17:32:05;81901679;81762655;139024;
22.01.2019;17:33:04;81901829;81762824;139005;
22.01.2019;17:34:04;81901974;81763025;138949;
22.01.2019;17:35:05;81902140;81763225;138915;
22.01.2019;17:36:05;81902310;81763406;138904;
22.01.2019;17:37:05;81902466;81763569;138897;
22.01.2019;17:38:07;81902636;81763785;138851;
22.01.2019;17:39:06;81902823;81763964;138859;
22.01.2019;17:40:05;81902935;81764153;138782;
22.01.2019;17:41:05;81903096;81764319;138777;
22.01.2019;17:42:05;81903237;81764499;138738;
22.01.2019;17:43:04;81903407;81764672;138735;
22.01.2019;17:44:04;81903553;81764839;138714;
22.01.2019;17:45:05;81903704;81765004;138700;
22.01.2019;17:46:07;81903871;81765194;138677;
22.01.2019;17:47:04;81904030;81765372;138658;
22.01.2019;17:48:04;81904200;81765538;138662;
22.01.2019;17:49:04;81904353;81765711;138642;
22.01.2019;17:50:05;81904511;81765900;138611;
22.01.2019;17:51:05;81904659;81766089;138570;
22.01.2019;17:52:05;81904806;81766264;138542;
22.01.2019;17:53:06;81904971;81766434;138537;
22.01.2019;17:54:04;81905106;81766567;138539;
22.01.2019;17:55:05;81905274;81766745;138529;
22.01.2019;17:56:05;81905425;81766923;138502;
22.01.2019;17:57:05;81905559;81767114;138445;
22.01.2019;17:58:05;81905721;81767273;138448;
22.01.2019;17:59:04;81905868;81767422;138446;
22.01.2019;18:00:04;81905988;81767572;138416;
22.01.2019;18:01:07;81906156;81767746;138410;
22.01.2019;18:02:05;81906264;81767912;138352;
22.01.2019;18:03:05;81906401;81768064;138337;
22.01.2019;18:04:05;81906542;81768236;138306;
22.01.2019;18:05:05;81906697;81768413;138284;
22.01.2019;18:06:09;81906839;81768589;138250;
22.01.2019;18:07:04;81907034;81768711;138323;
22.01.2019;18:08:04;81907177;81768884;138293;
22.01.2019;18:09:10;81907334;81769059;138275;
22.01.2019;18:10:05;81907471;81769214;138257;
22.01.2019;18:11:05;81907632;81769370;138262;
22.01.2019;18:12:04;81907786;81769556;138230;
22.01.2019;18:13:04;81907924;81769680;138244;
22.01.2019;18:14:04;81908096;81769826;138270;
22.01.2019;18:15:05;81908256;81769977;138279;
22.01.2019;18:16:05;81908412;81770127;138285;
22.01.2019;18:17:07;81908574;81770314;138260;
22.01.2019;18:18:05;81908733;81770482;138251;
22.01.2019;18:19:05;81908912;81770610;138302;
22.01.2019;18:20:04;81909038;81770772;138266;
22.01.2019;18:21:04;81909175;81770923;138252;
22.01.2019;18:22:04;81909315;81771096;138219;
22.01.2019;18:23:05;81909443;81771242;138201;
22.01.2019;18:24:05;81909597;81771362;138235;
22.01.2019;18:25:04;81909699;81771500;138199;
22.01.2019;18:26:04;81909825;81771650;138175;
22.01.2019;18:27:06;81909956;81771792;138164;
22.01.2019;18:28:05;81910053;81771943;138110;
22.01.2019;18:29:05;81910183;81772050;138133;
22.01.2019;18:30:05;81910316;81772190;138126;
22.01.2019;18:31:05;81910425;81772319;138106;
22.01.2019;18:32:05;81910558;81772452;138106;
22.01.2019;18:33:05;81910696;81772571;138125;
22.01.2019;18:34:05;81910853;81772681;138172;
22.01.2019;18:35:05;81910990;81772809;138181;
22.01.2019;18:36:05;81911108;81772960;138148;
22.01.2019;18:37:04;81911246;81773085;138161;
22.01.2019;18:38:04;81911387;81773211;138176;
22.01.2019;18:39:05;81911527;81773334;138193;
22.01.2019;18:40:04;81911647;81773461;138186;
22.01.2019;18:41:04;81911790;81773582;138208;
22.01.2019;18:42:04;81911928;81773722;138206;
22.01.2019;18:43:04;81912067;81773840;138227;
22.01.2019;18:44:05;81912190;81773972;138218;
22.01.2019;18:45:04;81912321;81774062;138259;
22.01.2019;18:46:05;81912459;81774199;138260;
22.01.2019;18:47:05;81912581;81774336;138245;
22.01.2019;18:48:05;81912725;81774451;138274;
22.01.2019;18:49:05;81912838;81774566;138272;
22.01.2019;18:50:04;81912954;81774642;138312;
22.01.2019;18:51:04;81913093;81774768;138325;
22.01.2019;18:52:05;81913187;81774881;138306;
22.01.2019;18:53:05;81913271;81774974;138297;
22.01.2019;18:54:05;81913392;81775087;138305;
22.01.2019;18:55:04;81913517;81775207;138310;
22.01.2019;18:56:04;81913629;81775318;138311;
22.01.2019;18:57:06;81913751;81775455;138296;
22.01.2019;18:58:04;81913888;81775564;138324;
22.01.2019;18:59:04;81914025;81775696;138329;
22.01.2019;19:00:05;81914159;81775814;138345;
22.01.2019;19:01:05;81914309;81775933;138376;
22.01.2019;19:02:05;81914458;81776039;138419;
22.01.2019;19:03:05;81914580;81776171;138409;
22.01.2019;19:04:05;81914737;81776290;138447;
22.01.2019;19:05:05;81914859;81776402;138457;
22.01.2019;19:06:05;81914983;81776525;138458;
22.01.2019;19:07:05;81915119;81776656;138463;
22.01.2019;19:08:04;81915247;81776759;138488;
22.01.2019;19:09:05;81915388;81776863;138525;
22.01.2019;19:10:04;81915528;81776981;138547;
22.01.2019;19:11:05;81915675;81777082;138593;
22.01.2019;19:12:05;81915798;81777178;138620;
22.01.2019;19:13:05;81915957;81777282;138675;
22.01.2019;19:14:05;81916081;81777393;138688;
22.01.2019;19:15:05;81916225;81777503;138722;
22.01.2019;19:16:05;81916354;81777602;138752;
22.01.2019;19:17:05;81916492;81777709;138783;
22.01.2019;19:18:04;81916602;81777835;138767;
22.01.2019;19:19:05;81916757;81777951;138806;
22.01.2019;19:20:04;81916899;81778082;138817;
22.01.2019;19:21:04;81917036;81778176;138860;
22.01.2019;19:22:05;81917187;81778298;138889;
22.01.2019;19:23:04;81917349;81778391;138958;
22.01.2019;19:24:04;81917492;81778475;139017;
22.01.2019;19:25:04;81917623;81778573;139050;
22.01.2019;19:26:05;81917768;81778681;139087;
22.01.2019;19:27:05;81917897;81778790;139107;
22.01.2019;19:28:05;81918063;81778899;139164;
22.01.2019;19:29:05;81918198;81779025;139173;
22.01.2019;19:30:05;81918320;81779150;139170;
22.01.2019;19:31:04;81918456;81779243;139213;
22.01.2019;19:32:04;81918570;81779329;139241;
22.01.2019;19:33:04;81918682;81779398;139284;
22.01.2019;19:34:05;81918833;81779517;139316;
22.01.2019;19:35:05;81918982;81779608;139374;
22.01.2019;19:36:04;81919121;81779690;139431;
22.01.2019;19:37:04;81919239;81779768;139471;
22.01.2019;19:38:05;81919402;81779863;139539;
22.01.2019;19:39:05;81919531;81779947;139584;
22.01.2019;19:40:04;81919685;81780041;139644;
22.01.2019;19:41:05;81919833;81780131;139702;
22.01.2019;19:42:04;81919950;81780225;139725;
22.01.2019;19:43:04;81920064;81780318;139746;
22.01.2019;19:44:04;81920201;81780400;139801;
22.01.2019;19:45:04;81920298;81780481;139817;
22.01.2019;19:46:05;81920430;81780575;139855;
22.01.2019;19:47:05;81920530;81780672;139858;
22.01.2019;19:48:05;81920658;81780778;139880;
22.01.2019;19:49:05;81920793;81780858;139935;
22.01.2019;19:50:05;81920944;81780939;140005;
22.01.2019;19:51:05;81921110;81781025;140085;
22.01.2019;19:52:04;81921276;81781125;140151;
22.01.2019;19:53:04;81921427;81781211;140216;
22.01.2019;19:54:05;81926726;81781310;145416;
22.01.2019;19:55:05;81926854;81781408;145446;
22.01.2019;19:56:04;81926982;81781488;145494;
22.01.2019;19:57:05;81927124;81788639;138485;
22.01.2019;19:58:05;81927256;81788732;138524;
22.01.2019;19:59:09;81927404;81788819;138585;
22.01.2019;20:00:05;81927532;81788900;138632;
22.01.2019;20:01:05;81927680;81788973;138707;
22.01.2019;20:02:05;81927839;81789063;138776;
22.01.2019;20:03:05;81928012;81789145;138867;
22.01.2019;20:04:04;81928124;81789226;138898;
22.01.2019;20:05:04;81928249;81789298;138951;
22.01.2019;20:06:05;81928383;81789376;139007;
22.01.2019;20:07:05;81928527;81789452;139075;
22.01.2019;20:08:05;81928672;81789549;139123;
22.01.2019;20:09:05;81928798;81789630;139168;
22.01.2019;20:10:05;81928930;81789703;139227;
22.01.2019;20:11:05;81929043;81789781;139262;
22.01.2019;20:12:05;81929127;81789824;139303;
22.01.2019;20:13:05;81929250;81789893;139357;
22.01.2019;20:14:05;81929339;81789943;139396;
22.01.2019;20:15:05;81929472;81790006;139466;
22.01.2019;20:16:05;81929596;81790054;139542;
22.01.2019;20:17:05;81929710;81790118;139592;
22.01.2019;20:18:05;81929824;81790174;139650;
22.01.2019;20:19:05;81929917;81790226;139691;
22.01.2019;20:20:05;81930003;81790283;139720;
22.01.2019;20:21:04;81930124;81790357;139767;
22.01.2019;20:22:05;81930214;81790429;139785;
22.01.2019;20:23:04;81930319;81790467;139852;
22.01.2019;20:24:05;81930416;81790512;139904;
22.01.2019;20:25:05;81930495;81790567;139928;
22.01.2019;20:26:05;81930589;81790638;139951;
22.01.2019;20:27:05;81930703;81790673;140030;
22.01.2019;20:28:05;81930822;81790735;140087;
22.01.2019;20:29:05;81930924;81790792;140132;
22.01.2019;20:30:05;81931017;81790832;140185;
22.01.2019;20:31:05;81931126;81790892;140234;
22.01.2019;20:32:05;81931253;81790976;140277;
22.01.2019;20:33:05;81931385;81791020;140365;
22.01.2019;20:34:05;81931514;81791096;140418;
22.01.2019;20:35:05;81931653;81791166;140487;
22.01.2019;20:36:05;81931782;81791244;140538;
22.01.2019;20:37:05;81931901;81791313;140588;
22.01.2019;20:38:04;81932029;81791369;140660;
22.01.2019;20:39:05;81932176;81791422;140754;
22.01.2019;20:40:05;81932298;81791480;140818;
22.01.2019;20:41:05;81932414;81791537;140877;
22.01.2019;20:42:05;81932529;81791598;140931;
22.01.2019;20:43:05;81932649;81791667;140982;
22.01.2019;20:44:05;81932822;81791749;141073;
22.01.2019;20:45:05;81933041;81791828;141213;
22.01.2019;20:46:05;81933286;81791909;141377;
22.01.2019;20:47:05;81933523;81791977;141546;
22.01.2019;20:48:05;81933750;81792049;141701;
22.01.2019;20:49:05;81934018;81792121;141897;
22.01.2019;20:50:04;81934266;81792205;142061;
22.01.2019;20:51:04;81934503;81792277;142226;
22.01.2019;20:52:05;81934739;81792351;142388;
22.01.2019;20:53:05;81935002;81792408;142594;
22.01.2019;20:54:05;81935307;81792480;142827;
22.01.2019;20:55:05;81935622;81792557;143065;
22.01.2019;20:56:05;81935946;81792615;143331;
22.01.2019;20:57:06;81936285;81792701;143584;
22.01.2019;20:58:04;81936669;81792768;143901;
22.01.2019;20:59:04;81937087;81792853;144234;
22.01.2019;21:00:04;81937556;81792922;144634;
22.01.2019;21:01:04;81938015;81792980;145035;
22.01.2019;21:02:05;81938472;81793042;145430;
22.01.2019;21:03:05;81938893;81793114;145779;
22.01.2019;21:04:05;81939340;81793185;146155;
22.01.2019;21:05:05;81939787;81793244;146543;
22.01.2019;21:06:05;81940260;81793301;146959;
22.01.2019;21:07:05;81940716;81793395;147321;
22.01.2019;21:08:05;81941142;81793480;147662;
22.01.2019;21:09:05;81941622;81793543;148079;
22.01.2019;21:10:05;81942075;81793593;148482;
22.01.2019;21:11:05;81942527;81793689;148838;
22.01.2019;21:12:05;81943021;81793741;149280;
22.01.2019;21:13:05;81943491;81793799;149692;
22.01.2019;21:14:05;81943963;81793854;150109;
22.01.2019;21:15:04;81944449;81793908;150541;
22.01.2019;21:16:04;81944940;81793974;150966;
22.01.2019;21:17:05;81945447;81794054;151393;
22.01.2019;21:18:04;81945921;81794122;151799;
22.01.2019;21:19:04;81946399;81794198;152201;
22.01.2019;21:20:05;81946856;81794267;152589;
22.01.2019;21:21:05;81947362;81794299;153063;
22.01.2019;21:22:05;81947795;81794338;153457;
22.01.2019;21:23:04;81948250;81794400;153850;
22.01.2019;21:24:04;81948769;81794463;154306;
22.01.2019;21:25:05;81949271;81794536;154735;
22.01.2019;21:26:05;81949775;81794586;155189;
22.01.2019;21:27:05;81950224;81794645;155579;
22.01.2019;21:28:05;81950739;81794689;156050;
22.01.2019;21:29:05;81951256;81794755;156501;
22.01.2019;21:30:05;81951769;81794800;156969;
22.01.2019;21:31:04;81952253;81794855;157398;
22.01.2019;21:32:05;81952759;81794903;157856;
22.01.2019;21:33:05;81953290;81794960;158330;
22.01.2019;21:34:05;81953816;81795037;158779;
22.01.2019;21:35:05;81954333;81795097;159236;
22.01.2019;21:36:05;81954845;81795160;159685;
22.01.2019;21:37:05;81955358;81795205;160153;
22.01.2019;21:38:05;81955957;81795257;160700;
22.01.2019;21:39:07;81956540;81795307;161233;
22.01.2019;21:40:05;81957094;81795361;161733;
22.01.2019;21:41:05;81957602;81795416;162186;
22.01.2019;21:42:05;81958163;81795470;162693;
22.01.2019;21:43:05;81958713;81795512;163201;
22.01.2019;21:44:05;81959250;81795548;163702;
22.01.2019;21:45:05;81959815;81795613;164202;
22.01.2019;21:46:05;81960334;81795651;164683;
22.01.2019;21:47:05;81960877;81795698;165179;
22.01.2019;21:48:04;81961431;81795747;165684;
22.01.2019;21:49:04;81961982;81795838;166144;
22.01.2019;21:50:04;81962542;81795887;166655;
22.01.2019;21:51:05;81963112;81795951;167161;
22.01.2019;21:52:05;81963703;81796015;167688;
22.01.2019;21:53:05;81964239;81796025;168214;
22.01.2019;21:54:05;81964798;81796093;168705;
22.01.2019;21:55:05;81965343;81796139;169204;
22.01.2019;21:56:05;81965855;81796167;169688;
22.01.2019;21:57:05;81966433;81796220;170213;
22.01.2019;21:58:04;81966964;81796278;170686;
22.01.2019;21:59:05;81967490;81796331;171159;
22.01.2019;22:00:04;81968022;81796379;171643;
22.01.2019;22:01:04;81968520;81796430;172090;
22.01.2019;22:02:04;81969036;81796500;172536;
22.01.2019;22:03:05;81969572;81796549;173023;
22.01.2019;22:04:05;81970081;81796597;173484;
22.01.2019;22:05:05;81970629;81796655;173974;
22.01.2019;22:06:05;81971188;81796700;174488;
22.01.2019;22:07:05;81971768;81796751;175017;
22.01.2019;22:08:04;81972347;81796803;175544;
22.01.2019;22:09:06;81972901;81796849;176052;
22.01.2019;22:10:05;81973469;81796892;176577;
22.01.2019;22:11:06;81973962;81796944;177018;
22.01.2019;22:12:05;81974501;81797005;177496;
22.01.2019;22:13:05;81975025;81797060;177965;
22.01.2019;22:14:05;81975550;81797102;178448;
22.01.2019;22:15:05;81976021;81797150;178871;
22.01.2019;22:16:05;81976552;81797188;179364;
22.01.2019;22:17:05;81977057;81797241;179816;
22.01.2019;22:18:05;81977551;81797292;180259;
22.01.2019;22:19:05;81978118;81797338;180780;
22.01.2019;22:20:05;81978653;81797377;181276;
22.01.2019;22:21:08;81979190;81797408;181782;
22.01.2019;22:22:05;81979652;81797443;182209;
22.01.2019;22:23:05;81980113;81797482;182631;
22.01.2019;22:24:05;81980552;81797533;183019;
22.01.2019;22:25:05;81981045;81797581;183464;
22.01.2019;22:26:05;81981505;81797616;183889;
22.01.2019;22:27:05;81981989;81797653;184336;
22.01.2019;22:28:05;81982395;81797683;184712;
22.01.2019;22:29:05;81982908;81797707;185201;
22.01.2019;22:30:05;81983403;81797741;185662;
22.01.2019;22:31:05;81983899;81797778;186121;
22.01.2019;22:32:05;81984352;81797816;186536;
22.01.2019;22:33:05;81984834;81797842;186992;
22.01.2019;22:34:05;81985305;81797868;187437;
22.01.2019;22:35:05;81985728;81797918;187810;
22.01.2019;22:36:05;81986245;81797950;188295;
22.01.2019;22:37:04;81986771;81797982;188789;
22.01.2019;22:38:04;81987235;81798023;189212;
22.01.2019;22:39:05;81987712;81798070;189642;
22.01.2019;22:40:05;81988177;81798114;190063;
22.01.2019;22:41:04;81988689;81798158;190531;
22.01.2019;22:42:05;81989207;81798191;191016;
22.01.2019;22:43:04;81989674;81798233;191441;
22.01.2019;22:44:04;81990138;81798293;191845;
22.01.2019;22:45:05;81990628;81798342;192286;
22.01.2019;22:46:05;81991097;81798365;192732;
22.01.2019;22:47:04;81991551;81798394;193157;
22.01.2019;22:48:04;81991985;81798425;193560;
22.01.2019;22:49:04;81992493;81798471;194022;
22.01.2019;22:50:04;81992962;81798520;194442;
22.01.2019;22:51:05;81993452;81798568;194884;
22.01.2019;22:52:05;81993958;81798613;195345;
22.01.2019;22:53:05;81994396;81798664;195732;
22.01.2019;22:54:05;81994835;81798702;196133;
22.01.2019;22:55:05;81995328;81798738;196590;
22.01.2019;22:56:05;81995768;81798775;196993;
22.01.2019;22:57:05;81996252;81798823;197429;
22.01.2019;22:58:05;81996731;81798858;197873;
22.01.2019;22:59:05;81997218;81798908;198310;
22.01.2019;23:00:05;81997688;81798938;198750;
22.01.2019;23:01:05;81998138;81798979;199159;
22.01.2019;23:02:04;81998622;81799018;199604;
22.01.2019;23:03:04;81999058;81799047;200011;
22.01.2019;23:04:05;81999544;81799087;200457;
22.01.2019;23:05:05;82000057;81799127;200930;
22.01.2019;23:06:05;82000602;81799182;201420;
22.01.2019;23:07:05;82001132;81799221;201911;
22.01.2019;23:08:05;82001569;81799257;202312;
22.01.2019;23:09:06;82002024;81799283;202741;
22.01.2019;23:10:05;82002473;81799320;203153;
22.01.2019;23:11:05;82002868;81799355;203513;
22.01.2019;23:12:05;82003328;81799395;203933;
22.01.2019;23:13:05;82003763;81799427;204336;
22.01.2019;23:14:04;82004232;81799460;204772;
22.01.2019;23:15:07;82004650;81799511;205139;
22.01.2019;23:16:05;82005095;81799538;205557;
22.01.2019;23:17:05;82005524;81799588;205936;
22.01.2019;23:18:05;82005989;81799637;206352;
22.01.2019;23:19:04;82006392;81799667;206725;
22.01.2019;23:20:04;82006887;81799701;207186;
22.01.2019;23:21:05;82007310;81799727;207583;
22.01.2019;23:22:05;82007737;81799770;207967;
22.01.2019;23:23:04;82008151;81799800;208351;
22.01.2019;23:24:05;82008615;81799833;208782;
22.01.2019;23:25:05;82009016;81799866;209150;
22.01.2019;23:26:05;82009387;81799899;209488;
22.01.2019;23:27:06;82009802;81799921;209881;
22.01.2019;23:28:05;82010194;81799974;210220;
22.01.2019;23:29:05;82010591;81799986;210605;
22.01.2019;23:30:05;82011026;81800027;210999;
22.01.2019;23:31:05;82011420;81800065;211355;
22.01.2019;23:32:04;82011828;81800092;211736;
22.01.2019;23:33:04;82012237;81800137;212100;
22.01.2019;23:34:05;82012608;81800187;212421;
22.01.2019;23:35:05;82012972;81800214;212758;
22.01.2019;23:36:05;82013354;81800239;213115;
22.01.2019;23:37:04;82013747;81800263;213484;
22.01.2019;23:38:04;82014127;81800309;213818;
22.01.2019;23:39:04;82014494;81800344;214150;
22.01.2019;23:40:05;82014897;81800372;214525;
22.01.2019;23:41:05;82015249;81800396;214853;
22.01.2019;23:42:04;82015598;81800433;215165;
22.01.2019;23:43:05;82016000;81800464;215536;
22.01.2019;23:44:05;82016357;81800497;215860;
22.01.2019;23:45:05;82016686;81800529;216157;
22.01.2019;23:46:05;82017030;81800564;216466;
22.01.2019;23:47:05;82017426;81800597;216829;
22.01.2019;23:48:04;82017755;81800632;217123;
22.01.2019;23:49:04;82018168;81800668;217500;
22.01.2019;23:50:05;82018572;81800716;217856;
22.01.2019;23:51:05;82018951;81800755;218196;
22.01.2019;23:52:04;82019300;81800786;218514;
22.01.2019;23:53:04;82019680;81800822;218858;
22.01.2019;23:54:05;82020052;81800868;219184;
22.01.2019;23:55:05;82020428;81800913;219515;
22.01.2019;23:56:04;82020782;81800950;219832;
22.01.2019;23:57:04;82021145;81800984;220161;
22.01.2019;23:58:05;82021543;81801008;220535;
22.01.2019;23:59:05;82021902;81801029;220873;
23.01.2019;00:00:08;82022214;81801045;221169;
23.01.2019;00:01:08;82022614;81801077;221537;
23.01.2019;00:02:08;82023034;81801126;221908;
23.01.2019;00:03:08;82023365;81801157;222208;
23.01.2019;00:04:11;82023742;81801184;222558;
23.01.2019;00:05:07;82024100;81801215;222885;
23.01.2019;00:06:09;82024465;81801237;223228;
23.01.2019;00:07:08;82024833;81801259;223574;
23.01.2019;00:08:08;82025186;81801298;223888;
23.01.2019;00:09:09;82025582;81801345;224237;
23.01.2019;00:10:10;82025932;81801381;224551;
23.01.2019;00:11:07;82026271;81801412;224859;
23.01.2019;00:12:07;82026614;81801450;225164;
23.01.2019;00:13:07;82026940;81801479;225461;
23.01.2019;00:14:07;82027324;81801522;225802;
23.01.2019;00:15:08;82027681;81801560;226121;
23.01.2019;00:16:08;82027977;81801575;226402;
23.01.2019;00:17:08;82028245;81801602;226643;
23.01.2019;00:18:08;82028434;81801640;226794;
23.01.2019;00:19:08;82028609;81801663;226946;
23.01.2019;00:20:08;82028814;81801694;227120;
23.01.2019;00:21:07;82029059;81801709;227350;
23.01.2019;00:22:07;82029263;81801760;227503;
23.01.2019;00:23:08;82029371;81801787;227584;
23.01.2019;00:24:07;82029507;81801816;227691;
23.01.2019;00:25:08;82029588;81801836;227752;
23.01.2019;00:26:08;82029699;81801864;227835;
23.01.2019;00:27:07;82029810;81801882;227928;
23.01.2019;00:28:07;82029903;81801904;227999;
23.01.2019;00:29:07;82030022;81801925;228097;
23.01.2019;00:30:07;82030128;81801951;228177;
23.01.2019;00:31:08;82030281;81801976;228305;
23.01.2019;00:32:06;82030459;81802015;228444;
23.01.2019;00:33:08;82030624;81802041;228583;
23.01.2019;00:34:07;82030824;81802079;228745;
23.01.2019;00:35:08;82030976;81802098;228878;
23.01.2019;00:36:09;82031160;81802132;229028;
23.01.2019;00:37:09;82031348;81802145;229203;
23.01.2019;00:38:08;82031506;81802174;229332;
23.01.2019;00:39:09;82031650;81802216;229434;
23.01.2019;00:40:08;82031837;81802234;229603;
23.01.2019;00:41:08;82032039;81802262;229777;
23.01.2019;00:42:08;82032242;81802281;229961;
23.01.2019;00:43:07;82032407;81802323;230084;
23.01.2019;00:44:09;82032614;81802348;230266;
23.01.2019;00:45:07;82032815;81802383;230432;
23.01.2019;00:46:08;82033015;81802419;230596;
23.01.2019;00:47:07;82033242;81802448;230794;
23.01.2019;00:48:08;82033469;81802488;230981;
23.01.2019;00:49:08;82033685;81802513;231172;
23.01.2019;00:50:07;82033885;81802535;231350;
23.01.2019;00:51:07;82034122;81802574;231548;
23.01.2019;00:52:08;82034354;81802609;231745;
23.01.2019;00:53:08;82034591;81802640;231951;
23.01.2019;00:54:08;82034859;81802675;232184;
23.01.2019;00:55:08;82035127;81802704;232423;
23.01.2019;00:56:07;82035411;81802737;232674;
23.01.2019;00:57:07;82035659;81802770;232889;
23.01.2019;00:58:07;82035939;81802804;233135;
23.01.2019;00:59:08;82036244;81802834;233410;
23.01.2019;01:00:04;82036518;81802856;233662;
23.01.2019;01:01:04;82036781;81802872;233909;
23.01.2019;01:02:05;82037035;81802895;234140;
23.01.2019;01:03:04;82037226;81802935;234291;
23.01.2019;01:04:04;82037583;81802967;234616;
23.01.2019;01:05:05;82037886;81802986;234900;
23.01.2019;01:06:04;82038176;81803031;235145;
23.01.2019;01:07:04;82038446;81803073;235373;
23.01.2019;01:08:05;82038756;81803106;235650;
23.01.2019;01:09:07;82039067;81803151;235916;
23.01.2019;01:10:04;82039352;81803200;236152;
23.01.2019;01:11:04;82039630;81803237;236393;
23.01.2019;01:12:05;82039890;81803284;236606;
23.01.2019;01:13:05;82040121;81803306;236815;
23.01.2019;01:14:05;82040469;81803343;237126;
23.01.2019;01:15:05;82040736;81803396;237340;
23.01.2019;01:16:04;82041049;81803432;237617;
23.01.2019;01:17:04;82041352;81803473;237879;
23.01.2019;01:18:05;82041673;81803514;238159;
23.01.2019;01:19:04;82041933;81803553;238380;
23.01.2019;01:20:04;82042207;81803599;238608;
23.01.2019;01:21:05;82042494;81803640;238854;
23.01.2019;01:22:05;82042812;81803671;239141;
23.01.2019;01:23:05;82043122;81803704;239418;
23.01.2019;01:24:04;82043424;81803739;239685;
23.01.2019;01:25:04;82043741;81803776;239965;
23.01.2019;01:26:04;82044024;81803816;240208;
23.01.2019;01:27:05;82044337;81803856;240481;
23.01.2019;01:28:06;82044624;81803900;240724;
23.01.2019;01:29:05;82044924;81803943;240981;
23.01.2019;01:30:05;82045197;81803980;241217;
23.01.2019;01:31:05;82045511;81804005;241506;
23.01.2019;01:32:04;82045794;81804050;241744;
23.01.2019;01:33:05;82046060;81804090;241970;
23.01.2019;01:34:05;82046359;81804128;242231;
23.01.2019;01:35:04;82046612;81804177;242435;
23.01.2019;01:36:04;82046920;81804233;242687;
23.01.2019;01:37:05;82047225;81804272;242953;
23.01.2019;01:38:04;82047489;81804314;243175;
23.01.2019;01:39:07;82047778;81804356;243422;
23.01.2019;01:40:04;82048057;81804410;243647;
23.01.2019;01:41:04;82048328;81804460;243868;
23.01.2019;01:42:04;82048627;81804502;244125;
23.01.2019;01:43:04;82048909;81804560;244349;
23.01.2019;01:44:04;82049180;81804595;244585;
23.01.2019;01:45:05;82049466;81804653;244813;
23.01.2019;01:46:05;82049758;81804702;245056;
23.01.2019;01:47:04;82050040;81804760;245280;
23.01.2019;01:48:05;82050312;81804807;245505;
23.01.2019;01:49:05;82050599;81804864;245735;
23.01.2019;01:50:04;82050866;81804913;245953;
23.01.2019;01:51:05;82051148;81804983;246165;
23.01.2019;01:52:05;82051396;81805039;246357;
23.01.2019;01:53:04;82051669;81805073;246596;
23.01.2019;01:54:04;82051937;81805118;246819;
23.01.2019;01:55:04;82052219;81805168;247051;
23.01.2019;01:56:05;82052470;81805199;247271;
23.01.2019;01:57:05;82052764;81805255;247509;
23.01.2019;01:58:04;82053064;81805301;247763;
23.01.2019;01:59:04;82053335;81805345;247990;
23.01.2019;02:00:04;82053647;81805418;248229;
23.01.2019;02:01:05;82053907;81805465;248442;
23.01.2019;02:02:05;82054157;81805516;248641;
23.01.2019;02:03:04;82054435;81805581;248854;
23.01.2019;02:04:04;82054708;81805630;249078;
23.01.2019;02:05:05;82054944;81805677;249267;
23.01.2019;02:06:04;82055196;81805736;249460;
23.01.2019;02:07:04;82055446;81805791;249655;
23.01.2019;02:08:05;82055698;81805847;249851;
23.01.2019;02:09:05;82055984;81805919;250065;
23.01.2019;02:10:04;82056275;81805971;250304;
23.01.2019;02:11:04;82056541;81806023;250518;
23.01.2019;02:12:04;82056789;81806080;250709;
23.01.2019;02:13:05;82057042;81806133;250909;
23.01.2019;02:14:05;82057293;81806203;251090;
23.01.2019;02:15:05;82057444;81806293;251151;
23.01.2019;02:16:04;82057642;81806349;251293;
23.01.2019;02:17:05;82057805;81806412;251393;
23.01.2019;02:18:05;82057863;81806470;251393;
23.01.2019;02:19:05;82057956;81806524;251432;
23.01.2019;02:20:04;82058041;81806590;251451;
23.01.2019;02:21:04;82058150;81806656;251494;
23.01.2019;02:22:05;82058274;81806729;251545;
23.01.2019;02:23:04;82058416;81806803;251613;
23.01.2019;02:24:04;82058509;81806868;251641;
23.01.2019;02:25:04;82058618;81806934;251684;
23.01.2019;02:26:04;82058758;81807002;251756;
23.01.2019;02:27:04;82058881;81807065;251816;
23.01.2019;02:28:05;82059017;81807127;251890;
23.01.2019;02:29:05;82059156;81807187;251969;
23.01.2019;02:30:05;82059270;81807257;252013;
23.01.2019;02:31:04;82059485;81807312;252173;
23.01.2019;02:32:04;82059672;81807388;252284;
23.01.2019;02:33:04;82059820;81807448;252372;
23.01.2019;02:34:05;82060022;81807536;252486;
23.01.2019;02:35:05;82060227;81807609;252618;
23.01.2019;02:36:04;82060419;81807682;252737;
23.01.2019;02:37:05;82060653;81807761;252892;
23.01.2019;02:38:05;82060887;81807861;253026;
23.01.2019;02:39:04;82061104;81807940;253164;
23.01.2019;02:40:04;82061319;81808015;253304;
23.01.2019;02:41:05;82061556;81808069;253487;
23.01.2019;02:42:04;82061782;81808136;253646;
23.01.2019;02:43:04;82062056;81808218;253838;
23.01.2019;02:44:05;82062280;81808292;253988;
23.01.2019;02:45:05;82062546;81808371;254175;
23.01.2019;02:46:04;82062777;81808442;254335;
23.01.2019;02:47:04;82063017;81808530;254487;
23.01.2019;02:48:05;82063300;81808596;254704;
23.01.2019;02:49:04;82063550;81808660;254890;
23.01.2019;02:50:05;82063839;81808766;255073;
23.01.2019;02:51:04;82064140;81808832;255308;
23.01.2019;02:52:04;82064413;81808930;255483;
23.01.2019;02:53:05;82064654;81809014;255640;
23.01.2019;02:54:04;82064905;81809090;255815;
23.01.2019;02:55:04;82065177;81809202;255975;
23.01.2019;02:56:05;82065435;81809289;256146;
23.01.2019;02:57:05;82065696;81809366;256330;
23.01.2019;02:58:04;82065932;81809459;256473;
23.01.2019;02:59:04;82066189;81809538;256651;
23.01.2019;03:00:05;82066445;81809628;256817;
23.01.2019;03:01:05;82066704;81809708;256996;
23.01.2019;03:02:05;82066947;81809798;257149;
23.01.2019;03:03:04;82067207;81809891;257316;
23.01.2019;03:04:04;82067442;81809981;257461;
23.01.2019;03:05:05;82067692;81810068;257624;
23.01.2019;03:06:04;82067963;81810171;257792;
23.01.2019;03:07:05;82068204;81810257;257947;
23.01.2019;03:08:05;82068443;81810344;258099;
23.01.2019;03:09:04;82068686;81810419;258267;
23.01.2019;03:10:04;82068886;81810499;258387;
23.01.2019;03:11:05;82069133;81810616;258517;
23.01.2019;03:12:04;82069404;81810707;258697;
23.01.2019;03:13:09;82069675;81810818;258857;
23.01.2019;03:14:06;82069918;81810907;259011;
23.01.2019;03:15:04;82070161;81811002;259159;
23.01.2019;03:16:04;82070430;81811106;259324;
23.01.2019;03:17:05;82070687;81811211;259476;
23.01.2019;03:18:05;82070927;81811305;259622;
23.01.2019;03:19:04;82071185;81811417;259768;
23.01.2019;03:20:04;82071409;81811514;259895;
23.01.2019;03:21:05;82071636;81811608;260028;
23.01.2019;03:22:05;82071868;81811707;260161;
23.01.2019;03:23:04;82072141;81811803;260338;
23.01.2019;03:24:04;82072364;81811897;260467;
23.01.2019;03:25:05;82072593;81812005;260588;
23.01.2019;03:26:05;82072821;81812105;260716;
23.01.2019;03:27:05;82073040;81812206;260834;
23.01.2019;03:28:05;82073257;81812289;260968;
23.01.2019;03:29:04;82073533;81812368;261165;
23.01.2019;03:30:05;82073784;81812467;261317;
23.01.2019;03:31:05;82074065;81812561;261504;
23.01.2019;03:32:04;82074326;81812665;261661;
23.01.2019;03:33:05;82074609;81812771;261838;
23.01.2019;03:34:05;82074816;81812893;261923;
23.01.2019;03:35:05;82075071;81812998;262073;
23.01.2019;03:36:04;82075314;81813100;262214;
23.01.2019;03:37:04;82075564;81813183;262381;
23.01.2019;03:38:05;82075849;81813302;262547;
23.01.2019;03:39:06;82076109;81813414;262695;
23.01.2019;03:40:04;82076349;81813523;262826;
23.01.2019;03:41:05;82076585;81813652;262933;
23.01.2019;03:42:05;82076811;81813756;263055;
23.01.2019;03:43:04;82077066;81813847;263219;
23.01.2019;03:44:04;82077313;81813944;263369;
23.01.2019;03:45:04;82077550;81814056;263494;
23.01.2019;03:46:05;82077829;81814173;263656;
23.01.2019;03:47:04;82078090;81814299;263791;
23.01.2019;03:48:04;82078325;81814395;263930;
23.01.2019;03:49:04;82078578;81814483;264095;
23.01.2019;03:50:05;82078819;81814571;264248;
23.01.2019;03:51:05;82079054;81814685;264369;
23.01.2019;03:52:05;82079259;81814820;264439;
23.01.2019;03:53:04;82079498;81814946;264552;
23.01.2019;03:54:04;82079737;81815042;264695;
23.01.2019;03:55:05;82079988;81815147;264841;
23.01.2019;03:56:04;82080218;81815232;264986;
23.01.2019;03:57:04;82080416;81815316;265100;
23.01.2019;03:58:05;82080662;81815446;265216;
23.01.2019;03:59:04;82080885;81815549;265336;
23.01.2019;04:00:05;82081100;81815652;265448;
23.01.2019;04:01:05;82081350;81815754;265596;
23.01.2019;04:02:04;82081619;81815881;265738;
23.01.2019;04:03:05;82081855;81815983;265872;
23.01.2019;04:04:05;82082064;81816099;265965;
23.01.2019;04:05:04;82082303;81816216;266087;
23.01.2019;04:06:05;82082570;81816326;266244;
23.01.2019;04:07:05;82082799;81816399;266400;
23.01.2019;04:08:04;82083043;81816507;266536;
23.01.2019;04:09:05;82083291;81816610;266681;
23.01.2019;04:10:05;82083530;81816737;266793;
23.01.2019;04:11:04;82083740;81816864;266876;
23.01.2019;04:12:04;82083998;81816971;267027;
23.01.2019;04:13:05;82084293;81817080;267213;
23.01.2019;04:14:05;82084510;81817181;267329;
23.01.2019;04:15:05;82084751;81817302;267449;
23.01.2019;04:16:05;82084977;81817398;267579;
23.01.2019;04:17:05;82085137;81817540;267597;
23.01.2019;04:18:05;82085341;81817661;267680;
23.01.2019;04:19:04;82085505;81817747;267758;
23.01.2019;04:20:04;82085641;81817861;267780;
23.01.2019;04:21:05;82085804;81817973;267831;
23.01.2019;04:22:04;82085893;81818080;267813;
23.01.2019;04:23:04;82085994;81818172;267822;
23.01.2019;04:24:04;82086089;81818269;267820;
23.01.2019;04:25:05;82086192;81818385;267807;
23.01.2019;04:26:05;82086290;81818484;267806;
23.01.2019;04:27:04;82086400;81818599;267801;
23.01.2019;04:28:05;82086503;81818688;267815;
23.01.2019;04:29:05;82086575;81818801;267774;
23.01.2019;04:30:04;82086696;81818892;267804;
23.01.2019;04:31:04;82086812;81818989;267823;
23.01.2019;04:32:05;82086934;81819067;267867;
23.01.2019;04:35:04;82087431;81819387;268044;
23.01.2019;04:49:05;82090207;81820890;269317;
23.01.2019;04:50:05;82090423;81820983;269440;
23.01.2019;04:51:04;82090616;81821100;269516;
23.01.2019;04:54:05;82091271;81821426;269845;
23.01.2019;04:55:05;82091526;81821531;269995;
23.01.2019;04:56:04;82091743;81821637;270106;
23.01.2019;04:57:04;82091922;81821749;270173;
23.01.2019;04:58:05;82092220;81821850;270370;
23.01.2019;04:59:05;82092418;81821943;270475;
23.01.2019;05:00:04;82092624;81822055;270569;
23.01.2019;05:01:04;82092859;81822134;270725;
23.01.2019;05:02:05;82093050;81822252;270798;
23.01.2019;05:03:05;82093223;81822352;270871;
23.01.2019;05:04:05;82093436;81822462;270974;
23.01.2019;05:05:05;82093663;81822566;271097;
23.01.2019;05:06:05;82093885;81822679;271206;
23.01.2019;05:07:05;82094090;81822780;271310;
23.01.2019;05:08:05;82094281;81822884;271397;
23.01.2019;05:09:05;82094488;81823013;271475;
23.01.2019;05:10:05;82094696;81823141;271555;
23.01.2019;05:11:05;82094866;81823244;271622;
23.01.2019;05:12:05;82095096;81823352;271744;
23.01.2019;05:13:05;82095294;81823468;271826;
23.01.2019;05:14:05;82095516;81823583;271933;
23.01.2019;05:15:04;82095745;81823713;272032;
23.01.2019;05:16:04;82095938;81823829;272109;
23.01.2019;05:17:05;82096147;81823963;272184;
23.01.2019;05:18:05;82096353;81824076;272277;
23.01.2019;05:19:04;82096562;81824191;272371;
23.01.2019;05:20:04;82096758;81824293;272465;
23.01.2019;05:21:05;82096993;81824394;272599;
23.01.2019;05:22:05;82097201;81824519;272682;
23.01.2019;05:23:04;82097399;81824616;272783;
23.01.2019;05:24:05;82097626;81824745;272881;
23.01.2019;05:25:04;82097839;81824869;272970;
23.01.2019;05:26:04;82098054;81824970;273084;
23.01.2019;05:27:05;82098255;81825101;273154;
23.01.2019;05:28:05;82098460;81825217;273243;
23.01.2019;05:29:05;82098673;81825324;273349;
23.01.2019;05:30:04;82098867;81825439;273428;
23.01.2019;05:31:04;82099038;81825533;273505;
23.01.2019;05:32:05;82099237;81825653;273584;
23.01.2019;05:33:05;82099398;81825783;273615;
23.01.2019;05:34:05;82099606;81825890;273716;
23.01.2019;05:35:05;82099805;81825973;273832;
23.01.2019;05:36:04;82099982;81826085;273897;
23.01.2019;05:37:05;82100164;81826188;273976;
23.01.2019;05:38:05;82100375;81826312;274063;
23.01.2019;05:39:04;82100592;81826412;274180;
23.01.2019;05:40:04;82100788;81826509;274279;
23.01.2019;05:41:05;82100980;81826618;274362;
23.01.2019;05:42:05;82101181;81826731;274450;
23.01.2019;05:43:04;82101353;81826824;274529;
23.01.2019;05:44:04;82101531;81826943;274588;
23.01.2019;05:45:05;82101745;81827089;274656;
23.01.2019;05:46:05;82101943;81827199;274744;
23.01.2019;05:47:05;82102135;81827318;274817;
23.01.2019;05:48:05;82102316;81827454;274862;
23.01.2019;05:49:04;82102514;81827570;274944;
23.01.2019;05:50:05;82102716;81827694;275022;
23.01.2019;05:51:04;82102915;81827817;275098;
23.01.2019;05:52:04;82103134;81827925;275209;
23.01.2019;05:53:05;82103304;81828040;275264;
23.01.2019;05:54:05;82103488;81828145;275343;
23.01.2019;05:55:04;82103663;81828252;275411;
23.01.2019;05:56:04;82103835;81828364;275471;
23.01.2019;05:57:05;82104013;81828484;275529;
23.01.2019;05:58:05;82104212;81828603;275609;
23.01.2019;05:59:05;82104414;81828737;275677;
23.01.2019;06:00:04;82104556;81828871;275685;
23.01.2019;06:01:04;82104750;81828986;275764;
23.01.2019;06:02:05;82104935;81829115;275820;
23.01.2019;06:03:04;82105125;81829232;275893;
23.01.2019;06:04:04;82105294;81829348;275946;
23.01.2019;06:05:05;82105470;81829470;276000;
23.01.2019;06:06:05;82105644;81829578;276066;
23.01.2019;06:07:04;82105818;81829701;276117;
23.01.2019;06:08:04;82105977;81829794;276183;
23.01.2019;06:09:05;82106125;81829924;276201;
23.01.2019;06:10:05;82106230;81830015;276215;
23.01.2019;06:11:05;82106323;81830099;276224;
23.01.2019;06:12:04;82106423;81830190;276233;
23.01.2019;06:13:05;82106513;81830304;276209;
23.01.2019;06:14:04;82106594;81830395;276199;
23.01.2019;06:15:05;82106680;81830482;276198;
23.01.2019;06:16:05;82106746;81830590;276156;
23.01.2019;06:17:04;82106838;81830677;276161;
23.01.2019;06:18:04;82106958;81830787;276171;
23.01.2019;06:19:05;82107095;81830901;276194;
23.01.2019;06:20:05;82107201;81831007;276194;
23.01.2019;06:21:04;82107329;81831099;276230;
23.01.2019;06:22:04;82107476;81831204;276272;
23.01.2019;06:23:04;82107578;81831313;276265;
23.01.2019;06:24:05;82107698;81831427;276271;
23.01.2019;06:25:08;82107820;81831549;276271;
23.01.2019;06:26:04;82107960;81831645;276315;
23.01.2019;06:27:05;82108113;81831761;276352;
23.01.2019;06:28:04;82108250;81831855;276395;
23.01.2019;06:29:04;82108404;81831947;276457;
23.01.2019;06:30:08;82108564;81832077;276487;
23.01.2019;06:31:04;82108695;81832154;276541;
23.01.2019;06:32:04;82108839;81832255;276584;
23.01.2019;06:33:05;82108990;81832364;276626;
23.01.2019;06:34:05;82109156;81832442;276714;
23.01.2019;06:35:04;82109304;81832532;276772;
23.01.2019;06:36:04;82109457;81832614;276843;
23.01.2019;06:37:04;82109612;81832731;276881;
23.01.2019;06:38:05;82109763;81832852;276911;
23.01.2019;06:39:06;82109924;81832950;276974;
23.01.2019;06:40:04;82110100;81833047;277053;
23.01.2019;06:41:04;82110274;81833132;277142;
23.01.2019;06:42:05;82110440;81833253;277187;
23.01.2019;06:43:05;82110592;81833387;277205;
23.01.2019;06:44:08;82110750;81833513;277237;
23.01.2019;06:45:06;82110940;81833622;277318;
23.01.2019;06:46:08;82111110;81833744;277366;
23.01.2019;06:47:04;82111271;81833838;277433;
23.01.2019;06:48:05;82111456;81833955;277501;
23.01.2019;06:49:04;82111622;81834074;277548;
23.01.2019;06:50:08;82111821;81834147;277674;
23.01.2019;06:51:05;82111993;81834253;277740;
23.01.2019;06:52:05;82112176;81834359;277817;
23.01.2019;06:53:04;82112291;81834428;277863;
23.01.2019;06:54:08;82112453;81834560;277893;
23.01.2019;06:55:05;82112594;81834660;277934;
23.01.2019;06:56:05;82112752;81834774;277978;
23.01.2019;06:57:05;82112924;81834884;278040;
23.01.2019;06:58:05;82113095;81835001;278094;
23.01.2019;06:59:08;82113260;81835122;278138;
23.01.2019;07:00:05;82113430;81835213;278217;
23.01.2019;07:01:05;82113607;81835309;278298;
23.01.2019;07:02:05;82113755;81835420;278335;
23.01.2019;07:03:05;82113909;81835508;278401;
23.01.2019;07:04:05;82114053;81835620;278433;
23.01.2019;07:05:05;82114217;81835741;278476;
23.01.2019;07:06:05;82114352;81835847;278505;
23.01.2019;07:07:05;82114500;81835972;278528;
23.01.2019;07:08:05;82114662;81836093;278569;
23.01.2019;07:09:07;82114836;81836203;278633;
23.01.2019;07:10:05;82114995;81836303;278692;
23.01.2019;07:11:05;82115169;81836409;278760;
23.01.2019;07:12:04;82115342;81836515;278827;
23.01.2019;07:13:05;82115505;81836623;278882;
23.01.2019;07:14:05;82115649;81836737;278912;
23.01.2019;07:15:04;82115826;81836867;278959;
23.01.2019;07:16:04;82115976;81836982;278994;
23.01.2019;07:17:04;82116157;81837105;279052;
23.01.2019;07:18:04;82116334;81837230;279104;
23.01.2019;07:19:05;82116489;81837348;279141;
23.01.2019;07:20:04;82116641;81837437;279204;
23.01.2019;07:21:04;82116786;81837561;279225;
23.01.2019;07:22:04;82116930;81837674;279256;
23.01.2019;07:23:05;82117057;81837780;279277;
23.01.2019;07:24:04;82117182;81837890;279292;
23.01.2019;07:25:04;82117334;81838008;279326;
23.01.2019;07:26:05;82117489;81838108;279381;
23.01.2019;07:27:04;82117618;81838225;279393;
23.01.2019;07:28:04;82117765;81838347;279418;
23.01.2019;07:29:04;82117933;81838465;279468;
23.01.2019;07:30:05;82118078;81838564;279514;
23.01.2019;07:31:05;82118225;81838685;279540;
23.01.2019;07:33:05;82118517;81838927;279590;
23.01.2019;07:34:04;82118639;81839053;279586;
23.01.2019;07:35:04;82118790;81839195;279595;
23.01.2019;07:36:05;82118942;81839292;279650;
23.01.2019;07:37:04;82119105;81839402;279703;
23.01.2019;07:38:04;82119241;81839534;279707;
23.01.2019;07:39:06;82119400;81839674;279726;
23.01.2019;07:40:04;82119550;81839798;279752;
23.01.2019;07:41:04;82119717;81839913;279804;
23.01.2019;07:42:05;82119900;81840026;279874;
23.01.2019;07:43:05;82120017;81840131;279886;
23.01.2019;07:44:04;82120145;81840253;279892;
23.01.2019;07:45:04;82120270;81840376;279894;
23.01.2019;07:46:04;82120401;81840495;279906;
23.01.2019;07:47:05;82120561;81840601;279960;
23.01.2019;07:48:05;82120722;81840729;279993;
23.01.2019;07:49:05;82120855;81840855;280000;
23.01.2019;07:50:05;82121014;81840995;280019;
23.01.2019;07:51:05;82121164;81841132;280032;
23.01.2019;07:52:05;82121312;81841259;280053;
23.01.2019;07:53:05;82121475;81841381;280094;
23.01.2019;07:54:05;82121624;81841502;280122;
23.01.2019;07:55:04;82121763;81841624;280139;
23.01.2019;07:56:05;82121934;81841747;280187;
23.01.2019;07:57:05;82122095;81841882;280213;
23.01.2019;07:58:05;82122218;81841992;280226;
23.01.2019;07:59:05;82122364;81842115;280249;
23.01.2019;08:00:04;82122494;81842235;280259;
23.01.2019;08:01:04;82122630;81842355;280275;
23.01.2019;08:02:05;82122772;81842464;280308;
23.01.2019;08:03:05;82122921;81842579;280342;
23.01.2019;08:04:04;82123069;81842709;280360;
23.01.2019;08:05:04;82123189;81842855;280334;
23.01.2019;08:06:05;82123290;81842959;280331;
23.01.2019;08:07:04;82123430;81843074;280356;
23.01.2019;08:08:04;82123547;81843193;280354;
23.01.2019;08:09:05;82123695;81843314;280381;
23.01.2019;08:10:04;82123843;81843458;280385;
23.01.2019;08:11:04;82123990;81843550;280440;
23.01.2019;08:12:05;82124146;81843672;280474;
23.01.2019;08:13:05;82124242;81843779;280463;
23.01.2019;08:14:04;82124292;81843863;280429;
23.01.2019;08:15:05;82124331;81843943;280388;
23.01.2019;08:16:04;82124383;81844021;280362;
23.01.2019;08:17:04;82124389;81844134;280255;
23.01.2019;08:18:04;82124425;81844223;280202;
23.01.2019;08:19:05;82124480;81844309;280171;
23.01.2019;08:20:05;82124519;81844423;280096;
23.01.2019;08:21:05;82124573;81844520;280053;
23.01.2019;08:22:04;82124647;81844637;280010;
23.01.2019;08:23:05;82124717;81844729;279988;
23.01.2019;08:24:05;82124808;81844845;279963;
23.01.2019;08:25:04;82124932;81844957;279975;
23.01.2019;08:26:04;82125047;81845068;279979;
23.01.2019;08:27:05;82125169;81845171;279998;
23.01.2019;08:28:05;82125267;81845284;279983;
23.01.2019;08:29:05;82125376;81845406;279970;
23.01.2019;08:30:05;82125522;81845534;279988;
23.01.2019;08:31:04;82125639;81845651;279988;
23.01.2019;08:32:04;82125786;81845755;280031;
23.01.2019;08:33:04;82125931;81845874;280057;
23.01.2019;08:34:04;82126042;81845977;280065;
23.01.2019;08:35:05;82126170;81846072;280098;
23.01.2019;08:36:04;82126323;81846211;280112;
23.01.2019;08:37:04;82126438;81846339;280099;
23.01.2019;08:38:05;82126569;81846458;280111;
23.01.2019;08:39:05;82126693;81846552;280141;
23.01.2019;08:40:04;82126819;81846657;280162;
23.01.2019;08:41:04;82126955;81846775;280180;
23.01.2019;08:42:05;82127110;81846901;280209;
23.01.2019;08:43:04;82127219;81847021;280198;
23.01.2019;08:44:04;82127361;81847130;280231;
23.01.2019;08:45:05;82127499;81847252;280247;
23.01.2019;08:46:04;82127641;81847358;280283;
23.01.2019;08:47:04;82127757;81847504;280253;
23.01.2019;08:48:05;82127885;81847644;280241;
23.01.2019;08:49:05;82127994;81847767;280227;
23.01.2019;08:50:04;82128120;81847875;280245;
23.01.2019;08:51:04;82128235;81848012;280223;
23.01.2019;08:52:08;82128364;81848139;280225;
23.01.2019;08:53:05;82128487;81848239;280248;
23.01.2019;08:54:05;82128623;81848350;280273;
23.01.2019;08:55:04;82128759;81848463;280296;
23.01.2019;08:56:04;82128900;81848579;280321;
23.01.2019;08:57:05;82129043;81848713;280330;
23.01.2019;08:58:05;82129168;81848825;280343;
23.01.2019;08:59:04;82129301;81848933;280368;
23.01.2019;09:00:04;82129460;81849062;280398;
23.01.2019;09:01:05;82129603;81849206;280397;
23.01.2019;09:02:04;82129709;81849335;280374;
23.01.2019;09:03:04;82129845;81849447;280398;
23.01.2019;09:04:05;82129991;81849575;280416;
23.01.2019;09:05:04;82130117;81849681;280436;
23.01.2019;09:06:04;82130247;81849790;280457;
23.01.2019;09:07:05;82130371;81849935;280436;
23.01.2019;09:08:04;82130485;81850056;280429;
23.01.2019;09:09:04;82130601;81850186;280415;
23.01.2019;09:10:04;82130731;81850306;280425;
23.01.2019;09:11:05;82130856;81850415;280441;
23.01.2019;09:12:04;82130968;81850567;280401;
23.01.2019;09:13:04;82131105;81850689;280416;
23.01.2019;09:14:05;82131240;81850824;280416;
23.01.2019;09:15:05;82131365;81850928;280437;
23.01.2019;09:16:04;82131497;81851059;280438;
23.01.2019;09:17:08;82131617;81851190;280427;
23.01.2019;09:18:05;82131737;81851315;280422;
23.01.2019;09:19:05;82131847;81851448;280399;
23.01.2019;09:20:04;82131978;81851547;280431;
23.01.2019;09:21:04;82132097;81851657;280440;
23.01.2019;09:22:05;82132229;81851782;280447;
23.01.2019;09:23:04;82132326;81851885;280441;
23.01.2019;09:24:04;82132460;81851994;280466;
23.01.2019;09:25:05;82132564;81852130;280434;
23.01.2019;09:26:05;82132684;81852254;280430;
23.01.2019;09:27:05;82132812;81852372;280440;
23.01.2019;09:28:05;82132945;81852479;280466;
23.01.2019;09:29:05;82133068;81852592;280476;
23.01.2019;09:30:04;82133185;81852722;280463;
23.01.2019;09:31:04;82133318;81852863;280455;
23.01.2019;09:32:05;82133433;81853009;280424;
23.01.2019;09:33:05;82133539;81853112;280427;
23.01.2019;09:34:05;82133659;81853229;280430;
23.01.2019;09:35:04;82133757;81853359;280398;
23.01.2019;09:36:04;82133901;81853498;280403;
23.01.2019;09:37:04;82133997;81853642;280355;
23.01.2019;09:38:05;82134143;81853767;280376;
23.01.2019;09:39:07;82134235;81853880;280355;
23.01.2019;09:40:05;82134349;81853991;280358;
23.01.2019;09:41:05;82134458;81854113;280345;
23.01.2019;09:42:05;82134577;81854229;280348;
23.01.2019;09:43:04;82134685;81854347;280338;
23.01.2019;09:44:04;82134785;81854468;280317;
23.01.2019;09:45:05;82134878;81854583;280295;
23.01.2019;09:46:05;82134972;81854696;280276;
23.01.2019;09:47:04;82135073;81854820;280253;
23.01.2019;09:48:04;82135169;81854936;280233;
23.01.2019;09:49:05;82135278;81855078;280200;
23.01.2019;09:50:05;82135385;81855211;280174;
23.01.2019;09:51:05;82135484;81855342;280142;
23.01.2019;09:52:04;82135578;81855472;280106;
23.01.2019;09:53:04;82135669;81855577;280092;
23.01.2019;09:54:05;82135786;81855682;280104;
23.01.2019;09:55:05;82135907;81855799;280108;
23.01.2019;09:56:04;82136022;81855934;280088;
23.01.2019;09:57:05;82136125;81856037;280088;
23.01.2019;09:58:04;82136182;81856113;280069;
23.01.2019;09:59:05;82136286;81856244;280042;
23.01.2019;10:00:05;82136410;81856393;280017;
23.01.2019;10:01:05;82136519;81856521;279998;
23.01.2019;10:02:05;82136615;81856648;279967;
23.01.2019;10:03:05;82136705;81856779;279926;
23.01.2019;10:04:05;82136836;81856898;279938;
23.01.2019;10:05:04;82136954;81857026;279928;
23.01.2019;10:06:04;82137046;81857131;279915;
23.01.2019;10:07:05;82137110;81857212;279898;
23.01.2019;10:08:04;82137166;81857336;279830;
23.01.2019;10:09:07;82137218;81857444;279774;
23.01.2019;10:10:04;82137291;81857558;279733;
23.01.2019;10:11:04;82137360;81857685;279675;
23.01.2019;10:12:05;82137371;81857797;279574;
23.01.2019;10:13:04;82137412;81857878;279534;
23.01.2019;10:14:05;82137471;81857983;279488;
23.01.2019;10:15:04;82137505;81858090;279415;
23.01.2019;10:16:05;82137535;81858189;279346;
23.01.2019;10:17:05;82137582;81858312;279270;
23.01.2019;10:18:05;82137620;81858423;279197;
23.01.2019;10:19:07;82137679;81858537;279142;
23.01.2019;10:20:04;82137733;81858644;279089;
23.01.2019;10:21:04;82137807;81858784;279023;
23.01.2019;10:22:07;82137893;81858906;278987;
23.01.2019;10:23:05;82137958;81859057;278901;
23.01.2019;10:24:05;82138061;81859182;278879;
23.01.2019;10:25:05;82138140;81859312;278828;
23.01.2019;10:26:05;82138231;81859435;278796;
23.01.2019;10:27:05;82138300;81859583;278717;
23.01.2019;10:28:04;82138377;81859722;278655;
23.01.2019;10:29:04;82138476;81859865;278611;
23.01.2019;10:30:05;82138563;81859986;278577;
23.01.2019;10:31:05;82138671;81860133;278538;
23.01.2019;10:32:04;82138789;81860247;278542;
23.01.2019;10:33:04;82138901;81860317;278584;
23.01.2019;10:34:05;82139002;81860455;278547;
23.01.2019;10:35:05;82139100;81860554;278546;
23.01.2019;10:36:04;82139224;81860672;278552;
23.01.2019;10:37:05;82139317;81860787;278530;
23.01.2019;10:38:05;82139411;81860925;278486;
23.01.2019;10:39:06;82139522;81861043;278479;
23.01.2019;10:40:04;82139606;81861165;278441;
23.01.2019;10:41:05;82139703;81861282;278421;
23.01.2019;10:42:04;82139811;81861426;278385;
23.01.2019;10:43:05;82139904;81861556;278348;
23.01.2019;10:44:05;82140025;81861685;278340;
23.01.2019;10:45:05;82140130;81861802;278328;
23.01.2019;10:46:04;82140217;81861918;278299;
23.01.2019;10:47:04;82140318;81862047;278271;
23.01.2019;10:48:04;82140435;81862181;278254;
23.01.2019;10:49:05;82140530;81862323;278207;
23.01.2019;10:50:05;82140639;81862428;278211;
23.01.2019;10:51:05;82140744;81862565;278179;
23.01.2019;10:52:04;82140848;81862684;278164;
23.01.2019;10:53:04;82140989;81862807;278182;
23.01.2019;10:54:04;82141095;81862943;278152;
23.01.2019;10:55:08;82141194;81863069;278125;
23.01.2019;10:56:04;82141302;81863194;278108;
23.01.2019;10:57:05;82141424;81863328;278096;
23.01.2019;10:58:05;82141534;81863489;278045;
23.01.2019;10:59:04;82141621;81863616;278005;
23.01.2019;11:00:04;82141706;81863742;277964;
23.01.2019;11:01:05;82141798;81863880;277918;
23.01.2019;11:02:04;82141922;81864005;277917;
23.01.2019;11:03:05;82142026;81864151;277875;
23.01.2019;11:04:04;82142125;81864266;277859;
23.01.2019;11:05:04;82142233;81864386;277847;
23.01.2019;11:06:05;82142346;81864497;277849;
23.01.2019;11:07:05;82142464;81864627;277837;
23.01.2019;11:08:05;82142563;81864760;277803;
23.01.2019;11:09:05;82142676;81864906;277770;
23.01.2019;11:10:06;82142784;81865036;277748;
23.01.2019;11:11:05;82142896;81865135;277761;
23.01.2019;11:12:05;82142998;81865263;277735;
23.01.2019;11:13:05;82143096;81865413;277683;
23.01.2019;11:14:04;82143199;81865550;277649;
23.01.2019;11:15:04;82143319;81865673;277646;
23.01.2019;11:16:05;82143442;81865808;277634;
23.01.2019;11:17:05;82143537;81865922;277615;
23.01.2019;11:18:05;82143654;81866061;277593;
23.01.2019;11:19:04;82143733;81866196;277537;
23.01.2019;11:20:04;82143864;81866318;277546;
23.01.2019;11:21:05;82143962;81866469;277493;
23.01.2019;11:22:05;82144081;81866617;277464;
23.01.2019;11:23:04;82144186;81866762;277424;
23.01.2019;11:24:04;82144318;81866907;277411;
23.01.2019;11:25:05;82144428;81867042;277386;
23.01.2019;11:26:04;82144559;81867167;277392;
23.01.2019;11:27:04;82144648;81867293;277355;
23.01.2019;11:28:05;82144768;81867436;277332;
23.01.2019;11:29:05;82144891;81867556;277335;
23.01.2019;11:30:04;82144974;81867694;277280;
23.01.2019;11:31:05;82145080;81867828;277252;
23.01.2019;11:32:05;82145193;81867953;277240;
23.01.2019;11:33:04;82145310;81868061;277249;
23.01.2019;11:34:05;82145416;81868206;277210;
23.01.2019;11:35:05;82145536;81868333;277203;
23.01.2019;11:36:04;82145667;81868462;277205;
23.01.2019;11:37:05;82145783;81868592;277191;
23.01.2019;11:38:05;82145884;81868725;277159;
23.01.2019;11:39:06;82146005;81868855;277150;
23.01.2019;11:40:04;82146127;81868993;277134;
23.01.2019;11:41:04;82146277;81869064;277213;
23.01.2019;11:42:05;82146419;81869151;277268;
23.01.2019;11:43:04;82146510;81869238;277272;
23.01.2019;11:44:04;82146603;81869354;277249;
23.01.2019;11:45:04;82146730;81869470;277260;
23.01.2019;11:46:05;82146838;81869572;277266;
23.01.2019;11:47:05;82146921;81869696;277225;
23.01.2019;11:48:05;82147025;81869822;277203;
23.01.2019;11:49:04;82147146;81869934;277212;
23.01.2019;11:50:04;82147270;81870041;277229;
23.01.2019;11:51:05;82147376;81870146;277230;
23.01.2019;11:52:05;82147458;81870273;277185;
23.01.2019;11:53:04;82147581;81870396;277185;
23.01.2019;11:54:04;82147663;81870526;277137;
23.01.2019;11:55:05;82147787;81870619;277168;
23.01.2019;11:56:05;82147893;81870746;277147;
23.01.2019;11:57:04;82147985;81870865;277120;
23.01.2019;11:58:05;82148067;81870973;277094;
23.01.2019;11:59:04;82147986;81871056;276930;
23.01.2019;12:00:05;82147920;81871122;276798;
23.01.2019;12:01:05;82147857;81871143;276714;
23.01.2019;12:02:06;82147859;81871209;276650;
23.01.2019;12:03:04;82147955;81871323;276632;
23.01.2019;12:04:06;82148047;81871426;276621;
23.01.2019;12:05:07;82148161;81871526;276635;
23.01.2019;12:06:06;82148267;81871633;276634;
23.01.2019;12:07:04;82148366;81871762;276604;
23.01.2019;12:08:10;82148490;81871927;276563;
23.01.2019;12:09:13;82148621;81872080;276541;
23.01.2019;12:10:05;82148746;81872172;276574;
23.01.2019;12:11:07;82148865;81872291;276574;
23.01.2019;12:12:05;82148970;81872418;276552;
23.01.2019;12:13:04;82149123;81872553;276570;
23.01.2019;12:14:05;82149249;81872693;276556;
23.01.2019;12:15:05;82149367;81872826;276541;
23.01.2019;12:16:06;82149482;81872945;276537;
23.01.2019;12:17:06;82149632;81873065;276567;
23.01.2019;12:18:06;82149751;81873174;276577;
23.01.2019;12:19:05;82149843;81873287;276556;
23.01.2019;12:20:04;82149962;81873439;276523;
23.01.2019;12:21:05;82150071;81873553;276518;
23.01.2019;12:22:05;82150189;81873689;276500;
23.01.2019;12:23:05;82150304;81873797;276507;
23.01.2019;12:24:05;82150426;81873913;276513;
23.01.2019;12:25:09;82150550;81874071;276479;
23.01.2019;12:26:04;82150663;81874198;276465;
23.01.2019;12:27:04;82150795;81874334;276461;
23.01.2019;12:28:05;82150909;81874473;276436;
23.01.2019;12:29:08;82151007;81874617;276390;
23.01.2019;12:30:04;82151121;81874743;276378;
23.01.2019;12:31:05;82151219;81874872;276347;
23.01.2019;12:32:05;82151338;81874986;276352;
23.01.2019;12:33:05;82151463;81875107;276356;
23.01.2019;12:34:07;82151594;81875238;276356;
23.01.2019;12:35:06;82151709;81875369;276340;
23.01.2019;12:36:05;82151826;81875510;276316;
23.01.2019;12:37:05;82151941;81875640;276301;
23.01.2019;12:38:05;82152086;81875781;276305;
23.01.2019;12:39:07;82152230;81875935;276295;
23.01.2019;12:40:05;82152336;81876056;276280;
23.01.2019;12:41:05;82152489;81876185;276304;
23.01.2019;12:42:05;82152606;81876309;276297;
23.01.2019;12:43:05;82152727;81876445;276282;
23.01.2019;12:44:04;82152868;81876572;276296;
23.01.2019;12:45:04;82152976;81876692;276284;
23.01.2019;12:46:05;82153110;81876810;276300;
23.01.2019;12:47:05;82153247;81876946;276301;
23.01.2019;12:48:05;82153376;81877097;276279;
23.01.2019;12:49:04;82153521;81877215;276306;
23.01.2019;12:50:04;82153663;81877323;276340;
23.01.2019;12:51:05;82153792;81877441;276351;
23.01.2019;12:52:05;82153910;81877566;276344;
23.01.2019;12:53:04;82153964;81877629;276335;
23.01.2019;12:54:04;82153889;81877670;276219;
23.01.2019;12:55:05;82153835;81877661;276174;
23.01.2019;12:56:05;82153457;81877553;275904;
23.01.2019;12:57:04;82153579;81877669;275910;
23.01.2019;12:58:04;82153709;81877797;275912;
23.01.2019;12:59:05;82153852;81877930;275922;
23.01.2019;13:00:05;82154007;81878058;275949;
23.01.2019;13:01:04;82154140;81878182;275958;
23.01.2019;13:02:04;82154274;81878324;275950;
23.01.2019;13:03:05;82154377;81878451;275926;
23.01.2019;13:04:04;82154511;81878562;275949;
23.01.2019;13:05:04;82154641;81878671;275970;
23.01.2019;13:06:05;82154784;81878795;275989;
23.01.2019;13:07:05;82154926;81878930;275996;
23.01.2019;13:08:04;82155066;81879053;276013;
23.01.2019;13:09:06;82155215;81879214;276001;
23.01.2019;13:10:05;82155343;81879367;275976;
23.01.2019;13:11:04;82155466;81879495;275971;
23.01.2019;13:12:04;82155609;81879629;275980;
23.01.2019;13:13:05;82155743;81879767;275976;
23.01.2019;13:14:04;82155870;81879897;275973;
23.01.2019;13:15:04;82156039;81880044;275995;
23.01.2019;13:16:05;82156181;81880185;275996;
23.01.2019;13:17:05;82156324;81880318;276006;
23.01.2019;13:18:05;82156484;81880467;276017;
23.01.2019;13:19:04;82156635;81880629;276006;
23.01.2019;13:20:04;82156769;81880776;275993;
23.01.2019;13:21:05;82156915;81880904;276011;
23.01.2019;13:22:05;82157050;81881075;275975;
23.01.2019;13:23:04;82157206;81881218;275988;
23.01.2019;13:24:05;82157352;81881357;275995;
23.01.2019;13:25:05;82157486;81881481;276005;
23.01.2019;13:26:04;82157620;81881631;275989;
23.01.2019;13:27:04;82157774;81881767;276007;
23.01.2019;13:28:05;82157915;81881905;276010;
23.01.2019;13:29:05;82158096;81882028;276068;
23.01.2019;13:30:05;82158249;81882166;276083;
23.01.2019;13:31:07;82158407;81882302;276105;
23.01.2019;13:32:04;82158557;81882435;276122;
23.01.2019;13:33:04;82158703;81882581;276122;
23.01.2019;13:34:06;82158852;81882754;276098;
23.01.2019;13:35:05;82159028;81882889;276139;
23.01.2019;13:36:04;82159190;81883048;276142;
23.01.2019;13:37:04;82159358;81883157;276201;
23.01.2019;13:38:06;82159521;81883303;276218;
23.01.2019;13:39:05;82159654;81883443;276211;
23.01.2019;13:40:05;82159808;81883599;276209;
23.01.2019;13:41:05;82159975;81883734;276241;
23.01.2019;13:42:04;82160147;81883864;276283;
23.01.2019;13:43:04;82160308;81884021;276287;
23.01.2019;13:44:04;82160452;81884164;276288;
23.01.2019;13:45:05;82160621;81884317;276304;
23.01.2019;13:46:05;82160776;81884456;276320;
23.01.2019;13:47:05;82160929;81884581;276348;
23.01.2019;13:48:05;82161097;81884728;276369;
23.01.2019;13:49:04;82161272;81884847;276425;
23.01.2019;13:50:04;82161435;81885014;276421;
23.01.2019;13:51:04;82161589;81885164;276425;
23.01.2019;13:52:05;82161764;81885309;276455;
23.01.2019;13:53:05;82161950;81885435;276515;
23.01.2019;13:54:05;82162112;81885551;276561;
23.01.2019;13:55:05;82162285;81885685;276600;
23.01.2019;13:56:06;82162451;81885831;276620;
23.01.2019;13:57:04;82162591;81885972;276619;
23.01.2019;13:58:10;82162751;81886136;276615;
23.01.2019;13:59:05;82162908;81886267;276641;
23.01.2019;14:00:04;82163096;81886421;276675;
23.01.2019;14:01:04;82163261;81886571;276690;
23.01.2019;14:02:05;82163410;81886730;276680;
23.01.2019;14:03:04;82163593;81886890;276703;
23.01.2019;14:04:04;82163755;81887041;276714;
23.01.2019;14:05:04;82163951;81887189;276762;
23.01.2019;14:06:05;82164094;81887325;276769;
23.01.2019;14:07:05;82164249;81887459;276790;
23.01.2019;14:08:05;82164391;81887628;276763;
23.01.2019;14:09:05;82164558;81887770;276788;
23.01.2019;14:10:09;82164742;81887961;276781;
23.01.2019;14:11:04;82164877;81888091;276786;
23.01.2019;14:12:05;82165024;81888246;276778;
23.01.2019;14:13:05;82165167;81888396;276771;
23.01.2019;14:14:04;82165282;81888539;276743;
23.01.2019;14:15:04;82165398;81888673;276725;
23.01.2019;14:16:05;82165539;81888821;276718;
23.01.2019;14:17:05;82165635;81888961;276674;
23.01.2019;14:18:05;82165800;81889105;276695;
23.01.2019;14:19:05;82165869;81889254;276615;
23.01.2019;14:20:05;82165960;81889386;276574;
23.01.2019;14:21:05;82166074;81889499;276575;
23.01.2019;14:22:04;82166217;81889636;276581;
23.01.2019;14:23:05;82166299;81889780;276519;
23.01.2019;14:24:04;82166414;81889926;276488;
23.01.2019;14:25:04;82166525;81890081;276444;
23.01.2019;14:26:05;82166656;81890239;276417;
23.01.2019;14:27:05;82166824;81890375;276449;
23.01.2019;14:28:05;82166979;81890533;276446;
23.01.2019;14:29:04;82167148;81890697;276451;
23.01.2019;14:30:04;82167273;81890825;276448;
23.01.2019;14:31:04;82167410;81890963;276447;
23.01.2019;14:32:05;82167589;81891113;276476;
23.01.2019;14:33:05;82167776;81891256;276520;
23.01.2019;14:34:04;82167946;81891376;276570;
23.01.2019;14:35:05;82168123;81891511;276612;
23.01.2019;14:36:05;82168316;81891678;276638;
23.01.2019;14:37:04;82168485;81891820;276665;
23.01.2019;14:38:05;82168648;81891974;276674;
23.01.2019;14:39:06;82168824;81892164;276660;
23.01.2019;14:40:04;82169018;81892334;276684;
23.01.2019;14:41:04;82169152;81892533;276619;
23.01.2019;14:42:05;82169321;81892659;276662;
23.01.2019;14:43:05;82169493;81892837;276656;
23.01.2019;14:44:05;82169665;81893000;276665;
23.01.2019;14:45:04;82169841;81893187;276654;
23.01.2019;14:46:04;82170006;81893336;276670;
23.01.2019;14:47:05;82170167;81893483;276684;
23.01.2019;14:48:05;82170373;81893624;276749;
23.01.2019;14:49:05;82170548;81893769;276779;
23.01.2019;14:50:04;82170731;81893939;276792;
23.01.2019;14:51:04;82170922;81894094;276828;
23.01.2019;14:52:05;82171105;81894252;276853;
23.01.2019;14:53:05;82171299;81894411;276888;
23.01.2019;14:54:04;82171457;81894574;276883;
23.01.2019;14:55:04;82171596;81894758;276838;
23.01.2019;14:56:05;82171771;81894910;276861;
23.01.2019;14:57:05;82171944;81895055;276889;
23.01.2019;14:58:05;82172105;81895219;276886;
23.01.2019;14:59:04;82172272;81895387;276885;
23.01.2019;15:00:07;82172458;81895579;276879;
23.01.2019;15:01:07;82172663;81895746;276917;
23.01.2019;15:02:07;82172850;81895906;276944;
23.01.2019;15:03:08;82173036;81896084;276952;
23.01.2019;15:04:12;82173233;81896248;276985;
23.01.2019;15:05:11;82173421;81896391;277030;
23.01.2019;15:06:13;82173633;81896564;277069;
23.01.2019;15:07:10;82173779;81896694;277085;
23.01.2019;15:08:11;82173928;81896859;277069;
23.01.2019;15:09:10;82174081;81897027;277054;
23.01.2019;15:10:07;82174254;81897167;277087;
23.01.2019;15:11:08;82174415;81897336;277079;
23.01.2019;15:12:08;82174580;81897518;277062;
23.01.2019;15:13:07;82174759;81897671;277088;
23.01.2019;15:14:08;82174949;81897824;277125;
23.01.2019;15:15:07;82175108;81897962;277146;
23.01.2019;15:16:08;82175282;81898142;277140;
23.01.2019;15:17:08;82175460;81898317;277143;
23.01.2019;15:18:08;82175639;81898500;277139;
23.01.2019;15:19:08;82175823;81898694;277129;
23.01.2019;15:20:08;82175984;81898855;277129;
23.01.2019;15:21:09;82176139;81898877;277262;
23.01.2019;15:22:06;82176301;81899181;277120;
23.01.2019;15:23:07;82176464;81899359;277105;
23.01.2019;15:24:08;82176637;81899519;277118;
23.01.2019;15:25:08;82176796;81899692;277104;
23.01.2019;15:26:08;82176948;81899847;277101;
23.01.2019;15:27:07;82177102;81900009;277093;
23.01.2019;15:28:09;82177287;81900190;277097;
23.01.2019;15:29:07;82177454;81900337;277117;
23.01.2019;15:30:07;82177648;81900506;277142;
23.01.2019;15:31:08;82177810;81900687;277123;
23.01.2019;15:32:07;82177994;81900847;277147;
23.01.2019;15:33:07;82178182;81900988;277194;
23.01.2019;15:34:06;82178372;81901147;277225;
23.01.2019;15:35:07;82178555;81901328;277227;
23.01.2019;15:36:07;82178731;81901514;277217;
23.01.2019;15:37:07;82178920;81901684;277236;
23.01.2019;15:38:07;82179083;81901857;277226;
23.01.2019;15:39:07;82179268;81902035;277233;
23.01.2019;15:40:08;82179469;81902187;277282;
23.01.2019;15:41:07;82179675;81902363;277312;
23.01.2019;15:42:08;82179867;81902562;277305;
23.01.2019;15:43:07;82180062;81902720;277342;
23.01.2019;15:44:08;82180245;81902912;277333;
23.01.2019;15:45:07;82180403;81903102;277301;
23.01.2019;15:46:08;82180602;81903279;277323;
23.01.2019;15:47:07;82180773;81903455;277318;
23.01.2019;15:48:07;82180943;81903644;277299;
23.01.2019;15:49:07;82181125;81903808;277317;
23.01.2019;15:50:07;82181314;81904001;277313;
23.01.2019;15:51:07;82181496;81904163;277333;
23.01.2019;15:52:07;82181672;81904364;277308;
23.01.2019;15:53:08;82181871;81904562;277309;
23.01.2019;15:54:08;82182041;81904707;277334;
23.01.2019;15:55:07;82182228;81904887;277341;
23.01.2019;15:56:07;82182422;81905054;277368;
23.01.2019;15:57:07;82182608;81905232;277376;
23.01.2019;15:58:08;82182803;81905417;277386;
23.01.2019;15:59:08;82182976;81905567;277409;
23.01.2019;16:00:05;82183154;81905722;277432;
23.01.2019;16:01:04;82183331;81905874;277457;
23.01.2019;16:02:04;82183517;81906044;277473;
23.01.2019;16:03:05;82183725;81906203;277522;
23.01.2019;16:04:04;82183900;81906367;277533;
23.01.2019;16:05:04;82184094;81906512;277582;
23.01.2019;16:06:05;82184283;81906663;277620;
23.01.2019;16:07:05;82184469;81906856;277613;
23.01.2019;16:08:04;82184641;81907018;277623;
23.01.2019;16:09:04;82184787;81907186;277601;
23.01.2019;16:10:05;82184980;81907356;277624;
23.01.2019;16:11:05;82185177;81907491;277686;
23.01.2019;16:12:04;82185341;81907666;277675;
23.01.2019;16:13:04;82185492;81907827;277665;
23.01.2019;16:14:04;82185665;81908004;277661;
23.01.2019;16:15:05;82185840;81908171;277669;
23.01.2019;16:16:05;82185986;81908360;277626;
23.01.2019;16:17:04;82186095;81908529;277566;
23.01.2019;16:18:04;82186238;81908683;277555;
23.01.2019;16:19:05;82186354;81908834;277520;
23.01.2019;16:20:05;82186458;81908982;277476;
23.01.2019;16:21:05;82186546;81909188;277358;
23.01.2019;16:22:05;82186681;81909332;277349;
23.01.2019;16:23:05;82186802;81909486;277316;
23.01.2019;16:24:04;82186936;81909643;277293;
23.01.2019;16:25:04;82187056;81909784;277272;
23.01.2019;16:26:05;82187174;81909932;277242;
23.01.2019;16:27:05;82187312;81910081;277231;
23.01.2019;16:28:04;82187454;81910292;277162;
23.01.2019;16:29:04;82187634;81910465;277169;
23.01.2019;16:30:05;82187757;81910645;277112;
23.01.2019;16:31:05;82187935;81910807;277128;
23.01.2019;16:32:04;82188102;81910971;277131;
23.01.2019;16:33:05;82188262;81911139;277123;
23.01.2019;16:34:04;82188448;81911291;277157;
23.01.2019;16:35:04;82188624;81911450;277174;
23.01.2019;16:36:05;82188809;81911620;277189;
23.01.2019;16:37:05;82188987;81911777;277210;
23.01.2019;16:38:05;82189205;81911940;277265;
23.01.2019;16:39:06;82189389;81912107;277282;
23.01.2019;16:40:09;82189571;81912274;277297;
23.01.2019;16:41:04;82189765;81912432;277333;
23.01.2019;16:42:05;82189949;81912610;277339;
23.01.2019;16:43:08;82190156;81912763;277393;
23.01.2019;16:44:11;82190354;81912986;277368;
23.01.2019;16:45:06;82190511;81913144;277367;
23.01.2019;16:46:05;82190685;81913318;277367;
23.01.2019;16:47:11;82190903;81913505;277398;
23.01.2019;16:48:05;82191053;81913649;277404;
23.01.2019;16:49:06;82191232;81913849;277383;
23.01.2019;16:50:08;82191405;81914057;277348;
23.01.2019;16:51:04;82191601;81914236;277365;
23.01.2019;16:52:04;82191774;81914405;277369;
23.01.2019;16:53:05;82191950;81914570;277380;
23.01.2019;16:54:04;82192127;81914760;277367;
23.01.2019;16:55:05;82192340;81914952;277388;
23.01.2019;16:56:05;82192524;81915156;277368;
23.01.2019;16:57:07;82192694;81915320;277374;
23.01.2019;16:58:05;82192861;81915459;277402;
23.01.2019;16:59:05;82193060;81915658;277402;
23.01.2019;17:00:05;82193225;81915820;277405;
23.01.2019;17:01:05;82193400;81915986;277414;
23.01.2019;17:02:06;82193581;81916165;277416;
23.01.2019;17:03:05;82193764;81916305;277459;
23.01.2019;17:04:05;82193970;81916475;277495;
23.01.2019;17:05:07;82194164;81916638;277526;
23.01.2019;17:06:05;82194354;81916795;277559;
23.01.2019;17:07:04;82194548;81916948;277600;
23.01.2019;17:08:05;82194736;81917128;277608;
23.01.2019;17:09:05;82194964;81917309;277655;
23.01.2019;17:10:09;82195171;81917504;277667;
23.01.2019;17:11:06;82195374;81917667;277707;
23.01.2019;17:12:07;82195580;81917856;277724;
23.01.2019;17:13:05;82195744;81918015;277729;
23.01.2019;17:14:04;82195904;81918204;277700;
23.01.2019;17:15:05;82196094;81918382;277712;
23.01.2019;17:16:10;82196298;81918562;277736;
23.01.2019;17:17:06;82196499;81918705;277794;
23.01.2019;17:18:06;82196718;81918881;277837;
23.01.2019;17:19:06;82196909;81919041;277868;
23.01.2019;17:20:06;82197083;81919185;277898;
23.01.2019;17:21:05;82197267;81919338;277929;
23.01.2019;17:22:05;82197482;81919532;277950;
23.01.2019;17:23:05;82197656;81919710;277946;
23.01.2019;17:24:05;82197866;81919890;277976;
23.01.2019;17:25:06;82198038;81920047;277991;
23.01.2019;17:26:05;82198213;81920222;277991;
23.01.2019;17:27:08;82198410;81920383;278027;
23.01.2019;17:28:05;82198578;81920550;278028;
23.01.2019;17:29:07;82198775;81920701;278074;
23.01.2019;17:30:04;82198967;81920848;278119;
23.01.2019;17:31:05;82199097;81920987;278110;
23.01.2019;17:32:05;82199306;81921162;278144;
23.01.2019;17:33:05;82199511;81921323;278188;
23.01.2019;17:34:08;82199697;81921492;278205;
23.01.2019;17:35:05;82199880;81921643;278237;
23.01.2019;17:36:05;82200088;81921804;278284;
23.01.2019;17:37:05;82200308;81921960;278348;
23.01.2019;17:38:05;82200499;81922159;278340;
23.01.2019;17:39:07;82200658;81922326;278332;
23.01.2019;17:40:05;82200858;81922471;278387;
23.01.2019;17:41:07;82201041;81922639;278402;
23.01.2019;17:42:05;82201230;81922795;278435;
23.01.2019;17:43:05;82201411;81922967;278444;
23.01.2019;17:44:05;82201590;81923116;278474;
23.01.2019;17:45:05;82201794;81923282;278512;
23.01.2019;17:46:04;82201967;81923438;278529;
23.01.2019;17:47:05;82202154;81923594;278560;
23.01.2019;17:48:08;82202356;81923754;278602;
23.01.2019;17:49:04;82202501;81923887;278614;
23.01.2019;17:50:04;82202663;81924042;278621;
23.01.2019;17:51:06;82202837;81924183;278654;
23.01.2019;17:52:05;82202981;81924316;278665;
23.01.2019;17:53:05;82203166;81924456;278710;
23.01.2019;17:54:05;82203335;81924603;278732;
23.01.2019;17:55:05;82203510;81924757;278753;
23.01.2019;17:56:07;82203682;81924911;278771;
23.01.2019;17:57:05;82203866;81925038;278828;
23.01.2019;17:58:05;82204057;81925207;278850;
23.01.2019;17:59:05;82204208;81925348;278860;
23.01.2019;18:00:05;82204400;81925545;278855;
23.01.2019;18:01:05;82204558;81925722;278836;
23.01.2019;18:02:04;82204741;81925879;278862;
23.01.2019;18:03:08;82204930;81926025;278905;
23.01.2019;18:04:05;82205101;81926163;278938;
23.01.2019;18:05:05;82205284;81926312;278972;
23.01.2019;18:06:05;82205442;81926486;278956;
23.01.2019;18:07:05;82205606;81926629;278977;
23.01.2019;18:08:05;82205763;81926793;278970;
23.01.2019;18:09:05;82205930;81926965;278965;
23.01.2019;18:10:08;82206135;81927124;279011;
23.01.2019;18:11:05;82206308;81927261;279047;
23.01.2019;18:12:05;82206494;81927402;279092;
23.01.2019;18:13:05;82206674;81927535;279139;
23.01.2019;18:14:05;82206850;81927678;279172;
23.01.2019;18:15:05;82207027;81927813;279214;
23.01.2019;18:16:05;82207205;81927968;279237;
23.01.2019;18:17:08;82207403;81928125;279278;
23.01.2019;18:18:05;82207586;81928256;279330;
23.01.2019;18:19:05;82207761;81928422;279339;
23.01.2019;18:20:05;82207961;81928575;279386;
23.01.2019;18:21:05;82208126;81928725;279401;
23.01.2019;18:22:05;82208306;81928840;279466;
23.01.2019;18:23:05;82208467;81928986;279481;
23.01.2019;18:24:08;82208609;81929104;279505;
23.01.2019;18:25:05;82208723;81929206;279517;
23.01.2019;18:26:05;82208849;81929320;279529;
23.01.2019;18:27:05;82208997;81929428;279569;
23.01.2019;18:28:05;82209126;81929538;279588;
23.01.2019;18:29:04;82209243;81929646;279597;
23.01.2019;18:30:04;82209373;81929749;279624;
23.01.2019;18:31:08;82209494;81929868;279626;
23.01.2019;18:32:07;82209589;81929954;279635;
23.01.2019;18:33:05;82209694;81930045;279649;
23.01.2019;18:34:04;82209814;81930172;279642;
23.01.2019;18:35:04;82209983;81930279;279704;
23.01.2019;18:36:05;82210135;81930419;279716;
23.01.2019;18:37:05;82210274;81930545;279729;
23.01.2019;18:38:07;82210432;81930668;279764;
23.01.2019;18:39:05;82210585;81930772;279813;
23.01.2019;18:40:05;82210711;81930898;279813;
23.01.2019;18:41:10;82210899;81930996;279903;
23.01.2019;18:42:04;82211037;81931105;279932;
23.01.2019;18:43:04;82211214;81931206;280008;
23.01.2019;18:44:04;82211368;81931327;280041;
23.01.2019;18:45:07;82211538;81931447;280091;
23.01.2019;18:46:05;82211704;81931561;280143;
23.01.2019;18:47:04;82211870;81931681;280189;
23.01.2019;18:48:05;82212026;81931785;280241;
23.01.2019;18:49:05;82212165;81931920;280245;
23.01.2019;18:50:05;82212349;81932031;280318;
23.01.2019;18:51:05;82212513;81932137;280376;
23.01.2019;18:52:08;82212720;81932254;280466;
23.01.2019;18:53:05;82212857;81932349;280508;
23.01.2019;18:54:05;82213022;81932451;280571;
23.01.2019;18:55:05;82213168;81932570;280598;
23.01.2019;18:56:04;82213351;81932675;280676;
23.01.2019;18:57:04;82213554;81932784;280770;
23.01.2019;18:58:05;82213740;81932903;280837;
23.01.2019;18:59:08;82213931;81933033;280898;
23.01.2019;19:00:05;82214113;81933113;281000;
23.01.2019;19:01:05;82214308;81933227;281081;
23.01.2019;19:02:05;82214482;81933336;281146;
23.01.2019;19:03:05;82214667;81933446;281221;
23.01.2019;19:04:05;82214825;81933560;281265;
23.01.2019;19:05:05;82215021;81933668;281353;
23.01.2019;19:06:08;82215199;81933781;281418;
23.01.2019;19:07:05;82215353;81933901;281452;
23.01.2019;19:08:05;82215520;81934019;281501;
23.01.2019;19:09:07;82215709;81934129;281580;
23.01.2019;19:10:05;82215922;81934244;281678;
23.01.2019;19:11:05;82216140;81934342;281798;
23.01.2019;19:12:05;82216346;81934438;281908;
23.01.2019;19:13:07;82216537;81934563;281974;
23.01.2019;19:14:04;82216731;81934650;282081;
23.01.2019;19:15:04;82216940;81934728;282212;
23.01.2019;19:16:04;82217137;81934834;282303;
23.01.2019;19:17:05;82217316;81934940;282376;
23.01.2019;19:18:05;82217515;81935048;282467;
23.01.2019;19:19:04;82217688;81935144;282544;
23.01.2019;19:20:09;82217902;81935243;282659;
23.01.2019;19:21:04;82218036;81935289;282747;
23.01.2019;19:22:05;82218243;81935360;282883;
23.01.2019;19:23:05;82218401;81935455;282946;
23.01.2019;19:24:05;82218589;81935584;283005;
23.01.2019;19:25:05;82218767;81935688;283079;
23.01.2019;19:26:05;82218952;81935772;283180;
23.01.2019;19:27:08;82219125;81935889;283236;
23.01.2019;19:28:04;82219285;81935971;283314;
23.01.2019;19:29:05;82219457;81936072;283385;
23.01.2019;19:30:05;82219653;81936169;283484;
23.01.2019;19:31:05;82219854;81936274;283580;
23.01.2019;19:32:05;82220040;81936364;283676;
23.01.2019;19:33:06;82220262;81936457;283805;
23.01.2019;19:34:07;82220426;81936554;283872;
23.01.2019;19:35:04;82220565;81936631;283934;
23.01.2019;19:36:05;82220728;81936712;284016;
23.01.2019;19:37:04;82220899;81936783;284116;
23.01.2019;19:38:04;82221074;81936880;284194;
23.01.2019;19:39:07;82221219;81936981;284238;
23.01.2019;19:40:05;82221289;81937060;284229;
23.01.2019;19:41:06;82221424;81937162;284262;
23.01.2019;19:42:05;82221556;81937247;284309;
23.01.2019;19:43:05;82221711;81937326;284385;
23.01.2019;19:44:05;82221840;81937429;284411;
23.01.2019;19:45:05;82221977;81937515;284462;
23.01.2019;19:46:05;82222128;81937580;284548;
23.01.2019;19:47:05;82222284;81937648;284636;
23.01.2019;19:48:05;82222397;81937738;284659;
23.01.2019;19:49:08;82222554;81937820;284734;
23.01.2019;19:50:05;82222705;81937919;284786;
23.01.2019;19:51:05;82222863;81937990;284873;
23.01.2019;19:52:05;82223033;81938075;284958;
23.01.2019;19:53:05;82223197;81938154;285043;
23.01.2019;19:54:05;82223361;81938231;285130;
23.01.2019;19:55:05;82223523;81938324;285199;
23.01.2019;19:56:08;82223685;81938394;285291;
23.01.2019;19:57:05;82223864;81938469;285395;
23.01.2019;19:58:05;82224045;81938565;285480;
23.01.2019;19:59:05;82224207;81938631;285576;
23.01.2019;20:00:05;82224352;81938707;285645;
23.01.2019;20:01:04;82224543;81938764;285779;
23.01.2019;20:02:04;82224680;81938833;285847;
23.01.2019;20:03:07;82229712;81938923;290789;
23.01.2019;20:04:05;82229894;81938995;290899;
23.01.2019;20:05:05;82230060;81939069;290991;
23.01.2019;20:06:05;82230214;81939118;291096;
23.01.2019;20:07:05;82230380;81939205;291175;
23.01.2019;20:08:05;82230549;81939288;291261;
23.01.2019;20:09:06;82230711;81939359;291352;
23.01.2019;20:10:08;82230898;81939436;291462;
23.01.2019;20:11:04;82231107;81944300;286807;
23.01.2019;20:12:05;82231296;81944378;286918;
23.01.2019;20:13:05;82231507;81944455;287052;
23.01.2019;20:14:05;82231712;81944545;287167;
23.01.2019;20:15:07;82231899;81944641;287258;
23.01.2019;20:16:05;82232076;81944709;287367;
23.01.2019;20:17:05;82232230;81944777;287453;
23.01.2019;20:18:06;82232397;81944843;287554;
23.01.2019;20:19:04;82232534;81944899;287635;
23.01.2019;20:20:07;82232693;81944962;287731;
23.01.2019;20:21:05;82232844;81945016;287828;
23.01.2019;20:22:05;82232963;81945058;287905;
23.01.2019;20:23:05;82233086;81945121;287965;
23.01.2019;20:24:05;82233245;81945183;288062;
23.01.2019;20:25:07;82233383;81945241;288142;
23.01.2019;20:26:04;82233487;81945289;288198;
23.01.2019;20:27:04;82233641;81945338;288303;
23.01.2019;20:28:04;82233789;81945401;288388;
23.01.2019;20:29:06;82233926;81945467;288459;
23.01.2019;20:30:04;82234073;81945506;288567;
23.01.2019;20:31:06;82234206;81945560;288646;
23.01.2019;20:32:07;82234368;81945609;288759;
23.01.2019;20:33:04;82234502;81945654;288848;
23.01.2019;20:34:04;82234654;81945706;288948;
23.01.2019;20:35:04;82234805;81945765;289040;
23.01.2019;20:36:05;82234941;81945821;289120;
23.01.2019;20:37:05;82235079;81945880;289199;
23.01.2019;20:38:05;82235240;81945932;289308;
23.01.2019;20:39:09;82235420;81945989;289431;
23.01.2019;20:40:04;82235548;81946021;289527;
23.01.2019;20:41:05;82235696;81946095;289601;
23.01.2019;20:42:05;82235845;81946143;289702;
23.01.2019;20:43:04;82236029;81946209;289820;
23.01.2019;20:44:04;82236206;81946260;289946;
23.01.2019;20:45:05;82236368;81946309;290059;
23.01.2019;20:46:05;82236529;81946370;290159;
23.01.2019;20:47:04;82236677;81946433;290244;
23.01.2019;20:48:05;82236828;81946485;290343;
23.01.2019;20:49:05;82236991;81946545;290446;
23.01.2019;20:50:04;82237212;81946611;290601;
23.01.2019;20:51:04;82237396;81946679;290717;
23.01.2019;20:52:04;82237551;81946743;290808;
23.01.2019;20:53:08;82237770;81946809;290961;
23.01.2019;20:54:05;82237931;81946870;291061;
23.01.2019;20:55:05;82238120;81946916;291204;
23.01.2019;20:56:04;82238278;81946977;291301;
23.01.2019;20:57:05;82238458;81947022;291436;
23.01.2019;20:58:05;82238635;81947084;291551;
23.01.2019;20:59:05;82238796;81947142;291654;
23.01.2019;21:00:08;82239010;81947206;291804;
23.01.2019;21:01:05;82239174;81947265;291909;
23.01.2019;21:02:05;82239331;81947336;291995;
23.01.2019;21:03:05;82239503;81947389;292114;
23.01.2019;21:04:05;82239648;81947432;292216;
23.01.2019;21:05:05;82239800;81947482;292318;
23.01.2019;21:06:05;82240002;81947540;292462;
23.01.2019;21:07:08;82240191;81947617;292574;
23.01.2019;21:08:05;82240386;81947662;292724;
23.01.2019;21:09:07;82240571;81947726;292845;
23.01.2019;21:10:05;82240770;81947767;293003;
23.01.2019;21:11:05;82240946;81947832;293114;
23.01.2019;21:12:04;82241113;81947879;293234;
23.01.2019;21:13:04;82241292;81947927;293365;
23.01.2019;21:14:08;82241470;81947980;293490;
23.01.2019;21:15:05;82241646;81948025;293621;
23.01.2019;21:16:05;82241809;81948065;293744;
23.01.2019;21:17:05;82242001;81948125;293876;
23.01.2019;21:18:06;82242191;81948177;294014;
23.01.2019;21:19:05;82242379;81948227;294152;
23.01.2019;21:20:04;82242554;81948267;294287;
23.01.2019;21:21:06;82242727;81948316;294411;
23.01.2019;21:22:05;82242912;81948366;294546;
23.01.2019;21:23:04;82243096;81948415;294681;
23.01.2019;21:24:05;82243258;81948459;294799;
23.01.2019;21:25:05;82243413;81948514;294899;
23.01.2019;21:26:05;82243612;81948556;295056;
23.01.2019;21:27:05;82243802;81948599;295203;
23.01.2019;21:28:07;82243974;81948628;295346;
23.01.2019;21:29:05;82244130;81948674;295456;
23.01.2019;21:30:05;82244329;81948711;295618;
23.01.2019;21:31:05;82244499;81948751;295748;
23.01.2019;21:32:05;82244681;81948795;295886;
23.01.2019;21:33:05;82244869;81948832;296037;
23.01.2019;21:34:05;82245052;81948888;296164;
23.01.2019;21:35:09;82245229;81948930;296299;
23.01.2019;21:36:04;82245382;81948962;296420;
23.01.2019;21:37:04;82245561;81949001;296560;
23.01.2019;21:38:05;82245743;81949046;296697;
23.01.2019;21:39:05;82245904;81949091;296813;
23.01.2019;21:40:05;82246111;81949154;296957;
23.01.2019;21:41:07;82246306;81949184;297122;
23.01.2019;21:42:04;82246463;81949217;297246;
23.01.2019;21:43:04;82246653;81949262;297391;
23.01.2019;21:44:04;82246835;81949299;297536;
23.01.2019;21:45:05;82247007;81949327;297680;
23.01.2019;21:46:06;82247186;81949378;297808;
23.01.2019;21:47:06;82247358;81949417;297941;
23.01.2019;21:48:09;82247542;81949471;298071;
23.01.2019;21:49:05;82247703;81949523;298180;
23.01.2019;21:50:05;82247779;81949500;298279;
23.01.2019;21:51:04;82247961;81949544;298417;
23.01.2019;21:52:04;82248105;81949598;298507;
23.01.2019;21:53:04;82248284;81949651;298633;
23.01.2019;21:54:05;82248431;81949698;298733;
23.01.2019;21:55:08;82248628;81949745;298883;
23.01.2019;21:56:05;82248783;81949772;299011;
23.01.2019;21:57:05;82248944;81949800;299144;
23.01.2019;21:58:06;82249111;81949839;299272;
23.01.2019;21:59:07;82249286;81949880;299406;
23.01.2019;22:00:10;82249496;81949908;299588;
23.01.2019;22:01:05;82249688;81949945;299743;
23.01.2019;22:02:08;82249879;81949994;299885;
23.01.2019;22:03:11;82250077;81950035;300042;
23.01.2019;22:04:05;82250245;81950068;300177;
23.01.2019;22:05:05;82250430;81950105;300325;
23.01.2019;22:06:05;82250636;81950138;300498;
23.01.2019;22:07:06;82250838;81950177;300661;
23.01.2019;22:08:04;82251017;81950212;300805;
23.01.2019;22:09:07;82251222;81950251;300971;
23.01.2019;22:10:06;82251376;81950284;301092;
23.01.2019;22:11:04;82251522;81950329;301193;
23.01.2019;22:12:06;82251717;81950354;301363;
23.01.2019;22:13:04;82251883;81950396;301487;
23.01.2019;22:14:04;82252091;81950436;301655;
23.01.2019;22:15:04;82252266;81950481;301785;
23.01.2019;22:16:07;82252474;81950518;301956;
23.01.2019;22:17:04;82252657;81950548;302109;
23.01.2019;22:18:04;82252813;81950595;302218;
23.01.2019;22:19:05;82252960;81950623;302337;
23.01.2019;22:20:05;82253078;81950661;302417;
23.01.2019;22:21:05;82253224;81950681;302543;
23.01.2019;22:22:04;82253353;81950710;302643;
23.01.2019;22:23:08;82253474;81950741;302733;
23.01.2019;22:24:05;82253616;81950767;302849;
23.01.2019;22:25:04;82253786;81950798;302988;
23.01.2019;22:26:06;82253931;81950834;303097;
23.01.2019;22:27:05;82254092;81950857;303235;
23.01.2019;22:28:06;82254239;81950888;303351;
23.01.2019;22:29:04;82254368;81950911;303457;
23.01.2019;22:30:06;82254529;81950935;303594;
23.01.2019;22:31:05;82254641;81950954;303687;
23.01.2019;22:32:06;82254783;81950963;303820;
23.01.2019;22:33:11;82254960;81950998;303962;
23.01.2019;22:34:05;82255101;81951039;304062;
23.01.2019;22:35:06;82255227;81951050;304177;
23.01.2019;22:36:05;82255358;81951064;304294;
23.01.2019;22:37:05;82255515;81951100;304415;
23.01.2019;22:38:04;82255644;81951135;304509;
23.01.2019;22:39:05;82255773;81951168;304605;
23.01.2019;22:40:05;82255926;81951185;304741;
23.01.2019;22:41:05;82256082;81951219;304863;
23.01.2019;22:42:05;82256200;81951238;304962;
23.01.2019;22:43:05;82256374;81951255;305119;
23.01.2019;22:44:05;82256518;81951286;305232;
23.01.2019;22:45:05;82256653;81951315;305338;
23.01.2019;22:46:06;82256838;81951331;305507;
23.01.2019;22:47:06;82256987;81951355;305632;
23.01.2019;22:48:06;82257151;81951395;305756;
23.01.2019;22:49:04;82257291;81951422;305869;
23.01.2019;22:50:05;82257484;81951462;306022;
23.01.2019;22:51:05;82257634;81951480;306154;
23.01.2019;22:52:04;82257803;81951524;306279;
23.01.2019;22:53:06;82257980;81951555;306425;
23.01.2019;22:54:10;82258182;81951589;306593;
23.01.2019;22:55:05;82258320;81951604;306716;
23.01.2019;22:56:05;82258518;81951632;306886;
23.01.2019;22:57:05;82258680;81951667;307013;
23.01.2019;22:58:06;82258864;81951701;307163;
23.01.2019;22:59:11;82259024;81951728;307296;
23.01.2019;23:00:05;82259195;81951748;307447;
23.01.2019;23:01:05;82259344;81951789;307555;
23.01.2019;23:02:11;82259514;81951821;307693;
23.01.2019;23:03:05;82259704;81951837;307867;
23.01.2019;23:04:05;82259879;81951868;308011;
23.01.2019;23:05:07;82260046;81951901;308145;
23.01.2019;23:06:06;82260213;81951929;308284;
23.01.2019;23:07:07;82260376;81951967;308409;
23.01.2019;23:08:05;82260532;81951989;308543;
23.01.2019;23:09:06;82260740;81952012;308728;
23.01.2019;23:10:05;82260889;81952056;308833;
23.01.2019;23:11:04;82261015;81952079;308936;
23.01.2019;23:12:04;82261159;81952111;309048;
23.01.2019;23:13:04;82261335;81952123;309212;
23.01.2019;23:14:05;82261513;81952146;309367;
23.01.2019;23:15:05;82261676;81952175;309501;
23.01.2019;23:16:05;82261850;81952198;309652;
23.01.2019;23:17:05;82261998;81952213;309785;
23.01.2019;23:18:05;82262141;81952231;309910;
23.01.2019;23:19:05;82262306;81952265;310041;
23.01.2019;23:20:05;82262461;81952288;310173;
23.01.2019;23:21:05;82262644;81952310;310334;
23.01.2019;23:22:04;82262784;81952340;310444;
23.01.2019;23:23:04;82262916;81952367;310549;
23.01.2019;23:24:05;82263043;81952392;310651;
23.01.2019;23:25:04;82263210;81952415;310795;
23.01.2019;23:26:05;82263362;81952441;310921;
23.01.2019;23:27:05;82263516;81952480;311036;
23.01.2019;23:28:05;82263661;81952500;311161;
23.01.2019;23:29:04;82263807;81952522;311285;
23.01.2019;23:30:05;82263961;81952553;311408;
23.01.2019;23:31:05;82264108;81952577;311531;
23.01.2019;23:32:05;82264238;81952608;311630;
23.01.2019;23:33:04;82264389;81952633;311756;
23.01.2019;23:34:04;82264559;81952660;311899;
23.01.2019;23:35:04;82264733;81952685;312048;
23.01.2019;23:36:05;82264880;81952713;312167;
23.01.2019;23:37:05;82265016;81952739;312277;
23.01.2019;23:38:05;82265199;81952764;312435;
23.01.2019;23:39:05;82265359;81952779;312580;
23.01.2019;23:40:05;82265510;81952800;312710;
23.01.2019;23:41:05;82265672;81952818;312854;
23.01.2019;23:42:04;82265822;81952830;312992;
23.01.2019;23:43:04;82265992;81952864;313128;
23.01.2019;23:44:04;82266157;81952897;313260;
23.01.2019;23:45:05;82266285;81952928;313357;
23.01.2019;23:46:04;82266440;81952942;313498;
23.01.2019;23:47:04;82266616;81952973;313643;
23.01.2019;23:48:04;82266773;81953002;313771;
23.01.2019;23:49:05;82266938;81953008;313930;
23.01.2019;23:50:05;82267096;81953047;314049;
23.01.2019;23:51:04;82267255;81953073;314182;
23.01.2019;23:52:05;82267368;81953106;314262;
23.01.2019;23:53:05;82267522;81953134;314388;
23.01.2019;23:54:04;82267650;81953158;314492;
23.01.2019;23:55:04;82267796;81953191;314605;
23.01.2019;23:56:04;82267962;81953210;314752;
23.01.2019;23:57:05;82268128;81953234;314894;
23.01.2019;23:58:05;82268289;81953257;315032;
23.01.2019;23:59:04;82268440;81953293;315147;
24.01.2019;00:00:07;82268582;81953313;315269;
24.01.2019;00:01:07;82268751;81953346;315405;
24.01.2019;00:02:08;82268905;81953373;315532;
24.01.2019;00:03:07;82269053;81953398;315655;
24.01.2019;00:04:07;82269199;81953419;315780;
24.01.2019;00:05:07;82269369;81953441;315928;
24.01.2019;00:06:07;82269498;81953461;316037;
24.01.2019;00:07:09;82269649;81953485;316164;
24.01.2019;00:08:07;82269781;81953505;316276;
24.01.2019;00:09:07;82269927;81953525;316402;
24.01.2019;00:10:08;82270065;81953556;316509;
24.01.2019;00:11:08;82270211;81953580;316631;
24.01.2019;00:12:07;82270341;81953614;316727;
24.01.2019;00:13:07;82270512;81953637;316875;
24.01.2019;00:14:08;82270642;81953641;317001;
24.01.2019;00:15:08;82270775;81953666;317109;
24.01.2019;00:16:07;82270871;81953687;317184;
24.01.2019;00:17:08;82270947;81953704;317243;
24.01.2019;00:18:07;82271021;81953711;317310;
24.01.2019;00:19:08;82271093;81953728;317365;
24.01.2019;00:20:08;82271167;81953760;317407;
24.01.2019;00:21:07;82271225;81953772;317453;
24.01.2019;00:22:07;82271268;81953798;317470;
24.01.2019;00:23:08;82271309;81953823;317486;
24.01.2019;00:24:08;82271390;81953849;317541;
24.01.2019;00:25:08;82271437;81953857;317580;
24.01.2019;00:26:08;82271537;81953876;317661;
24.01.2019;00:27:07;82271630;81953903;317727;
24.01.2019;00:28:08;82271702;81953932;317770;
24.01.2019;00:29:07;82271815;81953946;317869;
24.01.2019;00:30:08;82271933;81953963;317970;
24.01.2019;00:32:07;82272184;81954004;318180;
24.01.2019;00:33:08;82272316;81954023;318293;
24.01.2019;00:34:07;82272443;81954056;318387;
24.01.2019;00:35:08;82272566;81954076;318490;
24.01.2019;00:36:08;82272711;81954094;318617;
24.01.2019;00:37:08;82272834;81954122;318712;
24.01.2019;00:38:08;82272972;81954137;318835;
24.01.2019;00:39:09;82273119;81954154;318965;
24.01.2019;00:40:08;82273263;81954166;319097;
24.01.2019;00:41:07;82273414;81954189;319225;
24.01.2019;00:42:07;82273569;81954205;319364;
24.01.2019;00:43:07;82273736;81954225;319511;
24.01.2019;00:44:07;82273849;81954253;319596;
24.01.2019;00:45:08;82273987;81954276;319711;
24.01.2019;00:46:07;82274112;81954306;319806;
24.01.2019;00:47:08;82274259;81954338;319921;
24.01.2019;00:48:08;82274409;81954358;320051;
24.01.2019;00:49:07;82274537;81954375;320162;
24.01.2019;00:50:08;82274681;81954404;320277;
24.01.2019;00:51:07;82274818;81954430;320388;
24.01.2019;00:52:07;82274952;81954452;320500;
24.01.2019;00:53:08;82275089;81954478;320611;
24.01.2019;00:54:08;82275169;81954457;320712;
24.01.2019;00:55:08;82275284;81954474;320810;
24.01.2019;00:56:07;82275445;81954503;320942;
24.01.2019;00:57:08;82275617;81954540;321077;
24.01.2019;00:58:08;82275830;81954577;321253;
24.01.2019;00:59:08;82276004;81954612;321392;
24.01.2019;01:00:05;82276193;81954651;321542;
24.01.2019;01:01:04;82276362;81954686;321676;
24.01.2019;01:02:04;82276567;81954719;321848;
24.01.2019;01:03:05;82276777;81954747;322030;
24.01.2019;01:04:04;82276990;81954786;322204;
24.01.2019;01:05:05;82277162;81954816;322346;
24.01.2019;01:06:05;82277380;81954838;322542;
24.01.2019;01:07:04;82277562;81954887;322675;
24.01.2019;01:08:05;82277775;81954934;322841;
24.01.2019;01:09:05;82277960;81954954;323006;
24.01.2019;01:10:04;82278148;81954997;323151;
24.01.2019;01:11:04;82278341;81955025;323316;
24.01.2019;01:12:05;82278517;81955062;323455;
24.01.2019;01:13:05;82278684;81955099;323585;
24.01.2019;01:14:05;82278872;81955141;323731;
24.01.2019;01:15:04;82279063;81955176;323887;
24.01.2019;01:16:05;82279263;81955215;324048;
24.01.2019;01:17:05;82279428;81955257;324171;
24.01.2019;01:18:04;82279597;81955291;324306;
24.01.2019;01:19:04;82279787;81955313;324474;
24.01.2019;01:20:05;82279952;81955335;324617;
24.01.2019;01:21:04;82280127;81955372;324755;
24.01.2019;01:22:04;82280315;81955410;324905;
24.01.2019;01:23:04;82280497;81955430;325067;
24.01.2019;01:24:06;82280688;81955467;325221;
24.01.2019;01:25:04;82280887;81955500;325387;
24.01.2019;01:26:04;82281099;81955555;325544;
24.01.2019;01:27:04;82281285;81955610;325675;
24.01.2019;01:28:05;82281477;81955652;325825;
24.01.2019;01:29:05;82281675;81955678;325997;
24.01.2019;01:30:05;82281891;81955719;326172;
24.01.2019;01:31:04;82282067;81955757;326310;
24.01.2019;01:32:04;82282276;81955789;326487;
24.01.2019;01:33:04;82282461;81955838;326623;
24.01.2019;01:34:05;82282662;81955883;326779;
24.01.2019;01:35:05;82282884;81955923;326961;
24.01.2019;01:36:04;82283076;81955968;327108;
24.01.2019;01:37:05;82283260;81956010;327250;
24.01.2019;01:38:05;82283480;81956053;327427;
24.01.2019;01:39:04;82283664;81956080;327584;
24.01.2019;01:40:04;82283873;81956116;327757;
24.01.2019;01:41:05;82284082;81956156;327926;
24.01.2019;01:42:05;82284278;81956193;328085;
24.01.2019;01:43:05;82284474;81956230;328244;
24.01.2019;01:44:04;82284664;81956275;328389;
24.01.2019;01:45:04;82284868;81956333;328535;
24.01.2019;01:46:05;82285051;81956380;328671;
24.01.2019;01:47:04;82285260;81956430;328830;
24.01.2019;01:48:04;82285450;81956473;328977;
24.01.2019;01:49:05;82285666;81956531;329135;
24.01.2019;01:50:04;82285879;81956581;329298;
24.01.2019;01:51:04;82286067;81956643;329424;
24.01.2019;01:52:05;82286285;81956690;329595;
24.01.2019;01:53:04;82286477;81956736;329741;
24.01.2019;01:54:04;82286682;81956794;329888;
24.01.2019;01:55:05;82286865;81956848;330017;
24.01.2019;01:56:05;82287052;81956908;330144;
24.01.2019;01:57:04;82287275;81956952;330323;
24.01.2019;01:58:04;82287470;81956987;330483;
24.01.2019;01:59:05;82287644;81957025;330619;
24.01.2019;02:00:05;82287835;81957079;330756;
24.01.2019;02:01:05;82288010;81957150;330860;
24.01.2019;02:02:05;82288189;81957201;330988;
24.01.2019;02:03:04;82288389;81957252;331137;
24.01.2019;02:04:05;82288570;81957322;331248;
24.01.2019;02:05:04;82288743;81957368;331375;
24.01.2019;02:06:05;82288951;81957428;331523;
24.01.2019;02:07:05;82289126;81957483;331643;
24.01.2019;02:08:05;82289327;81957544;331783;
24.01.2019;02:09:10;82289511;81957615;331896;
24.01.2019;02:10:04;82289684;81957670;332014;
24.01.2019;02:11:05;82289861;81957728;332133;
24.01.2019;02:12:04;82290043;81957787;332256;
24.01.2019;02:13:05;82290237;81957856;332381;
24.01.2019;02:14:04;82290426;81957923;332503;
24.01.2019;02:15:04;82290603;81957983;332620;
24.01.2019;02:16:05;82290778;81958058;332720;
24.01.2019;02:17:04;82290904;81958115;332789;
24.01.2019;02:18:04;82291058;81958169;332889;
24.01.2019;02:19:05;82291192;81958233;332959;
24.01.2019;02:20:05;82291341;81958295;333046;
24.01.2019;02:21:04;82291486;81958356;333130;
24.01.2019;02:22:04;82291626;81958439;333187;
24.01.2019;02:23:04;82291749;81958512;333237;
24.01.2019;02:24:05;82291907;81958579;333328;
24.01.2019;02:25:04;82292040;81958631;333409;
24.01.2019;02:26:04;82292195;81958684;333511;
24.01.2019;02:27:05;82292359;81958749;333610;
24.01.2019;02:28:05;82292532;81958839;333693;
24.01.2019;02:29:04;82292655;81958887;333768;
24.01.2019;02:30:04;82292820;81958953;333867;
24.01.2019;02:31:05;82292986;81959020;333966;
24.01.2019;02:32:04;82293140;81959093;334047;
24.01.2019;02:33:04;82293312;81959148;334164;
24.01.2019;02:34:05;82293459;81959216;334243;
24.01.2019;02:35:05;82293614;81959292;334322;
24.01.2019;02:36:05;82293809;81959362;334447;
24.01.2019;02:37:04;82293982;81959443;334539;
24.01.2019;02:38:04;82294144;81959525;334619;
24.01.2019;02:39:05;82294306;81959589;334717;
24.01.2019;02:40:05;82294463;81959672;334791;
24.01.2019;02:41:04;82294638;81959745;334893;
24.01.2019;02:42:04;82294806;81959838;334968;
24.01.2019;02:43:05;82295007;81959924;335083;
24.01.2019;02:44:05;82295166;81960015;335151;
24.01.2019;02:45:04;82295345;81960085;335260;
24.01.2019;02:46:04;82295513;81960175;335338;
24.01.2019;02:47:10;82295709;81960275;335434;
24.01.2019;02:48:05;82295915;81960340;335575;
24.01.2019;02:49:05;82296096;81960419;335677;
24.01.2019;02:50:05;82296271;81960496;335775;
24.01.2019;02:51:04;82296437;81960607;335830;
24.01.2019;02:52:04;82296630;81960678;335952;
24.01.2019;02:53:04;82296802;81960773;336029;
24.01.2019;02:54:04;82296968;81960859;336109;
24.01.2019;02:55:05;82297123;81960946;336177;
24.01.2019;02:56:05;82297295;81961023;336272;
24.01.2019;02:57:05;82297479;81961104;336375;
24.01.2019;02:58:04;82297662;81961184;336478;
24.01.2019;02:59:04;82297847;81961288;336559;
24.01.2019;03:00:05;82298045;81961390;336655;
24.01.2019;03:01:04;82298232;81961466;336766;
24.01.2019;03:02:05;82298413;81961548;336865;
24.01.2019;03:03:04;82298592;81961658;336934;
24.01.2019;03:04:05;82298785;81961748;337037;
24.01.2019;03:05:05;82298961;81961845;337116;
24.01.2019;03:06:05;82299146;81961934;337212;
24.01.2019;03:07:04;82299302;81962026;337276;
24.01.2019;03:08:05;82299479;81962111;337368;
24.01.2019;03:09:05;82299639;81962194;337445;
24.01.2019;03:10:05;82299813;81962280;337533;
24.01.2019;03:11:05;82299958;81962375;337583;
24.01.2019;03:12:05;82300144;81962461;337683;
24.01.2019;03:13:05;82300332;81962561;337771;
24.01.2019;03:14:05;82300507;81962643;337864;
24.01.2019;03:15:04;82300692;81962723;337969;
24.01.2019;03:16:04;82300876;81962836;338040;
24.01.2019;03:17:05;82301071;81962927;338144;
24.01.2019;03:18:04;82301247;81963015;338232;
24.01.2019;03:19:05;82301432;81963125;338307;
24.01.2019;03:20:05;82301588;81963240;338348;
24.01.2019;03:21:04;82301766;81963328;338438;
24.01.2019;03:22:04;82301952;81963432;338520;
24.01.2019;03:23:04;82302140;81963538;338602;
24.01.2019;03:24:05;82302306;81963632;338674;
24.01.2019;03:25:05;82302470;81963747;338723;
24.01.2019;03:26:04;82302631;81963855;338776;
24.01.2019;03:27:05;82302830;81963968;338862;
24.01.2019;03:28:04;82302953;81964071;338882;
24.01.2019;03:29:04;82303120;81964165;338955;
24.01.2019;03:30:05;82303270;81964278;338992;
24.01.2019;03:31:05;82303429;81964394;339035;
24.01.2019;03:32:05;82303589;81964509;339080;
24.01.2019;03:33:04;82303737;81964609;339128;
24.01.2019;03:34:04;82303885;81964723;339162;
24.01.2019;03:35:05;82304056;81964813;339243;
24.01.2019;03:36:04;82304247;81964907;339340;
24.01.2019;03:37:04;82304410;81965001;339409;
24.01.2019;03:38:04;82304619;81965094;339525;
24.01.2019;03:39:05;82304812;81965218;339594;
24.01.2019;03:40:05;82304990;81965330;339660;
24.01.2019;03:41:04;82305130;81965432;339698;
24.01.2019;03:42:04;82305281;81965553;339728;
24.01.2019;03:43:05;82305467;81965662;339805;
24.01.2019;03:44:05;82305638;81965749;339889;
24.01.2019;03:45:04;82305831;81965847;339984;
24.01.2019;03:46:05;82306004;81965968;340036;
24.01.2019;03:47:05;82306178;81966091;340087;
24.01.2019;03:48:04;82306328;81966185;340143;
24.01.2019;03:49:05;82306498;81966307;340191;
24.01.2019;03:50:04;82306682;81966400;340282;
24.01.2019;03:51:04;82306873;81966508;340365;
24.01.2019;03:52:05;82307038;81966625;340413;
24.01.2019;03:53:05;82307213;81966745;340468;
24.01.2019;03:54:05;82307337;81966812;340525;
24.01.2019;03:55:05;82307531;81966911;340620;
24.01.2019;03:56:04;82307682;81967024;340658;
24.01.2019;03:57:04;82307855;81967134;340721;
24.01.2019;03:58:05;82308047;81967234;340813;
24.01.2019;03:59:04;82308192;81967351;340841;
24.01.2019;04:00:04;82308356;81967465;340891;
24.01.2019;04:01:05;82308513;81967576;340937;
24.01.2019;04:02:05;82308679;81967679;341000;
24.01.2019;04:03:04;82308841;81967784;341057;
24.01.2019;04:04:04;82309022;81967898;341124;
24.01.2019;04:05:05;82309202;81968027;341175;
24.01.2019;04:06:04;82309364;81968132;341232;
24.01.2019;04:07:04;82309534;81968228;341306;
24.01.2019;04:08:05;82309711;81968350;341361;
24.01.2019;04:09:06;82309879;81968480;341399;
24.01.2019;04:10:05;82310021;81968571;341450;
24.01.2019;04:11:04;82310183;81968688;341495;
24.01.2019;04:12:05;82310359;81968788;341571;
24.01.2019;04:13:05;82310467;81968904;341563;
24.01.2019;04:14:04;82310601;81969013;341588;
24.01.2019;04:15:05;82310728;81969106;341622;
24.01.2019;04:16:05;82310835;81969199;341636;
24.01.2019;04:17:05;82310945;81969300;341645;
24.01.2019;04:18:05;82311064;81969400;341664;
24.01.2019;04:19:05;82311193;81969507;341686;
24.01.2019;04:20:05;82311305;81969607;341698;
24.01.2019;04:21:05;82311452;81969705;341747;
24.01.2019;04:22:05;82311561;81969809;341752;
24.01.2019;04:23:05;82311667;81969926;341741;
24.01.2019;04:24:04;82311784;81970035;341749;
24.01.2019;04:25:04;82311891;81970145;341746;
24.01.2019;04:26:05;82312030;81970251;341779;
24.01.2019;04:27:05;82312160;81970354;341806;
24.01.2019;04:28:04;82312283;81970482;341801;
24.01.2019;04:29:04;82312416;81970597;341819;
24.01.2019;04:30:05;82312562;81970713;341849;
24.01.2019;04:31:05;82312689;81970822;341867;
24.01.2019;04:32:04;82312816;81970939;341877;
24.01.2019;04:33:04;82312985;81971064;341921;
24.01.2019;04:34:04;82313122;81971175;341947;
24.01.2019;04:35:04;82313286;81971276;342010;
24.01.2019;04:36:05;82313428;81971396;342032;
24.01.2019;04:37:05;82313578;81971523;342055;
24.01.2019;04:38:04;82313698;81971634;342064;
24.01.2019;04:39:06;82313841;81971741;342100;
24.01.2019;04:40:04;82313973;81971846;342127;
24.01.2019;04:41:04;82314109;81971935;342174;
24.01.2019;04:42:05;82314273;81972041;342232;
24.01.2019;04:43:05;82314438;81972147;342291;
24.01.2019;04:44:05;82314591;81972275;342316;
24.01.2019;04:45:04;82314744;81972377;342367;
24.01.2019;04:46:05;82314907;81972477;342430;
24.01.2019;04:47:04;82315057;81972601;342456;
24.01.2019;04:48:04;82315206;81972726;342480;
24.01.2019;04:49:04;82315359;81972856;342503;
24.01.2019;04:50:05;82315531;81972972;342559;
24.01.2019;04:51:05;82315702;81973101;342601;
24.01.2019;04:52:04;82315871;81973209;342662;
24.01.2019;04:53:05;82316034;81973317;342717;
24.01.2019;04:54:05;82316189;81973425;342764;
24.01.2019;04:55:04;82316351;81973532;342819;
24.01.2019;04:56:05;82316516;81973656;342860;
24.01.2019;04:57:05;82316676;81973775;342901;
24.01.2019;04:58:04;82316849;81973887;342962;
24.01.2019;04:59:05;82317011;81974003;343008;
24.01.2019;05:00:04;82317174;81974097;343077;
24.01.2019;05:01:04;82317333;81974205;343128;
24.01.2019;05:02:05;82317495;81974327;343168;
24.01.2019;05:03:04;82317643;81974448;343195;
24.01.2019;05:04:04;82317791;81974562;343229;
24.01.2019;05:05:05;82317932;81974659;343273;
24.01.2019;05:06:04;82318091;81974770;343321;
24.01.2019;05:07:04;82318246;81974893;343353;
24.01.2019;05:08:04;82318379;81975017;343362;
24.01.2019;05:09:07;82318530;81975126;343404;
24.01.2019;05:10:04;82318659;81975224;343435;
24.01.2019;05:11:05;82318809;81975374;343435;
24.01.2019;05:12:05;82318941;81975485;343456;
24.01.2019;05:13:04;82319086;81975594;343492;
24.01.2019;05:14:05;82319233;81975710;343523;
24.01.2019;05:15:05;82319387;81975843;343544;
24.01.2019;05:16:05;82319537;81975932;343605;
24.01.2019;05:17:05;82319677;81976045;343632;
24.01.2019;05:18:04;82319792;81976159;343633;
24.01.2019;05:19:05;82319924;81976283;343641;
24.01.2019;05:20:04;82320081;81976389;343692;
24.01.2019;05:21:04;82320230;81976503;343727;
24.01.2019;05:22:05;82320381;81976631;343750;
24.01.2019;05:23:04;82320548;81976753;343795;
24.01.2019;05:24:04;82320676;81976866;343810;
24.01.2019;05:25:05;82320810;81976971;343839;
24.01.2019;05:26:05;82320969;81977092;343877;
24.01.2019;05:27:04;82321124;81977223;343901;
24.01.2019;05:28:05;82321277;81977329;343948;
24.01.2019;05:29:05;82321436;81977455;343981;
24.01.2019;05:30:04;82321582;81977585;343997;
24.01.2019;05:31:05;82321713;81977698;344015;
24.01.2019;05:32:04;82321883;81977816;344067;
24.01.2019;05:33:04;82322008;81977926;344082;
24.01.2019;05:34:05;82322147;81978046;344101;
24.01.2019;05:35:04;82322285;81978181;344104;
24.01.2019;05:36:04;82322408;81978312;344096;
24.01.2019;05:37:05;82322531;81978399;344132;
24.01.2019;05:38:04;82322667;81978513;344154;
24.01.2019;05:39:04;82322812;81978643;344169;
24.01.2019;05:40:04;82322972;81978749;344223;
24.01.2019;05:41:04;82323097;81978865;344232;
24.01.2019;05:42:05;82323226;81979007;344219;
24.01.2019;05:43:05;82323363;81979129;344234;
24.01.2019;05:44:05;82323495;81979242;344253;
24.01.2019;05:45:05;82323636;81979361;344275;
24.01.2019;05:46:04;82323787;81979473;344314;
24.01.2019;05:47:04;82323914;81979579;344335;
24.01.2019;05:48:05;82324062;81979725;344337;
24.01.2019;05:49:04;82324210;81979847;344363;
24.01.2019;05:50:05;82324344;81979960;344384;
24.01.2019;05:51:05;82324502;81980056;344446;
24.01.2019;05:52:05;82324633;81980193;344440;
24.01.2019;05:53:04;82324774;81980305;344469;
24.01.2019;05:54:04;82324936;81980428;344508;
24.01.2019;05:55:05;82325096;81980536;344560;
24.01.2019;05:56:04;82325253;81980633;344620;
24.01.2019;05:57:04;82325414;81980766;344648;
24.01.2019;05:58:04;82325570;81980867;344703;
24.01.2019;05:59:10;82325705;81980970;344735;
24.01.2019;06:00:04;82325833;81981070;344763;
24.01.2019;06:01:04;82325950;81981184;344766;
24.01.2019;06:02:05;82326107;81981311;344796;
24.01.2019;06:03:04;82326269;81981427;344842;
24.01.2019;06:04:04;82326414;81981537;344877;
24.01.2019;06:05:05;82326528;81981658;344870;
24.01.2019;06:06:05;82326672;81981764;344908;
24.01.2019;06:07:04;82326814;81981882;344932;
24.01.2019;06:08:05;82326945;81982000;344945;
24.01.2019;06:09:06;82327096;81982109;344987;
24.01.2019;06:10:04;82327245;81982216;345029;
24.01.2019;06:11:05;82327360;81982331;345029;
24.01.2019;06:12:04;82327459;81982449;345010;
24.01.2019;06:13:04;82327560;81982562;344998;
24.01.2019;06:14:05;82327643;81982680;344963;
24.01.2019;06:15:05;82327739;81982777;344962;
24.01.2019;06:16:04;82327806;81982896;344910;
24.01.2019;06:17:05;82327912;81983005;344907;
24.01.2019;06:18:05;82327995;81983098;344897;
24.01.2019;06:19:04;82328089;81983225;344864;
24.01.2019;06:20:04;82328185;81983298;344887;
24.01.2019;06:21:05;82328272;81983414;344858;
24.01.2019;06:22:04;82328359;81983523;344836;
24.01.2019;06:23:05;82328471;81983654;344817;
24.01.2019;06:24:04;82328570;81983776;344794;
24.01.2019;06:25:08;82328699;81983896;344803;
24.01.2019;06:26:04;82328806;81984048;344758;
24.01.2019;06:27:04;82328927;81984154;344773;
24.01.2019;06:28:05;82329075;81984255;344820;
24.01.2019;06:29:05;82329211;81984366;344845;
24.01.2019;06:30:05;82329341;81984504;344837;
24.01.2019;06:31:05;82329475;81984620;344855;
24.01.2019;06:32:04;82329594;81984739;344855;
24.01.2019;06:33:04;82329741;81984882;344859;
24.01.2019;06:34:05;82329878;81984977;344901;
24.01.2019;06:35:05;82330002;81985105;344897;
24.01.2019;06:36:05;82330178;81985231;344947;
24.01.2019;06:37:04;82330332;81985333;344999;
24.01.2019;06:38:05;82330473;81985478;344995;
24.01.2019;06:39:05;82330614;81985589;345025;
24.01.2019;06:40:04;82330731;81985711;345020;
24.01.2019;06:41:04;82330881;81985827;345054;
24.01.2019;06:42:05;82331023;81985962;345061;
24.01.2019;06:43:04;82331145;81986062;345083;
24.01.2019;06:44:04;82331294;81986179;345115;
24.01.2019;06:45:05;82331427;81986307;345120;
24.01.2019;06:46:05;82331566;81986449;345117;
24.01.2019;06:47:04;82331706;81986583;345123;
24.01.2019;06:48:05;82331847;81986693;345154;
24.01.2019;06:49:04;82331991;81986826;345165;
24.01.2019;06:50:04;82332137;81986947;345190;
24.01.2019;06:51:05;82332279;81987077;345202;
24.01.2019;06:52:08;82332427;81987198;345229;
24.01.2019;06:53:04;82332556;81987333;345223;
24.01.2019;06:54:05;82332705;81987447;345258;
24.01.2019;06:55:04;82332863;81987592;345271;
24.01.2019;06:56:04;82333004;81987709;345295;
24.01.2019;06:57:05;82333151;81987818;345333;
24.01.2019;06:58:05;82333255;81987899;345356;
24.01.2019;06:59:05;82333373;81988004;345369;
24.01.2019;07:00:04;82333520;81988125;345395;
24.01.2019;07:01:04;82333676;81988231;345445;
24.01.2019;07:02:07;82333839;81988360;345479;
24.01.2019;07:03:05;82333966;81988465;345501;
24.01.2019;07:04:05;82334110;81988587;345523;
24.01.2019;07:05:05;82334241;81988722;345519;
24.01.2019;07:06:04;82334391;81988868;345523;
24.01.2019;07:07:05;82334538;81988969;345569;
24.01.2019;07:08:04;82334682;81989086;345596;
24.01.2019;07:09:04;82334841;81989218;345623;
24.01.2019;07:10:04;82334975;81989306;345669;
24.01.2019;07:11:05;82335133;81989436;345697;
24.01.2019;07:12:05;82335259;81989549;345710;
24.01.2019;07:13:05;82335381;81989671;345710;
24.01.2019;07:14:08;82335498;81989796;345702;
24.01.2019;07:15:04;82335617;81989887;345730;
24.01.2019;07:16:04;82335742;81990002;345740;
24.01.2019;07:17:04;82335859;81990128;345731;
24.01.2019;07:18:04;82335980;81990264;345716;
24.01.2019;07:19:05;82336109;81990396;345713;
24.01.2019;07:20:05;82336237;81990518;345719;
24.01.2019;07:21:05;82336375;81990641;345734;
24.01.2019;07:22:05;82336484;81990766;345718;
24.01.2019;07:23:04;82336598;81990900;345698;
24.01.2019;07:24:06;82336748;81991048;345700;
24.01.2019;07:25:04;82336870;81991168;345702;
24.01.2019;07:26:05;82337010;81991301;345709;
24.01.2019;07:27:04;82337149;81991432;345717;
24.01.2019;07:28:04;82337283;81991566;345717;
24.01.2019;07:29:05;82337422;81991699;345723;
24.01.2019;07:30:04;82337543;81991822;345721;
24.01.2019;07:31:05;82337694;81991945;345749;
24.01.2019;07:32:04;82337831;81992061;345770;
24.01.2019;07:33:04;82337955;81992159;345796;
24.01.2019;07:34:05;82338106;81992294;345812;
24.01.2019;07:35:04;82338243;81992397;345846;
24.01.2019;07:36:04;82338365;81992522;345843;
24.01.2019;07:37:05;82338483;81992618;345865;
24.01.2019;07:38:04;82338614;81992733;345881;
24.01.2019;07:39:07;82338751;81992865;345886;
24.01.2019;07:40:05;82338892;81993001;345891;
24.01.2019;07:41:04;82339010;81993115;345895;
24.01.2019;07:42:05;82339120;81993243;345877;
24.01.2019;07:43:04;82339260;81993370;345890;
24.01.2019;07:44:04;82339383;81993494;345889;
24.01.2019;07:45:04;82339503;81993616;345887;
24.01.2019;07:46:05;82339626;81993742;345884;
24.01.2019;07:47:04;82339734;81993888;345846;
24.01.2019;07:48:05;82339871;81994026;345845;
24.01.2019;07:49:04;82339997;81994158;345839;
24.01.2019;07:50:04;82340133;81994307;345826;
24.01.2019;07:51:04;82340283;81994410;345873;
24.01.2019;07:52:04;82340384;81994552;345832;
24.01.2019;07:53:05;82340505;81994685;345820;
24.01.2019;07:54:04;82340626;81994796;345830;
24.01.2019;07:55:04;82340741;81994913;345828;
24.01.2019;07:56:05;82340846;81995036;345810;
24.01.2019;07:57:04;82340959;81995143;345816;
24.01.2019;07:58:05;82341086;81995265;345821;
24.01.2019;07:59:05;82341206;81995381;345825;
24.01.2019;08:00:04;82341314;81995496;345818;
24.01.2019;08:01:04;82341425;81995607;345818;
24.01.2019;08:02:04;82341525;81995731;345794;
24.01.2019;08:03:05;82341645;81995885;345760;
24.01.2019;08:04:04;82341785;81996003;345782;
24.01.2019;08:05:05;82341899;81996137;345762;
24.01.2019;08:06:05;82342023;81996279;345744;
24.01.2019;08:07:04;82342122;81996399;345723;
24.01.2019;08:08:04;82342220;81996505;345715;
24.01.2019;08:09:06;82342310;81996622;345688;
24.01.2019;08:10:04;82342378;81996706;345672;
24.01.2019;08:11:05;82342437;81996793;345644;
24.01.2019;08:12:04;82342518;81996911;345607;
24.01.2019;08:13:05;82342573;81997028;345545;
24.01.2019;08:14:04;82342601;81997124;345477;
24.01.2019;08:15:05;82342675;81997214;345461;
24.01.2019;08:16:04;82342744;81997311;345433;
24.01.2019;08:17:04;82342822;81997423;345399;
24.01.2019;08:18:05;82342885;81997543;345342;
24.01.2019;08:19:04;82342939;81997665;345274;
24.01.2019;08:20:04;82343027;81997777;345250;
24.01.2019;08:21:04;82343107;81997895;345212;
24.01.2019;08:22:05;82343191;81997999;345192;
24.01.2019;08:23:04;82343289;81998116;345173;
24.01.2019;08:24:05;82343410;81998237;345173;
24.01.2019;08:25:04;82343508;81998360;345148;
24.01.2019;08:26:04;82343615;81998494;345121;
24.01.2019;08:27:05;82343722;81998613;345109;
24.01.2019;08:28:05;82343825;81998741;345084;
24.01.2019;08:29:04;82343918;81998830;345088;
24.01.2019;08:30:04;82344025;81998954;345071;
24.01.2019;08:31:04;82344131;81999082;345049;
24.01.2019;08:32:09;82344252;81999195;345057;
24.01.2019;08:33:04;82344350;81999317;345033;
24.01.2019;08:34:05;82344462;81999460;345002;
24.01.2019;08:35:04;82344563;81999578;344985;
24.01.2019;08:36:04;82344685;81999683;345002;
24.01.2019;08:37:04;82344757;81999812;344945;
24.01.2019;08:38:05;82344854;81999953;344901;
24.01.2019;08:39:05;82344964;82000069;344895;
24.01.2019;08:40:04;82345088;82000209;344879;
24.01.2019;08:41:05;82345206;82000329;344877;
24.01.2019;08:42:04;82345315;82000447;344868;
24.01.2019;08:43:04;82345401;82000573;344828;
24.01.2019;08:44:05;82345488;82000702;344786;
24.01.2019;08:45:04;82345591;82000837;344754;
24.01.2019;08:46:05;82345711;82000947;344764;
24.01.2019;08:47:04;82345811;82001071;344740;
24.01.2019;08:48:04;82345904;82001204;344700;
24.01.2019;08:49:05;82346009;82001338;344671;
24.01.2019;08:50:04;82346103;82001465;344638;
24.01.2019;08:51:05;82346220;82001601;344619;
24.01.2019;08:52:04;82346335;82001723;344612;
24.01.2019;08:53:04;82346443;82001846;344597;
24.01.2019;08:54:04;82346559;82001970;344589;
24.01.2019;08:55:05;82346675;82002097;344578;
24.01.2019;08:56:04;82346772;82002236;344536;
24.01.2019;08:57:04;82346899;82002358;344541;
24.01.2019;08:58:05;82347022;82002479;344543;
24.01.2019;08:59:04;82347129;82002619;344510;
24.01.2019;09:00:04;82347235;82002750;344485;
24.01.2019;09:01:04;82347314;82002892;344422;
24.01.2019;09:02:04;82347410;82003030;344380;
24.01.2019;09:03:05;82347518;82003155;344363;
24.01.2019;09:04:05;82347592;82003298;344294;
24.01.2019;09:05:04;82347676;82003418;344258;
24.01.2019;09:06:04;82347772;82003551;344221;
24.01.2019;09:07:05;82347876;82003677;344199;
24.01.2019;09:08:04;82347980;82003821;344159;
24.01.2019;09:09:05;82348077;82003962;344115;
24.01.2019;09:10:05;82348164;82004087;344077;
24.01.2019;09:11:04;82348256;82004206;344050;
24.01.2019;09:12:04;82348367;82004347;344020;
24.01.2019;09:13:05;82348473;82004472;344001;
24.01.2019;09:14:05;82348556;82004628;343928;
24.01.2019;09:15:05;82348636;82004771;343865;
24.01.2019;09:16:04;82348725;82004896;343829;
24.01.2019;09:17:04;82348821;82005020;343801;
24.01.2019;09:18:05;82348916;82005147;343769;
24.01.2019;09:19:04;82349001;82005280;343721;
24.01.2019;09:20:04;82349094;82005415;343679;
24.01.2019;09:21:04;82349188;82005525;343663;
24.01.2019;09:22:05;82349274;82005656;343618;
24.01.2019;09:23:04;82349383;82005780;343603;
24.01.2019;09:24:05;82349469;82005908;343561;
24.01.2019;09:25:04;82349570;82006030;343540;
24.01.2019;09:26:04;82349645;82006168;343477;
24.01.2019;09:27:05;82349732;82006306;343426;
24.01.2019;09:28:04;82349825;82006427;343398;
24.01.2019;09:29:04;82349919;82006535;343384;
24.01.2019;09:30:05;82350005;82006667;343338;
24.01.2019;09:31:04;82350070;82006805;343265;
24.01.2019;09:32:04;82350179;82006936;343243;
24.01.2019;09:33:05;82350274;82007087;343187;
24.01.2019;09:34:05;82350371;82007201;343170;
24.01.2019;09:35:04;82350464;82007321;343143;
24.01.2019;09:36:04;82350564;82007440;343124;
24.01.2019;09:37:05;82350663;82007554;343109;
24.01.2019;09:38:05;82350767;82007652;343115;
24.01.2019;09:39:06;82350840;82007768;343072;
24.01.2019;09:40:06;82350914;82007899;343015;
24.01.2019;09:41:04;82350988;82008007;342981;
24.01.2019;09:42:04;82351070;82008104;342966;
24.01.2019;09:43:05;82351177;82008205;342972;
24.01.2019;09:44:04;82351248;82008343;342905;
24.01.2019;09:45:04;82351328;82008467;342861;
24.01.2019;09:46:05;82351418;82008575;342843;
24.01.2019;09:47:05;82351492;82008691;342801;
24.01.2019;09:48:04;82351555;82008815;342740;
24.01.2019;09:49:05;82351654;82008946;342708;
24.01.2019;09:50:05;82351723;82009065;342658;
24.01.2019;09:51:04;82351799;82009195;342604;
24.01.2019;09:52:04;82351866;82009266;342600;
24.01.2019;09:53:05;82351936;82009389;342547;
24.01.2019;09:54:05;82352009;82009517;342492;
24.01.2019;09:55:04;82352087;82009655;342432;
24.01.2019;09:56:05;82352153;82009777;342376;
24.01.2019;09:57:05;82352218;82009909;342309;
24.01.2019;09:58:04;82352295;82010024;342271;
24.01.2019;09:59:04;82352373;82010149;342224;
24.01.2019;10:00:04;82352450;82010279;342171;
24.01.2019;10:01:04;82352520;82010396;342124;
24.01.2019;10:02:05;82352606;82010529;342077;
24.01.2019;10:03:04;82352691;82010670;342021;
24.01.2019;10:04:04;82352762;82010802;341960;
24.01.2019;10:05:05;82352830;82010928;341902;
24.01.2019;10:06:04;82352892;82011072;341820;
24.01.2019;10:07:04;82352978;82011178;341800;
24.01.2019;10:08:04;82353070;82011321;341749;
24.01.2019;10:09:04;82353151;82011452;341699;
24.01.2019;10:10:05;82353240;82011590;341650;
24.01.2019;10:11:05;82353333;82011748;341585;
24.01.2019;10:12:05;82353391;82011854;341537;
24.01.2019;10:13:04;82353450;82011993;341457;
24.01.2019;10:14:05;82353530;82012120;341410;
24.01.2019;10:15:04;82353588;82012260;341328;
24.01.2019;10:16:05;82353629;82012358;341271;
24.01.2019;10:17:04;82353665;82012483;341182;
24.01.2019;10:18:04;82353695;82012614;341081;
24.01.2019;10:19:05;82353710;82012729;340981;
24.01.2019;10:20:04;82353723;82012830;340893;
24.01.2019;10:21:04;82353745;82012945;340800;
24.01.2019;10:22:05;82353799;82013046;340753;
24.01.2019;10:23:05;82353816;82013174;340642;
24.01.2019;10:24:04;82353886;82013285;340601;
24.01.2019;10:25:05;82353953;82013427;340526;
24.01.2019;10:26:04;82354021;82013548;340473;
24.01.2019;10:27:04;82354107;82013682;340425;
24.01.2019;10:28:04;82354192;82013819;340373;
24.01.2019;10:29:05;82354281;82013918;340363;
24.01.2019;10:30:04;82354341;82014095;340246;
24.01.2019;10:31:05;82354417;82014226;340191;
24.01.2019;10:32:04;82354487;82014351;340136;
24.01.2019;10:33:04;82354554;82014496;340058;
24.01.2019;10:34:05;82354627;82014640;339987;
24.01.2019;10:35:05;82354717;82014751;339966;
24.01.2019;10:36:04;82354820;82014878;339942;
24.01.2019;10:37:04;82354897;82015010;339887;
24.01.2019;10:38:05;82354983;82015144;339839;
24.01.2019;10:39:04;82355068;82015259;339809;
24.01.2019;10:40:04;82355139;82015426;339713;
24.01.2019;10:41:04;82355228;82015537;339691;
24.01.2019;10:42:04;82355313;82015631;339682;
24.01.2019;10:43:05;82355427;82015742;339685;
24.01.2019;10:44:05;82355513;82015806;339707;
24.01.2019;10:45:04;82355598;82015932;339666;
24.01.2019;10:46:04;82355679;82016038;339641;
24.01.2019;10:47:05;82355753;82016183;339570;
24.01.2019;10:48:04;82355844;82016311;339533;
24.01.2019;10:49:05;82355926;82016447;339479;
24.01.2019;10:50:04;82356015;82016574;339441;
24.01.2019;10:51:04;82356092;82016707;339385;
24.01.2019;10:52:05;82356188;82016822;339366;
24.01.2019;10:53:05;82356279;82016950;339329;
24.01.2019;10:54:04;82356371;82017069;339302;
24.01.2019;10:55:05;82356463;82017193;339270;
24.01.2019;10:56:05;82356527;82017340;339187;
24.01.2019;10:57:04;82356620;82017464;339156;
24.01.2019;10:58:04;82356698;82017582;339116;
24.01.2019;10:59:04;82356780;82017697;339083;
24.01.2019;11:00:05;82356867;82017828;339039;
24.01.2019;11:01:04;82356943;82017945;338998;
24.01.2019;11:02:04;82357022;82018059;338963;
24.01.2019;11:03:04;82357118;82018197;338921;
24.01.2019;11:04:04;82357203;82018310;338893;
24.01.2019;11:05:04;82357263;82018438;338825;
24.01.2019;11:06:05;82357370;82018570;338800;
24.01.2019;11:07:05;82357440;82018693;338747;
24.01.2019;11:08:04;82357528;82018829;338699;
24.01.2019;11:09:06;82357613;82018964;338649;
24.01.2019;11:10:04;82357700;82019105;338595;
24.01.2019;11:11:04;82357785;82019237;338548;
24.01.2019;11:12:05;82357867;82019380;338487;
24.01.2019;11:13:04;82357940;82019523;338417;
24.01.2019;11:14:05;82358003;82019661;338342;
24.01.2019;11:15:05;82358090;82019765;338325;
24.01.2019;11:16:04;82358177;82019908;338269;
24.01.2019;11:17:04;82358260;82020054;338206;
24.01.2019;11:18:05;82358347;82020187;338160;
24.01.2019;11:19:04;82358437;82020313;338124;
24.01.2019;11:20:04;82358503;82020418;338085;
24.01.2019;11:21:05;82358581;82020536;338045;
24.01.2019;11:22:05;82358664;82020688;337976;
24.01.2019;11:23:05;82358745;82020798;337947;
24.01.2019;11:24:04;82358842;82020920;337922;
24.01.2019;11:25:04;82358925;82021044;337881;
24.01.2019;11:26:05;82359002;82021167;337835;
24.01.2019;11:27:05;82359111;82021321;337790;
24.01.2019;11:28:04;82359199;82021451;337748;
24.01.2019;11:29:05;82359274;82021598;337676;
24.01.2019;11:30:05;82359362;82021747;337615;
24.01.2019;11:31:04;82359432;82021889;337543;
24.01.2019;11:32:04;82359503;82021999;337504;
24.01.2019;11:33:05;82359580;82022121;337459;
24.01.2019;11:34:04;82359667;82022261;337406;
24.01.2019;11:35:04;82359742;82022386;337356;
24.01.2019;11:36:05;82359829;82022538;337291;
24.01.2019;11:37:04;82359909;82022677;337232;
24.01.2019;11:38:04;82359988;82022776;337212;
24.01.2019;11:39:05;82360062;82022912;337150;
24.01.2019;11:40:04;82360148;82023038;337110;
24.01.2019;11:41:04;82360221;82023174;337047;
24.01.2019;11:42:05;82360319;82023323;336996;
24.01.2019;11:43:04;82360388;82023455;336933;
24.01.2019;11:44:05;82360464;82023581;336883;
24.01.2019;11:45:04;82360540;82023734;336806;
24.01.2019;11:46:05;82360617;82023880;336737;
24.01.2019;11:47:04;82360709;82024025;336684;
24.01.2019;11:48:04;82360800;82024166;336634;
24.01.2019;11:49:04;82360926;82024284;336642;
24.01.2019;11:50:04;82361004;82024423;336581;
24.01.2019;11:51:05;82361088;82024574;336514;
24.01.2019;11:52:05;82361182;82024702;336480;
24.01.2019;11:53:04;82361259;82024819;336440;
24.01.2019;11:54:05;82361347;82024965;336382;
24.01.2019;11:55:04;82361437;82025094;336343;
24.01.2019;11:56:04;82361531;82025239;336292;
24.01.2019;11:57:05;82361618;82025423;336195;
24.01.2019;11:58:04;82361709;82025566;336143;
24.01.2019;11:59:05;82361803;82025720;336083;
24.01.2019;12:00:05;82361867;82025857;336010;
24.01.2019;12:01:05;82361950;82025982;335968;
24.01.2019;12:02:04;82362032;82026091;335941;
24.01.2019;12:03:04;82362111;82026231;335880;
24.01.2019;12:04:05;82362186;82026355;335831;
24.01.2019;12:05:04;82362269;82026511;335758;
24.01.2019;12:06:04;82362290;82026596;335694;
24.01.2019;12:07:05;82362352;82026730;335622;
24.01.2019;12:08:05;82362465;82026851;335614;
24.01.2019;12:09:04;82362565;82026996;335569;
24.01.2019;12:10:04;82362626;82027154;335472;
24.01.2019;12:11:05;82362676;82027309;335367;
24.01.2019;12:12:04;82362708;82027404;335304;
24.01.2019;12:13:04;82362705;82027483;335222;
24.01.2019;12:14:05;82362681;82027554;335127;
24.01.2019;12:15:05;82362688;82027635;335053;
24.01.2019;12:16:04;82362757;82027773;334984;
24.01.2019;12:17:05;82362849;82027926;334923;
24.01.2019;12:18:05;82362938;82028082;334856;
24.01.2019;12:19:04;82363015;82028209;334806;
24.01.2019;12:20:04;82363113;82028320;334793;
24.01.2019;12:21:05;82363198;82028443;334755;
24.01.2019;12:22:04;82363304;82028572;334732;
24.01.2019;12:23:04;82363410;82028693;334717;
24.01.2019;12:24:05;82363491;82028851;334640;
24.01.2019;12:25:04;82363594;82028991;334603;
24.01.2019;12:26:04;82363704;82029134;334570;
24.01.2019;12:27:04;82363804;82029296;334508;
24.01.2019;12:28:04;82363911;82029431;334480;
24.01.2019;12:29:04;82363990;82029573;334417;
24.01.2019;12:30:05;82364094;82029693;334401;
24.01.2019;12:31:04;82364198;82029823;334375;
24.01.2019;12:32:05;82364278;82029969;334309;
24.01.2019;12:33:05;82364354;82030103;334251;
24.01.2019;12:34:05;82364436;82030249;334187;
24.01.2019;12:35:04;82364529;82030392;334137;
24.01.2019;12:36:04;82364621;82030539;334082;
24.01.2019;12:37:05;82364726;82030674;334052;
24.01.2019;12:38:04;82364825;82030816;334009;
24.01.2019;12:39:05;82364936;82030966;333970;
24.01.2019;12:40:05;82365018;82031095;333923;
24.01.2019;12:41:05;82365133;82031233;333900;
24.01.2019;12:42:04;82365216;82031385;333831;
24.01.2019;12:43:05;82365320;82031528;333792;
24.01.2019;12:44:04;82365421;82031650;333771;
24.01.2019;12:45:04;82365480;82031741;333739;
24.01.2019;12:46:05;82364924;82031420;333504;
24.01.2019;12:47:05;82364836;82031422;333414;
24.01.2019;12:48:04;82364920;82031549;333371;
24.01.2019;12:49:04;82364998;82031703;333295;
24.01.2019;12:50:05;82365092;82031812;333280;
24.01.2019;12:51:04;82365187;82031952;333235;
24.01.2019;12:52:05;82365299;82032097;333202;
24.01.2019;12:53:07;82365402;82032252;333150;
24.01.2019;12:54:05;82365495;82032384;333111;
24.01.2019;12:55:05;82365590;82032508;333082;
24.01.2019;12:56:04;82365698;82032640;333058;
24.01.2019;12:57:05;82365803;82032785;333018;
24.01.2019;12:58:04;82365906;82032919;332987;
24.01.2019;12:59:04;82366033;82033040;332993;
24.01.2019;13:00:05;82366152;82033189;332963;
24.01.2019;13:01:04;82366262;82033320;332942;
24.01.2019;13:02:04;82366371;82033447;332924;
24.01.2019;13:03:05;82366502;82033589;332913;
24.01.2019;13:04:04;82366629;82033704;332925;
24.01.2019;13:05:05;82366749;82033813;332936;
24.01.2019;13:06:05;82366887;82033940;332947;
24.01.2019;13:07:04;82366977;82034044;332933;
24.01.2019;13:08:04;82367105;82034170;332935;
24.01.2019;13:09:05;82367237;82034299;332938;
24.01.2019;13:10:04;82367337;82034444;332893;
24.01.2019;13:11:04;82367447;82034565;332882;
24.01.2019;13:12:05;82367556;82034687;332869;
24.01.2019;13:13:04;82367662;82034807;332855;
24.01.2019;13:14:04;82367783;82034910;332873;
24.01.2019;13:15:04;82367882;82035035;332847;
24.01.2019;13:16:05;82367999;82035184;332815;
24.01.2019;13:17:04;82368114;82035327;332787;
24.01.2019;13:18:04;82368212;82035454;332758;
24.01.2019;13:19:05;82368307;82035584;332723;
24.01.2019;13:20:05;82368430;82035699;332731;
24.01.2019;13:21:04;82368568;82035843;332725;
24.01.2019;13:22:05;82368702;82035991;332711;
24.01.2019;13:23:05;82368816;82036106;332710;
24.01.2019;13:24:04;82368917;82036225;332692;
24.01.2019;13:25:04;82369036;82036364;332672;
24.01.2019;13:26:05;82369171;82036510;332661;
24.01.2019;13:27:04;82369266;82036625;332641;
24.01.2019;13:28:04;82369360;82036786;332574;
24.01.2019;13:29:04;82369456;82036924;332532;
24.01.2019;13:30:05;82369555;82037062;332493;
24.01.2019;13:31:05;82369659;82037237;332422;
24.01.2019;13:32:05;82369788;82037370;332418;
24.01.2019;13:33:04;82369925;82037503;332422;
24.01.2019;13:34:04;82370034;82037623;332411;
24.01.2019;13:35:04;82370163;82037757;332406;
24.01.2019;13:36:04;82370281;82037877;332404;
24.01.2019;13:37:05;82370404;82038019;332385;
24.01.2019;13:38:05;82370515;82038163;332352;
24.01.2019;13:39:06;82370625;82038312;332313;
24.01.2019;13:40:05;82370737;82038462;332275;
24.01.2019;13:41:09;82370865;82038634;332231;
24.01.2019;13:42:05;82370986;82038747;332239;
24.01.2019;13:43:04;82371090;82038867;332223;
24.01.2019;13:44:04;82371200;82039025;332175;
24.01.2019;13:45:05;82371315;82039152;332163;
24.01.2019;13:46:04;82371432;82039292;332140;
24.01.2019;13:47:04;82371549;82039453;332096;
24.01.2019;13:48:04;82371660;82039603;332057;
24.01.2019;13:49:04;82371800;82039744;332056;
24.01.2019;13:50:05;82371914;82039877;332037;
24.01.2019;13:51:04;82372063;82040025;332038;
24.01.2019;13:52:04;82372191;82040187;332004;
24.01.2019;13:53:05;82372329;82040316;332013;
24.01.2019;13:54:04;82372456;82040477;331979;
24.01.2019;13:55:05;82372579;82040615;331964;
24.01.2019;13:56:05;82372702;82040767;331935;
24.01.2019;13:57:04;82372846;82040905;331941;
24.01.2019;13:58:05;82372979;82041028;331951;
24.01.2019;13:59:04;82373129;82041179;331950;
24.01.2019;14:00:04;82373256;82041333;331923;
24.01.2019;14:01:07;82373387;82041460;331927;
24.01.2019;14:02:05;82373500;82041614;331886;
24.01.2019;14:03:04;82373628;82041758;331870;
24.01.2019;14:04:04;82373766;82041888;331878;
24.01.2019;14:05:05;82373905;82042037;331868;
24.01.2019;14:06:04;82374065;82042154;331911;
24.01.2019;14:07:04;82374229;82042316;331913;
24.01.2019;14:08:05;82374362;82042501;331861;
24.01.2019;14:09:04;82374501;82042633;331868;
24.01.2019;14:10:05;82374646;82042796;331850;
24.01.2019;14:11:04;82374802;82042956;331846;
24.01.2019;14:12:04;82374910;82043116;331794;
24.01.2019;14:13:04;82375029;82043231;331798;
24.01.2019;14:14:04;82375165;82043378;331787;
24.01.2019;14:15:04;82375310;82043537;331773;
24.01.2019;14:16:04;82375414;82043689;331725;
24.01.2019;14:17:05;82375538;82043842;331696;
24.01.2019;14:18:05;82375634;82043982;331652;
24.01.2019;14:19:04;82375742;82044116;331626;
24.01.2019;14:20:04;82375859;82044250;331609;
24.01.2019;14:21:04;82375986;82044377;331609;
24.01.2019;14:22:05;82376098;82044528;331570;
24.01.2019;14:23:05;82376204;82044681;331523;
24.01.2019;14:24:04;82376306;82044840;331466;
24.01.2019;14:25:04;82376402;82044985;331417;
24.01.2019;14:26:05;82376521;82045122;331399;
24.01.2019;14:27:04;82376630;82045242;331388;
24.01.2019;14:28:04;82376750;82045389;331361;
24.01.2019;14:29:04;82376866;82045517;331349;
24.01.2019;14:30:05;82376982;82045664;331318;
24.01.2019;14:31:05;82377106;82045811;331295;
24.01.2019;14:32:05;82377219;82045981;331238;
24.01.2019;14:33:04;82377337;82046114;331223;
24.01.2019;14:34:04;82377449;82046261;331188;
24.01.2019;14:35:05;82377602;82046432;331170;
24.01.2019;14:36:05;82377725;82046564;331161;
24.01.2019;14:37:05;82377861;82046721;331140;
24.01.2019;14:38:04;82377995;82046867;331128;
24.01.2019;14:39:07;82378134;82047009;331125;
24.01.2019;14:40:05;82378258;82047146;331112;
24.01.2019;14:41:05;82378403;82047316;331087;
24.01.2019;14:42:04;82378551;82047485;331066;
24.01.2019;14:43:04;82378700;82047605;331095;
24.01.2019;14:44:05;82378852;82047786;331066;
24.01.2019;14:45:05;82378999;82047943;331056;
24.01.2019;14:46:04;82379132;82048114;331018;
24.01.2019;14:47:04;82379266;82048293;330973;
24.01.2019;14:48:05;82379439;82048455;330984;
24.01.2019;14:49:04;82379577;82048624;330953;
24.01.2019;14:50:05;82379739;82048794;330945;
24.01.2019;14:51:04;82379888;82048955;330933;
24.01.2019;14:52:04;82380030;82049106;330924;
24.01.2019;14:53:05;82380175;82049299;330876;
24.01.2019;14:54:04;82380307;82049439;330868;
24.01.2019;14:55:04;82380420;82049577;330843;
24.01.2019;14:56:05;82380573;82049760;330813;
24.01.2019;14:57:05;82380722;82049926;330796;
24.01.2019;14:58:05;82380843;82050115;330728;
24.01.2019;14:59:05;82381012;82050275;330737;
24.01.2019;15:00:08;82381170;82050438;330732;
24.01.2019;15:01:07;82381306;82050594;330712;
24.01.2019;15:02:08;82381484;82050741;330743;
24.01.2019;15:03:08;82381645;82050889;330756;
24.01.2019;15:04:08;82381768;82051045;330723;
24.01.2019;15:05:08;82381911;82051217;330694;
24.01.2019;15:06:07;82382051;82051379;330672;
24.01.2019;15:07:07;82382203;82051524;330679;
24.01.2019;15:08:07;82382343;82051696;330647;
24.01.2019;15:09:08;82382513;82051845;330668;
24.01.2019;15:10:08;82382661;82052000;330661;
24.01.2019;15:11:08;82382808;82052164;330644;
24.01.2019;15:12:08;82382937;82052357;330580;
24.01.2019;15:13:08;82383075;82052516;330559;
24.01.2019;15:14:08;82383235;82052697;330538;
24.01.2019;15:15:07;82383371;82052868;330503;
24.01.2019;15:16:07;82383534;82053048;330486;
24.01.2019;15:17:08;82383693;82053234;330459;
24.01.2019;15:18:10;82383837;82053415;330422;
24.01.2019;15:19:10;82383991;82053567;330424;
24.01.2019;15:20:09;82384131;82053755;330376;
24.01.2019;15:21:07;82384287;82053922;330365;
24.01.2019;15:22:09;82384408;82054096;330312;
24.01.2019;15:23:10;82384566;82054278;330288;
24.01.2019;15:24:09;82384726;82054451;330275;
24.01.2019;15:25:07;82384878;82054628;330250;
24.01.2019;15:26:07;82385036;82054797;330239;
24.01.2019;15:27:08;82385172;82054984;330188;
24.01.2019;15:28:07;82385337;82055163;330174;
24.01.2019;15:29:07;82385487;82055336;330151;
24.01.2019;15:30:08;82385641;82055496;330145;
24.01.2019;15:31:07;82385817;82055651;330166;
24.01.2019;15:32:07;82385965;82055809;330156;
24.01.2019;15:33:08;82386118;82055965;330153;
24.01.2019;15:34:07;82386287;82056153;330134;
24.01.2019;15:35:07;82386433;82056325;330108;
24.01.2019;15:36:08;82386574;82056502;330072;
24.01.2019;15:37:07;82386745;82056670;330075;
24.01.2019;15:38:08;82386886;82056832;330054;
24.01.2019;15:39:07;82387017;82056993;330024;
24.01.2019;15:40:07;82387171;82057142;330029;
24.01.2019;15:41:07;82387334;82057313;330021;
24.01.2019;15:42:07;82387492;82057503;329989;
24.01.2019;15:43:08;82387624;82057658;329966;
24.01.2019;15:44:07;82387777;82057802;329975;
24.01.2019;15:45:07;82387970;82057974;329996;
24.01.2019;15:46:08;82388131;82058142;329989;
24.01.2019;15:47:08;82388290;82058302;329988;
24.01.2019;15:48:08;82388445;82058481;329964;
24.01.2019;15:49:07;82388593;82058653;329940;
24.01.2019;15:50:07;82388748;82058818;329930;
24.01.2019;15:51:07;82388902;82058979;329923;
24.01.2019;15:52:07;82389053;82059159;329894;
24.01.2019;15:53:08;82389212;82059319;329893;
24.01.2019;15:54:07;82389380;82059530;329850;
24.01.2019;15:55:08;82389535;82059718;329817;
24.01.2019;15:56:10;82389697;82059905;329792;
24.01.2019;15:57:07;82389842;82060051;329791;
24.01.2019;15:58:07;82389996;82060242;329754;
24.01.2019;15:59:08;82390169;82060413;329756;
24.01.2019;16:00:04;82390306;82060571;329735;
24.01.2019;16:01:04;82390452;82060712;329740;
24.01.2019;16:02:05;82390623;82060864;329759;
24.01.2019;16:03:05;82390804;82061040;329764;
24.01.2019;16:04:04;82390971;82061193;329778;
24.01.2019;16:05:04;82391133;82061344;329789;
24.01.2019;16:06:05;82391305;82061516;329789;
24.01.2019;16:07:04;82391468;82061694;329774;
24.01.2019;16:08:05;82391622;82061856;329766;
24.01.2019;16:09:04;82391786;82062016;329770;
24.01.2019;16:10:05;82391957;82062203;329754;
24.01.2019;16:11:05;82392122;82062354;329768;
24.01.2019;16:12:06;82392294;82062533;329761;
24.01.2019;16:13:04;82392469;82062714;329755;
24.01.2019;16:14:04;82392619;82062902;329717;
24.01.2019;16:15:05;82392795;82063071;329724;
24.01.2019;16:16:05;82392998;82063226;329772;
24.01.2019;16:17:05;82393156;82063408;329748;
24.01.2019;16:18:05;82393333;82063588;329745;
24.01.2019;16:19:05;82393498;82063760;329738;
24.01.2019;16:20:04;82393644;82063907;329737;
24.01.2019;16:21:04;82393806;82064048;329758;
24.01.2019;16:22:05;82393956;82064211;329745;
24.01.2019;16:23:04;82394094;82064383;329711;
24.01.2019;16:24:04;82394243;82064564;329679;
24.01.2019;16:25:05;82394403;82064752;329651;
24.01.2019;16:26:05;82394542;82064928;329614;
24.01.2019;16:27:05;82394655;82065107;329548;
24.01.2019;16:28:05;82394798;82065283;329515;
24.01.2019;16:29:04;82394926;82065474;329452;
24.01.2019;16:30:04;82395069;82065660;329409;
24.01.2019;16:31:05;82395130;82065801;329329;
24.01.2019;16:32:05;82395181;82065908;329273;
24.01.2019;16:33:05;82395303;82066038;329265;
24.01.2019;16:34:05;82395485;82066212;329273;
24.01.2019;16:35:11;82395661;82066388;329273;
24.01.2019;16:36:05;82395799;82066515;329284;
24.01.2019;16:37:05;82395967;82066681;329286;
24.01.2019;16:38:04;82396124;82066851;329273;
24.01.2019;16:39:06;82396282;82067005;329277;
24.01.2019;16:40:05;82396426;82067195;329231;
24.01.2019;16:41:05;82396589;82067399;329190;
24.01.2019;16:42:09;82396732;82067568;329164;
24.01.2019;16:43:05;82396889;82067733;329156;
24.01.2019;16:44:05;82397054;82067933;329121;
24.01.2019;16:45:05;82397228;82068093;329135;
24.01.2019;16:46:05;82397396;82068264;329132;
24.01.2019;16:47:05;82397531;82068407;329124;
24.01.2019;16:48:04;82397709;82068605;329104;
24.01.2019;16:49:04;82397873;82068796;329077;
24.01.2019;16:50:05;82398026;82068961;329065;
24.01.2019;16:51:05;82398182;82069143;329039;
24.01.2019;16:52:05;82398343;82069320;329023;
24.01.2019;16:53:05;82398497;82069487;329010;
24.01.2019;16:54:05;82398664;82069662;329002;
24.01.2019;16:55:05;82398818;82069851;328967;
24.01.2019;16:56:05;82398986;82070008;328978;
24.01.2019;16:57:04;82399177;82070178;328999;
24.01.2019;16:58:04;82399365;82070369;328996;
24.01.2019;16:59:05;82399555;82070520;329035;
24.01.2019;17:00:05;82399743;82070691;329052;
24.01.2019;17:01:04;82399949;82070850;329099;
24.01.2019;17:02:04;82400125;82071015;329110;
24.01.2019;17:03:05;82400304;82071233;329071;
24.01.2019;17:04:05;82400468;82071421;329047;
24.01.2019;17:05:04;82400651;82071606;329045;
24.01.2019;17:06:04;82400832;82071765;329067;
24.01.2019;17:07:05;82400998;82071958;329040;
24.01.2019;17:08:05;82401150;82072119;329031;
24.01.2019;17:09:06;82401314;82072271;329043;
24.01.2019;17:10:05;82401472;82072454;329018;
24.01.2019;17:11:05;82401666;82072620;329046;
24.01.2019;17:12:05;82401842;82072781;329061;
24.01.2019;17:13:04;82402008;82072944;329064;
24.01.2019;17:14:04;82402175;82073120;329055;
24.01.2019;17:15:05;82402346;82073280;329066;
24.01.2019;17:16:05;82402515;82073463;329052;
24.01.2019;17:17:06;82402706;82073653;329053;
24.01.2019;17:18:04;82402851;82073814;329037;
24.01.2019;17:19:04;82403015;82073994;329021;
24.01.2019;17:20:04;82403197;82074188;329009;
24.01.2019;17:21:04;82403366;82074364;329002;
24.01.2019;17:22:05;82403552;82074560;328992;
24.01.2019;17:23:05;82403689;82074704;328985;
24.01.2019;17:24:04;82403853;82074861;328992;
24.01.2019;17:25:05;82404033;82075040;328993;
24.01.2019;17:26:05;82404220;82075202;329018;
24.01.2019;17:27:04;82404380;82075388;328992;
24.01.2019;17:28:05;82404557;82075549;329008;
24.01.2019;17:29:05;82404747;82075718;329029;
24.01.2019;17:30:05;82404945;82075904;329041;
24.01.2019;17:31:04;82405126;82076111;329015;
24.01.2019;17:32:04;82405282;82076302;328980;
24.01.2019;17:33:05;82405438;82076455;328983;
24.01.2019;17:34:04;82405622;82076620;329002;
24.01.2019;17:35:04;82405811;82076786;329025;
24.01.2019;17:36:05;82405966;82076925;329041;
24.01.2019;17:37:05;82406148;82077104;329044;
24.01.2019;17:38:05;82406341;82077315;329026;
24.01.2019;17:39:06;82406541;82077481;329060;
24.01.2019;17:40:04;82406735;82077635;329100;
24.01.2019;17:41:05;82406919;82077792;329127;
24.01.2019;17:42:05;82407095;82077946;329149;
24.01.2019;17:43:04;82407281;82078111;329170;
24.01.2019;17:44:05;82407462;82078291;329171;
24.01.2019;17:45:04;82407636;82078475;329161;
24.01.2019;17:46:04;82407823;82078625;329198;
24.01.2019;17:47:05;82407983;82078786;329197;
24.01.2019;17:48:05;82408175;82078966;329209;
24.01.2019;17:49:04;82408329;82079126;329203;
24.01.2019;17:50:04;82408501;82079285;329216;
24.01.2019;17:51:05;82408681;82079453;329228;
24.01.2019;17:52:05;82408839;82079595;329244;
24.01.2019;17:53:05;82409020;82079777;329243;
24.01.2019;17:54:04;82409209;82079944;329265;
24.01.2019;17:55:04;82409400;82080117;329283;
24.01.2019;17:56:05;82409577;82080263;329314;
24.01.2019;17:57:04;82409780;82080426;329354;
24.01.2019;17:58:04;82409956;82080561;329395;
24.01.2019;17:59:05;82410137;82080727;329410;
24.01.2019;18:00:05;82410317;82080875;329442;
24.01.2019;18:01:04;82410517;82081035;329482;
24.01.2019;18:02:04;82410691;82081214;329477;
24.01.2019;18:03:05;82410856;82081357;329499;
24.01.2019;18:04:05;82411072;82081509;329563;
24.01.2019;18:05:04;82411271;82081655;329616;
24.01.2019;18:06:05;82411452;82081806;329646;
24.01.2019;18:07:05;82411619;82081951;329668;
24.01.2019;18:08:05;82411790;82082109;329681;
24.01.2019;18:09:05;82411976;82082263;329713;
24.01.2019;18:10:05;82412170;82082407;329763;
24.01.2019;18:11:05;82412364;82082572;329792;
24.01.2019;18:12:05;82412559;82082727;329832;
24.01.2019;18:13:05;82412759;82082897;329862;
24.01.2019;18:14:05;82412940;82083077;329863;
24.01.2019;18:15:05;82413141;82083208;329933;
24.01.2019;18:16:05;82413350;82083356;329994;
24.01.2019;18:17:05;82413553;82083504;330049;
24.01.2019;18:18:05;82413714;82083678;330036;
24.01.2019;18:19:06;82413925;82083813;330112;
24.01.2019;18:20:05;82414117;82083970;330147;
24.01.2019;18:21:04;82414305;82084114;330191;
24.01.2019;18:22:04;82414481;82084265;330216;
24.01.2019;18:23:05;82414600;82084360;330240;
24.01.2019;18:24:05;82414752;82084489;330263;
24.01.2019;18:25:05;82414921;82084634;330287;
24.01.2019;18:26:04;82415061;82084753;330308;
24.01.2019;18:27:04;82415143;82084870;330273;
24.01.2019;18:28:05;82415222;82085005;330217;
24.01.2019;18:29:04;82415330;82085126;330204;
24.01.2019;18:30:04;82415466;82085223;330243;
24.01.2019;18:31:04;82415623;82085341;330282;
24.01.2019;18:32:05;82415786;82085457;330329;
24.01.2019;18:33:05;82415951;82085590;330361;
24.01.2019;18:34:04;82416097;82085715;330382;
24.01.2019;18:35:04;82416255;82085865;330390;
24.01.2019;18:36:05;82416406;82085978;330428;
24.01.2019;18:37:05;82416553;82086095;330458;
24.01.2019;18:38:05;82416736;82086228;330508;
24.01.2019;18:39:13;82416918;82086384;330534;
24.01.2019;18:40:04;82417075;82086480;330595;
24.01.2019;18:41:04;82417278;82086595;330683;
24.01.2019;18:42:04;82417426;82086733;330693;
24.01.2019;18:43:05;82417601;82086842;330759;
24.01.2019;18:44:05;82417770;82086972;330798;
24.01.2019;18:45:05;82417926;82087122;330804;
24.01.2019;18:46:04;82418095;82087244;330851;
24.01.2019;18:47:05;82418267;82087390;330877;
24.01.2019;18:48:04;82418419;82087509;330910;
24.01.2019;18:49:04;82418583;82087619;330964;
24.01.2019;18:50:05;82418737;82087751;330986;
24.01.2019;18:51:05;82418909;82087906;331003;
24.01.2019;18:52:06;82419041;82088029;331012;
24.01.2019;18:53:05;82419121;82088168;330953;
24.01.2019;18:54:05;82419251;82088293;330958;
24.01.2019;18:55:05;82419394;82088411;330983;
24.01.2019;18:56:05;82419445;82088437;331008;
24.01.2019;18:57:05;82419565;82088559;331006;
24.01.2019;18:58:05;82419686;82088689;330997;
24.01.2019;18:59:05;82419840;82088813;331027;
24.01.2019;19:00:05;82419994;82088946;331048;
24.01.2019;19:01:05;82420150;82089054;331096;
24.01.2019;19:02:05;82420273;82089186;331087;
24.01.2019;19:03:05;82420443;82089286;331157;
24.01.2019;19:04:05;82420594;82089404;331190;
24.01.2019;19:05:05;82420763;82089509;331254;
24.01.2019;19:06:05;82420934;82089623;331311;
24.01.2019;19:07:04;82421078;82089733;331345;
24.01.2019;19:08:05;82421219;82089841;331378;
24.01.2019;19:09:05;82421352;82089940;331412;
24.01.2019;19:10:05;82421505;82090050;331455;
24.01.2019;19:11:05;82421667;82090160;331507;
24.01.2019;19:12:04;82421832;82090258;331574;
24.01.2019;19:13:05;82421965;82090378;331587;
24.01.2019;19:14:06;82422102;82090500;331602;
24.01.2019;19:15:05;82422262;82090604;331658;
24.01.2019;19:16:05;82422394;82090726;331668;
24.01.2019;19:17:05;82422567;82090854;331713;
24.01.2019;19:18:04;82422685;82090962;331723;
24.01.2019;19:19:04;82422809;82091061;331748;
24.01.2019;19:20:06;82422982;82091151;331831;
24.01.2019;19:21:05;82423126;82091250;331876;
24.01.2019;19:22:04;82423289;82091351;331938;
24.01.2019;19:23:04;82423472;82091451;332021;
24.01.2019;19:24:05;82423611;82091559;332052;
24.01.2019;19:25:05;82423748;82091646;332102;
24.01.2019;19:26:05;82423888;82091767;332121;
24.01.2019;19:27:05;82424053;82091891;332162;
24.01.2019;19:28:05;82424242;82091991;332251;
24.01.2019;19:29:06;82424378;82092075;332303;
24.01.2019;19:30:04;82424519;82092171;332348;
24.01.2019;19:31:10;82424659;82092277;332382;
24.01.2019;19:32:04;82424806;82092368;332438;
24.01.2019;19:33:05;82424944;82092450;332494;
24.01.2019;19:34:05;82425102;82092554;332548;
24.01.2019;19:35:05;82425264;82092632;332632;
24.01.2019;19:36:05;82425440;82092736;332704;
24.01.2019;19:37:05;82425583;82092840;332743;
24.01.2019;19:38:05;82425737;82092930;332807;
24.01.2019;19:39:06;82425899;82093014;332885;
24.01.2019;19:40:05;82426068;82093094;332974;
24.01.2019;19:41:05;82426211;82093171;333040;
24.01.2019;19:42:06;82426359;82093239;333120;
24.01.2019;19:43:05;82426500;82093313;333187;
24.01.2019;19:44:05;82426669;82093398;333271;
24.01.2019;19:45:05;82426822;82093427;333395;
24.01.2019;19:46:05;82426989;82093561;333428;
24.01.2019;19:47:05;82427135;82093638;333497;
24.01.2019;19:48:05;82427283;82093747;333536;
24.01.2019;19:49:05;82427450;82093806;333644;
24.01.2019;19:50:05;82427598;82093870;333728;
24.01.2019;19:51:05;82427726;82093966;333760;
24.01.2019;19:52:04;82427887;82094047;333840;
24.01.2019;19:53:05;82428052;82094129;333923;
24.01.2019;19:54:04;82428211;82094224;333987;
24.01.2019;19:55:05;82428367;82094322;334045;
24.01.2019;19:56:04;82428533;82094377;334156;
24.01.2019;19:57:04;82428670;82094442;334228;
24.01.2019;19:58:04;82428811;82094527;334284;
24.01.2019;19:59:05;82428960;82094607;334353;
24.01.2019;20:00:05;82429104;82094674;334430;
24.01.2019;20:01:05;82429238;82094740;334498;
24.01.2019;20:02:05;82429389;82094809;334580;
24.01.2019;20:03:05;82429531;82094902;334629;
24.01.2019;20:04:05;82429661;82094991;334670;
24.01.2019;20:05:05;82429811;82095079;334732;
24.01.2019;20:06:05;82429969;82095170;334799;
24.01.2019;20:07:05;82430109;82095236;334873;
24.01.2019;20:08:05;82430249;82095293;334956;
24.01.2019;20:09:05;82430398;82095360;335038;
24.01.2019;20:10:05;82430552;82095440;335112;
24.01.2019;20:11:06;82430694;82095500;335194;
24.01.2019;20:12:04;82430846;82095565;335281;
24.01.2019;20:13:04;82430977;82095633;335344;
24.01.2019;20:14:04;82431097;82095712;335385;
24.01.2019;20:15:04;82431242;82095767;335475;
24.01.2019;20:16:05;82431402;82095836;335566;
24.01.2019;20:17:05;82431529;82095903;335626;
24.01.2019;20:18:05;82431672;82095967;335705;
24.01.2019;20:19:05;82431791;82096025;335766;
24.01.2019;20:20:04;82431886;82096087;335799;
24.01.2019;20:21:04;82432014;82096152;335862;
24.01.2019;20:22:05;82432043;82096180;335863;
24.01.2019;20:23:05;82431993;82096185;335808;
24.01.2019;20:24:05;82431979;82096206;335773;
24.01.2019;20:25:05;82432100;82096265;335835;
24.01.2019;20:26:06;82432238;82096321;335917;
24.01.2019;20:27:05;82432380;82096377;336003;
24.01.2019;20:28:05;82432513;82096433;336080;
24.01.2019;20:29:05;82432609;82096494;336115;
24.01.2019;20:30:07;82432739;82096552;336187;
24.01.2019;20:31:04;82432856;82096619;336237;
24.01.2019;20:32:05;82432988;82096695;336293;
24.01.2019;20:33:05;82433136;82096767;336369;
24.01.2019;20:34:05;82433261;82096827;336434;
24.01.2019;20:35:05;82433397;82096866;336531;
24.01.2019;20:36:05;82433522;82096932;336590;
24.01.2019;20:37:05;82433654;82097000;336654;
24.01.2019;20:38:05;82433774;82097066;336708;
24.01.2019;20:39:07;82433896;82097124;336772;
24.01.2019;20:40:05;82434036;82097182;336854;
24.01.2019;20:41:05;82434168;82097247;336921;
24.01.2019;20:42:05;82434305;82097306;336999;
24.01.2019;20:43:05;82434445;82097366;337079;
24.01.2019;20:44:05;82434562;82097423;337139;
24.01.2019;20:45:04;82434694;82097504;337190;
24.01.2019;20:46:04;82434826;82097580;337246;
24.01.2019;20:47:05;82434975;82097640;337335;
24.01.2019;20:48:05;82435107;82097697;337410;
24.01.2019;20:49:05;82440007;82097750;342257;
24.01.2019;20:50:04;82440146;82106225;333921;
24.01.2019;20:51:05;82440294;82106290;334004;
24.01.2019;20:52:05;82440438;82106344;334094;
24.01.2019;20:53:05;82440585;82106406;334179;
24.01.2019;20:54:04;82440732;82106470;334262;
24.01.2019;20:55:05;82440905;82106520;334385;
24.01.2019;20:56:04;82441049;82106581;334468;
24.01.2019;20:57:04;82441211;82106630;334581;
24.01.2019;20:58:04;82441366;82106697;334669;
24.01.2019;20:59:05;82441523;82106773;334750;
24.01.2019;21:00:05;82441678;82106818;334860;
24.01.2019;21:01:05;82441833;82106876;334957;
24.01.2019;21:02:05;82441976;82106935;335041;
24.01.2019;21:03:06;82442098;82106995;335103;
24.01.2019;21:04:05;82442233;82107054;335179;
24.01.2019;21:05:05;82442384;82107121;335263;
24.01.2019;21:06:04;82442537;82107168;335369;
24.01.2019;21:07:04;82442666;82107219;335447;
24.01.2019;21:08:04;82442803;82107272;335531;
24.01.2019;21:09:05;82442962;82107313;335649;
24.01.2019;21:10:05;82443094;82107376;335718;
24.01.2019;21:11:06;82443239;82107446;335793;
24.01.2019;21:12:05;82443386;82107489;335897;
24.01.2019;21:13:05;82443558;82107525;336033;
24.01.2019;21:14:05;82443684;82107579;336105;
24.01.2019;21:15:05;82443846;82107640;336206;
24.01.2019;21:16:05;82443993;82107692;336301;
24.01.2019;21:17:05;82444144;82107743;336401;
24.01.2019;21:18:05;82444289;82107794;336495;
24.01.2019;21:19:06;82444440;82107838;336602;
24.01.2019;21:20:04;82444592;82107887;336705;
24.01.2019;21:21:04;82444759;82107935;336824;
24.01.2019;21:22:04;82444897;82107992;336905;
24.01.2019;21:23:04;82445053;82108048;337005;
24.01.2019;21:24:05;82445229;82108092;337137;
24.01.2019;21:25:05;82445381;82108145;337236;
24.01.2019;21:26:06;82445516;82108196;337320;
24.01.2019;21:27:05;82445652;82108250;337402;
24.01.2019;21:28:05;82445787;82108297;337490;
24.01.2019;21:29:05;82445930;82108333;337597;
24.01.2019;21:30:05;82446069;82108393;337676;
24.01.2019;21:31:05;82446215;82108446;337769;
24.01.2019;21:32:05;82446384;82108494;337890;
24.01.2019;21:33:05;82446536;82108541;337995;
24.01.2019;21:34:05;82446689;82108596;338093;
24.01.2019;21:35:04;82446859;82108644;338215;
24.01.2019;21:36:05;82447009;82108698;338311;
24.01.2019;21:37:05;82447160;82108746;338414;
24.01.2019;21:38:05;82447339;82108788;338551;
24.01.2019;21:39:04;82447493;82108833;338660;
24.01.2019;21:40:04;82447627;82108867;338760;
24.01.2019;21:41:04;82447787;82108913;338874;
24.01.2019;21:42:05;82447912;82108966;338946;
24.01.2019;21:43:05;82448056;82109010;339046;
24.01.2019;21:44:05;82448185;82109049;339136;
24.01.2019;21:45:05;82448327;82109094;339233;
24.01.2019;21:46:05;82448481;82109132;339349;
24.01.2019;21:47:04;82448647;82109178;339469;
24.01.2019;21:48:05;82448782;82109228;339554;
24.01.2019;21:49:05;82448959;82109262;339697;
24.01.2019;21:50:05;82449101;82109296;339805;
24.01.2019;21:51:05;82449245;82109327;339918;
24.01.2019;21:52:06;82449378;82109375;340003;
24.01.2019;21:53:06;82449498;82109419;340079;
24.01.2019;21:54:05;82449660;82109459;340201;
24.01.2019;21:55:04;82449828;82109503;340325;
24.01.2019;21:56:04;82449909;82109493;340416;
24.01.2019;21:57:04;82450075;82109534;340541;
24.01.2019;21:58:05;82450247;82109571;340676;
24.01.2019;21:59:04;82450383;82109620;340763;
24.01.2019;22:00:05;82450546;82109664;340882;
24.01.2019;22:01:05;82450723;82109702;341021;
24.01.2019;22:02:05;82450877;82109736;341141;
24.01.2019;22:03:05;82451009;82109773;341236;
24.01.2019;22:04:05;82451163;82109802;341361;
24.01.2019;22:05:04;82451309;82109854;341455;
24.01.2019;22:06:04;82451473;82109900;341573;
24.01.2019;22:07:05;82451631;82109936;341695;
24.01.2019;22:08:05;82451788;82109968;341820;
24.01.2019;22:09:05;82451932;82110003;341929;
24.01.2019;22:10:05;82452085;82110048;342037;
24.01.2019;22:11:05;82452238;82110084;342154;
24.01.2019;22:12:05;82452404;82110111;342293;
24.01.2019;22:13:05;82452571;82110144;342427;
24.01.2019;22:14:05;82452717;82110183;342534;
24.01.2019;22:15:05;82452868;82110217;342651;
24.01.2019;22:16:05;82452998;82110259;342739;
24.01.2019;22:17:05;82453146;82110291;342855;
24.01.2019;22:18:04;82453269;82110336;342933;
24.01.2019;22:19:05;82453400;82110381;343019;
24.01.2019;22:20:05;82453550;82110412;343138;
24.01.2019;22:21:05;82453666;82110428;343238;
24.01.2019;22:22:05;82453687;82110426;343261;
24.01.2019;22:23:05;82453814;82110460;343354;
24.01.2019;22:24:05;82453956;82110482;343474;
24.01.2019;22:25:06;82454062;82110514;343548;
24.01.2019;22:26:05;82454158;82110534;343624;
24.01.2019;22:27:05;82454252;82110569;343683;
24.01.2019;22:28:04;82454364;82110579;343785;
24.01.2019;22:29:04;82454481;82110598;343883;
24.01.2019;22:30:05;82454607;82110637;343970;
24.01.2019;22:31:05;82454741;82110676;344065;
24.01.2019;22:32:05;82454848;82110700;344148;
24.01.2019;22:33:05;82454978;82110720;344258;
24.01.2019;22:34:06;82455107;82110756;344351;
24.01.2019;22:35:05;82455253;82110790;344463;
24.01.2019;22:36:05;82455374;82110827;344547;
24.01.2019;22:37:05;82455512;82110839;344673;
24.01.2019;22:38:05;82455641;82110873;344768;
24.01.2019;22:39:06;82455796;82110910;344886;
24.01.2019;22:40:05;82455951;82110936;345015;
24.01.2019;22:41:05;82456084;82110982;345102;
24.01.2019;22:42:05;82456221;82111000;345221;
24.01.2019;22:43:05;82456365;82111035;345330;
24.01.2019;22:44:05;82456484;82111066;345418;
24.01.2019;22:45:05;82456630;82111098;345532;
24.01.2019;22:46:05;82456780;82111123;345657;
24.01.2019;22:47:04;82456904;82111159;345745;
24.01.2019;22:48:04;82457043;82111186;345857;
24.01.2019;22:49:06;82457192;82111226;345966;
24.01.2019;22:50:04;82457326;82111259;346067;
24.01.2019;22:51:04;82457468;82111298;346170;
24.01.2019;22:52:05;82457640;82111334;346306;
24.01.2019;22:53:04;82457777;82111367;346410;
24.01.2019;22:54:04;82457934;82111388;346546;
24.01.2019;22:55:05;82458081;82111431;346650;
24.01.2019;22:56:06;82458241;82111455;346786;
24.01.2019;22:57:05;82458377;82111479;346898;
24.01.2019;22:58:06;82458553;82111515;347038;
24.01.2019;22:59:05;82458683;82111532;347151;
24.01.2019;23:00:05;82458827;82111556;347271;
24.01.2019;23:01:05;82458990;82111595;347395;
24.01.2019;23:02:05;82459111;82111628;347483;
24.01.2019;23:03:05;82459247;82111659;347588;
24.01.2019;23:04:05;82459385;82111682;347703;
24.01.2019;23:05:05;82459507;82111713;347794;
24.01.2019;23:06:04;82459638;82111750;347888;
24.01.2019;23:07:05;82459761;82111774;347987;
24.01.2019;23:08:05;82459902;82111796;348106;
24.01.2019;23:09:05;82460068;82111824;348244;
24.01.2019;23:10:05;82460202;82111841;348361;
24.01.2019;23:11:04;82460371;82111871;348500;
24.01.2019;23:12:04;82460527;82111902;348625;
24.01.2019;23:13:05;82460663;82111933;348730;
24.01.2019;23:14:05;82460805;82111964;348841;
24.01.2019;23:15:05;82460961;82111998;348963;
24.01.2019;23:16:05;82461085;82112026;349059;
24.01.2019;23:17:06;82461249;82112059;349190;
24.01.2019;23:18:04;82461373;82112085;349288;
24.01.2019;23:19:04;82461537;82112111;349426;
24.01.2019;23:20:05;82461691;82112141;349550;
24.01.2019;23:21:05;82461842;82112159;349683;
24.01.2019;23:22:07;82462038;82112185;349853;
24.01.2019;23:23:05;82462173;82112212;349961;
24.01.2019;23:24:04;82462332;82112241;350091;
24.01.2019;23:25:05;82462469;82112260;350209;
24.01.2019;23:26:05;82462599;82112299;350300;
24.01.2019;23:27:05;82462726;82112325;350401;
24.01.2019;23:28:06;82462906;82112357;350549;
24.01.2019;23:29:05;82463047;82112382;350665;
24.01.2019;23:30:04;82463189;82112416;350773;
24.01.2019;23:31:05;82463315;82112447;350868;
24.01.2019;23:32:05;82463443;82112472;350971;
24.01.2019;23:33:04;82463574;82112504;351070;
24.01.2019;23:34:04;82463710;82112525;351185;
24.01.2019;23:35:05;82463852;82112563;351289;
24.01.2019;23:36:05;82463961;82112594;351367;
24.01.2019;23:37:10;82464142;82112614;351528;
24.01.2019;23:38:05;82464261;82112629;351632;
24.01.2019;23:39:05;82464418;82112653;351765;
24.01.2019;23:40:04;82464548;82112673;351875;
24.01.2019;23:41:04;82464669;82112695;351974;
24.01.2019;23:42:05;82464816;82112731;352085;
24.01.2019;23:43:05;82464932;82112752;352180;
24.01.2019;23:44:04;82465058;82112783;352275;
24.01.2019;23:45:04;82465189;82112813;352376;
24.01.2019;23:46:05;82465367;82112844;352523;
24.01.2019;23:47:05;82465483;82112875;352608;
24.01.2019;23:48:05;82465622;82112895;352727;
24.01.2019;23:49:05;82465746;82112920;352826;
24.01.2019;23:50:05;82465877;82112937;352940;
24.01.2019;23:51:05;82466011;82112959;353052;
24.01.2019;23:52:05;82466131;82112978;353153;
24.01.2019;23:53:05;82466279;82113000;353279;
24.01.2019;23:54:04;82466399;82113025;353374;
24.01.2019;23:55:04;82466551;82113052;353499;
24.01.2019;23:56:05;82466685;82113073;353612;
24.01.2019;23:57:05;82466795;82113108;353687;
24.01.2019;23:58:05;82466935;82113131;353804;
24.01.2019;23:59:05;82467061;82113155;353906;
25.01.2019;00:00:07;82467200;82113174;354026;
25.01.2019;00:01:07;82467316;82113204;354112;
25.01.2019;00:02:08;82467458;82113225;354233;
25.01.2019;00:03:08;82467549;82113253;354296;
25.01.2019;00:04:08;82467694;82113280;354414;
25.01.2019;00:05:08;82467805;82113304;354501;
25.01.2019;00:06:09;82467928;82113338;354590;
25.01.2019;00:07:07;82468060;82113360;354700;
25.01.2019;00:08:07;82468195;82113384;354811;
25.01.2019;00:09:08;82468331;82113411;354920;
25.01.2019;00:10:07;82468453;82113435;355018;
25.01.2019;00:11:07;82468561;82113457;355104;
25.01.2019;00:12:08;82468671;82113476;355195;
25.01.2019;00:13:07;82468818;82113498;355320;
25.01.2019;00:14:08;82468916;82113525;355391;
25.01.2019;00:15:08;82469054;82113560;355494;
25.01.2019;00:16:07;82469166;82113577;355589;
25.01.2019;00:17:08;82469267;82113584;355683;
25.01.2019;00:18:07;82469378;82113604;355774;
25.01.2019;00:19:07;82469474;82113622;355852;
25.01.2019;00:20:08;82469535;82113634;355901;
25.01.2019;00:21:08;82469603;82113645;355958;
25.01.2019;00:22:07;82469676;82113670;356006;
25.01.2019;00:23:07;82469742;82113678;356064;
25.01.2019;00:24:08;82469791;82113687;356104;
25.01.2019;00:25:07;82469870;82113693;356177;
25.01.2019;00:26:07;82469957;82113711;356246;
25.01.2019;00:27:08;82470072;82113736;356336;
25.01.2019;00:28:08;82470162;82113761;356401;
25.01.2019;00:29:07;82470281;82113789;356492;
25.01.2019;00:30:07;82470413;82113822;356591;
25.01.2019;00:31:07;82470531;82113839;356692;
25.01.2019;00:32:08;82470631;82113864;356767;
25.01.2019;00:33:07;82470724;82113891;356833;
25.01.2019;00:34:07;82470856;82113908;356948;
25.01.2019;00:35:07;82470957;82113934;357023;
25.01.2019;00:36:08;82471088;82113950;357138;
25.01.2019;00:37:08;82471202;82113966;357236;
25.01.2019;00:38:08;82471324;82113991;357333;
25.01.2019;00:39:08;82471461;82114011;357450;
25.01.2019;00:40:07;82471602;82114046;357556;
25.01.2019;00:41:08;82471700;82114059;357641;
25.01.2019;00:42:08;82471829;82114086;357743;
25.01.2019;00:43:08;82471944;82114110;357834;
25.01.2019;00:44:07;82472057;82114137;357920;
25.01.2019;00:45:08;82472173;82114162;358011;
25.01.2019;00:46:08;82472281;82114188;358093;
25.01.2019;00:47:07;82472398;82114217;358181;
25.01.2019;00:48:07;82472516;82114245;358271;
25.01.2019;00:49:07;82472645;82114274;358371;
25.01.2019;00:50:08;82472788;82114295;358493;
25.01.2019;00:51:08;82472905;82114322;358583;
25.01.2019;00:52:08;82473038;82114345;358693;
25.01.2019;00:53:07;82473181;82114373;358808;
25.01.2019;00:54:07;82473303;82114404;358899;
25.01.2019;00:55:07;82473428;82114433;358995;
25.01.2019;00:56:08;82473558;82114462;359096;
25.01.2019;00:57:08;82473628;82114434;359194;
25.01.2019;00:58:08;82473772;82114463;359309;
25.01.2019;00:59:08;82473918;82114488;359430;
25.01.2019;01:00:04;82474057;82114527;359530;
25.01.2019;01:01:04;82474178;82114548;359630;
25.01.2019;01:02:05;82474298;82114573;359725;
25.01.2019;01:03:05;82474417;82114600;359817;
25.01.2019;01:04:04;82474526;82114630;359896;
25.01.2019;01:05:04;82474653;82114670;359983;
25.01.2019;01:06:05;82474782;82114698;360084;
25.01.2019;01:07:05;82474913;82114723;360190;
25.01.2019;01:08:04;82475034;82114771;360263;
25.01.2019;01:09:05;82475147;82114794;360353;
25.01.2019;01:10:05;82475272;82114828;360444;
25.01.2019;01:11:04;82475393;82114859;360534;
25.01.2019;01:12:05;82475515;82114891;360624;
25.01.2019;01:13:05;82475618;82114926;360692;
25.01.2019;01:14:04;82475720;82114957;360763;
25.01.2019;01:15:06;82475859;82114976;360883;
25.01.2019;01:16:04;82475979;82115015;360964;
25.01.2019;01:17:04;82476095;82115037;361058;
25.01.2019;01:18:05;82476203;82115079;361124;
25.01.2019;01:19:05;82476330;82115113;361217;
25.01.2019;01:20:04;82476436;82115138;361298;
25.01.2019;01:21:04;82476571;82115160;361411;
25.01.2019;01:22:05;82476695;82115185;361510;
25.01.2019;01:23:05;82476810;82115226;361584;
25.01.2019;01:24:04;82476918;82115253;361665;
25.01.2019;01:25:04;82477043;82115278;361765;
25.01.2019;01:26:05;82477184;82115313;361871;
25.01.2019;01:27:05;82477331;82115370;361961;
25.01.2019;01:28:04;82477443;82115410;362033;
25.01.2019;01:29:04;82477557;82115442;362115;
25.01.2019;01:30:04;82477667;82115482;362185;
25.01.2019;01:31:05;82477785;82115530;362255;
25.01.2019;01:32:05;82477911;82115558;362353;
25.01.2019;01:33:04;82478014;82115584;362430;
25.01.2019;01:34:05;82478139;82115619;362520;
25.01.2019;01:35:05;82478260;82115648;362612;
25.01.2019;01:36:05;82478388;82115683;362705;
25.01.2019;01:37:04;82478504;82115726;362778;
25.01.2019;01:38:04;82478636;82115766;362870;
25.01.2019;01:39:05;82478739;82115786;362953;
25.01.2019;01:40:05;82478867;82115822;363045;
25.01.2019;01:41:05;82478994;82115861;363133;
25.01.2019;01:42:04;82479134;82115906;363228;
25.01.2019;01:43:04;82479275;82115950;363325;
25.01.2019;01:44:05;82479411;82115985;363426;
25.01.2019;01:45:04;82479544;82116042;363502;
25.01.2019;01:46:04;82479663;82116068;363595;
25.01.2019;01:47:05;82479782;82116115;363667;
25.01.2019;01:48:05;82479895;82116154;363741;
25.01.2019;01:49:05;82480012;82116187;363825;
25.01.2019;01:50:05;82480137;82116237;363900;
25.01.2019;01:51:04;82480251;82116279;363972;
25.01.2019;01:52:05;82480378;82116330;364048;
25.01.2019;01:53:05;82480515;82116389;364126;
25.01.2019;01:54:04;82480635;82116435;364200;
25.01.2019;01:55:04;82480778;82116486;364292;
25.01.2019;01:56:05;82480907;82116518;364389;
25.01.2019;01:57:05;82481024;82116552;364472;
25.01.2019;01:58:04;82481129;82116609;364520;
25.01.2019;01:59:04;82481245;82116671;364574;
25.01.2019;02:00:05;82481369;82116716;364653;
25.01.2019;02:01:05;82481504;82116759;364745;
25.01.2019;02:02:04;82481625;82116805;364820;
25.01.2019;02:03:04;82481727;82116854;364873;
25.01.2019;02:04:05;82481839;82116921;364918;
25.01.2019;02:05:05;82481978;82116983;364995;
25.01.2019;02:06:05;82482098;82117030;365068;
25.01.2019;02:07:04;82482237;82117089;365148;
25.01.2019;02:08:04;82482360;82117149;365211;
25.01.2019;02:09:06;82482500;82117185;365315;
25.01.2019;02:10:04;82482610;82117238;365372;
25.01.2019;02:11:04;82482745;82117293;365452;
25.01.2019;02:12:05;82482859;82117347;365512;
25.01.2019;02:13:04;82482982;82117414;365568;
25.01.2019;02:14:04;82483109;82117461;365648;
25.01.2019;02:15:04;82483232;82117507;365725;
25.01.2019;02:16:04;82483348;82117556;365792;
25.01.2019;02:17:05;82483439;82117629;365810;
25.01.2019;02:18:05;82483541;82117687;365854;
25.01.2019;02:19:04;82483663;82117748;365915;
25.01.2019;02:20:05;82483776;82117791;365985;
25.01.2019;02:21:04;82483857;82117866;365991;
25.01.2019;02:22:04;82483947;82117930;366017;
25.01.2019;02:23:05;82484048;82117997;366051;
25.01.2019;02:24:05;82484149;82118067;366082;
25.01.2019;02:25:05;82484238;82118135;366103;
25.01.2019;02:26:04;82484350;82118208;366142;
25.01.2019;02:27:04;82484438;82118260;366178;
25.01.2019;02:28:05;82484527;82118349;366178;
25.01.2019;02:29:05;82484655;82118398;366257;
25.01.2019;02:30:04;82484778;82118473;366305;
25.01.2019;02:31:04;82484879;82118549;366330;
25.01.2019;02:32:05;82485000;82118602;366398;
25.01.2019;02:33:04;82485111;82118672;366439;
25.01.2019;02:34:05;82485241;82118734;366507;
25.01.2019;02:35:04;82485334;82118810;366524;
25.01.2019;02:36:04;82485423;82118885;366538;
25.01.2019;02:37:05;82485534;82118967;366567;
25.01.2019;02:38:05;82485638;82119053;366585;
25.01.2019;02:39:05;82485749;82119122;366627;
25.01.2019;02:40:04;82485869;82119192;366677;
25.01.2019;02:41:04;82485994;82119256;366738;
25.01.2019;02:42:04;82486115;82119336;366779;
25.01.2019;02:43:05;82486220;82119405;366815;
25.01.2019;02:44:05;82486319;82119473;366846;
25.01.2019;02:45:04;82486448;82119554;366894;
25.01.2019;02:46:05;82486566;82119641;366925;
25.01.2019;02:47:05;82486668;82119727;366941;
25.01.2019;02:48:04;82486797;82119820;366977;
25.01.2019;02:49:04;82486932;82119919;367013;
25.01.2019;02:50:05;82487066;82119989;367077;
25.01.2019;02:51:05;82487166;82120088;367078;
25.01.2019;02:52:04;82487291;82120178;367113;
25.01.2019;02:53:05;82487415;82120257;367158;
25.01.2019;02:54:04;82487554;82120338;367216;
25.01.2019;02:55:04;82487668;82120430;367238;
25.01.2019;02:56:04;82487808;82120500;367308;
25.01.2019;02:57:05;82487935;82120573;367362;
25.01.2019;02:58:05;82488053;82120646;367407;
25.01.2019;02:59:04;82488187;82120751;367436;
25.01.2019;03:00:05;82488306;82120842;367464;
25.01.2019;03:01:05;82488438;82120912;367526;
25.01.2019;03:02:04;82488560;82121010;367550;
25.01.2019;03:03:04;82488693;82121092;367601;
25.01.2019;03:04:05;82488827;82121174;367653;
25.01.2019;03:05:05;82488958;82121272;367686;
25.01.2019;03:06:04;82489077;82121359;367718;
25.01.2019;03:07:05;82489197;82121446;367751;
25.01.2019;03:08:05;82489310;82121555;367755;
25.01.2019;03:09:04;82489430;82121660;367770;
25.01.2019;03:10:04;82489553;82121739;367814;
25.01.2019;03:11:05;82489701;82121852;367849;
25.01.2019;03:12:04;82489829;82121958;367871;
25.01.2019;03:13:04;82489964;82122052;367912;
25.01.2019;03:14:04;82490098;82122139;367959;
25.01.2019;03:15:05;82490224;82122227;367997;
25.01.2019;03:16:05;82490359;82122323;368036;
25.01.2019;03:17:04;82490484;82122426;368058;
25.01.2019;03:18:04;82490612;82122527;368085;
25.01.2019;03:19:05;82490745;82122610;368135;
25.01.2019;03:20:04;82490841;82122704;368137;
25.01.2019;03:21:05;82490967;82122799;368168;
25.01.2019;03:22:05;82491077;82122883;368194;
25.01.2019;03:23:04;82491200;82122993;368207;
25.01.2019;03:24:04;82491341;82123088;368253;
25.01.2019;03:25:04;82491454;82123207;368247;
25.01.2019;03:26:05;82491587;82123295;368292;
25.01.2019;03:27:04;82491701;82123407;368294;
25.01.2019;03:28:05;82491829;82123518;368311;
25.01.2019;03:29:05;82491966;82123627;368339;
25.01.2019;03:30:04;82492075;82123749;368326;
25.01.2019;03:31:05;82492201;82123842;368359;
25.01.2019;03:32:04;82492330;82123953;368377;
25.01.2019;03:33:05;82492453;82124051;368402;
25.01.2019;03:34:05;82492566;82124131;368435;
25.01.2019;03:35:04;82492696;82124234;368462;
25.01.2019;03:36:05;82492831;82124336;368495;
25.01.2019;03:37:05;82492939;82124446;368493;
25.01.2019;03:38:05;82493043;82124570;368473;
25.01.2019;03:39:06;82493187;82124683;368504;
25.01.2019;03:40:05;82493315;82124781;368534;
25.01.2019;03:41:05;82493424;82124891;368533;
25.01.2019;03:42:05;82493536;82124991;368545;
25.01.2019;03:43:05;82493667;82125112;368555;
25.01.2019;03:44:04;82493794;82125227;368567;
25.01.2019;03:45:05;82493908;82125333;368575;
25.01.2019;03:46:06;82494044;82125448;368596;
25.01.2019;03:47:05;82494178;82125573;368605;
25.01.2019;03:48:05;82494323;82125681;368642;
25.01.2019;03:49:05;82494444;82125801;368643;
25.01.2019;03:50:05;82494554;82125897;368657;
25.01.2019;03:51:04;82494679;82125997;368682;
25.01.2019;03:52:04;82494796;82126103;368693;
25.01.2019;03:53:05;82494932;82126204;368728;
25.01.2019;03:54:06;82495060;82126324;368736;
25.01.2019;03:55:04;82495200;82126434;368766;
25.01.2019;03:56:04;82495343;82126546;368797;
25.01.2019;03:57:05;82495464;82126650;368814;
25.01.2019;03:58:04;82495576;82126768;368808;
25.01.2019;03:59:04;82495701;82126891;368810;
25.01.2019;04:00:05;82495803;82127004;368799;
25.01.2019;04:01:04;82495907;82127087;368820;
25.01.2019;04:02:05;82496026;82127217;368809;
25.01.2019;04:03:05;82496153;82127327;368826;
25.01.2019;04:04:04;82496257;82127438;368819;
25.01.2019;04:05:04;82496375;82127561;368814;
25.01.2019;04:06:05;82496507;82127678;368829;
25.01.2019;04:07:04;82496651;82127786;368865;
25.01.2019;04:08:04;82496791;82127892;368899;
25.01.2019;04:09:06;82496912;82127984;368928;
25.01.2019;04:10:04;82497020;82128091;368929;
25.01.2019;04:11:04;82497145;82128200;368945;
25.01.2019;04:12:05;82497253;82128315;368938;
25.01.2019;04:13:04;82497362;82128441;368921;
25.01.2019;04:14:05;82497506;82128577;368929;
25.01.2019;04:15:05;82497625;82128694;368931;
25.01.2019;04:16:05;82497733;82128790;368943;
25.01.2019;04:17:05;82497821;82128897;368924;
25.01.2019;04:18:05;82497902;82128984;368918;
25.01.2019;04:19:05;82497986;82129087;368899;
25.01.2019;04:20:04;82498096;82129216;368880;
25.01.2019;04:21:05;82498183;82129354;368829;
25.01.2019;04:22:05;82498300;82129448;368852;
25.01.2019;04:23:04;82498403;82129573;368830;
25.01.2019;04:24:05;82498493;82129694;368799;
25.01.2019;04:25:05;82498609;82129787;368822;
25.01.2019;04:26:04;82498704;82129906;368798;
25.01.2019;04:27:04;82498809;82130027;368782;
25.01.2019;04:28:05;82498918;82130158;368760;
25.01.2019;04:29:04;82499027;82130265;368762;
25.01.2019;04:30:04;82499114;82130380;368734;
25.01.2019;04:31:05;82499236;82130488;368748;
25.01.2019;04:32:05;82499369;82130611;368758;
25.01.2019;04:33:04;82499428;82130719;368709;
25.01.2019;04:34:05;82499589;82130843;368746;
25.01.2019;04:35:04;82499708;82130979;368729;
25.01.2019;04:36:04;82499830;82131085;368745;
25.01.2019;04:37:04;82499939;82131193;368746;
25.01.2019;04:38:04;82500061;82131306;368755;
25.01.2019;04:39:05;82500188;82131422;368766;
25.01.2019;04:40:05;82500315;82131527;368788;
25.01.2019;04:41:04;82500444;82131631;368813;
25.01.2019;04:42:04;82500563;82131765;368798;
25.01.2019;04:43:04;82500694;82131875;368819;
25.01.2019;04:44:04;82500816;82131978;368838;
25.01.2019;04:45:05;82500948;82132090;368858;
25.01.2019;04:46:04;82501069;82132193;368876;
25.01.2019;04:47:05;82501211;82132314;368897;
25.01.2019;04:48:05;82501321;82132417;368904;
25.01.2019;04:49:05;82501454;82132537;368917;
25.01.2019;04:50:04;82501591;82132647;368944;
25.01.2019;04:51:04;82501719;82132785;368934;
25.01.2019;04:52:05;82501858;82132915;368943;
25.01.2019;04:53:04;82501978;82133044;368934;
25.01.2019;04:54:05;82502128;82133161;368967;
25.01.2019;04:55:04;82502252;82133275;368977;
25.01.2019;04:56:04;82502367;82133405;368962;
25.01.2019;04:57:05;82502491;82133513;368978;
25.01.2019;04:58:05;82502624;82133614;369010;
25.01.2019;04:59:04;82502781;82133739;369042;
25.01.2019;05:00:04;82502901;82133855;369046;
25.01.2019;05:01:05;82503035;82133995;369040;
25.01.2019;05:02:04;82503164;82134098;369066;
25.01.2019;05:03:05;82503324;82134217;369107;
25.01.2019;05:04:05;82503457;82134324;369133;
25.01.2019;05:05:04;82503599;82134443;369156;
25.01.2019;05:06:04;82503727;82134533;369194;
25.01.2019;05:07:04;82503874;82134668;369206;
25.01.2019;05:08:04;82504019;82134778;369241;
25.01.2019;05:09:05;82504154;82134900;369254;
25.01.2019;05:10:04;82504252;82135003;369249;
25.01.2019;05:11:05;82504374;82135118;369256;
25.01.2019;05:12:05;82504508;82135219;369289;
25.01.2019;05:13:04;82504637;82135325;369312;
25.01.2019;05:14:04;82504790;82135429;369361;
25.01.2019;05:15:05;82504908;82135559;369349;
25.01.2019;05:16:04;82505033;82135668;369365;
25.01.2019;05:17:05;82505140;82135799;369341;
25.01.2019;05:18:05;82505244;82135906;369338;
25.01.2019;05:19:04;82505379;82136016;369363;
25.01.2019;05:20:04;82505495;82136165;369330;
25.01.2019;05:21:05;82505636;82136296;369340;
25.01.2019;05:22:04;82505776;82136401;369375;
25.01.2019;05:23:04;82505902;82136513;369389;
25.01.2019;05:24:04;82506030;82136647;369383;
25.01.2019;05:25:04;82506160;82136777;369383;
25.01.2019;05:26:05;82506297;82136903;369394;
25.01.2019;05:27:05;82506427;82137037;369390;
25.01.2019;05:28:05;82506568;82137170;369398;
25.01.2019;05:29:04;82506683;82137280;369403;
25.01.2019;05:30:05;82506814;82137410;369404;
25.01.2019;05:31:05;82506965;82137516;369449;
25.01.2019;05:32:04;82507099;82137626;369473;
25.01.2019;05:33:05;82507229;82137745;369484;
25.01.2019;05:34:04;82507341;82137869;369472;
25.01.2019;05:35:04;82507474;82137976;369498;
25.01.2019;05:36:05;82507598;82138087;369511;
25.01.2019;05:37:04;82507706;82138203;369503;
25.01.2019;05:38:04;82507843;82138313;369530;
25.01.2019;05:39:05;82507944;82138452;369492;
25.01.2019;05:40:04;82508066;82138547;369519;
25.01.2019;05:41:05;82508206;82138674;369532;
25.01.2019;05:42:04;82508342;82138786;369556;
25.01.2019;05:43:04;82508453;82138896;369557;
25.01.2019;05:44:05;82508580;82139007;369573;
25.01.2019;05:45:05;82508681;82139156;369525;
25.01.2019;05:46:09;82508798;82139313;369485;
25.01.2019;05:47:05;82508923;82139430;369493;
25.01.2019;05:48:04;82509038;82139571;369467;
25.01.2019;05:49:05;82509180;82139698;369482;
25.01.2019;05:50:04;82509289;82139811;369478;
25.01.2019;05:51:04;82509420;82139931;369489;
25.01.2019;05:52:05;82509558;82140058;369500;
25.01.2019;05:53:04;82509680;82140180;369500;
25.01.2019;05:54:04;82509810;82140289;369521;
25.01.2019;05:55:04;82509918;82140404;369514;
25.01.2019;05:56:04;82510068;82140514;369554;
25.01.2019;05:57:04;82510203;82140625;369578;
25.01.2019;05:58:05;82510328;82140723;369605;
25.01.2019;05:59:04;82510436;82140846;369590;
25.01.2019;06:00:04;82510544;82140957;369587;
25.01.2019;06:01:05;82510631;82141055;369576;
25.01.2019;06:02:04;82510725;82141180;369545;
25.01.2019;06:03:05;82510859;82141317;369542;
25.01.2019;06:04:04;82510973;82141461;369512;
25.01.2019;06:05:04;82511099;82141580;369519;
25.01.2019;06:06:05;82511213;82141718;369495;
25.01.2019;06:07:04;82511334;82141855;369479;
25.01.2019;06:08:04;82511448;82141981;369467;
25.01.2019;06:09:05;82511570;82142110;369460;
25.01.2019;06:10:05;82511672;82142216;369456;
25.01.2019;06:11:05;82511778;82142323;369455;
25.01.2019;06:12:05;82511908;82142421;369487;
25.01.2019;06:13:04;82512009;82142536;369473;
25.01.2019;06:14:04;82512123;82142640;369483;
25.01.2019;06:15:05;82512248;82142767;369481;
25.01.2019;06:16:04;82512348;82142864;369484;
25.01.2019;06:17:04;82512449;82142998;369451;
25.01.2019;06:18:05;82512516;82143126;369390;
25.01.2019;06:19:04;82512594;82143219;369375;
25.01.2019;06:20:04;82512669;82143323;369346;
25.01.2019;06:21:05;82512786;82143424;369362;
25.01.2019;06:22:04;82512887;82143531;369356;
25.01.2019;06:23:04;82512955;82143607;369348;
25.01.2019;06:24:05;82513024;82143716;369308;
25.01.2019;06:25:07;82513111;82143821;369290;
25.01.2019;06:26:05;82513186;82143935;369251;
25.01.2019;06:27:04;82513265;82144052;369213;
25.01.2019;06:28:04;82513363;82144147;369216;
25.01.2019;06:29:05;82513448;82144260;369188;
25.01.2019;06:30:09;82513542;82144377;369165;
25.01.2019;06:31:04;82513617;82144470;369147;
25.01.2019;06:32:05;82513708;82144582;369126;
25.01.2019;06:33:05;82513800;82144722;369078;
25.01.2019;06:34:04;82513887;82144818;369069;
25.01.2019;06:35:04;82513995;82144925;369070;
25.01.2019;06:36:04;82514093;82145036;369057;
25.01.2019;06:37:04;82514193;82145161;369032;
25.01.2019;06:38:05;82514301;82145276;369025;
25.01.2019;06:39:05;82514394;82145406;368988;
25.01.2019;06:40:04;82514487;82145516;368971;
25.01.2019;06:41:05;82514588;82145661;368927;
25.01.2019;06:42:05;82514688;82145768;368920;
25.01.2019;06:43:04;82514820;82145888;368932;
25.01.2019;06:44:04;82514909;82146024;368885;
25.01.2019;06:45:04;82515011;82146159;368852;
25.01.2019;06:46:05;82515110;82146293;368817;
25.01.2019;06:47:04;82515215;82146422;368793;
25.01.2019;06:48:05;82515314;82146571;368743;
25.01.2019;06:49:04;82515417;82146706;368711;
25.01.2019;06:50:04;82515524;82146820;368704;
25.01.2019;06:51:05;82515632;82146965;368667;
25.01.2019;06:52:04;82515741;82147104;368637;
25.01.2019;06:53:05;82515855;82147219;368636;
25.01.2019;06:54:05;82515954;82147354;368600;
25.01.2019;06:55:05;82516057;82147473;368584;
25.01.2019;06:56:06;82516133;82147628;368505;
25.01.2019;06:57:07;82516240;82147772;368468;
25.01.2019;06:58:04;82516331;82147905;368426;
25.01.2019;06:59:04;82516429;82148041;368388;
25.01.2019;07:00:04;82516544;82148178;368366;
25.01.2019;07:01:05;82516654;82148306;368348;
25.01.2019;07:02:05;82516753;82148443;368310;
25.01.2019;07:03:05;82516849;82148595;368254;
25.01.2019;07:04:05;82516965;82148741;368224;
25.01.2019;07:05:04;82517047;82148870;368177;
25.01.2019;07:06:05;82517150;82149007;368143;
25.01.2019;07:07:05;82517253;82149146;368107;
25.01.2019;07:08:06;82517298;82149276;368022;
25.01.2019;07:09:06;82517397;82149445;367952;
25.01.2019;07:10:05;82517497;82149599;367898;
25.01.2019;07:11:04;82517579;82149734;367845;
25.01.2019;07:12:04;82517674;82149877;367797;
25.01.2019;07:13:05;82517757;82150041;367716;
25.01.2019;07:14:04;82517848;82150223;367625;
25.01.2019;07:15:04;82517935;82150388;367547;
25.01.2019;07:16:04;82518024;82150529;367495;
25.01.2019;07:17:05;82518106;82150679;367427;
25.01.2019;07:18:05;82518212;82150830;367382;
25.01.2019;07:19:04;82518310;82151013;367297;
25.01.2019;07:20:04;82518418;82151157;367261;
25.01.2019;07:21:05;82518517;82151316;367201;
25.01.2019;07:22:05;82518605;82151461;367144;
25.01.2019;07:23:04;82518704;82151633;367071;
25.01.2019;07:24:04;82518790;82151801;366989;
25.01.2019;07:25:05;82518897;82151945;366952;
25.01.2019;07:26:05;82518996;82152095;366901;
25.01.2019;07:27:05;82519087;82152229;366858;
25.01.2019;07:28:05;82519181;82152370;366811;
25.01.2019;07:29:05;82519279;82152527;366752;
25.01.2019;07:30:04;82519382;82152694;366688;
25.01.2019;07:31:05;82519473;82152855;366618;
25.01.2019;07:32:05;82519546;82153008;366538;
25.01.2019;07:33:04;82519649;82153138;366511;
25.01.2019;07:34:04;82519729;82153317;366412;
25.01.2019;07:35:05;82519832;82153493;366339;
25.01.2019;07:36:04;82519925;82153650;366275;
25.01.2019;07:37:04;82520008;82153803;366205;
25.01.2019;07:38:05;82520090;82153977;366113;
25.01.2019;07:39:04;82520167;82154153;366014;
25.01.2019;07:40:04;82520240;82154318;365922;
25.01.2019;07:41:05;82520334;82154486;365848;
25.01.2019;07:42:04;82520417;82154627;365790;
25.01.2019;07:44:04;82520626;82154930;365696;
25.01.2019;07:45:05;82520723;82155066;365657;
25.01.2019;07:46:05;82520811;82155214;365597;
25.01.2019;07:47:05;82520915;82155363;365552;
25.01.2019;07:48:04;82520991;82155505;365486;
25.01.2019;07:49:05;82521093;82155663;365430;
25.01.2019;07:50:04;82521179;82155819;365360;
25.01.2019;07:51:04;82521261;82155975;365286;
25.01.2019;07:52:05;82521351;82156140;365211;
25.01.2019;07:53:04;82521447;82156328;365119;
25.01.2019;07:54:05;82521546;82156460;365086;
25.01.2019;07:55:05;82521643;82156631;365012;
25.01.2019;07:56:05;82521730;82156769;364961;
25.01.2019;07:57:04;82521817;82156913;364904;
25.01.2019;07:58:04;82521912;82157045;364867;
25.01.2019;07:59:05;82521994;82157206;364788;
25.01.2019;08:00:04;82522066;82157387;364679;
25.01.2019;08:01:05;82522143;82157543;364600;
25.01.2019;08:02:04;82522222;82157705;364517;
25.01.2019;08:03:04;82522304;82157876;364428;
25.01.2019;08:04:05;82522373;82158035;364338;
25.01.2019;08:05:05;82522452;82158193;364259;
25.01.2019;08:06:04;82522549;82158323;364226;
25.01.2019;08:07:06;82522664;82158468;364196;
25.01.2019;08:08:04;82522757;82158582;364175;
25.01.2019;08:09:04;82522838;82158732;364106;
25.01.2019;08:10:05;82522922;82158863;364059;
25.01.2019;08:11:05;82522995;82159017;363978;
25.01.2019;08:12:05;82523073;82159162;363911;
25.01.2019;08:13:04;82523143;82159284;363859;
25.01.2019;08:14:05;82523188;82159447;363741;
25.01.2019;08:15:04;82523252;82159574;363678;
25.01.2019;08:16:04;82523329;82159698;363631;
25.01.2019;08:17:05;82523400;82159825;363575;
25.01.2019;08:18:04;82523453;82159954;363499;
25.01.2019;08:19:05;82523470;82160111;363359;
25.01.2019;08:20:05;82523539;82160248;363291;
25.01.2019;08:21:05;82523584;82160395;363189;
25.01.2019;08:22:04;82523654;82160506;363148;
25.01.2019;08:23:05;82523703;82160625;363078;
25.01.2019;08:24:05;82523771;82160765;363006;
25.01.2019;08:25:05;82523825;82160924;362901;
25.01.2019;08:26:04;82523899;82161055;362844;
25.01.2019;08:27:04;82523963;82161198;362765;
25.01.2019;08:28:04;82524024;82161361;362663;
25.01.2019;08:29:04;82524112;82161503;362609;
25.01.2019;08:30:04;82524196;82161653;362543;
25.01.2019;08:31:04;82524287;82161782;362505;
25.01.2019;08:32:04;82524345;82161946;362399;
25.01.2019;08:33:05;82524429;82162074;362355;
25.01.2019;08:34:04;82524499;82162209;362290;
25.01.2019;08:35:05;82524574;82162328;362246;
25.01.2019;08:36:04;82524634;82162454;362180;
25.01.2019;08:37:04;82524694;82162629;362065;
25.01.2019;08:38:05;82524778;82162783;361995;
25.01.2019;08:39:04;82524864;82162925;361939;
25.01.2019;08:40:04;82524927;82163075;361852;
25.01.2019;08:41:05;82525005;82163213;361792;
25.01.2019;08:42:04;82525077;82163366;361711;
25.01.2019;08:43:04;82525136;82163501;361635;
25.01.2019;08:44:05;82525210;82163652;361558;
25.01.2019;08:45:04;82525294;82163792;361502;
25.01.2019;08:46:04;82525366;82163949;361417;
25.01.2019;08:47:05;82525424;82164091;361333;
25.01.2019;08:48:04;82525503;82164243;361260;
25.01.2019;08:49:05;82525583;82164383;361200;
25.01.2019;08:50:05;82525650;82164539;361111;
25.01.2019;08:51:04;82525713;82164707;361006;
25.01.2019;08:52:05;82525774;82164849;360925;
25.01.2019;08:53:04;82525844;82164998;360846;
25.01.2019;08:54:04;82525902;82165181;360721;
25.01.2019;08:55:04;82525982;82165314;360668;
25.01.2019;08:56:05;82526080;82165453;360627;
25.01.2019;08:57:04;82526157;82165615;360542;
25.01.2019;08:58:05;82526235;82165764;360471;
25.01.2019;08:59:04;82526313;82165924;360389;
25.01.2019;09:00:04;82526392;82166079;360313;
25.01.2019;09:01:05;82526461;82166242;360219;
25.01.2019;09:02:05;82526545;82166399;360146;
25.01.2019;09:03:04;82526604;82166554;360050;
25.01.2019;09:04:05;82526677;82166706;359971;
25.01.2019;09:05:05;82526744;82166848;359896;
25.01.2019;09:06:05;82526822;82167010;359812;
25.01.2019;09:07:05;82526899;82167176;359723;
25.01.2019;09:08:04;82526985;82167315;359670;
25.01.2019;09:09:06;82527064;82167451;359613;
25.01.2019;09:10:05;82527141;82167588;359553;
25.01.2019;09:11:04;82527215;82167738;359477;
25.01.2019;09:12:04;82527313;82167883;359430;
25.01.2019;09:13:04;82527385;82168077;359308;
25.01.2019;09:14:04;82527457;82168237;359220;
25.01.2019;09:15:05;82527558;82168397;359161;
25.01.2019;09:16:05;82527634;82168544;359090;
25.01.2019;09:17:05;82527709;82168696;359013;
25.01.2019;09:18:04;82527783;82168861;358922;
25.01.2019;09:19:04;82527853;82169002;358851;
25.01.2019;09:20:05;82527929;82169146;358783;
25.01.2019;09:21:04;82527994;82169306;358688;
25.01.2019;09:22:05;82528077;82169494;358583;
25.01.2019;09:23:05;82528158;82169634;358524;
25.01.2019;09:24:04;82528231;82169804;358427;
25.01.2019;09:25:05;82528312;82169966;358346;
25.01.2019;09:26:05;82528388;82170125;358263;
25.01.2019;09:27:05;82528474;82170284;358190;
25.01.2019;09:28:04;82528547;82170450;358097;
25.01.2019;09:29:05;82528609;82170613;357996;
25.01.2019;09:30:05;82528662;82170776;357886;
25.01.2019;09:31:04;82528713;82170943;357770;
25.01.2019;09:32:04;82528789;82171113;357676;
25.01.2019;09:33:05;82528859;82171244;357615;
25.01.2019;09:34:04;82528948;82171408;357540;
25.01.2019;09:35:04;82529008;82171559;357449;
25.01.2019;09:36:04;82529087;82171703;357384;
25.01.2019;09:37:04;82529154;82171855;357299;
25.01.2019;09:38:04;82529221;82172011;357210;
25.01.2019;09:39:07;82529299;82172151;357148;
25.01.2019;09:40:04;82529356;82172291;357065;
25.01.2019;09:41:05;82529428;82172436;356992;
25.01.2019;09:42:04;82529481;82172594;356887;
25.01.2019;09:43:09;82529550;82172774;356776;
25.01.2019;09:44:05;82529627;82172911;356716;
25.01.2019;09:45:04;82529697;82173076;356621;
25.01.2019;09:46:05;82529764;82173236;356528;
25.01.2019;09:47:05;82529833;82173390;356443;
25.01.2019;09:48:05;82529908;82173529;356379;
25.01.2019;09:49:04;82529969;82173677;356292;
25.01.2019;09:50:05;82530024;82173804;356220;
25.01.2019;09:51:04;82530083;82173976;356107;
25.01.2019;09:52:04;82530143;82174147;355996;
25.01.2019;09:53:05;82530163;82174235;355928;
25.01.2019;09:54:04;82530234;82174385;355849;
25.01.2019;09:55:04;82530296;82174572;355724;
25.01.2019;09:56:05;82530344;82174713;355631;
25.01.2019;09:57:04;82530386;82174864;355522;
25.01.2019;09:58:05;82530471;82175016;355455;
25.01.2019;09:59:04;82530527;82175159;355368;
25.01.2019;10:00:05;82530584;82175315;355269;
25.01.2019;10:01:04;82530653;82175475;355178;
25.01.2019;10:02:05;82530701;82175616;355085;
25.01.2019;10:03:04;82530767;82175742;355025;
25.01.2019;10:04:04;82530828;82175906;354922;
25.01.2019;10:05:05;82530888;82176069;354819;
25.01.2019;10:06:04;82530943;82176209;354734;
25.01.2019;10:07:05;82531012;82176334;354678;
25.01.2019;10:08:04;82531073;82176460;354613;
25.01.2019;10:09:04;82531141;82176607;354534;
25.01.2019;10:10:05;82531199;82176759;354440;
25.01.2019;10:11:05;82531256;82176896;354360;
25.01.2019;10:12:04;82531346;82177037;354309;
25.01.2019;10:13:04;82531390;82177166;354224;
25.01.2019;10:14:05;82531458;82177316;354142;
25.01.2019;10:15:04;82531505;82177473;354032;
25.01.2019;10:16:05;82531547;82177624;353923;
25.01.2019;10:17:05;82531596;82177754;353842;
25.01.2019;10:18:04;82531640;82177883;353757;
25.01.2019;10:19:05;82531671;82178015;353656;
25.01.2019;10:20:05;82531711;82178168;353543;
25.01.2019;10:21:05;82531751;82178317;353434;
25.01.2019;10:22:04;82531792;82178478;353314;
25.01.2019;10:23:04;82531835;82178627;353208;
25.01.2019;10:24:05;82531886;82178765;353121;
25.01.2019;10:25:04;82531940;82178907;353033;
25.01.2019;10:26:05;82531987;82179059;352928;
25.01.2019;10:27:05;82532025;82179166;352859;
25.01.2019;10:28:04;82532087;82179296;352791;
25.01.2019;10:29:04;82532136;82179444;352692;
25.01.2019;10:30:05;82532192;82179577;352615;
25.01.2019;10:31:05;82532246;82179714;352532;
25.01.2019;10:32:05;82532303;82179861;352442;
25.01.2019;10:33:04;82532376;82180011;352365;
25.01.2019;10:34:04;82532421;82180148;352273;
25.01.2019;10:35:05;82532474;82180287;352187;
25.01.2019;10:36:04;82532528;82180472;352056;
25.01.2019;10:37:05;82532584;82180631;351953;
25.01.2019;10:38:04;82532627;82180798;351829;
25.01.2019;10:39:04;82532679;82180977;351702;
25.01.2019;10:40:04;82532748;82181136;351612;
25.01.2019;10:41:10;82532804;82181314;351490;
25.01.2019;10:42:04;82532872;82181454;351418;
25.01.2019;10:43:04;82532937;82181585;351352;
25.01.2019;10:44:04;82532988;82181719;351269;
25.01.2019;10:45:05;82533059;82181892;351167;
25.01.2019;10:46:04;82533117;82182036;351081;
25.01.2019;10:47:05;82533178;82182203;350975;
25.01.2019;10:48:04;82533243;82182362;350881;
25.01.2019;10:49:04;82533292;82182504;350788;
25.01.2019;10:50:05;82533348;82182642;350706;
25.01.2019;10:51:04;82533408;82182799;350609;
25.01.2019;10:52:05;82533474;82182954;350520;
25.01.2019;10:53:04;82533547;82183110;350437;
25.01.2019;10:54:05;82533605;82183272;350333;
25.01.2019;10:55:04;82533655;82183401;350254;
25.01.2019;10:56:05;82533726;82183564;350162;
25.01.2019;10:57:04;82533792;82183726;350066;
25.01.2019;10:58:04;82533850;82183876;349974;
25.01.2019;10:59:05;82533926;82184037;349889;
25.01.2019;11:00:04;82533984;82184197;349787;
25.01.2019;11:01:05;82534040;82184369;349671;
25.01.2019;11:02:04;82534102;82184555;349547;
25.01.2019;11:03:05;82534163;82184706;349457;
25.01.2019;11:04:05;82534245;82184847;349398;
25.01.2019;11:05:04;82534298;82185003;349295;
25.01.2019;11:06:04;82534360;82185145;349215;
25.01.2019;11:07:05;82534439;82185285;349154;
25.01.2019;11:08:04;82534500;82185441;349059;
25.01.2019;11:09:05;82534561;82185589;348972;
25.01.2019;11:10:05;82534628;82185740;348888;
25.01.2019;11:11:04;82534698;82185897;348801;
25.01.2019;11:12:04;82534775;82186058;348717;
25.01.2019;11:13:05;82534847;82186232;348615;
25.01.2019;11:14:04;82534897;82186396;348501;
25.01.2019;11:15:05;82534958;82186576;348382;
25.01.2019;11:16:05;82535039;82186723;348316;
25.01.2019;11:17:05;82535104;82186877;348227;
25.01.2019;11:18:05;82535188;82187023;348165;
25.01.2019;11:19:04;82535252;82187161;348091;
25.01.2019;11:20:05;82535336;82187321;348015;
25.01.2019;11:21:05;82535400;82187460;347940;
25.01.2019;11:22:04;82535459;82187603;347856;
25.01.2019;11:23:05;82535519;82187758;347761;
25.01.2019;11:24:06;82535602;82187894;347708;
25.01.2019;11:25:04;82535654;82188023;347631;
25.01.2019;11:26:05;82535714;82188181;347533;
25.01.2019;11:27:05;82535796;82188319;347477;
25.01.2019;11:28:05;82535849;82188466;347383;
25.01.2019;11:29:04;82535912;82188638;347274;
25.01.2019;11:30:04;82535979;82188787;347192;
25.01.2019;11:31:05;82536037;82188922;347115;
25.01.2019;11:32:04;82536116;82189084;347032;
25.01.2019;11:33:04;82536195;82189250;346945;
25.01.2019;11:34:05;82536254;82189440;346814;
25.01.2019;11:35:04;82536324;82189576;346748;
25.01.2019;11:36:05;82536368;82189746;346622;
25.01.2019;11:37:05;82536442;82189929;346513;
25.01.2019;11:38:05;82536503;82190080;346423;
25.01.2019;11:39:06;82536581;82190241;346340;
25.01.2019;11:40:04;82536649;82190393;346256;
25.01.2019;11:41:04;82536712;82190569;346143;
25.01.2019;11:42:05;82536790;82190730;346060;
25.01.2019;11:43:05;82536856;82190897;345959;
25.01.2019;11:44:04;82536921;82191036;345885;
25.01.2019;11:45:04;82536991;82191201;345790;
25.01.2019;11:46:05;82537067;82191376;345691;
25.01.2019;11:47:05;82537131;82191530;345601;
25.01.2019;11:48:04;82537216;82191696;345520;
25.01.2019;11:49:05;82537288;82191843;345445;
25.01.2019;11:50:04;82537372;82192020;345352;
25.01.2019;11:51:04;82537437;82192166;345271;
25.01.2019;11:52:05;82537501;82192311;345190;
25.01.2019;11:53:04;82537572;82192504;345068;
25.01.2019;11:54:04;82537652;82192646;345006;
25.01.2019;11:55:05;82537724;82192791;344933;
25.01.2019;11:56:05;82537803;82192952;344851;
25.01.2019;11:57:04;82537875;82193105;344770;
25.01.2019;11:58:04;82537935;82193239;344696;
25.01.2019;11:59:05;82537995;82193403;344592;
25.01.2019;12:00:05;82538075;82193546;344529;
25.01.2019;12:01:04;82538124;82193691;344433;
25.01.2019;12:02:05;82538189;82193847;344342;
25.01.2019;12:03:04;82538260;82194010;344250;
25.01.2019;12:04:05;82538333;82194142;344191;
25.01.2019;12:05:05;82538409;82194276;344133;
25.01.2019;12:06:05;82538477;82194413;344064;
25.01.2019;12:07:04;82538541;82194570;343971;
25.01.2019;12:08:04;82538612;82194738;343874;
25.01.2019;12:09:05;82538688;82194873;343815;
25.01.2019;12:10:04;82538751;82194999;343752;
25.01.2019;12:11:05;82538821;82195144;343677;
25.01.2019;12:12:06;82538897;82195308;343589;
25.01.2019;12:13:04;82538961;82195420;343541;
25.01.2019;12:14:05;82539023;82195549;343474;
25.01.2019;12:15:04;82539056;82195687;343369;
25.01.2019;12:16:04;82539112;82195845;343267;
25.01.2019;12:17:05;82539171;82195952;343219;
25.01.2019;12:18:05;82539215;82196017;343198;
25.01.2019;12:19:05;82539240;82196106;343134;
25.01.2019;12:20:04;82539274;82196205;343069;
25.01.2019;12:21:04;82539308;82196331;342977;
25.01.2019;12:22:05;82539388;82196451;342937;
25.01.2019;12:23:05;82539467;82196595;342872;
25.01.2019;12:24:04;82539542;82196728;342814;
25.01.2019;12:25:04;82539624;82196876;342748;
25.01.2019;12:26:04;82539692;82197013;342679;
25.01.2019;12:27:05;82539771;82197140;342631;
25.01.2019;12:28:05;82539842;82197284;342558;
25.01.2019;12:29:04;82539901;82197431;342470;
25.01.2019;12:30:04;82539985;82197591;342394;
25.01.2019;12:31:04;82540071;82197742;342329;
25.01.2019;12:32:04;82540147;82197876;342271;
25.01.2019;12:33:05;82540228;82198043;342185;
25.01.2019;12:34:04;82540312;82198173;342139;
25.01.2019;12:35:04;82540394;82198345;342049;
25.01.2019;12:36:04;82540478;82198500;341978;
25.01.2019;12:37:05;82540569;82198670;341899;
25.01.2019;12:38:04;82540655;82198819;341836;
25.01.2019;12:39:05;82540729;82199002;341727;
25.01.2019;12:40:05;82540809;82199152;341657;
25.01.2019;12:41:05;82540908;82199309;341599;
25.01.2019;12:42:05;82540973;82199457;341516;
25.01.2019;12:43:05;82541051;82199603;341448;
25.01.2019;12:44:04;82541128;82199742;341386;
25.01.2019;12:45:05;82541204;82199913;341291;
25.01.2019;12:46:05;82541267;82200076;341191;
25.01.2019;12:47:09;82541355;82200236;341119;
25.01.2019;12:48:04;82541387;82200347;341040;
25.01.2019;12:49:04;82541461;82200513;340948;
25.01.2019;12:50:05;82541545;82200661;340884;
25.01.2019;12:51:04;82541619;82200826;340793;
25.01.2019;12:52:04;82541707;82201000;340707;
25.01.2019;12:53:05;82541779;82201185;340594;
25.01.2019;12:54:04;82541881;82201368;340513;
25.01.2019;12:55:04;82541966;82201513;340453;
25.01.2019;12:56:05;82542041;82201662;340379;
25.01.2019;12:57:04;82542118;82201802;340316;
25.01.2019;12:58:05;82542203;82201969;340234;
25.01.2019;12:59:05;82542291;82202137;340154;
25.01.2019;13:00:05;82542382;82202264;340118;
25.01.2019;13:01:05;82542494;82202408;340086;
25.01.2019;13:02:04;82542573;82202550;340023;
25.01.2019;13:03:05;82542631;82202738;339893;
25.01.2019;13:04:04;82542712;82202890;339822;
25.01.2019;13:05:04;82542796;82203042;339754;
25.01.2019;13:06:04;82542875;82203179;339696;
25.01.2019;13:07:09;82542973;82203348;339625;
25.01.2019;13:08:05;82543049;82203504;339545;
25.01.2019;13:09:05;82543141;82203640;339501;
25.01.2019;13:10:05;82543224;82203786;339438;
25.01.2019;13:11:04;82543330;82203936;339394;
25.01.2019;13:12:05;82543432;82204108;339324;
25.01.2019;13:13:05;82543520;82204277;339243;
25.01.2019;13:14:05;82543605;82204432;339173;
25.01.2019;13:15:05;82543715;82204558;339157;
25.01.2019;13:16:05;82543802;82204699;339103;
25.01.2019;13:17:05;82543894;82204852;339042;
25.01.2019;13:18:05;82543996;82204996;339000;
25.01.2019;13:19:04;82544067;82205180;338887;
25.01.2019;13:20:05;82544155;82205346;338809;
25.01.2019;13:21:05;82544250;82205521;338729;
25.01.2019;13:22:05;82544340;82205669;338671;
25.01.2019;13:23:04;82544427;82205830;338597;
25.01.2019;13:24:04;82544535;82205991;338544;
25.01.2019;13:25:05;82544610;82206177;338433;
25.01.2019;13:26:05;82544711;82206330;338381;
25.01.2019;13:27:04;82544818;82206496;338322;
25.01.2019;13:28:05;82544922;82206648;338274;
25.01.2019;13:29:05;82545023;82206809;338214;
25.01.2019;13:30:05;82545115;82206984;338131;
25.01.2019;13:31:04;82545231;82207133;338098;
25.01.2019;13:33:07;82545416;82207452;337964;
25.01.2019;13:34:04;82545507;82207597;337910;
25.01.2019;13:35:05;82545601;82207751;337850;
25.01.2019;13:36:05;82545702;82207877;337825;
25.01.2019;13:37:05;82545804;82208030;337774;
25.01.2019;13:38:05;82545901;82208191;337710;
25.01.2019;13:39:05;82546018;82208347;337671;
25.01.2019;13:40:05;82546114;82208491;337623;
25.01.2019;13:41:05;82546233;82208657;337576;
25.01.2019;13:42:04;82546325;82208823;337502;
25.01.2019;13:43:04;82546437;82209001;337436;
25.01.2019;13:44:05;82546576;82209159;337417;
25.01.2019;13:45:04;82546663;82209334;337329;
25.01.2019;13:46:04;82546773;82209480;337293;
25.01.2019;13:47:04;82546893;82209625;337268;
25.01.2019;13:48:05;82547014;82209804;337210;
25.01.2019;13:49:04;82547115;82209957;337158;
25.01.2019;13:50:04;82547200;82210107;337093;
25.01.2019;13:51:05;82547302;82210295;337007;
25.01.2019;13:52:05;82547389;82210466;336923;
25.01.2019;13:53:05;82547482;82210639;336843;
25.01.2019;13:54:05;82547604;82210785;336819;
25.01.2019;13:55:05;82547709;82210969;336740;
25.01.2019;13:56:05;82547839;82211134;336705;
25.01.2019;13:57:04;82547919;82211308;336611;
25.01.2019;13:58:05;82548059;82211513;336546;
25.01.2019;13:59:05;82548151;82211682;336469;
25.01.2019;14:00:05;82548259;82211854;336405;
25.01.2019;14:01:05;82548386;82211996;336390;
25.01.2019;14:02:04;82548512;82212184;336328;
25.01.2019;14:03:05;82548623;82212339;336284;
25.01.2019;14:04:05;82548725;82212495;336230;
25.01.2019;14:05:04;82548833;82212632;336201;
25.01.2019;14:06:04;82548925;82212842;336083;
25.01.2019;14:07:05;82549006;82213007;335999;
25.01.2019;14:08:05;82549117;82213174;335943;
25.01.2019;14:09:05;82549215;82213353;335862;
25.01.2019;14:10:05;82549331;82213521;335810;
25.01.2019;14:11:05;82549427;82213712;335715;
25.01.2019;14:12:04;82549515;82213874;335641;
25.01.2019;14:13:04;82549623;82214030;335593;
25.01.2019;14:14:05;82549745;82214204;335541;
25.01.2019;14:15:05;82549836;82214377;335459;
25.01.2019;14:16:04;82549961;82214583;335378;
25.01.2019;14:17:05;82550073;82214752;335321;
25.01.2019;14:18:05;82550197;82214897;335300;
25.01.2019;14:19:04;82550301;82215038;335263;
25.01.2019;14:20:04;82550368;82215202;335166;
25.01.2019;14:21:04;82550444;82215331;335113;
25.01.2019;14:22:04;82550529;82215465;335064;
25.01.2019;14:23:04;82550602;82215640;334962;
25.01.2019;14:24:05;82550678;82215822;334856;
25.01.2019;14:25:05;82550744;82215966;334778;
25.01.2019;14:27:05;82550913;82216273;334640;
25.01.2019;14:28:05;82551014;82216458;334556;
25.01.2019;14:29:04;82551098;82216640;334458;
25.01.2019;14:30:04;82551213;82216790;334423;
25.01.2019;14:31:04;82551300;82216943;334357;
25.01.2019;14:32:05;82551396;82217097;334299;
25.01.2019;14:33:05;82551489;82217241;334248;
25.01.2019;14:34:05;82551556;82217436;334120;
25.01.2019;14:35:04;82551668;82217582;334086;
25.01.2019;14:36:04;82551776;82217729;334047;
25.01.2019;14:37:05;82551886;82217892;333994;
25.01.2019;14:38:05;82551987;82218048;333939;
25.01.2019;14:39:11;82552132;82218251;333881;
25.01.2019;14:40:05;82552231;82218427;333804;
25.01.2019;14:41:04;82552350;82218606;333744;
25.01.2019;14:42:05;82552468;82218791;333677;
25.01.2019;14:43:05;82552568;82218956;333612;
25.01.2019;14:44:05;82552687;82219104;333583;
25.01.2019;14:45:05;82552783;82219255;333528;
25.01.2019;14:46:05;82552903;82219430;333473;
25.01.2019;14:47:05;82553011;82219610;333401;
25.01.2019;14:48:05;82553120;82219811;333309;
25.01.2019;14:49:05;82553235;82220004;333231;
25.01.2019;14:50:05;82553352;82220182;333170;
25.01.2019;14:51:04;82553454;82220374;333080;
25.01.2019;14:52:04;82553580;82220556;333024;
25.01.2019;14:53:05;82553681;82220732;332949;
25.01.2019;14:54:04;82553813;82220896;332917;
25.01.2019;14:55:04;82553929;82221067;332862;
25.01.2019;14:56:04;82554065;82221242;332823;
25.01.2019;14:57:05;82554162;82221401;332761;
25.01.2019;14:58:05;82554298;82221580;332718;
25.01.2019;14:59:05;82554399;82221779;332620;
25.01.2019;15:00:07;82554522;82221986;332536;
25.01.2019;15:01:07;82554642;82222157;332485;
25.01.2019;15:02:08;82554756;82222333;332423;
25.01.2019;15:03:08;82554878;82222514;332364;
25.01.2019;15:04:08;82555001;82222687;332314;
25.01.2019;15:05:08;82555136;82222865;332271;
25.01.2019;15:06:07;82555253;82223040;332213;
25.01.2019;15:07:08;82555369;82223195;332174;
25.01.2019;15:08:08;82555487;82223401;332086;
25.01.2019;15:09:08;82555622;82223532;332090;
25.01.2019;15:10:08;82555748;82223726;332022;
25.01.2019;15:11:13;82555902;82223909;331993;
25.01.2019;15:12:07;82555998;82224076;331922;
25.01.2019;15:13:07;82556132;82224258;331874;
25.01.2019;15:14:08;82556242;82224450;331792;
25.01.2019;15:16:08;82556512;82224833;331679;
25.01.2019;15:17:07;82556638;82225005;331633;
25.01.2019;15:18:07;82556781;82225209;331572;
25.01.2019;15:19:08;82556911;82225382;331529;
25.01.2019;15:20:08;82557048;82225575;331473;
25.01.2019;15:21:08;82557160;82225768;331392;
25.01.2019;15:22:08;82557290;82225907;331383;
25.01.2019;15:23:07;82557417;82226080;331337;
25.01.2019;15:24:07;82557532;82226262;331270;
25.01.2019;15:26:07;82557787;82226616;331171;
25.01.2019;15:27:08;82557930;82226792;331138;
25.01.2019;15:28:08;82558077;82226983;331094;
25.01.2019;15:29:08;82558204;82227165;331039;
25.01.2019;15:30:08;82558345;82227319;331026;
25.01.2019;15:31:08;82558459;82227494;330965;
25.01.2019;15:32:08;82558579;82227659;330920;
25.01.2019;15:33:07;82558717;82227870;330847;
25.01.2019;15:34:08;82558836;82228060;330776;
25.01.2019;15:35:08;82558976;82228256;330720;
25.01.2019;15:36:08;82559097;82228444;330653;
25.01.2019;15:37:08;82559205;82228614;330591;
25.01.2019;15:38:07;82559333;82228790;330543;
25.01.2019;15:39:10;82559463;82228991;330472;
25.01.2019;15:40:08;82559596;82229172;330424;
25.01.2019;15:41:08;82559718;82229353;330365;
25.01.2019;15:42:08;82559828;82229545;330283;
25.01.2019;15:43:08;82559945;82229705;330240;
25.01.2019;15:44:07;82560096;82229877;330219;
25.01.2019;15:45:07;82560209;82230058;330151;
25.01.2019;15:46:08;82560357;82230245;330112;
25.01.2019;15:47:07;82560488;82230387;330101;
25.01.2019;15:48:07;82560617;82230570;330047;
25.01.2019;15:49:09;82560743;82230747;329996;
25.01.2019;15:50:08;82560886;82230940;329946;
25.01.2019;15:51:07;82561007;82231113;329894;
25.01.2019;15:52:08;82561167;82231310;329857;
25.01.2019;15:53:08;82561280;82231500;329780;
25.01.2019;15:54:07;82561410;82231688;329722;
25.01.2019;15:55:07;82561550;82231859;329691;
25.01.2019;15:56:07;82561684;82232060;329624;
25.01.2019;15:57:08;82561797;82232255;329542;
25.01.2019;15:58:08;82561919;82232440;329479;
25.01.2019;15:59:07;82562047;82232640;329407;
25.01.2019;16:00:08;82562191;82232829;329362;
25.01.2019;16:01:05;82562327;82232986;329341;
25.01.2019;16:02:05;82562464;82233194;329270;
25.01.2019;16:03:05;82562588;82233399;329189;
25.01.2019;16:04:05;82562724;82233598;329126;
25.01.2019;16:05:05;82562861;82233794;329067;
25.01.2019;16:06:05;82563001;82233963;329038;
25.01.2019;16:07:04;82563134;82234129;329005;
25.01.2019;16:08:10;82563290;82234357;328933;
25.01.2019;16:09:05;82563401;82234534;328867;
25.01.2019;16:10:05;82563542;82234725;328817;
25.01.2019;16:11:05;82563703;82234910;328793;
25.01.2019;16:12:05;82563843;82235094;328749;
25.01.2019;16:13:04;82563957;82235296;328661;
25.01.2019;16:14:05;82564105;82235489;328616;
25.01.2019;16:15:04;82564241;82235675;328566;
25.01.2019;16:16:05;82564394;82235868;328526;
25.01.2019;16:17:05;82564528;82236066;328462;
25.01.2019;16:19:05;82564780;82236440;328340;
25.01.2019;18:46:05;82584188;82261154;323034;
25.01.2019;18:47:05;82584300;82261286;323014;
25.01.2019;18:48:05;82584396;82261422;322974;
25.01.2019;18:49:04;82584515;82261529;322986;
25.01.2019;18:50:04;82584617;82261651;322966;
25.01.2019;18:51:05;82584743;82261781;322962;
25.01.2019;18:52:05;82584847;82261932;322915;
25.01.2019;18:53:04;82584970;82262051;322919;
25.01.2019;18:54:04;82585108;82262169;322939;
25.01.2019;18:55:08;82585256;82262299;322957;
25.01.2019;18:56:04;82585379;82262429;322950;
25.01.2019;18:57:05;82585501;82262543;322958;
25.01.2019;18:58:04;82585623;82262649;322974;
25.01.2019;18:59:04;82585744;82262753;322991;
25.01.2019;19:00:04;82585867;82262894;322973;
25.01.2019;19:01:08;82585994;82263044;322950;
25.01.2019;19:02:06;82586011;82263086;322925;
25.01.2019;19:03:04;82586132;82263220;322912;
25.01.2019;19:04:04;82586255;82263338;322917;
25.01.2019;19:05:04;82586360;82263455;322905;
25.01.2019;19:06:05;82586483;82263587;322896;
25.01.2019;19:07:04;82586597;82263721;322876;
25.01.2019;19:08:06;82586783;82263860;322923;
25.01.2019;19:09:05;82586900;82263971;322929;
25.01.2019;19:10:05;82587037;82264079;322958;
25.01.2019;19:11:04;82587160;82264197;322963;
25.01.2019;19:12:04;82587258;82264311;322947;
25.01.2019;19:13:04;82587376;82264449;322927;
25.01.2019;19:14:07;82587517;82264562;322955;
25.01.2019;19:15:04;82587625;82264663;322962;
25.01.2019;19:16:05;82587780;82264787;322993;
25.01.2019;19:17:04;82587899;82264917;322982;
25.01.2019;19:18:05;82588035;82265040;322995;
25.01.2019;19:19:05;82588193;82265138;323055;
25.01.2019;19:20:04;82588338;82265242;323096;
25.01.2019;19:21:08;82588505;82265351;323154;
25.01.2019;19:22:05;82588652;82265437;323215;
25.01.2019;19:23:05;82588775;82265540;323235;
25.01.2019;19:24:04;82588902;82265651;323251;
25.01.2019;19:25:05;82589021;82265786;323235;
25.01.2019;19:26:05;82589154;82265899;323255;
25.01.2019;19:27:05;82589323;82265996;323327;
25.01.2019;19:28:06;82589458;82266124;323334;
25.01.2019;19:29:05;82589583;82266247;323336;
25.01.2019;19:30:05;82589706;82266338;323368;
25.01.2019;19:31:05;82589856;82266440;323416;
25.01.2019;19:32:04;82589976;82266539;323437;
25.01.2019;19:33:05;82590096;82266628;323468;
25.01.2019;19:34:07;82590243;82266739;323504;
25.01.2019;19:35:04;82590387;82266836;323551;
25.01.2019;19:36:04;82590525;82266936;323589;
25.01.2019;19:37:05;82590685;82267048;323637;
25.01.2019;19:38:05;82590807;82267129;323678;
25.01.2019;19:39:06;82590929;82267233;323696;
25.01.2019;19:40:04;82591040;82267311;323729;
25.01.2019;19:41:07;82591175;82267416;323759;
25.01.2019;19:42:05;82591319;82267504;323815;
25.01.2019;19:43:05;82591441;82267608;323833;
25.01.2019;19:44:05;82591584;82267695;323889;
25.01.2019;19:45:04;82591721;82267796;323925;
25.01.2019;19:46:04;82591843;82267892;323951;
25.01.2019;19:47:07;82591903;82267987;323916;
25.01.2019;19:48:05;82592001;82268070;323931;
25.01.2019;19:49:04;82592072;82268161;323911;
25.01.2019;19:50:04;82592168;82268268;323900;
25.01.2019;19:51:05;82592270;82268380;323890;
25.01.2019;19:52:05;82592349;82268480;323869;
25.01.2019;19:53:05;82592455;82268567;323888;
25.01.2019;19:54:07;82592554;82268643;323911;
25.01.2019;19:55:04;82592658;82268727;323931;
25.01.2019;19:56:04;82592775;82268826;323949;
25.01.2019;19:57:05;82592855;82268910;323945;
25.01.2019;19:58:04;82592928;82269008;323920;
25.01.2019;19:59:04;82593057;82269089;323968;
25.01.2019;20:00:08;82593172;82269189;323983;
25.01.2019;20:01:04;82593272;82269278;323994;
25.01.2019;20:02:04;82593391;82269373;324018;
25.01.2019;20:03:05;82593528;82269469;324059;
25.01.2019;20:04:04;82593628;82269550;324078;
25.01.2019;20:05:04;82593758;82269638;324120;
25.01.2019;20:06:06;82593873;82269737;324136;
25.01.2019;20:07:04;82593986;82269810;324176;
25.01.2019;20:08:04;82594099;82269893;324206;
25.01.2019;20:09:05;82594185;82269977;324208;
25.01.2019;20:10:05;82594305;82270060;324245;
25.01.2019;20:11:04;82594409;82270145;324264;
25.01.2019;20:12:04;82594534;82270218;324316;
25.01.2019;20:13:07;82594635;82270321;324314;
25.01.2019;20:14:04;82594758;82270397;324361;
25.01.2019;20:15:06;82594873;82270477;324396;
25.01.2019;20:16:04;82594988;82270554;324434;
25.01.2019;20:17:04;82595085;82270641;324444;
25.01.2019;20:18:05;82595174;82270732;324442;
25.01.2019;20:19:06;82595242;82270786;324456;
25.01.2019;20:20:04;82595316;82270843;324473;
25.01.2019;20:21:05;82595397;82270914;324483;
25.01.2019;20:22:04;82595464;82270969;324495;
25.01.2019;20:23:09;82595580;82271035;324545;
25.01.2019;20:24:05;82595648;82271098;324550;
25.01.2019;20:25:04;82595749;82271158;324591;
25.01.2019;20:26:07;82595831;82271205;324626;
25.01.2019;20:27:04;82595934;82271245;324689;
25.01.2019;20:28:05;82596009;82271318;324691;
25.01.2019;20:29:05;82596103;82271374;324729;
25.01.2019;20:30:05;82596206;82271427;324779;
25.01.2019;20:31:05;82596296;82271478;324818;
25.01.2019;20:32:06;82596384;82271562;324822;
25.01.2019;20:33:07;82596497;82271627;324870;
25.01.2019;20:34:05;82596591;82271684;324907;
25.01.2019;20:35:05;82596704;82271752;324952;
25.01.2019;20:36:06;82596803;82271816;324987;
25.01.2019;20:37:04;82596904;82271859;325045;
25.01.2019;20:38:04;82597024;82271934;325090;
25.01.2019;20:39:09;82597139;82272000;325139;
25.01.2019;20:40:06;82597233;82272047;325186;
25.01.2019;20:41:05;82597328;82272102;325226;
25.01.2019;20:42:07;82597456;82272176;325280;
25.01.2019;20:43:06;82597573;82272238;325335;
25.01.2019;20:44:06;82597689;82272287;325402;
25.01.2019;20:45:12;82597803;82272353;325450;
25.01.2019;20:46:11;82597895;82272412;325483;
25.01.2019;20:47:04;82597994;82272467;325527;
25.01.2019;20:48:05;82598093;82272537;325556;
25.01.2019;20:49:04;82598227;82272607;325620;
25.01.2019;20:50:05;82598378;82272663;325715;
25.01.2019;20:51:11;82598525;82272723;325802;
25.01.2019;20:52:04;82598629;82272780;325849;
25.01.2019;20:53:10;82598795;82272879;325916;
25.01.2019;20:54:05;82598934;82272929;326005;
25.01.2019;20:55:05;82599058;82272997;326061;
25.01.2019;20:56:04;82599210;82273051;326159;
25.01.2019;20:57:04;82599320;82273100;326220;
25.01.2019;20:58:14;82599472;82273180;326292;
25.01.2019;20:59:04;82599568;82273235;326333;
25.01.2019;21:00:04;82599693;82273294;326399;
25.01.2019;21:01:05;82599834;82273365;326469;
25.01.2019;21:02:05;82599991;82279400;320591;
25.01.2019;21:03:05;82600110;82279467;320643;
25.01.2019;21:04:08;82600250;82279523;320727;
25.01.2019;21:05:12;82600391;82279568;320823;
25.01.2019;21:06:07;82600520;82279612;320908;
25.01.2019;21:07:08;82600629;82279672;320957;
25.01.2019;21:08:10;82600747;82279744;321003;
25.01.2019;21:09:05;82600878;82279800;321078;
25.01.2019;21:10:05;82601018;82279858;321160;
25.01.2019;21:11:05;82601157;82279914;321243;
25.01.2019;21:12:05;82599691;82279980;319711;
25.01.2019;21:13:05;82599782;82280037;319745;
25.01.2019;21:14:34;82599992;82280116;319876;
25.01.2019;21:15:05;82600080;82280133;319947;
25.01.2019;21:16:05;82600200;82280181;320019;
25.01.2019;21:17:05;82600349;82280236;320113;
25.01.2019;21:18:09;82600475;82280292;320183;
25.01.2019;21:19:06;82600595;82280358;320237;
25.01.2019;21:20:07;82600738;82280410;320328;
25.01.2019;21:21:04;82600853;82280458;320395;
25.01.2019;21:22:08;82601021;82280520;320501;
25.01.2019;21:23:04;82601148;82280569;320579;
25.01.2019;21:24:07;82601282;82280612;320670;
25.01.2019;21:25:07;82601416;82280649;320767;
25.01.2019;21:26:07;82601543;82280707;320836;
25.01.2019;21:27:05;82601686;82280747;320939;
25.01.2019;21:28:05;82601836;82280807;321029;
25.01.2019;21:29:13;82601996;82280877;321119;
25.01.2019;21:30:05;82602122;82280927;321195;
25.01.2019;21:31:07;82602245;82280976;321269;
25.01.2019;21:32:06;82602358;82281033;321325;
25.01.2019;21:33:05;82602477;82281080;321397;
25.01.2019;21:34:04;82602617;82281129;321488;
25.01.2019;21:35:06;82602758;82281180;321578;
25.01.2019;21:36:05;82602891;82281233;321658;
25.01.2019;21:37:06;82603056;82281287;321769;
25.01.2019;21:38:04;82603172;82281346;321826;
25.01.2019;21:39:08;82603279;82281408;321871;
25.01.2019;21:40:04;82603409;82281455;321954;
25.01.2019;21:41:04;82603525;82281508;322017;
25.01.2019;21:42:05;82603663;82281544;322119;
25.01.2019;21:43:08;82603785;82281584;322201;
25.01.2019;21:44:04;82603878;82281633;322245;
25.01.2019;21:45:12;82604015;82281682;322333;
25.01.2019;21:46:06;82604098;82281726;322372;
25.01.2019;21:47:05;82604196;82281772;322424;
25.01.2019;21:48:05;82604351;82281820;322531;
25.01.2019;21:49:07;82604492;82281862;322630;
25.01.2019;21:50:04;82604668;82281898;322770;
25.01.2019;21:51:04;82604804;82281930;322874;
25.01.2019;21:52:06;82604943;82281981;322962;
25.01.2019;21:53:06;82605085;82282027;323058;
25.01.2019;21:55:07;82605365;82282107;323258;
25.01.2019;21:56:06;82605508;82282152;323356;
25.01.2019;21:57:04;82605639;82282190;323449;
25.01.2019;21:58:05;82605776;82282219;323557;
25.01.2019;21:59:08;82605928;82282254;323674;
25.01.2019;22:00:05;82606071;82282300;323771;
25.01.2019;22:01:05;82606205;82282338;323867;
25.01.2019;22:02:05;82606320;82282369;323951;
25.01.2019;22:03:04;82606454;82282401;324053;
25.01.2019;22:04:05;82606576;82282447;324129;
25.01.2019;22:05:04;82606712;82282487;324225;
25.01.2019;22:06:04;82606826;82282528;324298;
25.01.2019;22:07:11;82606958;82282555;324403;
25.01.2019;22:08:07;82607085;82282593;324492;
25.01.2019;22:09:05;82607228;82282614;324614;
25.01.2019;22:10:06;82607343;82282635;324708;
25.01.2019;22:11:04;82607479;82282671;324808;
25.01.2019;22:12:04;82607626;82282711;324915;
25.01.2019;22:13:04;82607691;82282699;324992;
25.01.2019;22:14:08;82607841;82282730;325111;
25.01.2019;22:17:05;82608197;82282858;325339;
25.01.2019;22:18:08;82608344;82282892;325452;
25.01.2019;22:19:05;82608487;82282922;325565;
25.01.2019;22:20:05;82608600;82282966;325634;
25.01.2019;22:21:05;82608740;82282992;325748;
25.01.2019;22:23:06;82608954;82283050;325904;
25.01.2019;22:24:06;82609078;82283080;325998;
25.01.2019;22:25:05;82609174;82283105;326069;
25.01.2019;22:26:04;82609271;82283125;326146;
25.01.2019;22:27:04;82609350;82283153;326197;
25.01.2019;22:28:04;82609442;82283181;326261;
25.01.2019;22:29:08;82609578;82283209;326369;
25.01.2019;22:30:04;82609677;82283236;326441;
25.01.2019;22:31:04;82609794;82283249;326545;
25.01.2019;22:32:05;82609920;82283278;326642;
25.01.2019;22:33:05;82610037;82283311;326726;
25.01.2019;22:34:05;82610146;82283342;326804;
25.01.2019;22:35:14;82610284;82283364;326920;
25.01.2019;22:36:05;82610397;82283380;327017;
25.01.2019;22:37:05;82610499;82283418;327081;
25.01.2019;22:38:06;82610618;82283433;327185;
25.01.2019;22:39:06;82610738;82283458;327280;
25.01.2019;22:40:04;82610841;82283472;327369;
25.01.2019;22:41:05;82610960;82283495;327465;
25.01.2019;22:42:07;82611094;82283526;327568;
25.01.2019;22:43:04;82611177;82283550;327627;
25.01.2019;22:44:05;82611299;82283586;327713;
25.01.2019;22:45:05;82611426;82283632;327794;
25.01.2019;22:46:05;82611510;82283659;327851;
25.01.2019;22:47:04;82611639;82283688;327951;
25.01.2019;22:48:05;82611759;82283731;328028;
25.01.2019;22:49:05;82611862;82283755;328107;
25.01.2019;22:51:05;82612083;82283830;328253;
25.01.2019;22:52:05;82612184;82283872;328312;
25.01.2019;22:53:05;82612318;82283891;328427;
25.01.2019;22:54:05;82612443;82283928;328515;
25.01.2019;22:55:05;82612560;82283968;328592;
25.01.2019;22:56:04;82612689;82284005;328684;
25.01.2019;22:57:05;82612813;82284043;328770;
25.01.2019;22:58:05;82612964;82284077;328887;
25.01.2019;22:59:04;82613094;82284113;328981;
25.01.2019;23:00:05;82613233;82284138;329095;
25.01.2019;23:01:15;82613385;82284185;329200;
25.01.2019;23:02:05;82613486;82284220;329266;
25.01.2019;23:03:05;82613581;82284258;329323;
25.01.2019;23:04:09;82613696;82284294;329402;
25.01.2019;23:05:04;82613792;82284320;329472;
25.01.2019;23:06:04;82613926;82284339;329587;
25.01.2019;23:07:05;82614044;82284366;329678;
25.01.2019;23:08:04;82614159;82284399;329760;
25.01.2019;23:09:04;82614291;82284425;329866;
25.01.2019;23:10:07;82614421;82284454;329967;
25.01.2019;23:11:04;82614553;82284480;330073;
25.01.2019;23:12:04;82614683;82284507;330176;
25.01.2019;23:13:04;82614806;82284527;330279;
25.01.2019;23:14:05;82614930;82284552;330378;
25.01.2019;23:15:04;82615053;82284592;330461;
25.01.2019;23:16:04;82615169;82284626;330543;
25.01.2019;23:17:08;82615303;82284663;330640;
25.01.2019;23:18:05;82615424;82284674;330750;
25.01.2019;23:19:05;82615538;82284702;330836;
25.01.2019;23:20:06;82615665;82284730;330935;
25.01.2019;23:21:04;82615782;82284748;331034;
25.01.2019;23:22:05;82615906;82284785;331121;
25.01.2019;23:23:07;82616049;82284815;331234;
25.01.2019;23:24:04;82616166;82284843;331323;
25.01.2019;23:25:04;82616284;82284872;331412;
25.01.2019;23:26:05;82616421;82284907;331514;
25.01.2019;23:27:05;82616510;82284935;331575;
25.01.2019;23:28:05;82616641;82284955;331686;
25.01.2019;23:29:05;82616715;82284986;331729;
25.01.2019;23:30:07;82616854;82285012;331842;
25.01.2019;23:31:04;82616967;82285048;331919;
25.01.2019;23:32:05;82617106;82285080;332026;
25.01.2019;23:33:04;82617222;82285116;332106;
25.01.2019;23:34:04;82617334;82285145;332189;
25.01.2019;23:35:05;82617461;82285166;332295;
25.01.2019;23:36:08;82617586;82285193;332393;
25.01.2019;23:37:05;82617713;82285225;332488;
25.01.2019;23:38:04;82617835;82285249;332586;
25.01.2019;23:39:04;82617967;82285261;332706;
25.01.2019;23:40:04;82618076;82285290;332786;
25.01.2019;23:41:05;82618221;82285317;332904;
25.01.2019;23:42:06;82618362;82285355;333007;
25.01.2019;23:43:04;82618471;82285395;333076;
25.01.2019;23:44:06;82618595;82285414;333181;
25.01.2019;23:45:04;82618731;82285444;333287;
25.01.2019;23:46:04;82618848;82285475;333373;
25.01.2019;23:47:05;82618983;82285507;333476;
25.01.2019;23:48:05;82619122;82285530;333592;
25.01.2019;23:49:08;82619249;82285560;333689;
25.01.2019;23:50:04;82619370;82285586;333784;
25.01.2019;23:51:06;82619485;82285609;333876;
25.01.2019;23:52:05;82619602;82285637;333965;
25.01.2019;23:53:04;82619709;82285673;334036;
25.01.2019;23:54:04;82619843;82285703;334140;
25.01.2019;23:55:07;82619992;82285739;334253;
25.01.2019;23:56:04;82620099;82285749;334350;
25.01.2019;23:57:04;82620230;82285783;334447;
25.01.2019;23:58:04;82620340;82285799;334541;
25.01.2019;23:59:05;82620471;82285823;334648;
26.01.2019;00:00:12;82620603;82285851;334752;
26.01.2019;00:01:13;82620740;82285873;334867;
26.01.2019;00:02:13;82620864;82285900;334964;
26.01.2019;00:03:11;82620963;82285926;335037;
26.01.2019;00:04:11;82621100;82285952;335148;
26.01.2019;00:05:13;82621191;82285971;335220;
26.01.2019;00:06:11;82621334;82285992;335342;
26.01.2019;00:07:11;82621453;82286010;335443;
26.01.2019;00:08:17;82621586;82286037;335549;
26.01.2019;00:09:10;82621683;82286062;335621;
26.01.2019;00:10:10;82621796;82286090;335706;
26.01.2019;00:11:10;82621932;82286108;335824;
26.01.2019;00:12:14;82622049;82286134;335915;
26.01.2019;00:13:11;82622180;82286163;336017;
26.01.2019;00:14:16;82622287;82286193;336094;
26.01.2019;00:15:13;82622398;82286212;336186;
26.01.2019;00:16:12;82622507;82286241;336266;
26.01.2019;00:17:14;82622610;82286263;336347;
26.01.2019;00:18:14;82622701;82286287;336414;
26.01.2019;00:19:13;82622777;82286308;336469;
26.01.2019;00:20:13;82622867;82286327;336540;
26.01.2019;00:21:15;82622973;82286338;336635;
26.01.2019;00:22:13;82623067;82286376;336691;
26.01.2019;00:23:14;82623164;82286384;336780;
26.01.2019;00:24:13;82623256;82286414;336842;
26.01.2019;00:25:14;82623361;82286448;336913;
26.01.2019;00:26:15;82623468;82286472;336996;
26.01.2019;00:27:15;82623548;82286499;337049;
26.01.2019;00:28:13;82623641;82286531;337110;
26.01.2019;00:29:16;82623726;82286555;337171;
26.01.2019;00:30:14;82623834;82286582;337252;
26.01.2019;00:31:14;82623927;82286627;337300;
26.01.2019;00:32:15;82624049;82286648;337401;
26.01.2019;00:33:14;82624145;82286665;337480;
26.01.2019;00:34:16;82624261;82286704;337557;
26.01.2019;00:35:20;82624376;82286724;337652;
26.01.2019;00:38:08;82624644;82286807;337837;
26.01.2019;00:39:10;82624740;82286834;337906;
26.01.2019;00:40:11;82624845;82286860;337985;
26.01.2019;00:41:15;82624995;82286892;338103;
26.01.2019;00:42:11;82625100;82286921;338179;
26.01.2019;00:43:17;82625218;82286949;338269;
26.01.2019;00:44:12;82625326;82286977;338349;
26.01.2019;00:45:12;82625425;82287009;338416;
26.01.2019;00:46:11;82625554;82287025;338529;
26.01.2019;00:47:10;82625660;82287047;338613;
26.01.2019;00:48:14;82625796;82287081;338715;
26.01.2019;00:49:10;82625923;82287105;338818;
26.01.2019;00:50:13;82626056;82287136;338920;
26.01.2019;00:51:14;82626190;82287167;339023;
26.01.2019;00:52:11;82626287;82287212;339075;
26.01.2019;00:53:11;82626422;82287240;339182;
26.01.2019;00:54:12;82626535;82287266;339269;
26.01.2019;00:55:15;82626676;82287301;339375;
26.01.2019;00:56:12;82626782;82287331;339451;
26.01.2019;00:57:10;82626916;82287368;339548;
26.01.2019;00:58:13;82627041;82287399;339642;
26.01.2019;00:59:10;82627127;82287429;339698;
26.01.2019;01:00:14;82627253;82287462;339791;
26.01.2019;01:01:09;82627348;82287480;339868;
26.01.2019;01:02:05;82627460;82287515;339945;
26.01.2019;01:03:11;82627580;82287546;340034;
26.01.2019;01:04:05;82627695;82287573;340122;
26.01.2019;01:05:06;82627819;82287598;340221;
26.01.2019;01:06:08;82627945;82287629;340316;
26.01.2019;01:07:05;82628041;82287651;340390;
26.01.2019;01:08:06;82628180;82287692;340488;
26.01.2019;01:09:05;82628306;82287713;340593;
26.01.2019;01:10:05;82628408;82287741;340667;
26.01.2019;01:11:06;82628526;82287780;340746;
26.01.2019;01:12:04;82628647;82287817;340830;
26.01.2019;01:13:07;82628756;82287855;340901;
26.01.2019;01:14:05;82628810;82287853;340957;
26.01.2019;01:15:06;82628920;82287884;341036;
26.01.2019;01:16:05;82629039;82287916;341123;
26.01.2019;01:17:05;82629154;82287957;341197;
26.01.2019;01:18:04;82629277;82287987;341290;
26.01.2019;01:19:08;82629398;82288023;341375;
26.01.2019;01:20:05;82629497;82288052;341445;
26.01.2019;01:21:04;82629613;82288084;341529;
26.01.2019;01:22:05;82629726;82288115;341611;
26.01.2019;01:23:06;82629838;82288151;341687;
26.01.2019;01:24:05;82629955;82288187;341768;
26.01.2019;01:25:05;82630065;82288226;341839;
26.01.2019;01:26:08;82630209;82288274;341935;
26.01.2019;01:27:11;82630321;82288311;342010;
26.01.2019;01:28:11;82630456;82288343;342113;
26.01.2019;01:29:04;82630554;82288369;342185;
26.01.2019;01:30:10;82630653;82288398;342255;
26.01.2019;01:31:12;82630772;82288421;342351;
26.01.2019;01:32:05;82630874;82288460;342414;
26.01.2019;01:33:04;82630984;82288493;342491;
26.01.2019;01:34:04;82631090;82288537;342553;
26.01.2019;01:35:05;82631218;82288569;342649;
26.01.2019;01:36:05;82631340;82288610;342730;
26.01.2019;01:37:10;82631439;82288649;342790;
26.01.2019;01:38:04;82631555;82288683;342872;
26.01.2019;01:39:05;82631662;82288717;342945;
26.01.2019;01:40:10;82631780;82288758;343022;
26.01.2019;01:41:06;82631887;82288782;343105;
26.01.2019;01:42:11;82631978;82288825;343153;
26.01.2019;01:43:06;82632066;82288857;343209;
26.01.2019;01:44:06;82632139;82288886;343253;
26.01.2019;01:45:04;82632224;82288930;343294;
26.01.2019;01:46:05;82632323;82288968;343355;
26.01.2019;01:47:12;82632442;82289009;343433;
26.01.2019;01:48:04;82632558;82289056;343502;
26.01.2019;01:49:05;82632669;82289098;343571;
26.01.2019;01:50:04;82632773;82289153;343620;
26.01.2019;01:51:07;82632894;82289204;343690;
26.01.2019;01:52:06;82632993;82289254;343739;
26.01.2019;01:53:05;82633096;82289293;343803;
26.01.2019;01:54:04;82633204;82289348;343856;
26.01.2019;01:55:04;82633306;82289394;343912;
26.01.2019;01:56:05;82633409;82289451;343958;
26.01.2019;01:57:05;82633515;82289507;344008;
26.01.2019;01:58:05;82633611;82289562;344049;
26.01.2019;01:59:04;82633717;82289604;344113;
26.01.2019;02:00:05;82633830;82289670;344160;
26.01.2019;02:01:05;82633925;82289728;344197;
26.01.2019;02:02:05;82634059;82289792;344267;
26.01.2019;02:03:06;82634174;82289856;344318;
26.01.2019;02:04:04;82634270;82289901;344369;
26.01.2019;02:05:04;82634383;82289959;344424;
26.01.2019;02:06:05;82634498;82290028;344470;
26.01.2019;02:07:05;82634612;82290074;344538;
26.01.2019;02:08:04;82634702;82290139;344563;
26.01.2019;02:09:05;82634800;82290197;344603;
26.01.2019;02:10:07;82634919;82290258;344661;
26.01.2019;02:11:04;82635007;82290325;344682;
26.01.2019;02:12:04;82635104;82290388;344716;
26.01.2019;02:13:05;82635193;82290448;344745;
26.01.2019;02:14:04;82635284;82290514;344770;
26.01.2019;02:15:05;82635379;82290566;344813;
26.01.2019;02:16:05;82635475;82290630;344845;
26.01.2019;02:17:04;82635576;82290699;344877;
26.01.2019;02:18:06;82635661;82290755;344906;
26.01.2019;02:19:05;82635766;82290819;344947;
26.01.2019;02:20:05;82635880;82290896;344984;
26.01.2019;02:21:04;82635946;82290948;344998;
26.01.2019;02:22:04;82636023;82290992;345031;
26.01.2019;02:23:06;82636105;82291056;345049;
26.01.2019;02:24:04;82636179;82291128;345051;
26.01.2019;02:25:05;82636263;82291195;345068;
26.01.2019;02:26:04;82636352;82291257;345095;
26.01.2019;02:27:04;82636446;82291328;345118;
26.01.2019;02:28:05;82636533;82291377;345156;
26.01.2019;02:29:05;82636634;82291458;345176;
26.01.2019;02:30:04;82636731;82291531;345200;
26.01.2019;02:31:04;82636812;82291593;345219;
26.01.2019;02:32:06;82636910;82291654;345256;
26.01.2019;02:33:05;82637023;82291727;345296;
26.01.2019;02:34:04;82637143;82291782;345361;
26.01.2019;02:35:05;82637244;82291847;345397;
26.01.2019;02:36:05;82637350;82291908;345442;
26.01.2019;02:37:10;82637456;82291974;345482;
26.01.2019;02:38:06;82637565;82292055;345510;
26.01.2019;02:39:06;82637668;82292123;345545;
26.01.2019;02:40:12;82637769;82292207;345562;
26.01.2019;02:41:04;82637857;82292265;345592;
26.01.2019;02:42:04;82637972;82292333;345639;
26.01.2019;02:43:06;82638069;82292400;345669;
26.01.2019;02:44:05;82638163;82292490;345673;
26.01.2019;02:45:06;82638280;82292563;345717;
26.01.2019;02:46:06;82638394;82292642;345752;
26.01.2019;02:47:10;82638512;82292702;345810;
26.01.2019;02:48:04;82638615;82292794;345821;
26.01.2019;02:49:10;82638722;82292872;345850;
26.01.2019;02:50:04;82638826;82292959;345867;
26.01.2019;02:51:05;82638931;82293035;345896;
26.01.2019;02:52:05;82639053;82293116;345937;
26.01.2019;02:53:04;82639171;82293178;345993;
26.01.2019;02:54:05;82639274;82293257;346017;
26.01.2019;02:55:10;82639371;82293341;346030;
26.01.2019;02:56:06;82639456;82293416;346040;
26.01.2019;02:57:05;82639573;82293513;346060;
26.01.2019;02:58:06;82639700;82293590;346110;
26.01.2019;02:59:06;82639825;82293674;346151;
26.01.2019;03:00:05;82639940;82293755;346185;
26.01.2019;03:01:06;82640053;82293862;346191;
26.01.2019;03:02:05;82640163;82293948;346215;
26.01.2019;03:03:11;82640278;82294039;346239;
26.01.2019;03:04:05;82640389;82294115;346274;
26.01.2019;03:05:06;82640529;82294187;346342;
26.01.2019;03:06:05;82640641;82294279;346362;
26.01.2019;03:07:10;82640769;82294355;346414;
26.01.2019;03:08:06;82640880;82294426;346454;
26.01.2019;03:09:12;82641020;82294532;346488;
26.01.2019;03:10:10;82641107;82294614;346493;
26.01.2019;03:11:05;82641202;82294707;346495;
26.01.2019;03:12:04;82641312;82294811;346501;
26.01.2019;03:13:05;82641413;82294889;346524;
26.01.2019;03:14:06;82641546;82294980;346566;
26.01.2019;03:15:05;82641685;82295068;346617;
26.01.2019;03:16:05;82641809;82295151;346658;
26.01.2019;03:17:10;82641941;82295234;346707;
26.01.2019;03:18:04;82642063;82295341;346722;
26.01.2019;03:19:06;82642166;82295456;346710;
26.01.2019;03:20:07;82642293;82295580;346713;
26.01.2019;03:21:07;82642431;82295675;346756;
26.01.2019;03:22:09;82642525;82295770;346755;
26.01.2019;03:23:11;82642647;82295856;346791;
26.01.2019;03:24:05;82642776;82295947;346829;
26.01.2019;03:25:11;82642906;82296055;346851;
26.01.2019;03:26:04;82643019;82296128;346891;
26.01.2019;03:27:04;82643147;82296235;346912;
26.01.2019;03:28:05;82643251;82296336;346915;
26.01.2019;03:29:10;82643383;82296442;346941;
26.01.2019;03:30:11;82643500;82296522;346978;
26.01.2019;03:31:06;82643606;82296610;346996;
26.01.2019;03:32:11;82643754;82296697;347057;
26.01.2019;03:33:05;82643859;82296798;347061;
26.01.2019;03:34:04;82643972;82296881;347091;
26.01.2019;03:35:06;82644074;82296981;347093;
26.01.2019;03:36:05;82644178;82297080;347098;
26.01.2019;03:37:10;82644309;82297190;347119;
26.01.2019;03:38:07;82644458;82297277;347181;
26.01.2019;03:39:08;82644581;82297388;347193;
26.01.2019;03:40:10;82644683;82297495;347188;
26.01.2019;03:41:06;82644809;82297576;347233;
26.01.2019;03:42:05;82644930;82297654;347276;
26.01.2019;03:43:04;82645050;82297731;347319;
26.01.2019;03:44:06;82645179;82297828;347351;
26.01.2019;03:45:05;82645297;82297937;347360;
26.01.2019;03:46:04;82645408;82298044;347364;
26.01.2019;03:47:06;82645513;82298138;347375;
26.01.2019;03:48:05;82645622;82298237;347385;
26.01.2019;03:49:05;82645744;82298348;347396;
26.01.2019;03:50:04;82645870;82298453;347417;
26.01.2019;03:51:05;82646003;82298569;347434;
26.01.2019;03:52:05;82646118;82298660;347458;
26.01.2019;03:53:05;82646238;82298768;347470;
26.01.2019;03:54:10;82646351;82298904;347447;
26.01.2019;03:55:05;82646489;82298997;347492;
26.01.2019;03:56:04;82646590;82299085;347505;
26.01.2019;03:57:06;82646729;82299186;347543;
26.01.2019;03:58:05;82646849;82299263;347586;
26.01.2019;03:59:04;82646980;82299353;347627;
26.01.2019;04:00:05;82647099;82299442;347657;
26.01.2019;04:01:05;82647211;82299545;347666;
26.01.2019;04:02:04;82647344;82299653;347691;
26.01.2019;04:03:05;82647489;82299772;347717;
26.01.2019;04:04:05;82647594;82299882;347712;
26.01.2019;04:05:06;82647709;82300002;347707;
26.01.2019;04:06:09;82647839;82300105;347734;
26.01.2019;04:07:05;82647945;82300218;347727;
26.01.2019;04:08:05;82648076;82300331;347745;
26.01.2019;04:09:06;82648219;82300469;347750;
26.01.2019;04:10:04;82648356;82300575;347781;
26.01.2019;04:11:04;82648488;82300676;347812;
26.01.2019;04:12:05;82648596;82300784;347812;
26.01.2019;04:13:05;82648712;82300897;347815;
26.01.2019;04:14:04;82648813;82300991;347822;
26.01.2019;04:15:06;82648916;82301094;347822;
26.01.2019;04:16:05;82649017;82301206;347811;
26.01.2019;04:17:05;82649089;82301294;347795;
26.01.2019;04:18:08;82649192;82301391;347801;
26.01.2019;04:19:04;82649292;82301500;347792;
26.01.2019;04:20:05;82649396;82301609;347787;
26.01.2019;04:21:06;82649522;82301714;347808;
26.01.2019;04:22:05;82649612;82301834;347778;
26.01.2019;04:23:06;82649733;82301941;347792;
26.01.2019;04:24:04;82649824;82302036;347788;
26.01.2019;04:25:05;82649945;82302149;347796;
26.01.2019;04:26:06;82650034;82302231;347803;
26.01.2019;04:27:06;82650140;82302349;347791;
26.01.2019;04:28:05;82650257;82302462;347795;
26.01.2019;04:29:04;82650362;82302595;347767;
26.01.2019;04:30:05;82650477;82302727;347750;
26.01.2019;04:31:05;82650586;82302846;347740;
26.01.2019;04:32:04;82650700;82302962;347738;
26.01.2019;04:33:05;82650819;82303084;347735;
26.01.2019;04:34:05;82650959;82303203;347756;
26.01.2019;04:35:05;82651061;82303311;347750;
26.01.2019;04:36:05;82651159;82303408;347751;
26.01.2019;04:37:06;82651280;82303502;347778;
26.01.2019;04:38:06;82651402;82303605;347797;
26.01.2019;04:39:11;82651511;82303733;347778;
26.01.2019;04:40:11;82651607;82303861;347746;
26.01.2019;04:41:09;82651717;82303973;347744;
26.01.2019;04:42:07;82651852;82304090;347762;
26.01.2019;04:43:04;82651972;82304212;347760;
26.01.2019;04:44:06;82652073;82304346;347727;
26.01.2019;04:45:06;82652188;82304467;347721;
26.01.2019;04:46:06;82652319;82304568;347751;
26.01.2019;04:47:06;82652430;82304669;347761;
26.01.2019;04:48:05;82652547;82304774;347773;
26.01.2019;04:49:05;82652659;82304910;347749;
26.01.2019;04:50:06;82652788;82305051;347737;
26.01.2019;04:51:04;82652922;82305191;347731;
26.01.2019;04:52:05;82653063;82305302;347761;
26.01.2019;04:53:05;82653173;82305410;347763;
26.01.2019;04:54:04;82653262;82305529;347733;
26.01.2019;04:55:06;82653376;82305638;347738;
26.01.2019;04:56:06;82653496;82305766;347730;
26.01.2019;04:57:06;82653621;82305866;347755;
26.01.2019;04:58:06;82653755;82305988;347767;
26.01.2019;04:59:04;82653861;82306098;347763;
26.01.2019;05:00:05;82653979;82306241;347738;
26.01.2019;05:01:04;82654114;82306363;347751;
26.01.2019;05:02:04;82654247;82306479;347768;
26.01.2019;05:03:05;82654377;82306608;347769;
26.01.2019;05:04:04;82654502;82306733;347769;
26.01.2019;05:05:04;82654615;82306849;347766;
26.01.2019;05:06:06;82654744;82306981;347763;
26.01.2019;05:07:05;82654862;82307107;347755;
26.01.2019;05:08:05;82654985;82307247;347738;
26.01.2019;05:09:05;82655094;82307397;347697;
26.01.2019;05:10:04;82655212;82307499;347713;
26.01.2019;05:11:04;82655344;82307598;347746;
26.01.2019;05:12:05;82655439;82307722;347717;
26.01.2019;05:13:04;82655523;82307839;347684;
26.01.2019;05:14:04;82655658;82307973;347685;
26.01.2019;05:15:07;82655766;82308096;347670;
26.01.2019;05:16:05;82655882;82308223;347659;
26.01.2019;05:17:04;82656001;82308369;347632;
26.01.2019;05:18:05;82656120;82308483;347637;
26.01.2019;05:19:04;82656223;82308603;347620;
26.01.2019;05:20:06;82656323;82308752;347571;
26.01.2019;05:21:05;82656435;82308859;347576;
26.01.2019;05:22:04;82656584;82308986;347598;
26.01.2019;05:23:04;82656688;82309103;347585;
26.01.2019;05:24:04;82656799;82309237;347562;
26.01.2019;05:25:05;82656896;82309378;347518;
26.01.2019;05:26:04;82657003;82309494;347509;
26.01.2019;05:27:04;82657114;82309609;347505;
26.01.2019;05:28:05;82657246;82309731;347515;
26.01.2019;05:29:04;82657351;82309861;347490;
26.01.2019;05:30:04;82657481;82309995;347486;
26.01.2019;05:31:05;82657596;82310135;347461;
26.01.2019;05:32:06;82657703;82310271;347432;
26.01.2019;05:33:08;82657826;82310402;347424;
26.01.2019;05:34:05;82657921;82310541;347380;
26.01.2019;05:35:05;82658021;82310678;347343;
26.01.2019;05:36:06;82658125;82310816;347309;
26.01.2019;05:37:06;82658222;82310962;347260;
26.01.2019;05:38:04;82658336;82311110;347226;
26.01.2019;05:39:04;82658449;82311237;347212;
26.01.2019;05:40:05;82658550;82311358;347192;
26.01.2019;05:41:06;82658650;82311492;347158;
26.01.2019;05:42:05;82658747;82311622;347125;
26.01.2019;05:43:06;82658873;82311754;347119;
26.01.2019;05:44:04;82658976;82311872;347104;
26.01.2019;05:45:05;82659089;82311995;347094;
26.01.2019;05:46:04;82659209;82312130;347079;
26.01.2019;05:47:05;82659314;82312285;347029;
26.01.2019;05:48:04;82659417;82312423;346994;
26.01.2019;05:49:04;82659529;82312556;346973;
26.01.2019;05:50:05;82659659;82312702;346957;
26.01.2019;05:51:04;82659785;82312867;346918;
26.01.2019;05:52:04;82659894;82313012;346882;
26.01.2019;05:53:05;82660015;82313130;346885;
26.01.2019;05:54:04;82660122;82313257;346865;
26.01.2019;05:55:04;82660230;82313384;346846;
26.01.2019;05:56:05;82660348;82313514;346834;
26.01.2019;05:57:04;82660446;82313647;346799;
26.01.2019;05:58:06;82660569;82313788;346781;
26.01.2019;05:59:06;82660676;82313925;346751;
26.01.2019;06:00:04;82660776;82314067;346709;
26.01.2019;06:01:06;82660877;82314203;346674;
26.01.2019;06:02:05;82660989;82314341;346648;
26.01.2019;06:03:06;82661096;82314457;346639;
26.01.2019;06:04:04;82661199;82314591;346608;
26.01.2019;06:05:05;82661307;82314734;346573;
26.01.2019;06:06:04;82661437;82314870;346567;
26.01.2019;06:07:05;82661559;82315006;346553;
26.01.2019;06:08:06;82661664;82315118;346546;
26.01.2019;06:09:06;82661779;82315261;346518;
26.01.2019;06:10:04;82661871;82315377;346494;
26.01.2019;06:11:05;82661959;82315489;346470;
26.01.2019;06:12:04;82662025;82315616;346409;
26.01.2019;06:13:04;82662077;82315754;346323;
26.01.2019;06:14:05;82662153;82315882;346271;
26.01.2019;06:15:04;82662221;82315973;346248;
26.01.2019;06:16:05;82662276;82316124;346152;
26.01.2019;06:17:05;82662352;82316258;346094;
26.01.2019;06:18:05;82662430;82316334;346096;
26.01.2019;06:19:04;82662517;82316464;346053;
26.01.2019;06:20:04;82662570;82316592;345978;
26.01.2019;06:21:05;82662661;82316708;345953;
26.01.2019;06:22:06;82662736;82316847;345889;
26.01.2019;06:23:07;82662831;82317004;345827;
26.01.2019;06:24:05;82662923;82317125;345798;
26.01.2019;06:25:07;82663031;82317243;345788;
26.01.2019;06:26:05;82663121;82317364;345757;
26.01.2019;06:27:04;82663222;82317493;345729;
26.01.2019;06:28:04;82663321;82317630;345691;
26.01.2019;06:29:05;82663411;82317762;345649;
26.01.2019;06:30:04;82663498;82317896;345602;
26.01.2019;06:31:04;82663598;82318034;345564;
26.01.2019;06:32:06;82663732;82318168;345564;
26.01.2019;06:33:05;82663844;82318310;345534;
26.01.2019;06:34:05;82663957;82318452;345505;
26.01.2019;06:35:04;82664049;82318603;345446;
26.01.2019;06:36:10;82664147;82318749;345398;
26.01.2019;06:37:06;82664251;82318879;345372;
26.01.2019;06:38:05;82664341;82319018;345323;
26.01.2019;06:39:07;82664435;82319174;345261;
26.01.2019;06:40:06;82664545;82319363;345182;
26.01.2019;06:41:10;82664640;82319507;345133;
26.01.2019;06:42:05;82664752;82319636;345116;
26.01.2019;06:43:04;82664841;82319767;345074;
26.01.2019;06:44:05;82664941;82319934;345007;
26.01.2019;06:45:06;82665052;82320080;344972;
26.01.2019;06:46:04;82665156;82320239;344917;
26.01.2019;06:47:04;82665264;82320382;344882;
26.01.2019;06:48:05;82665362;82320555;344807;
26.01.2019;06:49:04;82665453;82320724;344729;
26.01.2019;06:50:04;82665548;82320883;344665;
26.01.2019;06:51:05;82665644;82321025;344619;
26.01.2019;06:52:04;82665735;82321190;344545;
26.01.2019;06:53:05;82665821;82321348;344473;
26.01.2019;06:54:05;82665904;82321510;344394;
26.01.2019;06:55:04;82666011;82321680;344331;
26.01.2019;06:56:04;82666093;82321808;344285;
26.01.2019;06:57:05;82666167;82321961;344206;
26.01.2019;06:58:04;82666258;82322123;344135;
26.01.2019;06:59:04;82666350;82322291;344059;
26.01.2019;07:00:05;82666447;82322464;343983;
26.01.2019;07:01:05;82666545;82322613;343932;
26.01.2019;07:02:05;82666642;82322769;343873;
26.01.2019;07:03:06;82666722;82322918;343804;
26.01.2019;07:04:06;82666830;82323078;343752;
26.01.2019;07:05:04;82666930;82323236;343694;
26.01.2019;07:06:04;82667018;82323383;343635;
26.01.2019;07:07:05;82667071;82323508;343563;
26.01.2019;07:08:05;82667150;82323626;343524;
26.01.2019;07:09:05;82667235;82323759;343476;
26.01.2019;07:10:04;82667305;82323900;343405;
26.01.2019;07:11:04;82667376;82324023;343353;
26.01.2019;07:12:05;82667453;82324195;343258;
26.01.2019;07:13:04;82667534;82324341;343193;
26.01.2019;07:14:04;82667623;82324502;343121;
26.01.2019;07:15:05;82667723;82324673;343050;
26.01.2019;07:16:05;82667809;82324834;342975;
26.01.2019;07:17:06;82667914;82324972;342942;
26.01.2019;07:18:05;82667997;82325118;342879;
26.01.2019;07:19:05;82668075;82325254;342821;
26.01.2019;07:20:04;82668168;82325424;342744;
26.01.2019;07:21:05;82668271;82325582;342689;
26.01.2019;07:22:05;82668354;82325722;342632;
26.01.2019;07:23:05;82668439;82325870;342569;
26.01.2019;07:24:05;82668538;82326049;342489;
26.01.2019;07:25:04;82668624;82326215;342409;
26.01.2019;07:26:05;82668705;82326351;342354;
26.01.2019;07:27:05;82668780;82326489;342291;
26.01.2019;07:28:05;82668891;82326653;342238;
26.01.2019;07:29:04;82668988;82326809;342179;
26.01.2019;07:30:05;82669067;82326981;342086;
26.01.2019;07:31:05;82669162;82327123;342039;
26.01.2019;07:32:05;82669267;82327298;341969;
26.01.2019;07:33:05;82669339;82327450;341889;
26.01.2019;07:34:04;82669423;82327609;341814;
26.01.2019;07:35:05;82669507;82327757;341750;
26.01.2019;07:36:04;82669593;82327880;341713;
26.01.2019;07:37:04;82669674;82328033;341641;
26.01.2019;07:38:06;82669778;82328218;341560;
26.01.2019;07:39:05;82669871;82328398;341473;
26.01.2019;07:40:05;82669958;82328552;341406;
26.01.2019;07:41:04;82670032;82328731;341301;
26.01.2019;07:42:04;82670103;82328897;341206;
26.01.2019;07:43:05;82670197;82329057;341140;
26.01.2019;07:44:05;82670288;82329251;341037;
26.01.2019;07:45:05;82670373;82329424;340949;
26.01.2019;07:46:04;82670456;82329565;340891;
26.01.2019;07:47:05;82670536;82329706;340830;
26.01.2019;07:48:05;82670623;82329886;340737;
26.01.2019;07:49:04;82670716;82330042;340674;
26.01.2019;07:50:05;82670794;82330194;340600;
26.01.2019;07:51:05;82670886;82330346;340540;
26.01.2019;07:52:09;82670977;82330525;340452;
26.01.2019;07:53:05;82671065;82330685;340380;
26.01.2019;07:54:04;82671169;82330838;340331;
26.01.2019;07:55:05;82671253;82330989;340264;
26.01.2019;07:56:04;82671351;82331145;340206;
26.01.2019;07:57:05;82671429;82331319;340110;
26.01.2019;07:58:05;82671514;82331473;340041;
26.01.2019;07:59:04;82671593;82331625;339968;
26.01.2019;08:00:05;82671690;82331769;339921;
26.01.2019;08:01:04;82671794;82331946;339848;
26.01.2019;08:02:04;82671889;82332107;339782;
26.01.2019;08:03:04;82671976;82332289;339687;
26.01.2019;08:04:05;82672064;82332445;339619;
26.01.2019;08:05:05;82672151;82332580;339571;
26.01.2019;08:06:04;82672254;82332752;339502;
26.01.2019;08:07:05;82672343;82332908;339435;
26.01.2019;08:08:05;82672421;82333038;339383;
26.01.2019;08:09:06;82672500;82333175;339325;
26.01.2019;08:10:05;82672583;82333338;339245;
26.01.2019;08:11:05;82672668;82333513;339155;
26.01.2019;08:12:04;82672743;82333672;339071;
26.01.2019;08:13:04;82672809;82333808;339001;
26.01.2019;08:14:05;82672868;82333938;338930;
26.01.2019;08:15:04;82672909;82334076;338833;
26.01.2019;08:16:04;82672942;82334204;338738;
26.01.2019;08:17:05;82672968;82334337;338631;
26.01.2019;08:18:04;82673035;82334482;338553;
26.01.2019;08:19:04;82673071;82334629;338442;
26.01.2019;08:20:04;82673119;82334779;338340;
26.01.2019;08:21:05;82673192;82334926;338266;
26.01.2019;08:22:04;82673252;82335100;338152;
26.01.2019;08:23:05;82673328;82335233;338095;
26.01.2019;08:24:05;82673392;82335398;337994;
26.01.2019;08:25:05;82673475;82335528;337947;
26.01.2019;08:26:06;82673544;82335707;337837;
26.01.2019;08:27:05;82673624;82335844;337780;
26.01.2019;08:28:07;82673707;82336025;337682;
26.01.2019;08:29:05;82673790;82336141;337649;
26.01.2019;08:30:04;82673866;82336302;337564;
26.01.2019;08:31:04;82673947;82336447;337500;
26.01.2019;08:32:05;82674013;82336599;337414;
26.01.2019;08:33:05;82674083;82336750;337333;
26.01.2019;08:34:04;82674166;82336905;337261;
26.01.2019;08:35:04;82674243;82337033;337210;
26.01.2019;08:36:06;82674318;82337188;337130;
26.01.2019;08:37:05;82674410;82337352;337058;
26.01.2019;08:38:05;82674489;82337512;336977;
26.01.2019;08:39:06;82674573;82337676;336897;
26.01.2019;08:40:05;82674659;82337826;336833;
26.01.2019;08:41:04;82674730;82337968;336762;
26.01.2019;08:42:04;82674818;82338116;336702;
26.01.2019;08:43:05;82674898;82338275;336623;
26.01.2019;08:44:05;82674987;82338424;336563;
26.01.2019;08:45:06;82675081;82338577;336504;
26.01.2019;08:46:05;82675173;82338715;336458;
26.01.2019;08:47:05;82675237;82338850;336387;
26.01.2019;08:48:04;82675315;82338978;336337;
26.01.2019;08:49:04;82675392;82339137;336255;
26.01.2019;08:50:04;82675468;82339284;336184;
26.01.2019;08:51:05;82675552;82339428;336124;
26.01.2019;08:52:05;82675630;82339591;336039;
26.01.2019;08:53:04;82675706;82339742;335964;
26.01.2019;08:54:05;82675755;82339895;335860;
26.01.2019;08:55:05;82675841;82340026;335815;
26.01.2019;08:56:05;82675918;82340171;335747;
26.01.2019;08:57:04;82676007;82340345;335662;
26.01.2019;08:58:04;82676105;82340505;335600;
26.01.2019;08:59:06;82676175;82340685;335490;
26.01.2019;09:00:05;82676273;82340847;335426;
26.01.2019;09:01:05;82676344;82341029;335315;
26.01.2019;09:02:04;82676438;82341166;335272;
26.01.2019;09:03:04;82676523;82341325;335198;
26.01.2019;09:04:05;82676586;82341492;335094;
26.01.2019;09:05:04;82676659;82341650;335009;
26.01.2019;09:06:05;82676730;82341815;334915;
26.01.2019;09:07:05;82676792;82341962;334830;
26.01.2019;09:08:06;82676874;82342139;334735;
26.01.2019;09:09:06;82676959;82342282;334677;
26.01.2019;09:10:10;82677048;82342454;334594;
26.01.2019;09:11:04;82677098;82342599;334499;
26.01.2019;09:12:05;82677185;82342717;334468;
26.01.2019;09:13:05;82677273;82342849;334424;
26.01.2019;09:14:05;82677351;82343002;334349;
26.01.2019;09:15:06;82677440;82343168;334272;
26.01.2019;09:16:07;82677525;82343338;334187;
26.01.2019;09:17:05;82677597;82343501;334096;
26.01.2019;09:18:07;82677668;82343672;333996;
26.01.2019;09:19:09;82677740;82343821;333919;
26.01.2019;09:20:04;82677811;82343964;333847;
26.01.2019;09:21:11;82677890;82344130;333760;
26.01.2019;09:22:05;82677972;82344270;333702;
26.01.2019;09:23:05;82678036;82344420;333616;
26.01.2019;09:24:10;82678106;82344615;333491;
26.01.2019;09:25:06;82678194;82344755;333439;
26.01.2019;09:26:05;82678287;82344869;333418;
26.01.2019;09:27:13;82678365;82345042;333323;
26.01.2019;09:28:04;82678443;82345184;333259;
26.01.2019;09:29:05;82678534;82345352;333182;
26.01.2019;09:30:06;82678607;82345509;333098;
26.01.2019;09:31:05;82678680;82345680;333000;
26.01.2019;09:32:04;82678745;82345843;332902;
26.01.2019;09:33:06;82678826;82345985;332841;
26.01.2019;09:34:13;82678905;82346166;332739;
26.01.2019;09:35:05;82678957;82346291;332666;
26.01.2019;09:36:04;82679051;82346439;332612;
26.01.2019;09:37:04;82679127;82346578;332549;
26.01.2019;09:38:05;82679206;82346736;332470;
26.01.2019;09:39:05;82679289;82346892;332397;
26.01.2019;09:40:15;82679364;82347083;332281;
26.01.2019;09:41:05;82679435;82347229;332206;
26.01.2019;09:42:06;82679518;82347363;332155;
26.01.2019;09:43:04;82679584;82347503;332081;
26.01.2019;09:44:05;82679663;82347645;332018;
26.01.2019;09:45:05;82679727;82347797;331930;
26.01.2019;09:46:06;82679795;82347966;331829;
26.01.2019;09:47:06;82679877;82348117;331760;
26.01.2019;09:48:07;82679956;82348282;331674;
26.01.2019;09:49:08;82680047;82348446;331601;
26.01.2019;09:50:10;82680114;82348591;331523;
26.01.2019;09:51:06;82680193;82348724;331469;
26.01.2019;09:52:05;82680283;82348877;331406;
26.01.2019;09:53:09;82680360;82349044;331316;
26.01.2019;09:54:06;82680437;82349182;331255;
26.01.2019;09:55:12;82680524;82349373;331151;
26.01.2019;09:56:11;82680612;82349542;331070;
26.01.2019;09:57:05;82680692;82349688;331004;
26.01.2019;09:58:06;82680785;82349857;330928;
26.01.2019;09:59:05;82680874;82350007;330867;
26.01.2019;10:00:04;82680945;82350180;330765;
26.01.2019;10:01:05;82681020;82350334;330686;
26.01.2019;10:02:10;82681108;82350496;330612;
26.01.2019;10:03:05;82681155;82350629;330526;
26.01.2019;10:04:06;82681196;82350760;330436;
26.01.2019;10:05:05;82681264;82350917;330347;
26.01.2019;10:06:05;82681322;82351053;330269;
26.01.2019;10:07:04;82681405;82351218;330187;
26.01.2019;10:08:08;82681482;82351352;330130;
26.01.2019;10:09:12;82681567;82351533;330034;
26.01.2019;10:10:10;82681655;82351676;329979;
26.01.2019;10:11:05;82681729;82351807;329922;
26.01.2019;10:12:04;82681802;82351979;329823;
26.01.2019;10:13:04;82681881;82352135;329746;
26.01.2019;10:14:06;82681914;82352297;329617;
26.01.2019;10:15:04;82681969;82352435;329534;
26.01.2019;10:16:06;82682032;82352567;329465;
26.01.2019;10:17:06;82682087;82352712;329375;
26.01.2019;10:18:05;82682136;82352833;329303;
26.01.2019;10:19:04;82682196;82352970;329226;
26.01.2019;10:20:04;82682248;82353103;329145;
26.01.2019;10:21:05;82682309;82353278;329031;
26.01.2019;10:22:04;82682375;82353417;328958;
26.01.2019;10:23:05;82682423;82353572;328851;
26.01.2019;10:24:05;82682483;82353751;328732;
26.01.2019;10:25:05;82682561;82353921;328640;
26.01.2019;10:26:06;82682633;82354067;328566;
26.01.2019;10:27:07;82682716;82354229;328487;
26.01.2019;10:28:07;82682766;82354371;328395;
26.01.2019;10:29:06;82682838;82354528;328310;
26.01.2019;10:30:04;82682910;82354684;328226;
26.01.2019;10:31:06;82682974;82354875;328099;
26.01.2019;10:32:07;82683057;82355052;328005;
26.01.2019;10:33:05;82683106;82355192;327914;
26.01.2019;10:34:07;82683198;82355366;327832;
26.01.2019;10:35:04;82683273;82355515;327758;
26.01.2019;10:36:05;82683345;82355675;327670;
26.01.2019;10:37:07;82683425;82355839;327586;
26.01.2019;10:38:06;82683512;82355997;327515;
26.01.2019;10:39:07;82683609;82356142;327467;
26.01.2019;10:40:04;82683667;82356279;327388;
26.01.2019;10:41:04;82683757;82356457;327300;
26.01.2019;10:42:05;82683826;82356588;327238;
26.01.2019;10:43:05;82683922;82356731;327191;
26.01.2019;10:44:04;82684005;82356890;327115;
26.01.2019;10:45:04;82684080;82357034;327046;
26.01.2019;10:46:05;82684146;82357183;326963;
26.01.2019;10:47:04;82684229;82357330;326899;
26.01.2019;10:48:06;82684300;82357504;326796;
26.01.2019;10:49:04;82684378;82357674;326704;
26.01.2019;10:50:04;82684447;82357843;326604;
26.01.2019;10:51:05;82684519;82358000;326519;
26.01.2019;10:52:05;82684592;82358142;326450;
26.01.2019;10:53:04;82684665;82358279;326386;
26.01.2019;10:54:04;82684746;82358421;326325;
26.01.2019;10:55:05;82684816;82358587;326229;
26.01.2019;10:56:04;82684893;82358738;326155;
26.01.2019;10:57:04;82684971;82358887;326084;
26.01.2019;10:58:05;82685053;82359063;325990;
26.01.2019;10:59:04;82685145;82359233;325912;
26.01.2019;11:00:04;82685226;82359403;325823;
26.01.2019;11:01:05;82685305;82359559;325746;
26.01.2019;11:02:04;82685387;82359697;325690;
26.01.2019;11:03:05;82685463;82359869;325594;
26.01.2019;11:04:04;82685543;82360032;325511;
26.01.2019;11:05:04;82685635;82360194;325441;
26.01.2019;11:06:05;82685725;82360339;325386;
26.01.2019;11:07:06;82685801;82360481;325320;
26.01.2019;11:08:05;82685880;82360605;325275;
26.01.2019;11:09:11;82685968;82360788;325180;
26.01.2019;11:10:04;82686040;82360948;325092;
26.01.2019;11:11:05;82686114;82361104;325010;
26.01.2019;11:12:07;82686181;82361268;324913;
26.01.2019;11:13:05;82686263;82361382;324881;
26.01.2019;11:14:05;82686338;82361544;324794;
26.01.2019;11:15:05;82686417;82361708;324709;
26.01.2019;11:16:04;82686504;82361859;324645;
26.01.2019;11:17:04;82686580;82362014;324566;
26.01.2019;11:18:05;82686651;82362183;324468;
26.01.2019;11:19:04;82686726;82362329;324397;
26.01.2019;11:20:05;82686818;82362483;324335;
26.01.2019;11:21:05;82686904;82362644;324260;
26.01.2019;11:22:04;82686991;82362795;324196;
26.01.2019;11:23:04;82687060;82362958;324102;
26.01.2019;11:24:05;82687141;82363106;324035;
26.01.2019;11:25:04;82687222;82363268;323954;
26.01.2019;11:26:04;82687287;82363420;323867;
26.01.2019;11:27:05;82687379;82363566;323813;
26.01.2019;11:28:04;82687441;82363724;323717;
26.01.2019;11:29:04;82687495;82363882;323613;
26.01.2019;11:30:05;82687596;82364036;323560;
26.01.2019;11:31:05;82687697;82364235;323462;
26.01.2019;11:32:05;82687757;82364389;323368;
26.01.2019;11:33:04;82687843;82364535;323308;
26.01.2019;11:34:04;82687918;82364681;323237;
26.01.2019;11:35:05;82688002;82364861;323141;
26.01.2019;11:36:04;82688102;82365014;323088;
26.01.2019;11:37:04;82688172;82365169;323003;
26.01.2019;11:38:05;82688252;82365348;322904;
26.01.2019;11:39:05;82688329;82365525;322804;
26.01.2019;11:40:04;82688404;82365673;322731;
26.01.2019;11:41:04;82688516;82365828;322688;
26.01.2019;11:42:05;82688606;82365975;322631;
26.01.2019;11:43:05;82688703;82366142;322561;
26.01.2019;11:44:04;82688787;82366320;322467;
26.01.2019;11:45:06;82688887;82366477;322410;
26.01.2019;11:46:04;82688971;82366654;322317;
26.01.2019;11:47:05;82689053;82366796;322257;
26.01.2019;11:48:04;82689135;82366961;322174;
26.01.2019;11:49:04;82689213;82367123;322090;
26.01.2019;11:50:08;82689331;82367315;322016;
26.01.2019;11:51:05;82689417;82367465;321952;
26.01.2019;11:52:05;82689508;82367636;321872;
26.01.2019;11:53:04;82689594;82367806;321788;
26.01.2019;11:54:04;82689660;82367961;321699;
26.01.2019;11:55:05;82689724;82368100;321624;
26.01.2019;11:56:05;82689810;82368231;321579;
26.01.2019;11:57:06;82689892;82368383;321509;
26.01.2019;11:58:04;82689965;82368539;321426;
26.01.2019;11:59:04;82690053;82368686;321367;
26.01.2019;12:00:05;82690133;82368849;321284;
26.01.2019;12:01:04;82690220;82369007;321213;
26.01.2019;12:02:05;82690305;82369153;321152;
26.01.2019;12:03:08;82690397;82369307;321090;
26.01.2019;12:04:04;82690463;82369457;321006;
26.01.2019;12:05:04;82690546;82369595;320951;
26.01.2019;12:06:05;82690623;82369742;320881;
26.01.2019;12:07:04;82690704;82369907;320797;
26.01.2019;12:08:04;82690794;82370045;320749;
26.01.2019;12:09:08;82690880;82370234;320646;
26.01.2019;12:10:05;82690972;82370387;320585;
26.01.2019;12:11:04;82691066;82370549;320517;
26.01.2019;12:12:04;82691121;82370684;320437;
26.01.2019;12:13:05;82691185;82370805;320380;
26.01.2019;12:14:04;82691254;82370958;320296;
26.01.2019;12:15:05;82691323;82371065;320258;
26.01.2019;12:16:08;82691368;82371187;320181;
26.01.2019;12:17:05;82691443;82371316;320127;
26.01.2019;12:18:04;82691485;82371420;320065;
26.01.2019;12:19:04;82691536;82371546;319990;
26.01.2019;12:20:05;82691607;82371704;319903;
26.01.2019;12:21:04;82691695;82371855;319840;
26.01.2019;12:22:06;82691754;82372011;319743;
26.01.2019;12:23:04;82691833;82372147;319686;
26.01.2019;12:24:05;82691909;82372288;319621;
26.01.2019;12:25:04;82691996;82372442;319554;
26.01.2019;12:26:04;82692075;82372593;319482;
26.01.2019;12:27:05;82692175;82372769;319406;
26.01.2019;12:28:05;82692261;82372916;319345;
26.01.2019;12:29:07;82692338;82373068;319270;
26.01.2019;12:30:05;82692418;82373221;319197;
26.01.2019;12:31:04;82692506;82373364;319142;
26.01.2019;12:32:05;82692573;82373533;319040;
26.01.2019;12:33:05;82692660;82373720;318940;
26.01.2019;12:34:04;82692724;82373848;318876;
26.01.2019;12:35:10;82692809;82373985;318824;
26.01.2019;12:36:07;82692907;82374120;318787;
26.01.2019;12:37:04;82692989;82374263;318726;
26.01.2019;12:38:04;82693067;82374416;318651;
26.01.2019;12:39:08;82693157;82374614;318543;
26.01.2019;12:40:04;82693226;82374780;318446;
26.01.2019;12:41:04;82693293;82374905;318388;
26.01.2019;12:42:06;82693370;82375045;318325;
26.01.2019;12:43:04;82693450;82375207;318243;
26.01.2019;12:44:05;82693563;82375379;318184;
26.01.2019;12:45:05;82693648;82375532;318116;
26.01.2019;12:46:05;82693738;82375685;318053;
26.01.2019;12:47:05;82693819;82375843;317976;
26.01.2019;12:48:04;82693889;82375990;317899;
26.01.2019;12:49:07;82693990;82376156;317834;
26.01.2019;12:50:05;82694071;82376305;317766;
26.01.2019;12:51:05;82694156;82376447;317709;
26.01.2019;12:52:04;82694242;82376588;317654;
26.01.2019;12:53:04;82694327;82376720;317607;
26.01.2019;12:54:05;82694433;82376860;317573;
26.01.2019;12:55:06;82694528;82377026;317502;
26.01.2019;12:56:06;82694605;82377165;317440;
26.01.2019;12:57:04;82694690;82377322;317368;
26.01.2019;12:58:04;82694763;82377466;317297;
26.01.2019;12:59:05;82694856;82377628;317228;
26.01.2019;13:00:05;82694927;82377754;317173;
26.01.2019;13:01:04;82694823;82377715;317108;
26.01.2019;13:02:13;82694390;82377509;316881;
26.01.2019;13:03:05;82694477;82377660;316817;
26.01.2019;13:04:04;82694555;82377805;316750;
26.01.2019;13:05:05;82694658;82377950;316708;
26.01.2019;13:06:04;82694732;82378125;316607;
26.01.2019;13:07:10;82694846;82378288;316558;
26.01.2019;13:08:05;82694919;82378433;316486;
26.01.2019;13:09:06;82695015;82378598;316417;
26.01.2019;13:10:04;82695116;82378750;316366;
26.01.2019;13:11:11;82695208;82378917;316291;
26.01.2019;13:12:04;82695298;82379036;316262;
26.01.2019;13:13:05;82695372;82379192;316180;
26.01.2019;13:14:05;82695469;82379356;316113;
26.01.2019;13:15:12;82695579;82379514;316065;
26.01.2019;13:16:04;82695664;82379658;316006;
26.01.2019;13:17:04;82695753;82379801;315952;
26.01.2019;13:18:06;82695830;82379974;315856;
26.01.2019;13:19:06;82695933;82380126;315807;
26.01.2019;13:20:04;82696015;82380259;315756;
26.01.2019;13:21:07;82696124;82380444;315680;
26.01.2019;13:22:09;82696214;82380603;315611;
26.01.2019;13:23:05;82696303;82380746;315557;
26.01.2019;13:24:05;82696402;82380901;315501;
26.01.2019;13:25:11;82696489;82381071;315418;
26.01.2019;13:26:05;82696576;82381235;315341;
26.01.2019;13:27:13;82696690;82381391;315299;
26.01.2019;13:28:05;82696784;82381521;315263;
26.01.2019;13:29:05;82696859;82381685;315174;
26.01.2019;13:30:04;82696963;82381836;315127;
26.01.2019;13:31:06;82697070;82381996;315074;
26.01.2019;13:32:04;82697158;82382147;315011;
26.01.2019;13:33:06;82697228;82382279;314949;
26.01.2019;13:34:07;82697315;82382445;314870;
26.01.2019;13:35:05;82697408;82382603;314805;
26.01.2019;13:36:05;82697510;82382772;314738;
26.01.2019;13:37:04;82697577;82382924;314653;
26.01.2019;13:38:05;82697656;82383053;314603;
26.01.2019;13:40:10;82697867;82383347;314520;
26.01.2019;13:41:11;82697961;82383533;314428;
26.01.2019;13:42:05;82698061;82383667;314394;
26.01.2019;13:43:04;82698136;82383835;314301;
26.01.2019;13:44:05;82698215;82383993;314222;
26.01.2019;13:45:05;82698302;82384143;314159;
26.01.2019;13:46:05;82698393;82384299;314094;
26.01.2019;13:47:05;82698491;82384438;314053;
26.01.2019;13:48:05;82698593;82384581;314012;
26.01.2019;13:49:05;82698695;82384719;313976;
26.01.2019;13:50:04;82698824;82384892;313932;
26.01.2019;13:51:07;82698940;82385055;313885;
26.01.2019;13:52:05;82699015;82385213;313802;
26.01.2019;13:53:06;82699115;82385385;313730;
26.01.2019;13:54:04;82699194;82385538;313656;
26.01.2019;13:55:04;82699291;82385688;313603;
26.01.2019;13:56:08;82699378;82385849;313529;
26.01.2019;13:57:09;82699475;82386000;313475;
26.01.2019;13:58:06;82699577;82386161;313416;
26.01.2019;13:59:06;82699669;82386320;313349;
26.01.2019;14:00:06;82699779;82386468;313311;
26.01.2019;14:01:10;82699898;82386656;313242;
26.01.2019;14:02:07;82699986;82386818;313168;
26.01.2019;14:03:07;82700086;82386965;313121;
26.01.2019;14:04:05;82700181;82387118;313063;
26.01.2019;14:05:04;82700266;82387287;312979;
26.01.2019;14:06:06;82700382;82387468;312914;
26.01.2019;14:07:04;82700466;82387585;312881;
26.01.2019;14:08:05;82700558;82387763;312795;
26.01.2019;14:09:07;82700652;82387946;312706;
26.01.2019;14:10:05;82700741;82388125;312616;
26.01.2019;14:11:04;82700847;82388258;312589;
26.01.2019;14:12:05;82700934;82388416;312518;
26.01.2019;14:13:05;82701032;82388565;312467;
26.01.2019;14:14:04;82701151;82388709;312442;
26.01.2019;14:15:09;82701258;82388885;312373;
26.01.2019;14:16:04;82701359;82389010;312349;
26.01.2019;14:17:06;82701464;82389180;312284;
26.01.2019;14:18:04;82701576;82389343;312233;
26.01.2019;14:19:05;82701661;82389497;312164;
26.01.2019;14:20:04;82701735;82389659;312076;
26.01.2019;14:21:09;82701800;82389819;311981;
26.01.2019;14:22:04;82701880;82389952;311928;
26.01.2019;14:23:05;82701953;82390114;311839;
26.01.2019;14:24:05;82702034;82390238;311796;
26.01.2019;14:25:04;82702112;82390385;311727;
26.01.2019;14:26:04;82702195;82390557;311638;
26.01.2019;14:27:09;82702290;82390740;311550;
26.01.2019;14:28:05;82702378;82390894;311484;
26.01.2019;14:29:06;82702479;82391047;311432;
26.01.2019;14:30:05;82702580;82391190;311390;
26.01.2019;14:31:06;82702666;82391340;311326;
26.01.2019;14:32:06;82702767;82391495;311272;
26.01.2019;14:33:06;82702867;82391665;311202;
26.01.2019;14:34:05;82702955;82391847;311108;
26.01.2019;14:35:05;82703030;82392009;311021;
26.01.2019;14:36:04;82703133;82392200;310933;
26.01.2019;14:37:05;82703262;82392361;310901;
26.01.2019;14:38:06;82703352;82392562;310790;
26.01.2019;14:39:04;82703447;82392711;310736;
26.01.2019;14:40:07;82703535;82392882;310653;
26.01.2019;14:41:04;82703617;82393056;310561;
26.01.2019;14:42:05;82703694;82393228;310466;
26.01.2019;14:43:04;82703789;82393390;310399;
26.01.2019;14:44:04;82703865;82393570;310295;
26.01.2019;14:45:05;82703989;82393737;310252;
26.01.2019;14:46:09;82704089;82393924;310165;
26.01.2019;14:47:04;82704200;82394075;310125;
26.01.2019;14:48:05;82704314;82394244;310070;
26.01.2019;14:49:07;82704415;82394402;310013;
26.01.2019;14:50:06;82704509;82394561;309948;
26.01.2019;14:51:04;82704635;82394718;309917;
26.01.2019;14:52:08;82704752;82394890;309862;
26.01.2019;14:53:06;82704861;82395059;309802;
26.01.2019;14:54:05;82704973;82395248;309725;
26.01.2019;14:55:11;82705088;82395455;309633;
26.01.2019;14:56:06;82705203;82395617;309586;
26.01.2019;14:57:04;82705303;82395789;309514;
26.01.2019;14:58:08;82705397;82395936;309461;
26.01.2019;14:59:04;82705508;82396108;309400;
26.01.2019;15:00:08;82705614;82396309;309305;
26.01.2019;15:01:10;82705741;82396482;309259;
26.01.2019;15:02:12;82705840;82396648;309192;
26.01.2019;15:03:12;82705940;82396804;309136;
26.01.2019;15:04:12;82706068;82397009;309059;
26.01.2019;15:05:11;82706176;82397163;309013;
26.01.2019;15:06:16;82706319;82397363;308956;
26.01.2019;15:07:11;82706418;82397527;308891;
26.01.2019;15:08:16;82706527;82397720;308807;
26.01.2019;15:09:14;82706633;82397879;308754;
26.01.2019;15:10:12;82706748;82398044;308704;
26.01.2019;15:11:11;82706847;82398222;308625;
26.01.2019;15:12:14;82706965;82398398;308567;
26.01.2019;15:13:12;82707072;82398555;308517;
26.01.2019;15:14:17;82707196;82398740;308456;
26.01.2019;15:15:12;82707296;82398897;308399;
26.01.2019;15:16:15;82707441;82399081;308360;
26.01.2019;15:17:12;82707535;82399255;308280;
26.01.2019;15:18:14;82707635;82399412;308223;
26.01.2019;15:19:19;82707769;82399601;308168;
26.01.2019;15:20:12;82707868;82399749;308119;
26.01.2019;15:21:15;82707984;82399901;308083;
26.01.2019;15:22:10;82708101;82400102;307999;
26.01.2019;15:23:12;82708233;82400307;307926;
26.01.2019;15:24:20;82708376;82400521;307855;
26.01.2019;15:25:11;82708503;82400669;307834;
26.01.2019;15:26:09;82708629;82400839;307790;
26.01.2019;15:27:16;82708774;82401058;307716;
26.01.2019;15:28:12;82708903;82401229;307674;
26.01.2019;15:29:12;82709018;82401436;307582;
26.01.2019;15:30:14;82709139;82401641;307498;
26.01.2019;15:31:11;82709243;82401804;307439;
26.01.2019;15:32:10;82709369;82401972;307397;
26.01.2019;15:33:17;82709503;82402153;307350;
26.01.2019;15:34:13;82709597;82402318;307279;
26.01.2019;15:35:11;82709724;82402519;307205;
26.01.2019;15:36:16;82709873;82402726;307147;
26.01.2019;15:37:12;82709994;82402867;307127;
26.01.2019;15:38:13;82710109;82403031;307078;
26.01.2019;15:39:19;82710222;82403221;307001;
26.01.2019;15:40:14;82710326;82403361;306965;
26.01.2019;15:41:20;82710467;82403536;306931;
26.01.2019;15:42:22;82710595;82403738;306857;
26.01.2019;15:43:13;82710708;82403884;306824;
26.01.2019;15:44:18;82710838;82404071;306767;
26.01.2019;15:45:20;82710943;82404241;306702;
26.01.2019;15:46:14;82711050;82404402;306648;
26.01.2019;15:47:16;82711187;82404566;306621;
26.01.2019;15:48:13;82711324;82404737;306587;
26.01.2019;15:49:17;82711453;82404941;306512;
26.01.2019;15:50:13;82711557;82405094;306463;
26.01.2019;15:51:14;82711677;82405276;306401;
26.01.2019;15:52:17;82711818;82405434;306384;
26.01.2019;15:53:14;82711929;82405594;306335;
26.01.2019;15:54:22;82712080;82405775;306305;
26.01.2019;15:55:13;82712198;82405900;306298;
26.01.2019;15:56:19;82712342;82406028;306314;
26.01.2019;15:57:16;82712470;82406149;306321;
26.01.2019;15:58:21;82712616;82406342;306274;
26.01.2019;15:59:17;82712736;82406487;306249;
26.01.2019;16:00:15;82712849;82406668;306181;
26.01.2019;16:02:07;82713052;82407017;306035;
26.01.2019;16:03:05;82713167;82407158;306009;
26.01.2019;16:04:05;82713303;82407372;305931;
26.01.2019;16:05:05;82713431;82407566;305865;
26.01.2019;16:06:05;82713563;82407729;305834;
26.01.2019;16:07:04;82713683;82407886;305797;
26.01.2019;16:08:08;82713811;82408078;305733;
26.01.2019;16:09:08;82713952;82408283;305669;
26.01.2019;16:10:06;82714054;82408451;305603;
26.01.2019;16:11:04;82714170;82408630;305540;
26.01.2019;16:12:04;82714287;82408780;305507;
26.01.2019;16:13:05;82714413;82408920;305493;
26.01.2019;16:14:15;82714543;82409145;305398;
26.01.2019;16:15:04;82714646;82409281;305365;
26.01.2019;16:16:04;82714779;82409450;305329;
26.01.2019;16:17:06;82714927;82409591;305336;
26.01.2019;16:18:09;82715018;82409762;305256;
26.01.2019;16:19:04;82715143;82409920;305223;
26.01.2019;16:20:08;82715264;82410089;305175;
26.01.2019;16:21:10;82715399;82410236;305163;
26.01.2019;16:22:04;82715509;82410355;305154;
26.01.2019;16:23:04;82715618;82410534;305084;
26.01.2019;16:24:06;82715720;82410707;305013;
26.01.2019;16:25:05;82715842;82410879;304963;
26.01.2019;16:26:05;82715989;82411009;304980;
26.01.2019;16:27:07;82716095;82411158;304937;
26.01.2019;16:28:04;82716217;82411309;304908;
26.01.2019;16:29:04;82716341;82411479;304862;
26.01.2019;16:30:06;82716476;82411652;304824;
26.01.2019;16:31:05;82716595;82411791;304804;
26.01.2019;16:32:05;82716701;82411954;304747;
26.01.2019;16:33:07;82716824;82412137;304687;
26.01.2019;16:34:04;82716947;82412262;304685;
26.01.2019;16:35:09;82717098;82412441;304657;
26.01.2019;16:36:07;82717203;82412590;304613;
26.01.2019;16:37:04;82717323;82412718;304605;
26.01.2019;16:38:04;82717458;82412897;304561;
26.01.2019;16:39:09;82717594;82413068;304526;
26.01.2019;16:40:05;82717694;82413238;304456;
26.01.2019;16:41:05;82717798;82413378;304420;
26.01.2019;16:42:05;82717913;82413532;304381;
26.01.2019;16:43:06;82718025;82413696;304329;
26.01.2019;16:44:05;82718148;82413859;304289;
26.01.2019;16:45:08;82718282;82414039;304243;
26.01.2019;16:46:05;82718402;82414235;304167;
26.01.2019;16:47:05;82718532;82414399;304133;
26.01.2019;16:48:06;82718662;82414549;304113;
26.01.2019;16:49:05;82718785;82414694;304091;
26.01.2019;16:50:10;82718907;82414881;304026;
26.01.2019;16:51:08;82719032;82415042;303990;
26.01.2019;16:52:05;82719171;82415206;303965;
26.01.2019;16:53:05;82719308;82415385;303923;
26.01.2019;16:54:06;82719440;82415548;303892;
26.01.2019;16:55:04;82719587;82415703;303884;
26.01.2019;16:56:09;82719699;82415908;303791;
26.01.2019;16:57:08;82719821;82416062;303759;
26.01.2019;16:58:06;82719941;82416217;303724;
26.01.2019;16:59:04;82720057;82416378;303679;
26.01.2019;17:00:05;82720195;82416565;303630;
26.01.2019;17:01:05;82720350;82416747;303603;
26.01.2019;17:02:11;82720503;82416931;303572;
26.01.2019;17:03:09;82720629;82417100;303529;
26.01.2019;17:04:05;82720748;82417275;303473;
26.01.2019;17:05:05;82720869;82417450;303419;
26.01.2019;17:06:05;82721030;82417589;303441;
26.01.2019;17:07:04;82721136;82417750;303386;
26.01.2019;17:08:04;82721257;82417922;303335;
26.01.2019;17:09:06;82721399;82418085;303314;
26.01.2019;17:10:10;82721535;82418267;303268;
26.01.2019;17:11:04;82721661;82418410;303251;
26.01.2019;17:12:04;82721811;82418567;303244;
26.01.2019;17:13:10;82721952;82418744;303208;
26.01.2019;17:14:05;82722074;82418882;303192;
26.01.2019;17:15:11;82722232;82419073;303159;
26.01.2019;17:16:09;82722371;82419256;303115;
26.01.2019;17:17:06;82722506;82419425;303081;
26.01.2019;17:18:05;82722615;82419577;303038;
26.01.2019;17:19:10;82722740;82419748;302992;
26.01.2019;17:20:11;82722883;82419920;302963;
26.01.2019;17:21:05;82723012;82420065;302947;
26.01.2019;17:22:09;82723137;82420226;302911;
26.01.2019;17:23:06;82723270;82420375;302895;
26.01.2019;17:24:10;82723391;82420527;302864;
26.01.2019;17:25:05;82723546;82420681;302865;
26.01.2019;17:26:06;82723703;82420837;302866;
26.01.2019;17:27:05;82723834;82420976;302858;
26.01.2019;17:28:09;82723973;82421146;302827;
26.01.2019;17:29:05;82724114;82421321;302793;
26.01.2019;17:30:05;82724263;82421489;302774;
26.01.2019;17:31:06;82724424;82421600;302824;
26.01.2019;17:32:04;82724548;82421785;302763;
26.01.2019;17:33:04;82724685;82421944;302741;
26.01.2019;17:34:09;82724815;82422152;302663;
26.01.2019;17:35:04;82724942;82422318;302624;
26.01.2019;17:36:04;82725075;82422471;302604;
26.01.2019;17:37:05;82725202;82422637;302565;
26.01.2019;17:38:05;82725371;82422797;302574;
26.01.2019;17:39:07;82725514;82422937;302577;
26.01.2019;17:40:08;82725642;82423110;302532;
26.01.2019;17:41:05;82725775;82423262;302513;
26.01.2019;17:42:06;82725913;82423448;302465;
26.01.2019;17:43:05;82726059;82423594;302465;
26.01.2019;17:44:05;82726202;82423745;302457;
26.01.2019;17:45:04;82726339;82423898;302441;
26.01.2019;17:46:07;82726484;82424054;302430;
26.01.2019;17:47:04;82726622;82424200;302422;
26.01.2019;17:48:04;82726764;82424367;302397;
26.01.2019;17:49:05;82726893;82424541;302352;
26.01.2019;17:50:05;82727045;82424690;302355;
26.01.2019;17:51:05;82727184;82424828;302356;
26.01.2019;17:52:07;82727333;82424984;302349;
26.01.2019;17:53:04;82727441;82425114;302327;
26.01.2019;17:54:06;82727631;82425302;302329;
26.01.2019;17:55:05;82727762;82425447;302315;
26.01.2019;17:56:04;82727896;82425607;302289;
26.01.2019;17:57:04;82728016;82425773;302243;
26.01.2019;17:58:05;82728169;82425931;302238;
26.01.2019;17:59:08;82728309;82426102;302207;
26.01.2019;18:00:05;82728426;82426258;302168;
26.01.2019;18:01:05;82728557;82426429;302128;
26.01.2019;18:02:04;82728694;82426578;302116;
26.01.2019;18:03:05;82728818;82426730;302088;
26.01.2019;18:04:04;82728951;82426878;302073;
26.01.2019;18:05:07;82729106;82427006;302100;
26.01.2019;18:06:05;82729252;82427134;302118;
26.01.2019;18:07:04;82729400;82427290;302110;
26.01.2019;18:08:04;82729538;82427432;302106;
26.01.2019;18:09:06;82729687;82427574;302113;
26.01.2019;18:10:04;82729837;82427698;302139;
26.01.2019;18:11:08;82729966;82427830;302136;
26.01.2019;18:12:05;82730098;82427971;302127;
26.01.2019;18:13:04;82730210;82428106;302104;
26.01.2019;18:14:04;82730335;82428236;302099;
26.01.2019;18:15:04;82730498;82428380;302118;
26.01.2019;18:16:05;82730604;82428510;302094;
26.01.2019;18:17:07;82730732;82428655;302077;
26.01.2019;18:18:05;82730827;82428788;302039;
26.01.2019;18:19:04;82730939;82428926;302013;
26.01.2019;18:20:04;82731059;82429038;302021;
26.01.2019;18:21:04;82731184;82429159;302025;
26.01.2019;18:22:04;82731278;82429287;301991;
26.01.2019;18:23:07;82731403;82429409;301994;
26.01.2019;18:24:05;82731507;82429544;301963;
26.01.2019;18:25:09;82731635;82429677;301958;
26.01.2019;18:26:05;82731763;82429785;301978;
26.01.2019;18:27:05;82731887;82429941;301946;
26.01.2019;18:28:05;82731994;82430056;301938;
26.01.2019;18:29:05;82732108;82430201;301907;
26.01.2019;18:30:07;82732216;82430332;301884;
26.01.2019;18:31:05;82732309;82430452;301857;
26.01.2019;18:32:05;82732439;82430587;301852;
26.01.2019;18:33:04;82732549;82430702;301847;
26.01.2019;18:34:04;82732684;82430827;301857;
26.01.2019;18:35:04;82732815;82430954;301861;
26.01.2019;18:36:08;82732954;82431088;301866;
26.01.2019;18:37:05;82733084;82431195;301889;
26.01.2019;18:38:05;82733210;82431320;301890;
26.01.2019;18:39:07;82733339;82431455;301884;
26.01.2019;18:40:05;82733455;82431566;301889;
26.01.2019;18:41:05;82733568;82431700;301868;
26.01.2019;18:42:07;82733700;82431830;301870;
26.01.2019;18:43:04;82733840;82431931;301909;
26.01.2019;18:44:04;82733967;82432081;301886;
26.01.2019;18:45:04;82734084;82432216;301868;
26.01.2019;18:46:04;82734249;82432316;301933;
26.01.2019;18:47:05;82734383;82432444;301939;
26.01.2019;18:48:08;82734498;82432520;301978;
26.01.2019;18:49:04;82734595;82432616;301979;
26.01.2019;18:50:04;82734709;82432713;301996;
26.01.2019;18:51:04;82734815;82432812;302003;
26.01.2019;18:52:05;82734935;82432922;302013;
26.01.2019;18:54:07;82735230;82433163;302067;
26.01.2019;18:55:04;82735365;82433280;302085;
26.01.2019;18:56:04;82735509;82433399;302110;
26.01.2019;18:57:05;82735628;82433527;302101;
26.01.2019;18:58:04;82735758;82433632;302126;
26.01.2019;18:59:04;82735907;82433749;302158;
26.01.2019;19:00:07;82736038;82433863;302175;
26.01.2019;19:01:05;82736168;82433962;302206;
26.01.2019;19:02:05;82736297;82434092;302205;
26.01.2019;19:03:04;82736426;82434222;302204;
26.01.2019;19:04:05;82736574;82434353;302221;
26.01.2019;19:05:05;82736719;82434468;302251;
26.01.2019;19:06:06;82736848;82434575;302273;
26.01.2019;19:07:05;82736983;82434682;302301;
26.01.2019;19:08:04;82737109;82434805;302304;
26.01.2019;19:09:04;82737246;82434907;302339;
26.01.2019;19:10:06;82737375;82435030;302345;
26.01.2019;19:11:05;82737512;82435135;302377;
26.01.2019;19:12:05;82737652;82435258;302394;
26.01.2019;19:13:07;82737798;82435368;302430;
26.01.2019;19:14:04;82737922;82435461;302461;
26.01.2019;19:15:04;82738053;82435572;302481;
26.01.2019;19:16:06;82738196;82435702;302494;
26.01.2019;19:17:05;82738224;82435827;302397;
26.01.2019;19:18:08;82738318;82435947;302371;
26.01.2019;19:19:07;82738406;82436039;302367;
26.01.2019;19:20:04;82738490;82436144;302346;
26.01.2019;19:21:05;82738558;82436265;302293;
26.01.2019;19:22:05;82738658;82436373;302285;
26.01.2019;19:23:05;82738740;82436466;302274;
26.01.2019;19:24:05;82738870;82436573;302297;
26.01.2019;19:25:08;82738965;82436669;302296;
26.01.2019;19:26:06;82739090;82436783;302307;
26.01.2019;19:27:05;82739200;82436867;302333;
26.01.2019;19:28:04;82739300;82436980;302320;
26.01.2019;19:29:05;82739389;82437083;302306;
26.01.2019;19:30:08;82739483;82437195;302288;
26.01.2019;19:31:05;82739614;82437283;302331;
26.01.2019;19:32:05;82739761;82437392;302369;
26.01.2019;19:33:05;82739880;82437477;302403;
26.01.2019;19:34:05;82739973;82437580;302393;
26.01.2019;19:35:05;82740086;82437684;302402;
26.01.2019;19:36:08;82740215;82437785;302430;
26.01.2019;19:37:05;82740320;82437872;302448;
26.01.2019;19:38:05;82740417;82437983;302434;
26.01.2019;19:39:05;82740526;82438098;302428;
26.01.2019;19:40:05;82740636;82438176;302460;
26.01.2019;19:41:04;82740778;82438282;302496;
26.01.2019;19:42:08;82740913;82438388;302525;
26.01.2019;19:43:05;82741022;82438475;302547;
26.01.2019;19:44:05;82741126;82438565;302561;
26.01.2019;19:45:05;82741223;82438663;302560;
26.01.2019;19:46:11;82741375;82438743;302632;
26.01.2019;19:47:05;82741498;82438828;302670;
26.01.2019;19:48:08;82741626;82438938;302688;
26.01.2019;19:49:05;82741719;82439021;302698;
26.01.2019;19:50:05;82741858;82439134;302724;
26.01.2019;19:51:05;82741994;82439227;302767;
26.01.2019;19:52:05;82742109;82439308;302801;
26.01.2019;19:53:06;82742225;82439412;302813;
26.01.2019;19:54:07;82742337;82439488;302849;
26.01.2019;19:55:06;82742481;82439556;302925;
26.01.2019;19:56:05;82742588;82439640;302948;
26.01.2019;19:57:07;82742752;82439723;303029;
26.01.2019;19:58:05;82742882;82439802;303080;
26.01.2019;19:59:09;82743001;82439906;303095;
26.01.2019;20:00:07;82743107;82439982;303125;
26.01.2019;20:01:05;82743239;82440040;303199;
26.01.2019;20:02:06;82743362;82440130;303232;
26.01.2019;20:03:04;82743472;82440193;303279;
26.01.2019;20:04:06;82743590;82440273;303317;
26.01.2019;20:05:05;82743707;82440358;303349;
26.01.2019;20:06:08;82743828;82440443;303385;
26.01.2019;20:07:06;82743952;82440530;303422;
26.01.2019;20:08:06;82744067;82440608;303459;
26.01.2019;20:09:07;82744189;82440701;303488;
26.01.2019;20:10:06;82744314;82440774;303540;
26.01.2019;20:11:18;82744414;82440854;303560;
26.01.2019;20:12:05;82744537;82440917;303620;
26.01.2019;20:13:06;82744663;82440987;303676;
26.01.2019;20:14:10;82744817;82441069;303748;
26.01.2019;20:15:07;82744922;82441122;303800;
26.01.2019;20:16:05;82745063;82441202;303861;
26.01.2019;20:17:05;82745176;82441280;303896;
26.01.2019;20:18:06;82745306;82441372;303934;
26.01.2019;20:19:06;82745402;82441446;303956;
26.01.2019;20:20:06;82745517;82441495;304022;
26.01.2019;20:21:06;82745626;82441550;304076;
26.01.2019;20:22:04;82745750;82441604;304146;
26.01.2019;20:23:05;82745855;82441681;304174;
26.01.2019;20:24:06;82745955;82441748;304207;
26.01.2019;20:25:14;82746062;82441817;304245;
26.01.2019;20:26:11;82746176;82441863;304313;
26.01.2019;20:27:05;82746263;82441900;304363;
26.01.2019;20:28:06;82746357;82441957;304400;
26.01.2019;20:29:04;82746459;82442005;304454;
26.01.2019;20:30:04;82746576;82442064;304512;
26.01.2019;20:31:09;82746681;82442142;304539;
26.01.2019;20:32:06;82746792;82442196;304596;
26.01.2019;20:33:05;82746908;82442241;304667;
26.01.2019;20:34:06;82747001;82442320;304681;
26.01.2019;20:35:06;82747103;82442386;304717;
26.01.2019;20:36:08;82747221;82442459;304762;
26.01.2019;20:37:13;82747322;82442513;304809;
26.01.2019;20:38:05;82747427;82442551;304876;
26.01.2019;20:39:06;82747522;82442600;304922;
26.01.2019;20:40:06;82747636;82442648;304988;
26.01.2019;20:41:04;82747742;82442698;305044;
26.01.2019;20:42:05;82747870;82442753;305117;
26.01.2019;20:43:05;82747986;82442799;305187;
26.01.2019;20:44:07;82748110;82442839;305271;
26.01.2019;20:45:06;82748246;82442888;305358;
26.01.2019;20:46:06;82748367;82442952;305415;
26.01.2019;20:47:05;82748502;82443016;305486;
26.01.2019;20:48:06;82748651;82443056;305595;
26.01.2019;20:49:06;82748754;82443094;305660;
26.01.2019;20:50:05;82748835;82443129;305706;
26.01.2019;20:51:04;82748934;82443184;305750;
26.01.2019;20:52:04;82749048;82443260;305788;
26.01.2019;20:53:06;82749164;82443331;305833;
26.01.2019;20:54:04;82749276;82443395;305881;
26.01.2019;20:55:09;82749436;82443452;305984;
26.01.2019;20:56:08;82749553;82443515;306038;
26.01.2019;20:57:11;82749698;82443584;306114;
26.01.2019;20:58:05;82749824;82443636;306188;
26.01.2019;20:59:10;82749967;82443696;306271;
26.01.2019;21:00:05;82750100;82443756;306344;
26.01.2019;21:01:05;82750247;82443818;306429;
26.01.2019;21:02:09;82750353;82443880;306473;
26.01.2019;21:03:04;82750489;82443950;306539;
26.01.2019;21:04:06;82750622;82444007;306615;
26.01.2019;21:05:06;82750769;82444084;306685;
26.01.2019;21:06:05;82750903;82444129;306774;
26.01.2019;21:07:06;82751018;82444172;306846;
26.01.2019;21:08:08;82751133;82444237;306896;
26.01.2019;21:09:05;82751244;82444307;306937;
26.01.2019;21:10:05;82751374;82444373;307001;
26.01.2019;21:11:05;82751507;82444423;307084;
26.01.2019;21:12:07;82751642;82444485;307157;
26.01.2019;21:13:11;82751786;82444547;307239;
26.01.2019;21:14:09;82751924;82444593;307331;
26.01.2019;21:15:11;82752033;82444647;307386;
26.01.2019;21:16:06;82752155;82444694;307461;
26.01.2019;21:17:05;82752274;82444743;307531;
26.01.2019;21:18:05;82752399;82444806;307593;
26.01.2019;21:19:06;82752533;82444844;307689;
26.01.2019;21:20:07;82752651;82444891;307760;
26.01.2019;21:21:08;82752783;82444942;307841;
26.01.2019;21:22:05;82752896;82444986;307910;
26.01.2019;21:23:04;82752998;82445031;307967;
26.01.2019;21:24:09;82753127;82445089;308038;
26.01.2019;21:25:06;82753236;82452126;301110;
26.01.2019;21:26:05;82753370;82452167;301203;
26.01.2019;21:27:07;82753518;82452220;301298;
26.01.2019;21:28:05;82753641;82452267;301374;
26.01.2019;21:29:05;82753846;82452315;301531;
26.01.2019;21:30:06;82753963;82452371;301592;
26.01.2019;21:31:05;82754091;82452419;301672;
26.01.2019;21:32:05;82754205;82452472;301733;
26.01.2019;21:33:08;82754312;82452532;301780;
26.01.2019;21:34:07;82754439;82452584;301855;
26.01.2019;21:35:04;82754566;82452621;301945;
26.01.2019;21:36:05;82754686;82452668;302018;
26.01.2019;21:37:04;82754815;82452717;302098;
26.01.2019;21:38:07;82754957;82452766;302191;
26.01.2019;21:39:07;82755075;82452809;302266;
26.01.2019;21:40:05;82755110;82452787;302323;
26.01.2019;21:41:05;82755225;82452833;302392;
26.01.2019;21:42:06;82755367;82452888;302479;
26.01.2019;21:43:05;82755516;82452930;302586;
26.01.2019;21:44:06;82755660;82452968;302692;
26.01.2019;21:45:08;82755792;82453006;302786;
26.01.2019;21:46:05;82755915;82453054;302861;
26.01.2019;21:47:04;82756050;82453109;302941;
26.01.2019;21:48:05;82756171;82453141;303030;
26.01.2019;21:49:06;82756275;82453186;303089;
26.01.2019;21:50:04;82756410;82453228;303182;
26.01.2019;21:51:07;82756539;82453263;303276;
26.01.2019;21:52:04;82756656;82453308;303348;
26.01.2019;21:53:04;82756779;82453352;303427;
26.01.2019;21:54:05;82756899;82453397;303502;
26.01.2019;21:55:05;82757013;82453439;303574;
26.01.2019;21:56:06;82757147;82453484;303663;
26.01.2019;21:57:08;82757289;82453522;303767;
26.01.2019;21:58:04;82757387;82453554;303833;
26.01.2019;21:59:05;82757496;82453584;303912;
26.01.2019;22:00:06;82757621;82453621;304000;
26.01.2019;22:01:06;82757743;82453674;304069;
26.01.2019;22:02:08;82757863;82453708;304155;
26.01.2019;22:03:08;82757987;82453740;304247;
26.01.2019;22:04:05;82758101;82453783;304318;
26.01.2019;22:05:05;82758228;82453819;304409;
26.01.2019;22:06:05;82758355;82453863;304492;
26.01.2019;22:07:05;82758486;82453901;304585;
26.01.2019;22:08:05;82758612;82453944;304668;
26.01.2019;22:09:08;82758736;82454000;304736;
26.01.2019;22:10:04;82758827;82454039;304788;
26.01.2019;22:11:05;82758938;82454094;304844;
26.01.2019;22:12:05;82759072;82454133;304939;
26.01.2019;22:13:04;82759189;82454170;305019;
26.01.2019;22:14:04;82759290;82454206;305084;
26.01.2019;22:15:07;82759412;82454256;305156;
26.01.2019;22:16:05;82759534;82454296;305238;
26.01.2019;22:17:06;82759641;82454315;305326;
26.01.2019;22:18:04;82759727;82454347;305380;
26.01.2019;22:19:05;82759825;82454374;305451;
26.01.2019;22:20:05;82759910;82454405;305505;
26.01.2019;22:21:07;82760008;82454433;305575;
26.01.2019;22:22:05;82760127;82454473;305654;
26.01.2019;22:23:06;82760236;82454508;305728;
26.01.2019;22:24:04;82760333;82454529;305804;
26.01.2019;22:25:06;82760440;82454550;305890;
26.01.2019;22:26:06;82760537;82454586;305951;
26.01.2019;22:27:05;82760647;82454607;306040;
26.01.2019;22:28:07;82760734;82454641;306093;
26.01.2019;22:29:05;82760829;82454681;306148;
26.01.2019;22:30:05;82760904;82454711;306193;
26.01.2019;22:31:05;82761000;82454746;306254;
26.01.2019;22:32:05;82761101;82454772;306329;
26.01.2019;22:33:05;82761206;82454781;306425;
26.01.2019;22:34:07;82761307;82454810;306497;
26.01.2019;22:35:06;82761409;82454848;306561;
26.01.2019;22:36:05;82761513;82454886;306627;
26.01.2019;22:37:05;82761613;82454910;306703;
26.01.2019;22:38:05;82761728;82454937;306791;
26.01.2019;22:39:09;82761816;82454971;306845;
26.01.2019;22:40:05;82761937;82455007;306930;
26.01.2019;22:41:05;82762019;82455038;306981;
26.01.2019;22:42:05;82762139;82455066;307073;
26.01.2019;22:43:05;82762248;82455114;307134;
26.01.2019;22:44:05;82762338;82455140;307198;
26.01.2019;22:45:08;82762459;82455168;307291;
26.01.2019;22:46:04;82762556;82455197;307359;
26.01.2019;22:47:04;82762656;82455223;307433;
26.01.2019;22:48:05;82762773;82455266;307507;
26.01.2019;22:49:05;82762877;82455293;307584;
26.01.2019;22:50:05;82762990;82455311;307679;
26.01.2019;22:51:08;82763103;82455354;307749;
26.01.2019;22:52:05;82763228;82455382;307846;
26.01.2019;22:53:05;82763341;82455404;307937;
26.01.2019;22:54:04;82763451;82455426;308025;
26.01.2019;22:55:05;82763559;82455445;308114;
26.01.2019;22:56:05;82763695;82455466;308229;
26.01.2019;22:57:06;82763807;82455506;308301;
26.01.2019;22:58:04;82763899;82455542;308357;
26.01.2019;22:59:05;82764013;82455570;308443;
26.01.2019;23:00:04;82764112;82455591;308521;
26.01.2019;23:01:05;82764241;82455639;308602;
26.01.2019;23:02:05;82764342;82455657;308685;
26.01.2019;23:03:06;82764446;82455687;308759;
26.01.2019;23:04:05;82764555;82455723;308832;
26.01.2019;23:05:05;82764671;82455752;308919;
26.01.2019;23:06:05;82764791;82455773;309018;
26.01.2019;23:07:05;82764913;82455813;309100;
26.01.2019;23:08:05;82765043;82455834;309209;
26.01.2019;23:09:07;82765159;82455858;309301;
26.01.2019;23:10:05;82765257;82455885;309372;
26.01.2019;23:11:05;82765359;82455914;309445;
26.01.2019;23:12:05;82765499;82455944;309555;
26.01.2019;23:13:05;82765609;82455976;309633;
26.01.2019;23:14:05;82765726;82456002;309724;
26.01.2019;23:16:04;82765918;82456058;309860;
26.01.2019;23:17:04;82766032;82456082;309950;
26.01.2019;23:18:04;82766146;82456115;310031;
26.01.2019;23:19:05;82766252;82456150;310102;
26.01.2019;23:20:07;82766381;82456185;310196;
26.01.2019;23:21:05;82766472;82456217;310255;
26.01.2019;23:22:04;82766579;82456252;310327;
26.01.2019;23:23:04;82766707;82456286;310421;
26.01.2019;23:24:05;82766828;82456310;310518;
26.01.2019;23:25:05;82766963;82456342;310621;
26.01.2019;23:26:08;82767096;82456370;310726;
26.01.2019;23:27:05;82767201;82456395;310806;
26.01.2019;23:28:04;82767321;82456424;310897;
26.01.2019;23:33:05;82767937;82456564;311373;
26.01.2019;23:34:04;82768066;82456593;311473;
26.01.2019;23:35:04;82768185;82456614;311571;
26.01.2019;23:36:05;82768316;82456642;311674;
26.01.2019;23:37:04;82768424;82456674;311750;
26.01.2019;23:38:05;82768555;82456701;311854;
26.01.2019;23:39:05;82768647;82456724;311923;
26.01.2019;23:40:05;82768749;82456752;311997;
26.01.2019;23:41:04;82768841;82456777;312064;
26.01.2019;23:42:04;82768967;82456792;312175;
26.01.2019;23:43:04;82769110;82456816;312294;
26.01.2019;23:44:05;82769227;82456847;312380;
26.01.2019;23:45:07;82769336;82456874;312462;
26.01.2019;23:46:05;82769450;82456899;312551;
26.01.2019;23:47:04;82769568;82456928;312640;
26.01.2019;23:48:05;82769677;82456957;312720;
26.01.2019;23:49:09;82769789;82456988;312801;
26.01.2019;23:50:04;82769887;82457013;312874;
26.01.2019;23:51:07;82769989;82457032;312957;
26.01.2019;23:52:04;82770086;82457049;313037;
26.01.2019;23:53:04;82770216;82457066;313150;
26.01.2019;23:54:05;82770328;82457101;313227;
26.01.2019;23:55:05;82770434;82457112;313322;
26.01.2019;23:56:05;82770546;82457137;313409;
26.01.2019;23:57:07;82770650;82457164;313486;
26.01.2019;23:58:04;82770740;82457188;313552;
26.01.2019;23:59:05;82770844;82457208;313636;
27.01.2019;00:00:08;82770950;82457233;313717;
27.01.2019;00:01:11;82771070;82457256;313814;
27.01.2019;00:02:13;82771187;82457286;313901;
27.01.2019;00:03:10;82771277;82457310;313967;
27.01.2019;00:04:10;82771378;82457332;314046;
27.01.2019;00:05:13;82771491;82457351;314140;
27.01.2019;00:06:12;82771612;82457384;314228;
27.01.2019;00:07:10;82771710;82457409;314301;
27.01.2019;00:08:10;82771820;82457439;314381;
27.01.2019;00:09:08;82771923;82457470;314453;
27.01.2019;00:10:07;82772027;82457484;314543;
27.01.2019;00:11:08;82772151;82457515;314636;
27.01.2019;00:12:07;82772261;82457538;314723;
27.01.2019;00:13:07;82772360;82457562;314798;
27.01.2019;00:14:07;82772447;82457598;314849;
27.01.2019;00:15:09;82772555;82457624;314931;
27.01.2019;00:16:08;82772638;82457660;314978;
27.01.2019;00:17:08;82772686;82457682;315004;
27.01.2019;00:18:08;82772763;82457711;315052;
27.01.2019;00:19:07;82772848;82457713;315135;
27.01.2019;00:20:08;82772920;82457736;315184;
27.01.2019;00:21:07;82772991;82457761;315230;
27.01.2019;00:22:08;82773101;82457790;315311;
27.01.2019;00:23:08;82773183;82457807;315376;
27.01.2019;00:24:08;82773279;82457828;315451;
27.01.2019;00:25:07;82773394;82457841;315553;
27.01.2019;00:26:07;82773484;82457875;315609;
27.01.2019;00:27:07;82773541;82457891;315650;
27.01.2019;00:28:07;82773628;82457922;315706;
27.01.2019;00:29:07;82773737;82457950;315787;
27.01.2019;00:30:08;82773838;82457977;315861;
27.01.2019;00:31:08;82773945;82458001;315944;
27.01.2019;00:32:07;82774048;82458037;316011;
27.01.2019;00:33:08;82774154;82458063;316091;
27.01.2019;00:34:08;82774278;82458098;316180;
27.01.2019;00:35:08;82774411;82458123;316288;
27.01.2019;00:36:07;82774528;82458150;316378;
27.01.2019;00:37:07;82774631;82458160;316471;
27.01.2019;00:38:07;82774755;82458190;316565;
27.01.2019;00:43:08;82775302;82458318;316984;
27.01.2019;00:44:08;82775404;82458346;317058;
27.01.2019;00:45:07;82775529;82458372;317157;
27.01.2019;00:46:08;82775627;82458399;317228;
27.01.2019;00:47:07;82775716;82458426;317290;
27.01.2019;00:48:07;82775823;82458438;317385;
27.01.2019;00:49:08;82775917;82458461;317456;
27.01.2019;00:50:07;82776002;82458466;317536;
27.01.2019;00:51:07;82776127;82458486;317641;
27.01.2019;00:52:08;82776245;82458527;317718;
27.01.2019;00:53:07;82776355;82458555;317800;
27.01.2019;00:54:07;82776480;82458576;317904;
27.01.2019;00:55:07;82776569;82458605;317964;
27.01.2019;00:56:07;82776671;82458632;318039;
27.01.2019;00:57:07;82776774;82458652;318122;
27.01.2019;00:58:08;82776873;82458689;318184;
27.01.2019;00:59:08;82776974;82458712;318262;
27.01.2019;01:00:04;82777097;82458745;318352;
27.01.2019;01:01:04;82777205;82458768;318437;
27.01.2019;01:02:05;82777328;82458791;318537;
27.01.2019;01:03:05;82777429;82458825;318604;
27.01.2019;01:04:04;82777546;82458852;318694;
27.01.2019;01:05:04;82777662;82458873;318789;
27.01.2019;01:06:04;82777750;82458905;318845;
27.01.2019;01:07:05;82777845;82458929;318916;
27.01.2019;01:08:04;82777935;82458952;318983;
27.01.2019;01:09:06;82778059;82458981;319078;
27.01.2019;01:10:04;82778167;82459017;319150;
27.01.2019;01:11:05;82778266;82459048;319218;
27.01.2019;01:12:04;82778380;82459071;319309;
27.01.2019;01:13:04;82778494;82459106;319388;
27.01.2019;01:14:05;82778610;82459139;319471;
27.01.2019;01:15:05;82778739;82459174;319565;
27.01.2019;01:16:04;82778832;82459205;319627;
27.01.2019;01:17:04;82778931;82459225;319706;
27.01.2019;01:18:04;82779040;82459252;319788;
27.01.2019;01:19:04;82779156;82459290;319866;
27.01.2019;01:20:04;82779268;82459320;319948;
27.01.2019;01:21:04;82779404;82459347;320057;
27.01.2019;01:22:05;82779535;82459380;320155;
27.01.2019;01:23:05;82779660;82459418;320242;
27.01.2019;01:24:05;82779751;82459450;320301;
27.01.2019;01:25:04;82779871;82459476;320395;
27.01.2019;01:26:04;82779957;82459505;320452;
27.01.2019;01:27:04;82780056;82459544;320512;
27.01.2019;01:28:04;82780175;82459575;320600;
27.01.2019;01:29:05;82780255;82459606;320649;
27.01.2019;01:30:04;82780376;82459636;320740;
27.01.2019;01:31:05;82780470;82459660;320810;
27.01.2019;01:32:05;82780575;82459691;320884;
27.01.2019;01:33:05;82780669;82459731;320938;
27.01.2019;01:34:05;82780775;82459782;320993;
27.01.2019;01:35:04;82780889;82459820;321069;
27.01.2019;01:36:05;82780991;82459855;321136;
27.01.2019;01:37:05;82781110;82459891;321219;
27.01.2019;01:38:05;82781209;82459916;321293;
27.01.2019;01:39:04;82781315;82459950;321365;
27.01.2019;01:40:04;82781419;82459982;321437;
27.01.2019;01:41:05;82781532;82460010;321522;
27.01.2019;01:42:04;82781643;82460038;321605;
27.01.2019;01:43:05;82781754;82460080;321674;
27.01.2019;01:44:05;82781848;82460115;321733;
27.01.2019;01:45:05;82781962;82460160;321802;
27.01.2019;01:46:04;82782076;82460193;321883;
27.01.2019;01:47:05;82782200;82460239;321961;
27.01.2019;01:48:04;82782324;82460279;322045;
27.01.2019;01:49:04;82782466;82460339;322127;
27.01.2019;01:50:04;82782600;82460383;322217;
27.01.2019;01:51:05;82782696;82460432;322264;
27.01.2019;01:52:04;82782804;82460477;322327;
27.01.2019;01:53:04;82782895;82460514;322381;
27.01.2019;01:54:05;82782998;82460564;322434;
27.01.2019;01:55:04;82783089;82460612;322477;
27.01.2019;01:56:04;82783209;82460666;322543;
27.01.2019;01:57:04;82783328;82460707;322621;
27.01.2019;01:58:05;82783436;82460767;322669;
27.01.2019;01:59:04;82783547;82460816;322731;
27.01.2019;02:00:05;82783656;82460863;322793;
27.01.2019;02:01:04;82783772;82460916;322856;
27.01.2019;02:02:04;82783893;82460957;322936;
27.01.2019;02:03:05;82783999;82461004;322995;
27.01.2019;02:04:04;82784117;82461050;323067;
27.01.2019;02:05:04;82784234;82461083;323151;
27.01.2019;02:06:04;82784342;82461146;323196;
27.01.2019;02:07:05;82784465;82461191;323274;
27.01.2019;02:08:04;82784566;82461245;323321;
27.01.2019;02:09:04;82784669;82461291;323378;
27.01.2019;02:10:05;82784787;82461336;323451;
27.01.2019;02:11:05;82784893;82461386;323507;
27.01.2019;02:12:05;82784991;82461441;323550;
27.01.2019;02:13:05;82785101;82461487;323614;
27.01.2019;02:14:05;82785214;82461549;323665;
27.01.2019;02:15:04;82785312;82461611;323701;
27.01.2019;02:16:04;82785389;82461660;323729;
27.01.2019;02:17:05;82785495;82461701;323794;
27.01.2019;02:18:05;82785552;82461754;323798;
27.01.2019;02:19:04;82785641;82461815;323826;
27.01.2019;02:20:04;82785702;82461883;323819;
27.01.2019;02:21:05;82785800;82461918;323882;
27.01.2019;02:22:05;82785895;82461973;323922;
27.01.2019;02:23:05;82785967;82462027;323940;
27.01.2019;02:24:05;82786019;82462072;323947;
27.01.2019;02:25:04;82786101;82462124;323977;
27.01.2019;02:26:04;82786173;82462171;324002;
27.01.2019;02:27:05;82786262;82462217;324045;
27.01.2019;02:28:05;82786348;82462268;324080;
27.01.2019;02:29:05;82786432;82462333;324099;
27.01.2019;02:30:04;82786517;82462374;324143;
27.01.2019;02:31:04;82786574;82462416;324158;
27.01.2019;02:32:04;82786678;82462466;324212;
27.01.2019;02:33:05;82786771;82462521;324250;
27.01.2019;02:34:04;82786863;82462604;324259;
27.01.2019;02:35:04;82786961;82462654;324307;
27.01.2019;02:36:05;82787073;82462716;324357;
27.01.2019;02:37:04;82787210;82462791;324419;
27.01.2019;02:38:04;82787291;82462856;324435;
27.01.2019;02:39:07;82787375;82462919;324456;
27.01.2019;02:40:04;82787473;82462995;324478;
27.01.2019;02:41:05;82787574;82463059;324515;
27.01.2019;02:42:05;82787671;82463130;324541;
27.01.2019;02:43:04;82787780;82463202;324578;
27.01.2019;02:44:05;82787884;82463266;324618;
27.01.2019;02:45:04;82787989;82463331;324658;
27.01.2019;02:46:05;82788085;82463406;324679;
27.01.2019;02:47:04;82788177;82463475;324702;
27.01.2019;02:48:04;82788289;82463570;324719;
27.01.2019;02:49:05;82788401;82463649;324752;
27.01.2019;02:50:05;82788499;82463715;324784;
27.01.2019;02:51:04;82788597;82463788;324809;
27.01.2019;02:52:04;82788699;82463855;324844;
27.01.2019;02:53:05;82788813;82463913;324900;
27.01.2019;02:54:04;82788884;82463988;324896;
27.01.2019;02:55:05;82788987;82464081;324906;
27.01.2019;02:56:04;82789076;82464160;324916;
27.01.2019;02:57:05;82789192;82464250;324942;
27.01.2019;02:58:04;82789292;82464326;324966;
27.01.2019;02:59:05;82789392;82464405;324987;
27.01.2019;03:00:05;82789494;82464475;325019;
27.01.2019;03:01:04;82789620;82464545;325075;
27.01.2019;03:02:04;82789720;82464622;325098;
27.01.2019;03:03:05;82789815;82464698;325117;
27.01.2019;03:04:04;82789936;82464803;325133;
27.01.2019;03:05:05;82790059;82464893;325166;
27.01.2019;03:06:05;82790161;82464973;325188;
27.01.2019;03:07:05;82790285;82465063;325222;
27.01.2019;03:08:04;82790394;82465149;325245;
27.01.2019;03:09:04;82790499;82465220;325279;
27.01.2019;03:10:05;82790589;82465331;325258;
27.01.2019;03:11:04;82790698;82465425;325273;
27.01.2019;03:12:04;82790817;82465512;325305;
27.01.2019;03:13:04;82790937;82465614;325323;
27.01.2019;03:14:05;82791019;82465714;325305;
27.01.2019;03:15:04;82791124;82465798;325326;
27.01.2019;03:16:04;82791228;82465895;325333;
27.01.2019;03:17:05;82791315;82465987;325328;
27.01.2019;03:18:05;82791429;82466096;325333;
27.01.2019;03:19:04;82791516;82466182;325334;
27.01.2019;03:20:04;82791637;82466256;325381;
27.01.2019;03:21:05;82791749;82466378;325371;
27.01.2019;03:22:05;82791853;82466493;325360;
27.01.2019;03:23:05;82791938;82466609;325329;
27.01.2019;03:24:04;82792025;82466714;325311;
27.01.2019;03:25:05;82792132;82466819;325313;
27.01.2019;03:26:04;82792231;82466923;325308;
27.01.2019;03:27:05;82792328;82467022;325306;
27.01.2019;03:28:04;82792436;82467137;325299;
27.01.2019;03:29:09;82792529;82467247;325282;
27.01.2019;03:30:05;82792627;82467369;325258;
27.01.2019;03:31:04;82792710;82467469;325241;
27.01.2019;03:32:04;82792834;82467560;325274;
27.01.2019;03:33:05;82792937;82467653;325284;
27.01.2019;03:34:05;82793035;82467737;325298;
27.01.2019;03:35:05;82793132;82467865;325267;
27.01.2019;03:36:04;82793234;82467973;325261;
27.01.2019;03:37:04;82793340;82468092;325248;
27.01.2019;03:38:05;82793417;82468203;325214;
27.01.2019;03:39:06;82793514;82468293;325221;
27.01.2019;03:40:04;82793617;82468394;325223;
27.01.2019;03:41:05;82793719;82468509;325210;
27.01.2019;03:42:04;82793837;82468626;325211;
27.01.2019;03:43:04;82793944;82468747;325197;
27.01.2019;03:44:05;82794049;82468851;325198;
27.01.2019;03:45:05;82794171;82468972;325199;
27.01.2019;03:46:05;82794275;82469091;325184;
27.01.2019;03:47:04;82794366;82469208;325158;
27.01.2019;03:48:05;82794482;82469335;325147;
27.01.2019;03:49:05;82794584;82469450;325134;
27.01.2019;03:50:04;82794698;82469564;325134;
27.01.2019;03:51:04;82794795;82469657;325138;
27.01.2019;03:52:05;82794886;82469772;325114;
27.01.2019;03:53:04;82794934;82469847;325087;
27.01.2019;03:54:05;82795041;82469962;325079;
27.01.2019;03:55:05;82795133;82470073;325060;
27.01.2019;03:56:04;82795235;82470210;325025;
27.01.2019;03:57:04;82795342;82470330;325012;
27.01.2019;03:58:05;82795474;82470425;325049;
27.01.2019;03:59:04;82795572;82470565;325007;
27.01.2019;04:00:04;82795674;82470694;324980;
27.01.2019;04:01:04;82795769;82470808;324961;
27.01.2019;04:02:05;82795872;82470946;324926;
27.01.2019;04:03:04;82795981;82471063;324918;
27.01.2019;04:04:05;82796113;82471174;324939;
27.01.2019;04:05:05;82796225;82471308;324917;
27.01.2019;04:06:04;82796312;82471414;324898;
27.01.2019;04:07:04;82796402;82471540;324862;
27.01.2019;04:08:04;82796484;82471656;324828;
27.01.2019;04:09:06;82796576;82471784;324792;
27.01.2019;04:10:04;82796649;82471914;324735;
27.01.2019;04:11:04;82796753;82472046;324707;
27.01.2019;04:12:05;82796871;82472175;324696;
27.01.2019;04:13:04;82796952;82472291;324661;
27.01.2019;04:14:04;82797038;82472410;324628;
27.01.2019;04:15:05;82797132;82472516;324616;
27.01.2019;04:16:04;82797191;82472633;324558;
27.01.2019;04:17:04;82797277;82472768;324509;
27.01.2019;04:18:05;82797343;82472921;324422;
27.01.2019;04:19:04;82797412;82473056;324356;
27.01.2019;04:20:04;82797506;82473164;324342;
27.01.2019;04:21:05;82797586;82473284;324302;
27.01.2019;04:22:04;82797638;82473413;324225;
27.01.2019;04:23:05;82797728;82473561;324167;
27.01.2019;04:24:05;82797836;82473688;324148;
27.01.2019;04:25:04;82797930;82473802;324128;
27.01.2019;04:26:05;82798029;82473930;324099;
27.01.2019;04:27:04;82798135;82474084;324051;
27.01.2019;04:28:04;82798228;82474210;324018;
27.01.2019;04:29:05;82798325;82474331;323994;
27.01.2019;04:30:04;82798430;82474477;323953;
27.01.2019;04:31:04;82798535;82474586;323949;
27.01.2019;04:32:05;82798645;82474727;323918;
27.01.2019;04:33:05;82798746;82474862;323884;
27.01.2019;04:34:04;82798838;82475003;323835;
27.01.2019;04:35:04;82798964;82475106;323858;
27.01.2019;04:36:05;82799059;82475255;323804;
27.01.2019;04:37:05;82799180;82475392;323788;
27.01.2019;04:38:04;82799295;82475524;323771;
27.01.2019;04:39:04;82799388;82475671;323717;
27.01.2019;04:40:05;82799498;82475827;323671;
27.01.2019;04:41:04;82799624;82475953;323671;
27.01.2019;04:42:04;82799720;82476094;323626;
27.01.2019;04:43:05;82799824;82476253;323571;
27.01.2019;04:44:05;82799931;82476398;323533;
27.01.2019;04:45:04;82800054;82476547;323507;
27.01.2019;04:46:05;82800167;82476681;323486;
27.01.2019;04:47:04;82800257;82476814;323443;
27.01.2019;04:48:04;82800353;82476971;323382;
27.01.2019;04:49:04;82800468;82477087;323381;
27.01.2019;04:50:05;82800575;82477199;323376;
27.01.2019;04:51:04;82800680;82477345;323335;
27.01.2019;04:52:04;82800790;82477471;323319;
27.01.2019;04:53:05;82800903;82477618;323285;
27.01.2019;04:54:05;82801014;82477755;323259;
27.01.2019;04:55:04;82801127;82477931;323196;
27.01.2019;04:56:05;82801239;82478077;323162;
27.01.2019;04:57:04;82801340;82478209;323131;
27.01.2019;04:58:05;82801439;82478350;323089;
27.01.2019;04:59:05;82801534;82478478;323056;
27.01.2019;05:00:04;82801644;82478609;323035;
27.01.2019;05:01:04;82801756;82478758;322998;
27.01.2019;05:02:05;82801859;82478925;322934;
27.01.2019;05:03:04;82801952;82479070;322882;
27.01.2019;05:04:05;82802055;82479215;322840;
27.01.2019;05:05:05;82802155;82479370;322785;
27.01.2019;05:06:04;82802253;82479515;322738;
27.01.2019;05:07:04;82802368;82479683;322685;
27.01.2019;05:08:05;82802479;82479816;322663;
27.01.2019;05:09:05;82802565;82479974;322591;
27.01.2019;05:10:04;82802664;82480137;322527;
27.01.2019;05:11:04;82802763;82480264;322499;
27.01.2019;05:12:05;82802868;82480393;322475;
27.01.2019;05:13:04;82802957;82480539;322418;
27.01.2019;05:14:05;82803064;82480682;322382;
27.01.2019;05:15:05;82803185;82480823;322362;
27.01.2019;05:16:05;82803280;82480970;322310;
27.01.2019;05:17:05;82803384;82481129;322255;
27.01.2019;05:18:04;82803499;82481281;322218;
27.01.2019;05:19:04;82803606;82481443;322163;
27.01.2019;05:20:05;82803723;82481577;322146;
27.01.2019;05:21:05;82803832;82481708;322124;
27.01.2019;05:22:05;82803932;82481844;322088;
27.01.2019;05:23:04;82804031;82481990;322041;
27.01.2019;05:24:04;82804129;82482112;322017;
27.01.2019;05:25:05;82804237;82482262;321975;
27.01.2019;05:26:04;82804341;82482393;321948;
27.01.2019;05:27:04;82804435;82482536;321899;
27.01.2019;05:28:05;82804510;82482691;321819;
27.01.2019;05:29:04;82804596;82482832;321764;
27.01.2019;05:30:05;82804709;82482991;321718;
27.01.2019;05:31:05;82804809;82483137;321672;
27.01.2019;05:32:05;82804892;82483271;321621;
27.01.2019;05:33:04;82804984;82483430;321554;
27.01.2019;05:34:05;82805104;82483581;321523;
27.01.2019;05:35:04;82805188;82483735;321453;
27.01.2019;05:36:05;82805281;82483866;321415;
27.01.2019;05:37:04;82805372;82484014;321358;
27.01.2019;05:38:04;82805469;82484173;321296;
27.01.2019;05:39:05;82805578;82484315;321263;
27.01.2019;05:40:04;82805664;82484454;321210;
27.01.2019;05:41:05;82805782;82484617;321165;
27.01.2019;05:42:05;82805864;82484780;321084;
27.01.2019;05:43:04;82805969;82484927;321042;
27.01.2019;05:44:04;82806067;82485095;320972;
27.01.2019;05:45:05;82806184;82485257;320927;
27.01.2019;05:46:04;82806280;82485417;320863;
27.01.2019;05:47:05;82806380;82485575;320805;
27.01.2019;05:48:05;82806487;82485732;320755;
27.01.2019;05:49:04;82806598;82485870;320728;
27.01.2019;05:50:04;82806696;82486022;320674;
27.01.2019;05:51:05;82806788;82486167;320621;
27.01.2019;05:52:04;82806899;82486368;320531;
27.01.2019;05:53:05;82807017;82486536;320481;
27.01.2019;05:54:05;82807123;82486684;320439;
27.01.2019;05:55:04;82807225;82486853;320372;
27.01.2019;05:56:04;82807320;82486999;320321;
27.01.2019;05:57:05;82807397;82487148;320249;
27.01.2019;05:58:04;82807486;82487295;320191;
27.01.2019;05:59:04;82807611;82487438;320173;
27.01.2019;06:00:05;82807716;82487585;320131;
27.01.2019;06:01:04;82807815;82487758;320057;
27.01.2019;06:02:04;82807918;82487905;320013;
27.01.2019;06:03:05;82808023;82488074;319949;
27.01.2019;06:04:04;82808115;82488241;319874;
27.01.2019;06:05:05;82808220;82488387;319833;
27.01.2019;06:06:05;82808305;82488554;319751;
27.01.2019;06:07:05;82808400;82488708;319692;
27.01.2019;06:08:04;82808497;82488870;319627;
27.01.2019;06:09:04;82808613;82489028;319585;
27.01.2019;06:10:05;82808694;82489191;319503;
27.01.2019;06:11:05;82808798;82489333;319465;
27.01.2019;06:12:04;82808899;82489502;319397;
27.01.2019;06:13:04;82808988;82489636;319352;
27.01.2019;06:14:05;82809071;82489802;319269;
27.01.2019;06:15:04;82809152;82489942;319210;
27.01.2019;06:16:04;82809198;82490049;319149;
27.01.2019;06:17:06;82809271;82490187;319084;
27.01.2019;06:18:04;82809338;82490316;319022;
27.01.2019;06:19:04;82809436;82490466;318970;
27.01.2019;06:20:05;82809527;82490609;318918;
27.01.2019;06:21:04;82809626;82490740;318886;
27.01.2019;06:22:04;82809708;82490866;318842;
27.01.2019;06:23:06;82809803;82491042;318761;
27.01.2019;06:24:04;82809867;82491198;318669;
27.01.2019;06:25:07;82809967;82491370;318597;
27.01.2019;06:26:04;82810054;82491526;318528;
27.01.2019;06:27:05;82810150;82491683;318467;
27.01.2019;06:28:05;82810251;82491816;318435;
27.01.2019;06:29:05;82810339;82491989;318350;
27.01.2019;06:30:05;82810411;82492141;318270;
27.01.2019;06:31:05;82810487;82492334;318153;
27.01.2019;06:32:04;82810578;82492486;318092;
27.01.2019;06:33:04;82810688;82492632;318056;
27.01.2019;06:34:05;82810791;82492799;317992;
27.01.2019;06:35:04;82810882;82492971;317911;
27.01.2019;06:36:04;82810969;82493106;317863;
27.01.2019;06:37:05;82811060;82493248;317812;
27.01.2019;06:38:04;82811166;82493429;317737;
27.01.2019;06:39:06;82811263;82493580;317683;
27.01.2019;06:40:05;82811348;82493739;317609;
27.01.2019;06:41:04;82811453;82493899;317554;
27.01.2019;06:42:04;82811549;82494045;317504;
27.01.2019;06:43:05;82811656;82494181;317475;
27.01.2019;06:44:04;82811726;82494321;317405;
27.01.2019;06:45:04;82811819;82494470;317349;
27.01.2019;06:46:04;82811896;82494633;317263;
27.01.2019;06:47:08;82811934;82494770;317164;
27.01.2019;06:48:04;82812007;82494913;317094;
27.01.2019;06:49:04;82812104;82495073;317031;
27.01.2019;06:50:05;82812179;82495194;316985;
27.01.2019;06:51:04;82812281;82495329;316952;
27.01.2019;06:52:04;82812380;82495443;316937;
27.01.2019;06:53:05;82812482;82495597;316885;
27.01.2019;06:54:04;82812569;82495722;316847;
27.01.2019;06:55:04;82812654;82495824;316830;
27.01.2019;06:56:05;82812755;82495961;316794;
27.01.2019;06:57:05;82812833;82496113;316720;
27.01.2019;06:58:04;82812922;82496266;316656;
27.01.2019;06:59:04;82813028;82496389;316639;
27.01.2019;07:00:05;82813119;82496529;316590;
27.01.2019;07:01:04;82813200;82496662;316538;
27.01.2019;07:02:04;82813284;82496814;316470;
27.01.2019;07:03:05;82813375;82496959;316416;
27.01.2019;07:04:04;82813447;82497137;316310;
27.01.2019;07:05:04;82813533;82497280;316253;
27.01.2019;07:06:05;82813637;82497404;316233;
27.01.2019;07:07:05;82813723;82497525;316198;
27.01.2019;07:08:05;82813823;82497703;316120;
27.01.2019;07:09:06;82813915;82497883;316032;
27.01.2019;07:10:04;82814006;82498034;315972;
27.01.2019;07:11:05;82814099;82498176;315923;
27.01.2019;07:12:04;82814182;82498332;315850;
27.01.2019;07:13:05;82814268;82498494;315774;
27.01.2019;07:14:05;82814353;82498630;315723;
27.01.2019;07:15:04;82814448;82498755;315693;
27.01.2019;07:16:04;82814540;82498892;315648;
27.01.2019;07:17:05;82814621;82499070;315551;
27.01.2019;07:18:05;82814707;82499239;315468;
27.01.2019;07:19:05;82814788;82499382;315406;
27.01.2019;07:20:04;82814888;82499522;315366;
27.01.2019;07:21:04;82814965;82499688;315277;
27.01.2019;07:22:05;82815051;82499835;315216;
27.01.2019;07:23:05;82815134;82499983;315151;
27.01.2019;07:24:05;82815225;82500148;315077;
27.01.2019;07:25:04;82815322;82500293;315029;
27.01.2019;07:26:04;82815415;82500473;314942;
27.01.2019;07:27:05;82815510;82500641;314869;
27.01.2019;07:28:04;82815592;82500797;314795;
27.01.2019;07:29:04;82815684;82500947;314737;
27.01.2019;07:30:04;82815776;82501101;314675;
27.01.2019;07:31:05;82815863;82501256;314607;
27.01.2019;07:32:04;82815953;82501406;314547;
27.01.2019;07:33:04;82816054;82501546;314508;
27.01.2019;07:34:05;82816151;82501684;314467;
27.01.2019;07:35:05;82816237;82501821;314416;
27.01.2019;07:36:05;82816301;82501996;314305;
27.01.2019;07:37:05;82816366;82502122;314244;
27.01.2019;07:38:04;82816462;82502278;314184;
27.01.2019;07:39:05;82816538;82502418;314120;
27.01.2019;07:40:05;82816634;82502572;314062;
27.01.2019;07:41:05;82816710;82502726;313984;
27.01.2019;07:42:04;82816777;82502860;313917;
27.01.2019;07:43:05;82816856;82503017;313839;
27.01.2019;07:44:05;82816929;82503179;313750;
27.01.2019;07:45:04;82817020;82503329;313691;
27.01.2019;07:46:05;82817125;82503501;313624;
27.01.2019;07:47:05;82817187;82503667;313520;
27.01.2019;07:48:04;82817238;82503818;313420;
27.01.2019;07:49:04;82817317;82503967;313350;
27.01.2019;07:50:05;82817383;82504103;313280;
27.01.2019;07:51:05;82817473;82504258;313215;
27.01.2019;07:52:04;82817542;82504395;313147;
27.01.2019;07:53:05;82817618;82504559;313059;
27.01.2019;07:54:04;82817679;82504679;313000;
27.01.2019;07:55:05;82817759;82504815;312944;
27.01.2019;07:56:11;82817846;82505008;312838;
27.01.2019;07:57:07;82817929;82505160;312769;
27.01.2019;07:58:04;82817999;82505303;312696;
27.01.2019;07:59:05;82818079;82505472;312607;
27.01.2019;08:00:05;82818164;82505610;312554;
27.01.2019;08:01:04;82818256;82505761;312495;
27.01.2019;08:02:05;82818307;82505932;312375;
27.01.2019;08:03:08;82818337;82506089;312248;
27.01.2019;08:04:07;82818387;82506204;312183;
27.01.2019;08:05:05;82818430;82506324;312106;
27.01.2019;08:06:05;82818482;82506453;312029;
27.01.2019;08:07:05;82818542;82506581;311961;
27.01.2019;08:08:06;82818591;82506737;311854;
27.01.2019;08:09:06;82818667;82506873;311794;
27.01.2019;08:10:10;82818777;82507030;311747;
27.01.2019;08:11:06;82818831;82507154;311677;
27.01.2019;08:12:06;82818882;82507308;311574;
27.01.2019;08:13:06;82818950;82507429;311521;
27.01.2019;08:14:10;82819026;82507576;311450;
27.01.2019;08:15:11;82819089;82507736;311353;
27.01.2019;08:16:08;82819150;82507860;311290;
27.01.2019;08:17:05;82819211;82508010;311201;
27.01.2019;08:18:12;82819275;82508183;311092;
27.01.2019;08:19:06;82819356;82508302;311054;
27.01.2019;08:20:04;82819426;82508459;310967;
27.01.2019;08:21:05;82819478;82508614;310864;
27.01.2019;08:22:09;82819556;82508765;310791;
27.01.2019;08:23:06;82819637;82508919;310718;
27.01.2019;08:24:05;82819723;82509018;310705;
27.01.2019;08:25:05;82819793;82509164;310629;
27.01.2019;08:26:05;82819856;82509317;310539;
27.01.2019;08:27:06;82819925;82509485;310440;
27.01.2019;08:28:06;82819983;82509638;310345;
27.01.2019;08:29:11;82820051;82509786;310265;
27.01.2019;08:30:05;82820130;82509915;310215;
27.01.2019;08:31:06;82820182;82510075;310107;
27.01.2019;08:32:05;82820263;82510233;310030;
27.01.2019;08:33:06;82820346;82510366;309980;
27.01.2019;08:34:04;82820415;82510487;309928;
27.01.2019;08:35:06;82820494;82510642;309852;
27.01.2019;08:36:05;82820590;82510785;309805;
27.01.2019;08:37:04;82820670;82510912;309758;
27.01.2019;08:38:04;82820743;82511082;309661;
27.01.2019;08:39:06;82820808;82511241;309567;
27.01.2019;08:40:06;82820869;82511385;309484;
27.01.2019;08:41:05;82820938;82511532;309406;
27.01.2019;08:42:04;82821013;82511664;309349;
27.01.2019;08:43:04;82821075;82511837;309238;
27.01.2019;08:44:05;82821152;82511970;309182;
27.01.2019;08:45:05;82821211;82512161;309050;
27.01.2019;08:46:05;82821297;82512321;308976;
27.01.2019;08:47:05;82821380;82512464;308916;
27.01.2019;08:48:05;82821439;82512598;308841;
27.01.2019;08:49:04;82821536;82512698;308838;
27.01.2019;08:50:04;82821613;82512855;308758;
27.01.2019;08:51:05;82821702;82512989;308713;
27.01.2019;08:52:05;82821770;82513149;308621;
27.01.2019;08:53:05;82821843;82513272;308571;
27.01.2019;08:54:04;82821909;82513418;308491;
27.01.2019;08:55:05;82821994;82513564;308430;
27.01.2019;08:56:04;82822079;82513734;308345;
27.01.2019;08:57:05;82822156;82513896;308260;
27.01.2019;08:58:04;82822239;82514037;308202;
27.01.2019;08:59:05;82822312;82514200;308112;
27.01.2019;09:00:05;82822402;82514347;308055;
27.01.2019;09:01:04;82822467;82514504;307963;
27.01.2019;09:02:05;82822541;82514668;307873;
27.01.2019;09:03:05;82822603;82514807;307796;
27.01.2019;09:04:04;82822668;82514959;307709;
27.01.2019;09:05:04;82822736;82515096;307640;
27.01.2019;09:06:05;82822816;82515242;307574;
27.01.2019;09:07:05;82822883;82515377;307506;
27.01.2019;09:08:04;82822949;82515550;307399;
27.01.2019;09:09:06;82823036;82515722;307314;
27.01.2019;09:10:05;82823097;82515868;307229;
27.01.2019;09:11:04;82823168;82516020;307148;
27.01.2019;09:13:05;82823316;82516325;306991;
27.01.2019;09:14:04;82823382;82516452;306930;
27.01.2019;09:15:04;82823479;82516612;306867;
27.01.2019;09:16:05;82823546;82516762;306784;
27.01.2019;09:17:05;82823623;82516909;306714;
27.01.2019;09:18:05;82823687;82517060;306627;
27.01.2019;09:19:04;82823764;82517192;306572;
27.01.2019;09:20:05;82823835;82517341;306494;
27.01.2019;09:21:04;82823900;82517466;306434;
27.01.2019;09:22:04;82823954;82517630;306324;
27.01.2019;09:23:05;82824007;82517775;306232;
27.01.2019;09:24:04;82824069;82517922;306147;
27.01.2019;09:25:04;82824138;82518068;306070;
27.01.2019;09:26:05;82824205;82518236;305969;
27.01.2019;09:27:05;82824277;82518407;305870;
27.01.2019;09:28:05;82824353;82518541;305812;
27.01.2019;09:29:05;82824432;82518684;305748;
27.01.2019;09:30:04;82824512;82518850;305662;
27.01.2019;09:31:04;82824577;82519004;305573;
27.01.2019;09:32:04;82824662;82519151;305511;
27.01.2019;09:33:05;82824730;82519298;305432;
27.01.2019;09:34:05;82824776;82519449;305327;
27.01.2019;09:35:05;82824838;82519590;305248;
27.01.2019;09:36:05;82824903;82519726;305177;
27.01.2019;09:37:04;82824975;82519871;305104;
27.01.2019;09:38:04;82825074;82520030;305044;
27.01.2019;09:39:07;82825154;82520184;304970;
27.01.2019;09:40:05;82825217;82520314;304903;
27.01.2019;09:41:04;82825298;82520460;304838;
27.01.2019;09:42:04;82825363;82520608;304755;
27.01.2019;09:43:05;82825439;82520777;304662;
27.01.2019;09:44:05;82825524;82520936;304588;
27.01.2019;09:45:05;82825556;82521061;304495;
27.01.2019;09:46:05;82825575;82521157;304418;
27.01.2019;09:47:05;82825628;82521309;304319;
27.01.2019;09:48:05;82825698;82521466;304232;
27.01.2019;09:49:05;82825773;82521608;304165;
27.01.2019;09:50:05;82825850;82521771;304079;
27.01.2019;09:51:04;82825909;82521908;304001;
27.01.2019;09:52:04;82825963;82522065;303898;
27.01.2019;09:53:05;82826047;82522263;303784;
27.01.2019;09:54:05;82826109;82522400;303709;
27.01.2019;09:55:04;82826181;82522525;303656;
27.01.2019;09:56:05;82826256;82522678;303578;
27.01.2019;09:57:04;82826310;82522837;303473;
27.01.2019;09:58:05;82826386;82522975;303411;
27.01.2019;09:59:05;82826458;82523136;303322;
27.01.2019;10:00:05;82826507;82523313;303194;
27.01.2019;10:01:04;82826581;82523476;303105;
27.01.2019;10:02:05;82826658;82523620;303038;
27.01.2019;10:03:04;82826729;82523765;302964;
27.01.2019;10:04:04;82826808;82523903;302905;
27.01.2019;10:05:05;82826904;82524080;302824;
27.01.2019;10:06:04;82826968;82524215;302753;
27.01.2019;10:07:05;82827028;82524370;302658;
27.01.2019;10:08:05;82827084;82524525;302559;
27.01.2019;10:09:07;82827159;82524687;302472;
27.01.2019;10:10:10;82827215;82524860;302355;
27.01.2019;10:11:05;82827266;82524984;302282;
27.01.2019;10:12:05;82827324;82525104;302220;
27.01.2019;10:13:04;82827374;82525241;302133;
27.01.2019;10:14:05;82827439;82525344;302095;
27.01.2019;10:15:04;82827458;82525477;301981;
27.01.2019;10:16:04;82827505;82525634;301871;
27.01.2019;10:17:06;82827570;82525782;301788;
27.01.2019;10:18:05;82827621;82525919;301702;
27.01.2019;10:19:05;82827668;82526049;301619;
27.01.2019;10:20:05;82827708;82526172;301536;
27.01.2019;10:21:04;82827759;82526269;301490;
27.01.2019;10:22:05;82827793;82526395;301398;
27.01.2019;10:23:05;82827854;82526555;301299;
27.01.2019;10:24:05;82827919;82526682;301237;
27.01.2019;10:25:05;82827991;82526822;301169;
27.01.2019;10:26:05;82828040;82526976;301064;
27.01.2019;10:27:04;82828111;82527129;300982;
27.01.2019;10:28:04;82828170;82527274;300896;
27.01.2019;10:29:05;82828246;82527440;300806;
27.01.2019;10:30:04;82828312;82527619;300693;
27.01.2019;10:31:05;82828381;82527761;300620;
27.01.2019;10:32:05;82828458;82527881;300577;
27.01.2019;10:33:04;82828530;82528029;300501;
27.01.2019;10:34:04;82828606;82528217;300389;
27.01.2019;10:35:05;82828678;82528363;300315;
27.01.2019;10:36:06;82828754;82528521;300233;
27.01.2019;10:37:05;82828828;82528644;300184;
27.01.2019;10:38:05;82828897;82528772;300125;
27.01.2019;10:39:05;82828981;82528916;300065;
27.01.2019;10:40:04;82829052;82529082;299970;
27.01.2019;10:41:11;82829117;82529210;299907;
27.01.2019;10:42:06;82829179;82529327;299852;
27.01.2019;10:43:05;82829255;82529497;299758;
27.01.2019;10:44:12;82829327;82529666;299661;
27.01.2019;10:45:05;82829410;82529797;299613;
27.01.2019;10:46:04;82829494;82529951;299543;
27.01.2019;10:47:05;82829561;82530153;299408;
27.01.2019;10:48:04;82829640;82530304;299336;
27.01.2019;10:49:05;82829708;82530475;299233;
27.01.2019;10:50:04;82829778;82530632;299146;
27.01.2019;10:51:04;82829843;82530765;299078;
27.01.2019;10:52:05;82829923;82530939;298984;
27.01.2019;10:53:05;82830002;82531108;298894;
27.01.2019;10:54:04;82830083;82531263;298820;
27.01.2019;10:55:04;82830142;82531422;298720;
27.01.2019;10:56:05;82830188;82531568;298620;
27.01.2019;10:57:04;82830248;82531732;298516;
27.01.2019;10:58:04;82830330;82531875;298455;
27.01.2019;10:59:05;82830419;82532035;298384;
27.01.2019;11:00:05;82830507;82532204;298303;
27.01.2019;11:01:04;82830568;82532365;298203;
27.01.2019;11:02:04;82830664;82532520;298144;
27.01.2019;11:03:05;82830714;82532711;298003;
27.01.2019;11:04:05;82830776;82532865;297911;
27.01.2019;11:05:05;82830864;82533018;297846;
27.01.2019;11:06:04;82830924;82533165;297759;
27.01.2019;11:07:05;82831003;82533313;297690;
27.01.2019;11:08:04;82831075;82533477;297598;
27.01.2019;11:09:06;82831126;82533654;297472;
27.01.2019;11:10:05;82831196;82533811;297385;
27.01.2019;11:11:04;82831261;82533942;297319;
27.01.2019;11:12:05;82831329;82534098;297231;
27.01.2019;11:13:04;82831394;82534212;297182;
27.01.2019;11:14:05;82831455;82534354;297101;
27.01.2019;11:15:05;82831520;82534501;297019;
27.01.2019;11:16:05;82831579;82534624;296955;
27.01.2019;11:17:04;82831624;82534757;296867;
27.01.2019;11:18:05;82831678;82534904;296774;
27.01.2019;11:19:05;82831735;82535062;296673;
27.01.2019;11:20:05;82831806;82535210;296596;
27.01.2019;11:21:05;82831877;82535367;296510;
27.01.2019;11:22:04;82831945;82535523;296422;
27.01.2019;11:23:05;82831997;82535672;296325;
27.01.2019;11:24:05;82832056;82535830;296226;
27.01.2019;11:25:04;82832117;82535987;296130;
27.01.2019;11:26:04;82832178;82536122;296056;
27.01.2019;11:27:05;82832241;82536262;295979;
27.01.2019;11:28:04;82832303;82536430;295873;
27.01.2019;11:29:05;82832374;82536559;295815;
27.01.2019;11:30:06;82832450;82536716;295734;
27.01.2019;11:31:05;82832538;82536878;295660;
27.01.2019;11:32:05;82832598;82537042;295556;
27.01.2019;11:33:04;82832649;82537233;295416;
27.01.2019;11:34:05;82832730;82537372;295358;
27.01.2019;11:35:04;82832783;82537521;295262;
27.01.2019;11:36:05;82832858;82537662;295196;
27.01.2019;11:37:05;82832919;82537800;295119;
27.01.2019;11:38:07;82832981;82537946;295035;
27.01.2019;11:39:05;82833045;82538081;294964;
27.01.2019;11:40:05;82833106;82538219;294887;
27.01.2019;11:41:06;82833175;82538373;294802;
27.01.2019;11:42:05;82833253;82538522;294731;
27.01.2019;11:43:04;82833319;82538679;294640;
27.01.2019;11:44:05;82833391;82538827;294564;
27.01.2019;11:45:05;82833474;82539002;294472;
27.01.2019;11:46:04;82833544;82539131;294413;
27.01.2019;11:47:04;82833593;82539285;294308;
27.01.2019;11:48:05;82833670;82539441;294229;
27.01.2019;11:49:05;82833739;82539579;294160;
27.01.2019;11:50:04;82833825;82539732;294093;
27.01.2019;11:51:04;82833897;82539876;294021;
27.01.2019;11:52:05;82833956;82540012;293944;
27.01.2019;11:53:05;82834027;82540180;293847;
27.01.2019;11:54:04;82834102;82540300;293802;
27.01.2019;11:55:04;82834182;82540431;293751;
27.01.2019;11:56:04;82834256;82540576;293680;
27.01.2019;11:57:05;82834332;82540737;293595;
27.01.2019;11:58:05;82834419;82540883;293536;
27.01.2019;11:59:04;82834492;82541057;293435;
27.01.2019;12:00:05;82834565;82541192;293373;
27.01.2019;12:01:04;82834621;82541333;293288;
27.01.2019;12:02:05;82834680;82541467;293213;
27.01.2019;12:03:05;82834753;82541621;293132;
27.01.2019;12:04:04;82834815;82541770;293045;
27.01.2019;12:05:05;82834880;82541923;292957;
27.01.2019;12:06:05;82834940;82542073;292867;
27.01.2019;12:07:04;82835024;82542207;292817;
27.01.2019;12:08:04;82835088;82542366;292722;
27.01.2019;12:09:05;82835141;82542491;292650;
27.01.2019;12:10:05;82835178;82542645;292533;
27.01.2019;12:11:05;82835221;82542773;292448;
27.01.2019;12:12:05;82835268;82542903;292365;
27.01.2019;12:13:04;82835307;82543001;292306;
27.01.2019;12:14:05;82835341;82543126;292215;
27.01.2019;12:15:05;82835377;82543262;292115;
27.01.2019;12:16:05;82835415;82543394;292021;
27.01.2019;12:17:04;82835459;82543512;291947;
27.01.2019;12:18:04;82835517;82543637;291880;
27.01.2019;12:19:05;82835564;82543792;291772;
27.01.2019;12:20:04;82835627;82543939;291688;
27.01.2019;12:21:05;82835678;82544095;291583;
27.01.2019;12:22:05;82835727;82544248;291479;
27.01.2019;12:23:05;82835802;82544404;291398;
27.01.2019;12:24:05;82835846;82544531;291315;
27.01.2019;12:25:04;82835911;82544667;291244;
27.01.2019;12:26:04;82835998;82544840;291158;
27.01.2019;12:27:05;82836071;82544999;291072;
27.01.2019;12:28:05;82836133;82545136;290997;
27.01.2019;12:29:05;82836200;82545273;290927;
27.01.2019;12:30:05;82836283;82545423;290860;
27.01.2019;12:31:05;82836359;82545585;290774;
27.01.2019;12:32:04;82836422;82545749;290673;
27.01.2019;12:33:06;82836472;82545879;290593;
27.01.2019;12:34:05;82836536;82546023;290513;
27.01.2019;12:35:05;82836599;82546175;290424;
27.01.2019;12:36:04;82836666;82546327;290339;
27.01.2019;12:37:05;82836738;82546474;290264;
27.01.2019;12:38:05;82836810;82546618;290192;
27.01.2019;12:39:07;82836862;82546770;290092;
27.01.2019;12:40:05;82836941;82546925;290016;
27.01.2019;12:41:05;82837011;82547083;289928;
27.01.2019;12:42:04;82837090;82547228;289862;
27.01.2019;12:43:04;82836851;82547154;289697;
27.01.2019;12:44:04;82836595;82547020;289575;
27.01.2019;12:45:06;82836670;82547190;289480;
27.01.2019;12:46:05;82836750;82547326;289424;
27.01.2019;12:47:04;82836835;82547468;289367;
27.01.2019;12:48:05;82836926;82547626;289300;
27.01.2019;12:49:05;82836976;82547771;289205;
27.01.2019;12:50:05;82837060;82547905;289155;
27.01.2019;12:51:04;82837138;82548055;289083;
27.01.2019;12:52:05;82837225;82548182;289043;
27.01.2019;12:53:05;82837296;82548342;288954;
27.01.2019;12:54:05;82837390;82548466;288924;
27.01.2019;12:55:05;82837462;82548600;288862;
27.01.2019;12:56:04;82837536;82548739;288797;
27.01.2019;12:57:04;82837622;82548877;288745;
27.01.2019;12:58:05;82837693;82549029;288664;
27.01.2019;12:59:05;82837774;82549167;288607;
27.01.2019;13:00:05;82837860;82549322;288538;
27.01.2019;13:01:05;82837938;82549468;288470;
27.01.2019;13:02:04;82837979;82549614;288365;
27.01.2019;13:03:04;82838045;82549756;288289;
27.01.2019;13:04:05;82838142;82549903;288239;
27.01.2019;13:05:05;82838220;82550041;288179;
27.01.2019;13:06:05;82838294;82550180;288114;
27.01.2019;13:07:05;82838371;82550322;288049;
27.01.2019;13:08:04;82838421;82550484;287937;
27.01.2019;13:09:04;82838507;82550623;287884;
27.01.2019;13:10:05;82838575;82550791;287784;
27.01.2019;13:11:05;82838654;82550956;287698;
27.01.2019;13:12:04;82838724;82551098;287626;
27.01.2019;13:13:05;82838799;82551243;287556;
27.01.2019;13:14:04;82838868;82551379;287489;
27.01.2019;13:15:04;82838930;82551533;287397;
27.01.2019;13:16:05;82839009;82551647;287362;
27.01.2019;13:17:05;82839076;82551799;287277;
27.01.2019;13:18:05;82839148;82551957;287191;
27.01.2019;13:19:05;82839221;82552086;287135;
27.01.2019;13:20:04;82839275;82552256;287019;
27.01.2019;13:21:04;82839361;82552389;286972;
27.01.2019;13:22:04;82839428;82552548;286880;
27.01.2019;13:23:05;82839504;82552716;286788;
27.01.2019;13:24:05;82839598;82552872;286726;
27.01.2019;13:25:05;82839667;82553018;286649;
27.01.2019;13:26:05;82839739;82553177;286562;
27.01.2019;13:27:05;82839824;82553348;286476;
27.01.2019;13:28:04;82839896;82553504;286392;
27.01.2019;13:29:04;82839966;82553652;286314;
27.01.2019;13:30:05;82840037;82553802;286235;
27.01.2019;13:31:05;82840121;82553947;286174;
27.01.2019;13:32:05;82840190;82554082;286108;
27.01.2019;13:33:05;82840271;82554248;286023;
27.01.2019;13:34:05;82840358;82554401;285957;
27.01.2019;13:35:05;82840443;82554534;285909;
27.01.2019;13:36:04;82840507;82554681;285826;
27.01.2019;13:37:04;82840568;82554826;285742;
27.01.2019;13:38:04;82840645;82554968;285677;
27.01.2019;13:39:07;82840714;82555148;285566;
27.01.2019;13:40:05;82840779;82555315;285464;
27.01.2019;13:41:05;82840850;82555466;285384;
27.01.2019;13:42:04;82840934;82555603;285331;
27.01.2019;13:43:04;82841031;82555773;285258;
27.01.2019;13:44:04;82841114;82555906;285208;
27.01.2019;13:45:05;82841171;82556082;285089;
27.01.2019;13:46:05;82841242;82556222;285020;
27.01.2019;13:47:05;82841348;82556363;284985;
27.01.2019;13:48:05;82841422;82556496;284926;
27.01.2019;13:49:05;82841506;82556613;284893;
27.01.2019;13:50:05;82841574;82556755;284819;
27.01.2019;13:51:05;82841645;82556892;284753;
27.01.2019;13:52:05;82841726;82557053;284673;
27.01.2019;13:53:05;82841794;82557221;284573;
27.01.2019;13:54:05;82841882;82557364;284518;
27.01.2019;13:55:05;82841960;82557507;284453;
27.01.2019;13:56:05;82842037;82557659;284378;
27.01.2019;13:57:05;82842125;82557790;284335;
27.01.2019;13:58:05;82842211;82557971;284240;
27.01.2019;13:59:04;82842289;82558137;284152;
27.01.2019;14:00:04;82842368;82558289;284079;
27.01.2019;14:01:04;82842452;82558457;283995;
27.01.2019;14:02:05;82842534;82558608;283926;
27.01.2019;14:03:05;82842624;82558769;283855;
27.01.2019;14:04:04;82842691;82558903;283788;
27.01.2019;14:05:05;82842771;82559047;283724;
27.01.2019;14:06:05;82842840;82559191;283649;
27.01.2019;14:07:04;82842899;82559324;283575;
27.01.2019;14:08:04;82842976;82559447;283529;
27.01.2019;14:09:04;82843047;82559577;283470;
27.01.2019;14:10:04;82843108;82559723;283385;
27.01.2019;14:11:05;82843177;82559880;283297;
27.01.2019;14:12:05;82843246;82560038;283208;
27.01.2019;14:13:04;82843339;82560178;283161;
27.01.2019;14:14:04;82843390;82560307;283083;
27.01.2019;14:15:05;82843472;82560437;283035;
27.01.2019;14:16:05;82843532;82560579;282953;
27.01.2019;14:17:10;82843620;82560738;282882;
27.01.2019;14:18:05;82843693;82560875;282818;
27.01.2019;14:19:04;82843749;82561038;282711;
27.01.2019;14:20:04;82843817;82561195;282622;
27.01.2019;14:21:04;82843889;82561322;282567;
27.01.2019;14:22:04;82843971;82561486;282485;
27.01.2019;14:23:04;82844044;82561641;282403;
27.01.2019;14:24:05;82844108;82561788;282320;
27.01.2019;14:25:04;82844186;82561952;282234;
27.01.2019;14:26:04;82844257;82562117;282140;
27.01.2019;14:27:04;82844331;82562268;282063;
27.01.2019;14:28:04;82844383;82562409;281974;
27.01.2019;14:29:05;82844434;82562564;281870;
27.01.2019;14:30:05;82844501;82562695;281806;
27.01.2019;14:31:04;82844566;82562832;281734;
27.01.2019;14:32:05;82844655;82563017;281638;
27.01.2019;14:33:05;82844726;82563177;281549;
27.01.2019;14:34:05;82844813;82563314;281499;
27.01.2019;14:35:04;82844871;82563466;281405;
27.01.2019;14:36:04;82844932;82563624;281308;
27.01.2019;14:37:04;82845008;82563758;281250;
27.01.2019;14:38:05;82845077;82563907;281170;
27.01.2019;14:39:07;82845151;82564083;281068;
27.01.2019;14:40:06;82845217;82564231;280986;
27.01.2019;14:41:04;82845315;82564389;280926;
27.01.2019;14:42:04;82845388;82564535;280853;
27.01.2019;14:43:05;82845445;82564662;280783;
27.01.2019;14:44:05;82845533;82564818;280715;
27.01.2019;14:45:04;82845616;82564985;280631;
27.01.2019;14:46:04;82845684;82565170;280514;
27.01.2019;14:47:05;82845776;82565330;280446;
27.01.2019;14:48:04;82845846;82565469;280377;
27.01.2019;14:49:04;82845929;82565628;280301;
27.01.2019;14:50:05;82846017;82565796;280221;
27.01.2019;14:51:05;82846083;82565932;280151;
27.01.2019;14:52:05;82846172;82566094;280078;
27.01.2019;14:53:04;82846258;82566266;279992;
27.01.2019;14:54:04;82846338;82566404;279934;
27.01.2019;14:55:05;82846407;82566577;279830;
27.01.2019;14:56:04;82846485;82566719;279766;
27.01.2019;14:57:05;82846585;82566879;279706;
27.01.2019;14:58:05;82846682;82567042;279640;
27.01.2019;14:59:05;82846767;82567186;279581;
27.01.2019;15:00:08;82846844;82567345;279499;
27.01.2019;15:01:08;82846912;82567485;279427;
27.01.2019;15:02:07;82846997;82567619;279378;
27.01.2019;15:03:08;82847071;82567800;279271;
27.01.2019;15:04:07;82847148;82567940;279208;
27.01.2019;15:05:07;82847262;82568127;279135;
27.01.2019;15:06:08;82847360;82568296;279064;
27.01.2019;15:07:08;82847447;82568439;279008;
27.01.2019;15:08:07;82847520;82568598;278922;
27.01.2019;15:09:08;82847606;82568766;278840;
27.01.2019;15:10:07;82847703;82568941;278762;
27.01.2019;15:11:07;82847780;82569091;278689;
27.01.2019;15:12:08;82847866;82569242;278624;
27.01.2019;15:13:07;82847942;82569399;278543;
27.01.2019;15:14:08;82848047;82569554;278493;
27.01.2019;15:15:07;82848125;82569700;278425;
27.01.2019;15:16:07;82848201;82569859;278342;
27.01.2019;15:17:08;82848301;82570033;278268;
27.01.2019;15:18:08;82848386;82570196;278190;
27.01.2019;15:19:08;82848472;82570340;278132;
27.01.2019;15:20:07;82848566;82570498;278068;
27.01.2019;15:21:08;82848640;82570655;277985;
27.01.2019;15:22:08;82848739;82570803;277936;
27.01.2019;15:23:08;82848828;82570960;277868;
27.01.2019;15:24:07;82848936;82571133;277803;
27.01.2019;15:25:07;82849045;82571295;277750;
27.01.2019;15:26:07;82849138;82571461;277677;
27.01.2019;15:27:08;82849229;82571583;277646;
27.01.2019;15:28:07;82849333;82571735;277598;
27.01.2019;15:29:08;82849399;82571897;277502;
27.01.2019;15:30:07;82849477;82572066;277411;
27.01.2019;15:31:08;82849576;82572198;277378;
27.01.2019;15:32:08;82849683;82572315;277368;
27.01.2019;15:33:08;82849777;82572483;277294;
27.01.2019;15:34:07;82849848;82572616;277232;
27.01.2019;15:35:08;82849947;82572767;277180;
27.01.2019;15:36:07;82850046;82572932;277114;
27.01.2019;15:37:07;82850151;82573082;277069;
27.01.2019;15:38:08;82850270;82573248;277022;
27.01.2019;15:39:08;82850380;82573405;276975;
27.01.2019;15:40:07;82850486;82573555;276931;
27.01.2019;15:41:08;82850603;82573711;276892;
27.01.2019;15:42:07;82850697;82573885;276812;
27.01.2019;15:43:08;82850775;82574059;276716;
27.01.2019;15:44:07;82850884;82574203;276681;
27.01.2019;15:45:07;82850983;82574376;276607;
27.01.2019;15:46:08;82851074;82574513;276561;
27.01.2019;15:47:07;82851168;82574665;276503;
27.01.2019;15:48:07;82851279;82574837;276442;
27.01.2019;15:49:07;82851374;82574998;276376;
27.01.2019;15:50:08;82851482;82575153;276329;
27.01.2019;15:51:08;82851568;82575311;276257;
27.01.2019;15:52:07;82851655;82575501;276154;
27.01.2019;15:53:07;82851725;82575697;276028;
27.01.2019;15:54:08;82851814;82575825;275989;
27.01.2019;15:55:07;82851885;82575979;275906;
27.01.2019;15:56:08;82851995;82576130;275865;
27.01.2019;15:57:07;82852095;82576310;275785;
27.01.2019;15:58:08;82852198;82576458;275740;
27.01.2019;15:59:07;82852289;82576618;275671;
27.01.2019;16:00:04;82852378;82576772;275606;
27.01.2019;16:01:07;82852495;82576957;275538;
27.01.2019;16:02:04;82852587;82577117;275470;
27.01.2019;16:03:05;82852688;82577287;275401;
27.01.2019;16:04:08;82852793;82577506;275287;
27.01.2019;16:05:04;82852896;82577650;275246;
27.01.2019;16:06:04;82853002;82577815;275187;
27.01.2019;16:07:05;82853101;82577988;275113;
27.01.2019;16:08:05;82853176;82578155;275021;
27.01.2019;16:09:05;82853292;82578338;274954;
27.01.2019;16:10:04;82853379;82578504;274875;
27.01.2019;16:11:04;82853451;82578630;274821;
27.01.2019;16:12:05;82853554;82578771;274783;
27.01.2019;16:13:05;82853638;82578934;274704;
27.01.2019;16:14:05;82853738;82579075;274663;
27.01.2019;16:15:05;82853836;82579211;274625;
27.01.2019;16:16:04;82853933;82579376;274557;
27.01.2019;16:17:05;82854035;82579531;274504;
27.01.2019;16:18:04;82854106;82579678;274428;
27.01.2019;16:19:05;82854204;82579801;274403;
27.01.2019;16:20:05;82854290;82579946;274344;
27.01.2019;16:21:04;82854386;82580114;274272;
27.01.2019;16:22:04;82854459;82580248;274211;
27.01.2019;16:23:05;82854559;82580398;274161;
27.01.2019;16:24:04;82854653;82580552;274101;
27.01.2019;16:25:04;82854747;82580740;274007;
27.01.2019;16:26:04;82854823;82580892;273931;
27.01.2019;16:27:05;82854920;82581043;273877;
27.01.2019;16:28:05;82855002;82581177;273825;
27.01.2019;16:29:04;82855091;82581327;273764;
27.01.2019;16:30:04;82855178;82581462;273716;
27.01.2019;16:31:05;82855257;82581603;273654;
27.01.2019;16:32:05;82855363;82581751;273612;
27.01.2019;16:33:04;82855455;82581886;273569;
27.01.2019;16:34:04;82855548;82582058;273490;
27.01.2019;16:35:05;82855659;82582237;273422;
27.01.2019;16:36:04;82855760;82582411;273349;
27.01.2019;16:37:04;82855852;82582556;273296;
27.01.2019;16:38:04;82855944;82582695;273249;
27.01.2019;16:39:06;82856054;82582843;273211;
27.01.2019;16:40:05;82856164;82582998;273166;
27.01.2019;16:41:05;82856277;82583162;273115;
27.01.2019;16:42:05;82856371;82583338;273033;
27.01.2019;16:43:05;82856473;82583491;272982;
27.01.2019;16:44:04;82856577;82583654;272923;
27.01.2019;16:45:04;82856668;82583830;272838;
27.01.2019;16:46:05;82856754;82583990;272764;
27.01.2019;16:47:05;82856852;82584156;272696;
27.01.2019;16:48:04;82856982;82584310;272672;
27.01.2019;16:49:05;82857120;82584448;272672;
27.01.2019;16:50:05;82857246;82584598;272648;
27.01.2019;16:51:04;82857369;82584738;272631;
27.01.2019;16:52:04;82857498;82584888;272610;
27.01.2019;16:53:05;82857613;82585067;272546;
27.01.2019;16:54:05;82857722;82585223;272499;
27.01.2019;16:55:05;82857811;82585379;272432;
27.01.2019;16:56:05;82857921;82585518;272403;
27.01.2019;16:57:04;82858031;82585676;272355;
27.01.2019;16:58:04;82858144;82585840;272304;
27.01.2019;16:59:04;82858287;82586002;272285;
27.01.2019;17:00:05;82858419;82586137;272282;
27.01.2019;17:01:05;82858534;82586285;272249;
27.01.2019;17:02:05;82858638;82586432;272206;
27.01.2019;17:03:04;82858753;82586576;272177;
27.01.2019;17:04:05;82858858;82586721;272137;
27.01.2019;17:05:05;82858989;82586871;272118;
27.01.2019;17:06:05;82859116;82587017;272099;
27.01.2019;17:07:04;82859257;82587171;272086;
27.01.2019;17:08:04;82859387;82587324;272063;
27.01.2019;17:09:07;82859551;82587474;272077;
27.01.2019;17:10:04;82859676;82587613;272063;
27.01.2019;17:11:04;82859767;82587802;271965;
27.01.2019;17:12:04;82859903;82587964;271939;
27.01.2019;17:13:05;82860015;82588131;271884;
27.01.2019;17:14:04;82860144;82588280;271864;
27.01.2019;17:15:04;82860240;82588433;271807;
27.01.2019;17:16:04;82860350;82588593;271757;
27.01.2019;17:17:05;82860468;82588754;271714;
27.01.2019;17:18:04;82860590;82588927;271663;
27.01.2019;17:19:04;82860691;82589062;271629;
27.01.2019;17:20:05;82860819;82589193;271626;
27.01.2019;17:21:05;82860948;82589343;271605;
27.01.2019;17:22:05;82861066;82589477;271589;
27.01.2019;17:23:04;82861184;82589618;271566;
27.01.2019;17:24:04;82861306;82589764;271542;
27.01.2019;17:25:04;82861432;82589931;271501;
27.01.2019;17:26:05;82861551;82590082;271469;
27.01.2019;17:27:05;82861671;82590239;271432;
27.01.2019;17:28:04;82861762;82590413;271349;
27.01.2019;17:29:04;82861877;82590559;271318;
27.01.2019;17:30:04;82861984;82590722;271262;
27.01.2019;17:31:05;82862105;82590891;271214;
27.01.2019;17:32:05;82862240;82591018;271222;
27.01.2019;17:33:05;82862376;82591168;271208;
27.01.2019;17:34:05;82862519;82591329;271190;
27.01.2019;17:35:05;82862628;82591478;271150;
27.01.2019;17:36:05;82862732;82591611;271121;
27.01.2019;17:37:05;82862857;82591768;271089;
27.01.2019;17:38:05;82862986;82591910;271076;
27.01.2019;17:39:07;82863100;82592053;271047;
27.01.2019;17:40:05;82863217;82592186;271031;
27.01.2019;17:41:05;82863335;82592316;271019;
27.01.2019;17:42:05;82863467;82592448;271019;
27.01.2019;17:43:05;82863607;82592582;271025;
27.01.2019;17:44:04;82863727;82592727;271000;
27.01.2019;17:45:04;82863848;82592855;270993;
27.01.2019;17:46:05;82863977;82592984;270993;
27.01.2019;17:47:05;82864098;82593125;270973;
27.01.2019;17:48:04;82864211;82593283;270928;
27.01.2019;17:49:04;82864284;82593426;270858;
27.01.2019;17:50:04;82864434;82593558;270876;
27.01.2019;17:51:04;82864551;82593708;270843;
27.01.2019;17:52:05;82864649;82593853;270796;
27.01.2019;17:53:04;82864781;82593989;270792;
27.01.2019;17:54:04;82864896;82594166;270730;
27.01.2019;17:55:05;82865021;82594306;270715;
27.01.2019;17:56:04;82865114;82594458;270656;
27.01.2019;17:57:04;82865252;82594590;270662;
27.01.2019;17:58:04;82865378;82594722;270656;
27.01.2019;17:59:05;82865522;82594857;270665;
27.01.2019;18:00:05;82865640;82595002;270638;
27.01.2019;18:01:04;82865784;82595142;270642;
27.01.2019;18:02:04;82865933;82595262;270671;
27.01.2019;18:03:05;82866026;82595368;270658;
27.01.2019;18:04:05;82866145;82595499;270646;
27.01.2019;18:05:05;82866282;82595663;270619;
27.01.2019;18:06:04;82866371;82595813;270558;
27.01.2019;18:07:04;82866529;82595967;270562;
27.01.2019;18:08:05;82866633;82596122;270511;
27.01.2019;18:09:07;82866763;82596244;270519;
27.01.2019;18:10:05;82866877;82596379;270498;
27.01.2019;18:11:04;82866985;82596508;270477;
27.01.2019;18:12:04;82867104;82596639;270465;
27.01.2019;18:13:04;82867219;82596755;270464;
27.01.2019;18:14:04;82867329;82596897;270432;
27.01.2019;18:15:05;82867449;82597046;270403;
27.01.2019;18:16:05;82867577;82597163;270414;
27.01.2019;18:17:05;82867689;82597296;270393;
27.01.2019;18:18:10;82867817;82597438;270379;
27.01.2019;18:19:11;82867933;82597566;270367;
27.01.2019;18:20:11;82868029;82597685;270344;
27.01.2019;18:21:05;82868136;82597798;270338;
27.01.2019;18:22:05;82868227;82597918;270309;
27.01.2019;18:23:05;82868340;82598013;270327;
27.01.2019;18:24:04;82868447;82598132;270315;
27.01.2019;18:25:04;82868531;82598264;270267;
27.01.2019;18:26:04;82868618;82598376;270242;
27.01.2019;18:27:04;82868713;82598511;270202;
27.01.2019;18:28:05;82868838;82598634;270204;
27.01.2019;18:29:05;82868936;82598751;270185;
27.01.2019;18:30:05;82869003;82598865;270138;
27.01.2019;18:31:05;82869097;82598961;270136;
27.01.2019;18:32:05;82869195;82599087;270108;
27.01.2019;18:33:05;82869292;82599198;270094;
27.01.2019;18:34:12;82869389;82599331;270058;
27.01.2019;18:35:05;82869480;82599447;270033;
27.01.2019;18:36:05;82869572;82599580;269992;
27.01.2019;18:37:05;82869680;82599688;269992;
27.01.2019;18:38:05;82869785;82599799;269986;
27.01.2019;18:39:04;82869887;82599910;269977;
27.01.2019;18:40:05;82869916;82599947;269969;
27.01.2019;18:41:05;82870008;82600059;269949;
27.01.2019;18:42:04;82870115;82600174;269941;
27.01.2019;18:43:04;82870209;82600274;269935;
27.01.2019;18:44:05;82870319;82600370;269949;
27.01.2019;18:45:04;82870415;82600455;269960;
27.01.2019;18:46:04;82870498;82600577;269921;
27.01.2019;18:47:05;82870610;82600662;269948;
27.01.2019;18:48:05;82870730;82600746;269984;
27.01.2019;18:49:04;82870838;82600850;269988;
27.01.2019;18:50:04;82870965;82600958;270007;
27.01.2019;18:51:04;82871079;82601075;270004;
27.01.2019;18:52:04;82871192;82601207;269985;
27.01.2019;18:53:04;82871306;82601314;269992;
27.01.2019;18:54:05;82871402;82601420;269982;
27.01.2019;18:55:04;82871544;82601521;270023;
27.01.2019;18:56:05;82871639;82601645;269994;
27.01.2019;18:57:04;82871772;82601770;270002;
27.01.2019;18:58:04;82871887;82601884;270003;
27.01.2019;18:59:05;82872031;82602013;270018;
27.01.2019;19:00:08;82872155;82602108;270047;
27.01.2019;19:01:04;82872269;82602207;270062;
27.01.2019;19:02:05;82872406;82602303;270103;
27.01.2019;19:03:05;82872514;82602440;270074;
27.01.2019;19:04:05;82872658;82602536;270122;
27.01.2019;19:05:05;82872790;82602638;270152;
27.01.2019;19:06:05;82872922;82602749;270173;
27.01.2019;19:07:05;82873060;82602863;270197;
27.01.2019;19:08:05;82873172;82602976;270196;
27.01.2019;19:09:07;82873289;82603091;270198;
27.01.2019;19:10:05;82873388;82603179;270209;
27.01.2019;19:11:05;82873506;82603282;270224;
27.01.2019;19:12:05;82873614;82603387;270227;
27.01.2019;19:13:05;82873735;82603490;270245;
27.01.2019;19:14:05;82873849;82603590;270259;
27.01.2019;19:15:04;82873946;82603675;270271;
27.01.2019;19:16:04;82874055;82603769;270286;
27.01.2019;19:17:05;82874183;82603884;270299;
27.01.2019;19:18:04;82874304;82603977;270327;
27.01.2019;19:19:05;82874438;82604080;270358;
27.01.2019;19:20:04;82874535;82604180;270355;
27.01.2019;19:21:04;82874649;82604264;270385;
27.01.2019;19:22:05;82874689;82604387;270302;
27.01.2019;19:23:05;82874669;82604476;270193;
27.01.2019;19:24:05;82874690;82604563;270127;
27.01.2019;19:25:05;82874762;82604664;270098;
27.01.2019;19:26:05;82874869;82604756;270113;
27.01.2019;19:27:05;82874947;82604852;270095;
27.01.2019;19:28:04;82875025;82604922;270103;
27.01.2019;19:29:05;82875122;82604992;270130;
27.01.2019;19:30:05;82875185;82605089;270096;
27.01.2019;19:31:04;82875247;82605193;270054;
27.01.2019;19:32:04;82875341;82605279;270062;
27.01.2019;19:33:05;82875428;82605361;270067;
27.01.2019;19:34:05;82875499;82605453;270046;
27.01.2019;19:35:05;82875606;82605535;270071;
27.01.2019;19:36:05;82875712;82605632;270080;
27.01.2019;19:37:05;82875821;82605733;270088;
27.01.2019;19:38:05;82875909;82605822;270087;
27.01.2019;19:39:06;82875993;82605881;270112;
27.01.2019;19:40:04;82876091;82605960;270131;
27.01.2019;19:41:05;82876153;82606048;270105;
27.01.2019;19:42:05;82876247;82606109;270138;
27.01.2019;19:43:05;82876327;82606195;270132;
27.01.2019;19:44:05;82876409;82606272;270137;
27.01.2019;19:45:04;82876483;82606352;270131;
27.01.2019;19:46:05;82876564;82606416;270148;
27.01.2019;19:47:05;82876646;82606496;270150;
27.01.2019;19:48:05;82876740;82606571;270169;
27.01.2019;19:49:04;82876844;82606652;270192;
27.01.2019;19:50:04;82876937;82606719;270218;
27.01.2019;19:51:05;82877030;82606794;270236;
27.01.2019;19:52:05;82877113;82606882;270231;
27.01.2019;19:53:05;82877184;82606974;270210;
27.01.2019;19:54:05;82877269;82607058;270211;
27.01.2019;19:55:04;82877362;82607131;270231;
27.01.2019;19:56:04;82877451;82607208;270243;
27.01.2019;19:57:05;82877554;82607288;270266;
27.01.2019;19:58:05;82877664;82607363;270301;
27.01.2019;19:59:05;82877757;82607434;270323;
27.01.2019;20:00:05;82877843;82607508;270335;
27.01.2019;20:01:05;82877930;82607574;270356;
27.01.2019;20:02:05;82878020;82607624;270396;
27.01.2019;20:03:05;82878115;82607696;270419;
27.01.2019;20:04:05;82878234;82607789;270445;
27.01.2019;20:05:05;82878334;82607860;270474;
27.01.2019;20:06:04;82878432;82607926;270506;
27.01.2019;20:07:04;82878531;82608009;270522;
27.01.2019;20:08:05;82878628;82608083;270545;
27.01.2019;20:09:06;82878715;82608164;270551;
27.01.2019;20:10:05;82878791;82608244;270547;
27.01.2019;20:11:05;82878887;82608310;270577;
27.01.2019;20:12:05;82878965;82608377;270588;
27.01.2019;20:13:05;82879074;82608441;270633;
27.01.2019;20:14:05;82879151;82608510;270641;
27.01.2019;20:15:04;82879242;82608601;270641;
27.01.2019;20:16:04;82879308;82608664;270644;
27.01.2019;20:17:05;82879371;82608714;270657;
27.01.2019;20:18:05;82879441;82608749;270692;
27.01.2019;20:19:05;82879529;82608788;270741;
27.01.2019;20:20:04;82879606;82608854;270752;
27.01.2019;20:21:05;82879708;82608903;270805;
27.01.2019;20:22:05;82879802;82608939;270863;
27.01.2019;20:23:05;82879861;82608975;270886;
27.01.2019;20:24:05;82879955;82609033;270922;
27.01.2019;20:25:05;82880040;82609086;270954;
27.01.2019;20:26:04;82880135;82609131;271004;
27.01.2019;20:27:04;82880240;82609201;271039;
27.01.2019;20:28:04;82880333;82609250;271083;
27.01.2019;20:29:05;82880411;82609291;271120;
27.01.2019;20:30:06;82880493;82609363;271130;
27.01.2019;20:31:05;82880589;82609394;271195;
27.01.2019;20:32:05;82880681;82609432;271249;
27.01.2019;20:33:05;82880760;82609490;271270;
27.01.2019;20:34:05;82880851;82609543;271308;
27.01.2019;20:35:05;82880944;82609587;271357;
27.01.2019;20:36:04;82881018;82609647;271371;
27.01.2019;20:37:05;82881129;82609677;271452;
27.01.2019;20:38:04;82881206;82609720;271486;
27.01.2019;20:39:05;82881314;82609768;271546;
27.01.2019;20:40:05;82881390;82609814;271576;
27.01.2019;20:41:05;82881468;82609852;271616;
27.01.2019;20:42:05;82881575;82609898;271677;
27.01.2019;20:43:05;82881669;82609959;271710;
27.01.2019;20:44:06;82881749;82610010;271739;
27.01.2019;20:45:04;82881845;82610055;271790;
27.01.2019;20:46:05;82881959;82610119;271840;
27.01.2019;20:47:05;82882068;82610165;271903;
27.01.2019;20:48:05;82882150;82610230;271920;
27.01.2019;20:49:05;82882245;82610267;271978;
27.01.2019;20:50:05;82882319;82610319;272000;
27.01.2019;20:51:05;82882418;82610383;272035;
27.01.2019;20:52:05;82882533;82610427;272106;
27.01.2019;20:53:05;82882637;82610472;272165;
27.01.2019;20:54:05;82882740;82610526;272214;
27.01.2019;20:55:05;82882830;82610589;272241;
27.01.2019;20:56:04;82882933;82610650;272283;
27.01.2019;20:57:05;82883060;82610701;272359;
27.01.2019;20:58:05;82883172;82610746;272426;
27.01.2019;20:59:04;82883267;82610790;272477;
27.01.2019;21:00:04;82883365;82610844;272521;
27.01.2019;21:01:05;82883476;82610877;272599;
27.01.2019;21:02:05;82883547;82610927;272620;
27.01.2019;21:03:05;82883642;82610981;272661;
27.01.2019;21:04:05;82883719;82611040;272679;
27.01.2019;21:05:05;82883791;82611096;272695;
27.01.2019;21:06:05;82883899;82611128;272771;
27.01.2019;21:07:04;82884004;82611176;272828;
27.01.2019;21:08:04;82884113;82611229;272884;
27.01.2019;21:09:05;82884206;82611290;272916;
27.01.2019;21:10:05;82884315;82611332;272983;
27.01.2019;21:11:06;82884423;82611387;273036;
27.01.2019;21:12:05;82884508;82611430;273078;
27.01.2019;21:13:05;82884615;82611498;273117;
27.01.2019;21:14:05;82884721;82611540;273181;
27.01.2019;21:15:05;82884834;82611585;273249;
27.01.2019;21:16:05;82884942;82611627;273315;
27.01.2019;21:17:06;82885046;82611674;273372;
27.01.2019;21:18:05;82885164;82611730;273434;
27.01.2019;21:19:04;82885274;82611777;273497;
27.01.2019;21:20:05;82885384;82611821;273563;
27.01.2019;21:21:04;82885504;82611860;273644;
27.01.2019;21:22:05;82885597;82611900;273697;
27.01.2019;21:23:04;82885736;82611935;273801;
27.01.2019;21:24:04;82885837;82611990;273847;
27.01.2019;21:25:05;82885961;82612051;273910;
27.01.2019;21:26:05;82886065;82612086;273979;
27.01.2019;21:27:04;82886178;82612114;274064;
27.01.2019;21:28:05;82886281;82612164;274117;
27.01.2019;21:29:07;82886393;82612207;274186;
27.01.2019;21:30:04;82886499;82612246;274253;
27.01.2019;21:31:09;82886605;82612289;274316;
27.01.2019;21:32:11;82886706;82612334;274372;
27.01.2019;21:33:05;82886792;82612372;274420;
27.01.2019;21:34:06;82886893;82612421;274472;
27.01.2019;21:35:05;82887019;82612461;274558;
27.01.2019;21:36:05;82887131;82612501;274630;
27.01.2019;21:37:05;82887223;82612558;274665;
27.01.2019;21:38:05;82888486;82612598;275888;
27.01.2019;21:39:05;82888577;82612636;275941;
27.01.2019;21:40:05;82888692;82612678;276014;
27.01.2019;21:41:05;82888808;82612719;276089;
27.01.2019;21:42:05;82888916;82612751;276165;
27.01.2019;21:43:05;82888998;82618869;270129;
27.01.2019;21:44:04;82889096;82618900;270196;
27.01.2019;21:45:05;82889241;82618957;270284;
27.01.2019;21:46:05;82889269;82618944;270325;
27.01.2019;21:47:05;82889390;82618983;270407;
27.01.2019;21:48:05;82889477;82619022;270455;
27.01.2019;21:49:05;82889579;82619054;270525;
27.01.2019;21:50:06;82889708;82619092;270616;
27.01.2019;21:51:05;82889794;82619126;270668;
27.01.2019;21:52:05;82889892;82619164;270728;
27.01.2019;21:53:05;82890001;82619196;270805;
27.01.2019;21:54:05;82890108;82619236;270872;
27.01.2019;21:55:04;82890200;82619264;270936;
27.01.2019;21:56:05;82890285;82619296;270989;
27.01.2019;21:57:06;82890385;82619338;271047;
27.01.2019;21:58:05;82890491;82619369;271122;
27.01.2019;21:59:05;82890592;82619392;271200;
27.01.2019;22:00:05;82890709;82619429;271280;
27.01.2019;22:02:06;82890919;82619503;271416;
27.01.2019;22:03:05;82891007;82619538;271469;
27.01.2019;22:04:05;82891083;82619572;271511;
27.01.2019;22:05:04;82891170;82619615;271555;
27.01.2019;22:06:05;82891261;82619645;271616;
27.01.2019;22:07:04;82891349;82619685;271664;
27.01.2019;22:08:05;82891442;82619718;271724;
27.01.2019;22:09:05;82891534;82619750;271784;
27.01.2019;22:10:05;82891650;82619790;271860;
27.01.2019;22:11:05;82891756;82619825;271931;
27.01.2019;22:12:05;82891836;82619853;271983;
27.01.2019;22:13:04;82891908;82619874;272034;
27.01.2019;22:14:07;82891987;82619897;272090;
27.01.2019;22:15:05;82892074;82619927;272147;
27.01.2019;22:16:05;82892164;82619956;272208;
27.01.2019;22:17:05;82892247;82619983;272264;
27.01.2019;22:18:04;82892328;82619992;272336;
27.01.2019;22:19:05;82892424;82620009;272415;
27.01.2019;22:20:05;82892492;82620031;272461;
27.01.2019;22:21:05;82892560;82620052;272508;
27.01.2019;22:22:05;82892623;82620067;272556;
27.01.2019;22:23:05;82892704;82620099;272605;
27.01.2019;22:24:04;82892803;82620121;272682;
27.01.2019;22:25:05;82892914;82620150;272764;
27.01.2019;22:26:05;82892982;82620159;272823;
27.01.2019;22:27:04;82893075;82620189;272886;
27.01.2019;22:28:05;82893144;82620214;272930;
27.01.2019;22:29:05;82893229;82620242;272987;
27.01.2019;22:30:05;82893310;82620276;273034;
27.01.2019;22:31:06;82893384;82620311;273073;
27.01.2019;22:32:04;82893464;82620336;273128;
27.01.2019;22:33:04;82893524;82620351;273173;
27.01.2019;22:34:05;82893607;82620368;273239;
27.01.2019;22:35:05;82893696;82620395;273301;
27.01.2019;22:36:04;82893775;82620422;273353;
27.01.2019;22:37:04;82893870;82620447;273423;
27.01.2019;22:38:05;82893980;82620477;273503;
27.01.2019;22:39:07;82894066;82620517;273549;
27.01.2019;22:40:05;82894141;82620544;273597;
27.01.2019;22:41:05;82894238;82620559;273679;
27.01.2019;22:42:05;82894352;82620586;273766;
27.01.2019;22:43:05;82894452;82620613;273839;
27.01.2019;22:44:05;82894550;82620644;273906;
27.01.2019;22:45:04;82894640;82620673;273967;
27.01.2019;22:46:04;82894740;82620698;274042;
27.01.2019;22:47:04;82894845;82620732;274113;
27.01.2019;22:48:05;82894925;82620765;274160;
27.01.2019;22:49:05;82895024;82620797;274227;
27.01.2019;22:50:05;82895127;82620820;274307;
27.01.2019;22:51:04;82895218;82620856;274362;
27.01.2019;22:52:05;82895300;82620885;274415;
27.01.2019;22:53:05;82895420;82620899;274521;
27.01.2019;22:54:04;82895530;82620915;274615;
27.01.2019;22:55:04;82895615;82620933;274682;
27.01.2019;22:56:05;82895704;82620954;274750;
27.01.2019;22:57:07;82895809;82620979;274830;
27.01.2019;22:58:06;82895892;82621005;274887;
27.01.2019;22:59:05;82896004;82621042;274962;
27.01.2019;23:00:05;82896100;82621075;275025;
27.01.2019;23:01:06;82896198;82621105;275093;
27.01.2019;23:02:05;82896294;82621124;275170;
27.01.2019;23:03:05;82896400;82621153;275247;
27.01.2019;23:04:05;82896499;82621176;275323;
27.01.2019;23:05:04;82896574;82621203;275371;
27.01.2019;23:06:05;82896661;82621226;275435;
27.01.2019;23:07:06;82896770;82621257;275513;
27.01.2019;23:08:04;82896855;82621280;275575;
27.01.2019;23:09:06;82896971;82621316;275655;
27.01.2019;23:10:05;82897076;82621342;275734;
27.01.2019;23:11:06;82897155;82621364;275791;
27.01.2019;23:12:09;82897253;82621382;275871;
27.01.2019;23:13:05;82897350;82621418;275932;
27.01.2019;23:14:04;82897453;82621443;276010;
27.01.2019;23:15:04;82897568;82621467;276101;
27.01.2019;23:16:05;82897677;82621490;276187;
27.01.2019;23:17:05;82897757;82621510;276247;
27.01.2019;23:18:06;82897849;82621533;276316;
27.01.2019;23:19:05;82897959;82621558;276401;
27.01.2019;23:20:04;82898069;82621589;276480;
27.01.2019;23:21:05;82898171;82621614;276557;
27.01.2019;23:22:05;82898258;82621638;276620;
27.01.2019;23:23:05;82898336;82621665;276671;
27.01.2019;23:24:09;82898418;82621694;276724;
27.01.2019;23:25:07;82898516;82621715;276801;
27.01.2019;23:26:04;82898613;82621738;276875;
27.01.2019;23:27:04;82898679;82621752;276927;
27.01.2019;23:29:09;82898882;82621803;277079;
27.01.2019;23:30:05;82898987;82621832;277155;
27.01.2019;23:31:05;82899083;82621853;277230;
27.01.2019;23:32:05;82899192;82621885;277307;
27.01.2019;23:33:06;82899306;82621912;277394;
27.01.2019;23:34:05;82899395;82621944;277451;
27.01.2019;23:35:05;82899483;82621972;277511;
27.01.2019;23:36:04;82899589;82622009;277580;
27.01.2019;23:37:05;82899684;82622029;277655;
27.01.2019;23:38:05;82899789;82622049;277740;
27.01.2019;23:39:05;82899886;82622081;277805;
27.01.2019;23:40:05;82899986;82622104;277882;
27.01.2019;23:41:05;82900076;82622133;277943;
27.01.2019;23:42:05;82900170;82622148;278022;
27.01.2019;23:43:05;82900236;82622173;278063;
27.01.2019;23:44:05;82900310;82622206;278104;
27.01.2019;23:45:04;82900381;82622226;278155;
27.01.2019;23:46:05;82900466;82622249;278217;
27.01.2019;23:47:06;82900551;82622259;278292;
27.01.2019;23:48:06;82900616;82622282;278334;
27.01.2019;23:49:05;82900698;82622309;278389;
27.01.2019;23:50:05;82900772;82622329;278443;
27.01.2019;23:51:04;82900852;82622354;278498;
27.01.2019;23:52:04;82900947;82622371;278576;
27.01.2019;23:53:05;82901029;82622406;278623;
27.01.2019;23:54:04;82901107;82622428;278679;
27.01.2019;23:55:04;82901197;82622451;278746;
27.01.2019;23:56:04;82901276;82622480;278796;
27.01.2019;23:57:05;82901368;82622502;278866;
27.01.2019;23:58:05;82901449;82622520;278929;
27.01.2019;23:59:04;82901543;82622540;279003;
28.01.2019;00:00:08;82901641;82622568;279073;
28.01.2019;00:01:08;82901724;82622595;279129;
28.01.2019;00:02:07;82901821;82622608;279213;
28.01.2019;00:03:08;82901903;82622631;279272;
28.01.2019;00:04:08;82901992;82622649;279343;
28.01.2019;00:05:08;82902094;82622676;279418;
28.01.2019;00:06:08;82902184;82622695;279489;
28.01.2019;00:07:08;82902267;82622730;279537;
28.01.2019;00:08:08;82902356;82622750;279606;
28.01.2019;00:09:08;82902449;82622769;279680;
28.01.2019;00:10:08;82902561;82622800;279761;
28.01.2019;00:11:08;82902682;82622827;279855;
28.01.2019;00:12:08;82902755;82622855;279900;
28.01.2019;00:13:07;82902822;82622870;279952;
28.01.2019;00:14:08;82902886;82622889;279997;
28.01.2019;00:15:08;82902961;82622911;280050;
28.01.2019;00:16:08;82903017;82622930;280087;
28.01.2019;00:17:08;82903091;82622941;280150;
28.01.2019;00:18:07;82903157;82622962;280195;
28.01.2019;00:19:08;82903211;82622977;280234;
28.01.2019;00:20:07;82903262;82622995;280267;
28.01.2019;00:21:08;82903316;82623016;280300;
28.01.2019;00:22:06;82903402;82623034;280368;
28.01.2019;00:23:08;82903477;82623051;280426;
28.01.2019;00:24:07;82903566;82623069;280497;
28.01.2019;00:25:08;82903611;82623080;280531;
28.01.2019;00:26:08;82903682;82623095;280587;
28.01.2019;00:27:08;82903786;82623126;280660;
28.01.2019;00:28:07;82903850;82623139;280711;
28.01.2019;00:29:07;82903931;82623162;280769;
28.01.2019;00:30:08;82904008;82623185;280823;
28.01.2019;00:31:08;82904076;82623208;280868;
28.01.2019;00:32:08;82904146;82623222;280924;
28.01.2019;00:33:07;82904234;82623237;280997;
28.01.2019;00:34:08;82904313;82623255;281058;
28.01.2019;00:35:08;82904396;82623271;281125;
28.01.2019;00:36:08;82904473;82623290;281183;
28.01.2019;00:37:09;82904557;82623317;281240;
28.01.2019;00:38:07;82904619;82623346;281273;
28.01.2019;00:39:08;82904718;82623364;281354;
28.01.2019;00:40:08;82904813;82623380;281433;
28.01.2019;00:41:08;82904893;82623399;281494;
28.01.2019;00:42:06;82904955;82623423;281532;
28.01.2019;00:43:07;82905052;82623449;281603;
28.01.2019;00:44:08;82905163;82623471;281692;
28.01.2019;00:45:08;82905260;82623499;281761;
28.01.2019;00:46:08;82905342;82623534;281808;
28.01.2019;00:47:07;82905422;82623562;281860;
28.01.2019;00:48:08;82905529;82623576;281953;
28.01.2019;00:49:08;82905611;82623603;282008;
28.01.2019;00:50:08;82905707;82623634;282073;
28.01.2019;00:51:08;82905782;82623654;282128;
28.01.2019;00:52:09;82905870;82623677;282193;
28.01.2019;00:53:08;82905846;82623644;282202;
28.01.2019;00:54:09;82905919;82623668;282251;
28.01.2019;00:55:11;82906002;82623686;282316;
28.01.2019;00:56:07;82906091;82623710;282381;
28.01.2019;00:57:08;82906193;82623738;282455;
28.01.2019;00:58:08;82906299;82623762;282537;
28.01.2019;00:59:08;82906388;82623791;282597;
28.01.2019;01:00:05;82906483;82623821;282662;
28.01.2019;01:01:05;82906579;82623842;282737;
28.01.2019;01:02:06;82906650;82623870;282780;
28.01.2019;01:03:06;82906750;82623901;282849;
28.01.2019;01:04:07;82906834;82623924;282910;
28.01.2019;01:05:04;82906900;82623944;282956;
28.01.2019;01:06:05;82906978;82623971;283007;
28.01.2019;01:07:06;82907068;82624011;283057;
28.01.2019;01:08:04;82907158;82624045;283113;
28.01.2019;01:09:06;82907245;82624061;283184;
28.01.2019;01:10:10;82907320;82624086;283234;
28.01.2019;01:11:05;82907422;82624113;283309;
28.01.2019;01:12:04;82907499;82624140;283359;
28.01.2019;01:13:11;82907599;82624167;283432;
28.01.2019;01:14:06;82907664;82624198;283466;
28.01.2019;01:15:05;82907729;82624218;283511;
28.01.2019;01:16:05;82907817;82624238;283579;
28.01.2019;01:17:06;82907876;82624268;283608;
28.01.2019;01:18:05;82907950;82624301;283649;
28.01.2019;01:19:04;82908029;82624336;283693;
28.01.2019;01:20:07;82908115;82624368;283747;
28.01.2019;01:21:06;82908203;82624400;283803;
28.01.2019;01:22:05;82908286;82624433;283853;
28.01.2019;01:23:05;82908377;82624458;283919;
28.01.2019;01:24:06;82908464;82624479;283985;
28.01.2019;01:25:09;82908569;82624511;284058;
28.01.2019;01:26:06;82908653;82624546;284107;
28.01.2019;01:27:06;82908740;82624574;284166;
28.01.2019;01:28:04;82908825;82624605;284220;
28.01.2019;01:29:05;82908907;82624642;284265;
28.01.2019;01:30:05;82908968;82624667;284301;
28.01.2019;01:31:05;82909066;82624695;284371;
28.01.2019;01:32:04;82909148;82624732;284416;
28.01.2019;01:33:06;82909247;82624766;284481;
28.01.2019;01:34:06;82909341;82624795;284546;
28.01.2019;01:35:05;82909417;82624827;284590;
28.01.2019;01:36:06;82909475;82624860;284615;
28.01.2019;01:37:06;82909544;82624901;284643;
28.01.2019;01:38:04;82909635;82624934;284701;
28.01.2019;01:39:06;82909732;82624973;284759;
28.01.2019;01:40:05;82909832;82625005;284827;
28.01.2019;01:41:05;82909894;82625050;284844;
28.01.2019;01:42:04;82909954;82625094;284860;
28.01.2019;01:43:06;82910044;82625140;284904;
28.01.2019;01:44:06;82910135;82625157;284978;
28.01.2019;01:45:06;82910241;82625205;285036;
28.01.2019;01:46:05;82910336;82625238;285098;
28.01.2019;01:47:04;82910418;82625273;285145;
28.01.2019;01:48:05;82910478;82625319;285159;
28.01.2019;01:49:06;82910558;82625350;285208;
28.01.2019;01:50:04;82910638;82625392;285246;
28.01.2019;01:51:06;82910711;82625432;285279;
28.01.2019;01:52:04;82910814;82625461;285353;
28.01.2019;01:53:05;82910914;82625508;285406;
28.01.2019;01:54:04;82911030;82625544;285486;
28.01.2019;01:55:05;82911103;82625584;285519;
28.01.2019;01:56:04;82911185;82625620;285565;
28.01.2019;01:57:06;82911258;82625666;285592;
28.01.2019;01:58:05;82911337;82625697;285640;
28.01.2019;01:59:06;82911406;82625747;285659;
28.01.2019;02:00:06;82911472;82625802;285670;
28.01.2019;02:01:05;82911546;82625846;285700;
28.01.2019;02:02:05;82911641;82625913;285728;
28.01.2019;02:03:05;82911735;82625968;285767;
28.01.2019;02:04:04;82911809;82626014;285795;
28.01.2019;02:05:07;82911878;82626065;285813;
28.01.2019;02:06:04;82911960;82626109;285851;
28.01.2019;02:07:06;82912053;82626154;285899;
28.01.2019;02:08:06;82912146;82626219;285927;
28.01.2019;02:09:11;82912202;82626269;285933;
28.01.2019;02:10:05;82912263;82626306;285957;
28.01.2019;02:11:06;82912340;82626342;285998;
28.01.2019;02:12:05;82912419;82626381;286038;
28.01.2019;02:13:05;82912496;82626440;286056;
28.01.2019;02:14:06;82912571;82626492;286079;
28.01.2019;02:15:05;82912632;82626534;286098;
28.01.2019;02:16:05;82912700;82626590;286110;
28.01.2019;02:17:06;82912773;82626652;286121;
28.01.2019;02:18:06;82912809;82626692;286117;
28.01.2019;02:19:05;82912874;82626746;286128;
28.01.2019;02:20:05;82912947;82626792;286155;
28.01.2019;02:21:04;82913013;82626851;286162;
28.01.2019;02:22:04;82913064;82626905;286159;
28.01.2019;02:23:05;82913125;82626966;286159;
28.01.2019;02:24:04;82913206;82627012;286194;
28.01.2019;02:25:04;82913272;82627056;286216;
28.01.2019;02:26:05;82913358;82627111;286247;
28.01.2019;02:27:06;82913430;82627162;286268;
28.01.2019;02:28:04;82913503;82627227;286276;
28.01.2019;02:29:04;82913585;82627278;286307;
28.01.2019;02:30:06;82913657;82627353;286304;
28.01.2019;02:31:04;82913743;82627395;286348;
28.01.2019;02:32:04;82913845;82627447;286398;
28.01.2019;02:33:06;82913917;82627499;286418;
28.01.2019;02:34:05;82913989;82627560;286429;
28.01.2019;02:35:05;82914089;82627602;286487;
28.01.2019;02:36:05;82914171;82627668;286503;
28.01.2019;02:37:05;82914255;82627729;286526;
28.01.2019;02:38:06;82914326;82627781;286545;
28.01.2019;02:39:05;82914389;82627840;286549;
28.01.2019;02:40:06;82914493;82627911;286582;
28.01.2019;02:41:05;82914576;82627993;286583;
28.01.2019;02:42:07;82914671;82628063;286608;
28.01.2019;02:43:04;82914789;82628121;286668;
28.01.2019;02:44:05;82914875;82628188;286687;
28.01.2019;02:45:07;82914964;82628260;286704;
28.01.2019;02:46:04;82915049;82628319;286730;
28.01.2019;02:47:05;82915143;82628368;286775;
28.01.2019;02:48:04;82915234;82628440;286794;
28.01.2019;02:49:04;82915322;82628524;286798;
28.01.2019;02:50:06;82915407;82628591;286816;
28.01.2019;02:51:06;82915511;82628658;286853;
28.01.2019;02:52:11;82915603;82628741;286862;
28.01.2019;02:53:06;82915675;82628815;286860;
28.01.2019;02:54:05;82915763;82628879;286884;
28.01.2019;02:55:04;82915858;82628947;286911;
28.01.2019;02:56:06;82915949;82629030;286919;
28.01.2019;02:57:05;82916030;82629121;286909;
28.01.2019;02:58:05;82916111;82629197;286914;
28.01.2019;02:59:04;82916183;82629274;286909;
28.01.2019;03:00:04;82916294;82629326;286968;
28.01.2019;03:01:06;82916393;82629412;286981;
28.01.2019;03:02:06;82916451;82629475;286976;
28.01.2019;03:03:06;82916535;82629551;286984;
28.01.2019;03:04:05;82916639;82629625;287014;
28.01.2019;03:05:05;82916723;82629707;287016;
28.01.2019;03:06:06;82916821;82629792;287029;
28.01.2019;03:07:04;82916888;82629879;287009;
28.01.2019;03:08:04;82916982;82629970;287012;
28.01.2019;03:09:05;82917062;82630053;287009;
28.01.2019;03:10:06;82917136;82630124;287012;
28.01.2019;03:11:05;82917226;82630195;287031;
28.01.2019;03:12:06;82917306;82630269;287037;
28.01.2019;03:13:05;82917394;82630336;287058;
28.01.2019;03:14:04;82917472;82630422;287050;
28.01.2019;03:15:04;82917575;82630505;287070;
28.01.2019;03:16:06;82917675;82630602;287073;
28.01.2019;03:17:06;82917768;82630693;287075;
28.01.2019;03:18:06;82917878;82630778;287100;
28.01.2019;03:19:05;82917981;82630864;287117;
28.01.2019;03:20:06;82918076;82630952;287124;
28.01.2019;03:21:04;82918139;82631033;287106;
28.01.2019;03:22:04;82918231;82631099;287132;
28.01.2019;03:23:05;82918336;82631184;287152;
28.01.2019;03:24:11;82918400;82631256;287144;
28.01.2019;03:25:11;82918476;82631351;287125;
28.01.2019;03:26:06;82918558;82631414;287144;
28.01.2019;03:27:06;82918634;82631504;287130;
28.01.2019;03:28:06;82918733;82631569;287164;
28.01.2019;03:29:05;82918830;82631672;287158;
28.01.2019;03:30:05;82918910;82631773;287137;
28.01.2019;03:31:04;82919000;82631846;287154;
28.01.2019;03:32:05;82919074;82631933;287141;
28.01.2019;03:33:06;82919150;82632012;287138;
28.01.2019;03:34:06;82919237;82632093;287144;
28.01.2019;03:35:06;82919335;82632169;287166;
28.01.2019;03:36:10;82919412;82632255;287157;
28.01.2019;03:37:06;82919482;82632342;287140;
28.01.2019;03:38:05;82919556;82632453;287103;
28.01.2019;03:39:06;82919651;82632551;287100;
28.01.2019;03:40:05;82919739;82632651;287088;
28.01.2019;03:41:05;82919817;82632711;287106;
28.01.2019;03:42:04;82919914;82632793;287121;
28.01.2019;03:43:06;82919992;82632890;287102;
28.01.2019;03:44:07;82920011;82632944;287067;
28.01.2019;03:45:08;82920111;82633031;287080;
28.01.2019;03:46:06;82920205;82633130;287075;
28.01.2019;03:47:04;82920287;82633200;287087;
28.01.2019;03:48:06;82920382;82633292;287090;
28.01.2019;03:49:08;82920474;82633406;287068;
28.01.2019;03:50:05;82920565;82633488;287077;
28.01.2019;03:51:04;82920648;82633591;287057;
28.01.2019;03:52:06;82920735;82633688;287047;
28.01.2019;03:53:05;82920822;82633768;287054;
28.01.2019;03:54:07;82920900;82633865;287035;
28.01.2019;03:55:04;82920983;82633943;287040;
28.01.2019;03:56:06;82921088;82634055;287033;
28.01.2019;03:57:04;82921163;82634135;287028;
28.01.2019;03:58:06;82921255;82634235;287020;
28.01.2019;03:59:04;82921353;82634326;287027;
28.01.2019;04:00:05;82921440;82634413;287027;
28.01.2019;04:01:06;82921524;82634525;286999;
28.01.2019;04:02:06;82921602;82634609;286993;
28.01.2019;04:03:06;82921691;82634695;286996;
28.01.2019;04:04:06;82921770;82634802;286968;
28.01.2019;04:05:06;82921883;82634882;287001;
28.01.2019;04:06:06;82921974;82634973;287001;
28.01.2019;04:07:05;82922053;82635075;286978;
28.01.2019;04:08:06;82922132;82635163;286969;
28.01.2019;04:09:08;82922215;82635239;286976;
28.01.2019;04:10:06;82922283;82635343;286940;
28.01.2019;04:11:06;82922370;82635426;286944;
28.01.2019;04:12:06;82922439;82635514;286925;
28.01.2019;04:13:06;82922525;82635623;286902;
28.01.2019;04:14:06;82922594;82635713;286881;
28.01.2019;04:15:04;82922674;82635810;286864;
28.01.2019;04:16:06;82922743;82635881;286862;
28.01.2019;04:17:05;82922816;82635967;286849;
28.01.2019;04:18:05;82922897;82636055;286842;
28.01.2019;04:19:06;82922979;82636132;286847;
28.01.2019;04:20:04;82923068;82636249;286819;
28.01.2019;04:21:04;82923151;82636328;286823;
28.01.2019;04:22:05;82923220;82636420;286800;
28.01.2019;04:23:07;82923302;82636506;286796;
28.01.2019;04:24:05;82923389;82636592;286797;
28.01.2019;04:25:05;82923504;82636684;286820;
28.01.2019;04:26:04;82923585;82636777;286808;
28.01.2019;04:27:05;82923674;82636877;286797;
28.01.2019;04:28:05;82923777;82636967;286810;
28.01.2019;04:29:06;82923883;82637073;286810;
28.01.2019;04:30:04;82923992;82637169;286823;
28.01.2019;04:31:04;82924095;82637270;286825;
28.01.2019;04:32:06;82924222;82637365;286857;
28.01.2019;04:33:04;82924292;82637472;286820;
28.01.2019;04:34:05;82924408;82637589;286819;
28.01.2019;04:35:06;82924487;82637683;286804;
28.01.2019;04:36:05;82924605;82637771;286834;
28.01.2019;04:37:05;82924688;82637889;286799;
28.01.2019;04:38:07;82924777;82637989;286788;
28.01.2019;04:39:06;82924859;82638086;286773;
28.01.2019;04:40:04;82924950;82638181;286769;
28.01.2019;04:41:04;82925051;82638268;286783;
28.01.2019;04:42:05;82925168;82638375;286793;
28.01.2019;04:43:06;82925253;82638480;286773;
28.01.2019;04:44:05;82925348;82638567;286781;
28.01.2019;04:45:05;82925423;82638686;286737;
28.01.2019;04:46:06;82925520;82638786;286734;
28.01.2019;04:47:04;82925602;82638882;286720;
28.01.2019;04:48:04;82925703;82638999;286704;
28.01.2019;04:49:06;82925764;82639095;286669;
28.01.2019;04:50:06;82925852;82639196;286656;
28.01.2019;04:51:06;82925951;82639279;286672;
28.01.2019;04:52:08;82926046;82639380;286666;
28.01.2019;04:53:06;82926149;82639488;286661;
28.01.2019;04:54:04;82926236;82639583;286653;
28.01.2019;04:55:04;82926337;82639677;286660;
28.01.2019;04:56:05;82926429;82639765;286664;
28.01.2019;04:57:04;82926514;82639855;286659;
28.01.2019;04:58:05;82926608;82639960;286648;
28.01.2019;04:59:04;82926694;82640061;286633;
28.01.2019;05:00:04;82926779;82640155;286624;
28.01.2019;05:01:05;82926861;82640243;286618;
28.01.2019;05:02:05;82926963;82640338;286625;
28.01.2019;05:03:04;82927059;82640443;286616;
28.01.2019;05:04:06;82927149;82640548;286601;
28.01.2019;05:05:05;82927220;82640636;286584;
28.01.2019;05:06:04;82927306;82640731;286575;
28.01.2019;05:07:05;82927379;82640836;286543;
28.01.2019;05:08:04;82927477;82640920;286557;
28.01.2019;05:09:04;82927570;82641008;286562;
28.01.2019;05:10:04;82927659;82641112;286547;
28.01.2019;05:11:05;82927747;82641220;286527;
28.01.2019;05:12:05;82927843;82641324;286519;
28.01.2019;05:13:05;82927930;82641429;286501;
28.01.2019;05:14:04;82928011;82641502;286509;
28.01.2019;05:15:05;82928116;82641616;286500;
28.01.2019;05:16:06;82928202;82641712;286490;
28.01.2019;05:17:06;82928282;82641809;286473;
28.01.2019;05:18:05;82928362;82641905;286457;
28.01.2019;05:19:05;82928450;82642028;286422;
28.01.2019;05:20:04;82928532;82642122;286410;
28.01.2019;05:21:04;82928600;82642219;286381;
28.01.2019;05:22:05;82928690;82642327;286363;
28.01.2019;05:23:05;82928770;82642415;286355;
28.01.2019;05:24:04;82928870;82642505;286365;
28.01.2019;05:25:05;82928943;82642625;286318;
28.01.2019;05:26:05;82929009;82642731;286278;
28.01.2019;05:27:06;82929091;82642818;286273;
28.01.2019;05:28:05;82929174;82642931;286243;
28.01.2019;05:29:05;82929236;82643048;286188;
28.01.2019;05:30:04;82929319;82643160;286159;
28.01.2019;05:31:05;82929399;82643274;286125;
28.01.2019;05:32:06;82929488;82643377;286111;
28.01.2019;05:33:06;82929592;82643476;286116;
28.01.2019;05:34:05;82929681;82643569;286112;
28.01.2019;05:35:04;82929752;82643686;286066;
28.01.2019;05:36:05;82929851;82643798;286053;
28.01.2019;05:37:04;82929921;82643908;286013;
28.01.2019;05:38:05;82929991;82644023;285968;
28.01.2019;05:39:06;82930068;82644108;285960;
28.01.2019;05:40:05;82930162;82644203;285959;
28.01.2019;05:41:06;82930250;82644325;285925;
28.01.2019;05:42:06;82930337;82644419;285918;
28.01.2019;05:43:05;82930418;82644513;285905;
28.01.2019;05:44:04;82930494;82644599;285895;
28.01.2019;05:45:06;82930584;82644698;285886;
28.01.2019;05:46:05;82930677;82644788;285889;
28.01.2019;05:47:05;82930751;82644893;285858;
28.01.2019;05:48:04;82930810;82644985;285825;
28.01.2019;05:49:05;82930897;82645095;285802;
28.01.2019;05:50:05;82930970;82645200;285770;
28.01.2019;05:51:05;82931049;82645315;285734;
28.01.2019;05:52:06;82931127;82645437;285690;
28.01.2019;05:53:09;82931203;82645562;285641;
28.01.2019;05:54:04;82931270;82645669;285601;
28.01.2019;05:55:06;82931334;82645767;285567;
28.01.2019;05:56:05;82931415;82645881;285534;
28.01.2019;05:57:06;82931490;82646007;285483;
28.01.2019;05:58:06;82931573;82646103;285470;
28.01.2019;05:59:06;82931637;82646219;285418;
28.01.2019;06:00:04;82931703;82646302;285401;
28.01.2019;06:01:06;82931765;82646418;285347;
28.01.2019;06:02:06;82931842;82646512;285330;
28.01.2019;06:03:05;82931919;82646616;285303;
28.01.2019;06:04:04;82931991;82646701;285290;
28.01.2019;06:05:05;82932063;82646814;285249;
28.01.2019;06:06:05;82932123;82646927;285196;
28.01.2019;06:07:05;82932206;82647043;285163;
28.01.2019;06:08:05;82932276;82647151;285125;
28.01.2019;06:09:05;82932364;82647245;285119;
28.01.2019;06:10:05;82932440;82647339;285101;
28.01.2019;06:11:04;82932487;82647429;285058;
28.01.2019;06:12:04;82932532;82647554;284978;
28.01.2019;06:13:05;82932590;82647639;284951;
28.01.2019;06:14:06;82932636;82647716;284920;
28.01.2019;06:15:06;82932687;82647821;284866;
28.01.2019;06:16:05;82932722;82647909;284813;
28.01.2019;06:17:10;82932782;82648014;284768;
28.01.2019;06:18:04;82932850;82648103;284747;
28.01.2019;06:19:05;82932919;82648213;284706;
28.01.2019;06:20:04;82932982;82648299;284683;
28.01.2019;06:21:05;82933032;82648415;284617;
28.01.2019;06:22:04;82933061;82648506;284555;
28.01.2019;06:23:06;82933116;82648617;284499;
28.01.2019;06:24:06;82933159;82648686;284473;
28.01.2019;06:25:07;82933210;82648777;284433;
28.01.2019;06:26:06;82933261;82648869;284392;
28.01.2019;06:27:04;82933310;82648982;284328;
28.01.2019;06:28:06;82933374;82649060;284314;
28.01.2019;06:29:05;82933455;82649185;284270;
28.01.2019;06:30:04;82933539;82649297;284242;
28.01.2019;06:31:10;82933615;82649417;284198;
28.01.2019;06:32:05;82933675;82649515;284160;
28.01.2019;06:33:04;82933767;82649645;284122;
28.01.2019;06:34:05;82933832;82649750;284082;
28.01.2019;06:35:07;82933907;82649866;284041;
28.01.2019;06:36:05;82933968;82649962;284006;
28.01.2019;06:37:07;82934025;82650089;283936;
28.01.2019;06:38:12;82934085;82650195;283890;
28.01.2019;06:39:06;82934160;82650303;283857;
28.01.2019;06:40:05;82934229;82650408;283821;
28.01.2019;06:41:05;82934305;82650524;283781;
28.01.2019;06:42:04;82934308;82650602;283706;
28.01.2019;06:43:09;82934378;82650731;283647;
28.01.2019;06:44:05;82934454;82650817;283637;
28.01.2019;06:45:06;82934520;82650906;283614;
28.01.2019;06:46:05;82934586;82651020;283566;
28.01.2019;06:47:04;82934648;82651147;283501;
28.01.2019;06:48:05;82934728;82651240;283488;
28.01.2019;06:49:05;82934796;82651330;283466;
28.01.2019;06:50:05;82934876;82651428;283448;
28.01.2019;06:51:11;82934945;82651578;283367;
28.01.2019;06:52:06;82935007;82651663;283344;
28.01.2019;06:53:10;82935076;82651781;283295;
28.01.2019;06:54:05;82935138;82651888;283250;
28.01.2019;06:55:06;82935198;82651980;283218;
28.01.2019;06:56:05;82935248;82652078;283170;
28.01.2019;06:57:05;82935302;82652198;283104;
28.01.2019;06:58:06;82935380;82652299;283081;
28.01.2019;06:59:04;82935456;82652403;283053;
28.01.2019;07:00:04;82935527;82652506;283021;
28.01.2019;07:01:05;82935603;82652644;282959;
28.01.2019;07:02:06;82935658;82652769;282889;
28.01.2019;07:03:05;82935712;82652868;282844;
28.01.2019;07:04:05;82935767;82652980;282787;
28.01.2019;07:05:04;82935823;82653101;282722;
28.01.2019;07:06:05;82935893;82653223;282670;
28.01.2019;07:07:04;82935952;82653347;282605;
28.01.2019;07:08:05;82936022;82653493;282529;
28.01.2019;07:09:05;82936082;82653618;282464;
28.01.2019;07:10:05;82936148;82653743;282405;
28.01.2019;07:11:04;82936216;82653889;282327;
28.01.2019;07:12:05;82936301;82654012;282289;
28.01.2019;07:13:05;82936350;82654128;282222;
28.01.2019;07:14:05;82936416;82654246;282170;
28.01.2019;07:15:05;82936484;82654359;282125;
28.01.2019;07:16:05;82936548;82654463;282085;
28.01.2019;07:17:05;82936616;82654584;282032;
28.01.2019;07:18:05;82936687;82654676;282011;
28.01.2019;07:19:05;82936754;82654789;281965;
28.01.2019;07:20:05;82936805;82654904;281901;
28.01.2019;07:21:05;82936878;82655015;281863;
28.01.2019;07:22:07;82936938;82655143;281795;
28.01.2019;07:23:06;82937004;82655263;281741;
28.01.2019;07:24:05;82937077;82655373;281704;
28.01.2019;07:25:05;82937137;82655486;281651;
28.01.2019;07:26:04;82937199;82655600;281599;
28.01.2019;07:27:04;82937256;82655699;281557;
28.01.2019;07:28:04;82937327;82655817;281510;
28.01.2019;07:29:05;82937395;82655932;281463;
28.01.2019;07:30:05;82937460;82656047;281413;
28.01.2019;07:31:04;82937530;82656153;281377;
28.01.2019;07:32:04;82937598;82656257;281341;
28.01.2019;07:33:05;82937673;82656395;281278;
28.01.2019;07:34:05;82937733;82656518;281215;
28.01.2019;07:35:05;82937787;82656636;281151;
28.01.2019;07:36:04;82937841;82656731;281110;
28.01.2019;07:37:04;82937902;82656837;281065;
28.01.2019;07:38:05;82937954;82656940;281014;
28.01.2019;07:39:07;82938010;82657041;280969;
28.01.2019;07:40:05;82938081;82657164;280917;
28.01.2019;07:41:04;82938130;82657267;280863;
28.01.2019;07:42:04;82938170;82657417;280753;
28.01.2019;07:43:04;82938227;82657545;280682;
28.01.2019;07:44:05;82938292;82657669;280623;
28.01.2019;07:45:05;82938360;82657749;280611;
28.01.2019;07:46:04;82938445;82657854;280591;
28.01.2019;07:47:04;82938497;82657975;280522;
28.01.2019;07:48:05;82938549;82658057;280492;
28.01.2019;07:49:05;82938613;82658154;280459;
28.01.2019;07:50:05;82938675;82658266;280409;
28.01.2019;07:51:04;82938730;82658362;280368;
28.01.2019;07:52:04;82938778;82658472;280306;
28.01.2019;07:53:05;82938852;82658579;280273;
28.01.2019;07:54:05;82938925;82658687;280238;
28.01.2019;07:55:04;82938971;82658808;280163;
28.01.2019;07:56:04;82939016;82658912;280104;
28.01.2019;07:57:05;82939078;82659011;280067;
28.01.2019;07:58:04;82939136;82659115;280021;
28.01.2019;07:59:04;82939200;82659216;279984;
28.01.2019;08:00:05;82939256;82659313;279943;
28.01.2019;08:01:05;82939329;82659428;279901;
28.01.2019;08:02:05;82939380;82659554;279826;
28.01.2019;08:03:05;82939435;82659670;279765;
28.01.2019;08:04:05;82939483;82659781;279702;
28.01.2019;08:05:05;82939526;82659885;279641;
28.01.2019;08:06:05;82939574;82659981;279593;
28.01.2019;08:07:05;82939632;82660075;279557;
28.01.2019;08:08:04;82939693;82660150;279543;
28.01.2019;08:09:04;82939743;82660265;279478;
28.01.2019;08:10:05;82939784;82660365;279419;
28.01.2019;08:11:05;82939820;82660481;279339;
28.01.2019;08:12:05;82939865;82660603;279262;
28.01.2019;08:13:04;82939915;82660712;279203;
28.01.2019;08:14:04;82939943;82660815;279128;
28.01.2019;08:15:05;82939985;82660920;279065;
28.01.2019;08:16:05;82940056;82661028;279028;
28.01.2019;08:17:05;82940087;82661124;278963;
28.01.2019;08:18:05;82940118;82661227;278891;
28.01.2019;08:19:04;82940149;82661323;278826;
28.01.2019;08:20:04;82940185;82661430;278755;
28.01.2019;08:21:05;82940236;82661515;278721;
28.01.2019;08:22:05;82940289;82661626;278663;
28.01.2019;08:23:05;82940337;82661726;278611;
28.01.2019;08:24:05;82940376;82661842;278534;
28.01.2019;08:25:04;82940419;82661930;278489;
28.01.2019;08:26:05;82940475;82662032;278443;
28.01.2019;08:27:04;82940528;82662155;278373;
28.01.2019;08:28:05;82940564;82662262;278302;
28.01.2019;08:29:04;82940621;82662369;278252;
28.01.2019;08:30:05;82940663;82662490;278173;
28.01.2019;08:31:05;82940720;82662574;278146;
28.01.2019;08:32:04;82940769;82662701;278068;
28.01.2019;08:33:04;82940836;82662804;278032;
28.01.2019;08:34:04;82940895;82662920;277975;
28.01.2019;08:35:05;82940956;82663049;277907;
28.01.2019;08:36:05;82941016;82663161;277855;
28.01.2019;08:37:05;82941062;82663267;277795;
28.01.2019;08:38:04;82941119;82663380;277739;
28.01.2019;08:39:04;82941170;82663477;277693;
28.01.2019;08:40:05;82941223;82663607;277616;
28.01.2019;08:41:05;82941283;82663727;277556;
28.01.2019;08:42:04;82941332;82663824;277508;
28.01.2019;08:43:04;82941382;82663921;277461;
28.01.2019;08:44:05;82941451;82664021;277430;
28.01.2019;08:45:04;82941504;82664132;277372;
28.01.2019;08:46:05;82941567;82664255;277312;
28.01.2019;08:47:04;82941593;82664369;277224;
28.01.2019;08:48:04;82941640;82664496;277144;
28.01.2019;08:49:04;82941688;82664606;277082;
28.01.2019;08:50:05;82941750;82664707;277043;
28.01.2019;08:51:05;82941816;82664810;277006;
28.01.2019;08:53:04;82941928;82665038;276890;
28.01.2019;08:54:05;82941982;82665135;276847;
28.01.2019;08:55:04;82942036;82665243;276793;
28.01.2019;08:56:04;82942092;82665360;276732;
28.01.2019;08:57:05;82942152;82665485;276667;
28.01.2019;08:58:05;82942217;82665583;276634;
28.01.2019;08:59:04;82942266;82665724;276542;
28.01.2019;09:00:04;82942325;82665852;276473;
28.01.2019;09:01:04;82942397;82665981;276416;
28.01.2019;09:02:05;82942442;82666102;276340;
28.01.2019;09:03:04;82942506;82666227;276279;
28.01.2019;09:04:05;82942559;82666351;276208;
28.01.2019;09:05:05;82942618;82666461;276157;
28.01.2019;09:06:04;82942655;82666559;276096;
28.01.2019;09:07:04;82942724;82666679;276045;
28.01.2019;09:08:04;82942773;82666796;275977;
28.01.2019;09:09:06;82942822;82666910;275912;
28.01.2019;09:10:05;82942862;82667025;275837;
28.01.2019;09:11:05;82942922;82667148;275774;
28.01.2019;09:12:04;82942983;82667262;275721;
28.01.2019;09:13:04;82943036;82667358;275678;
28.01.2019;09:14:05;82943086;82667488;275598;
28.01.2019;09:15:04;82943135;82667600;275535;
28.01.2019;09:16:05;82943172;82667709;275463;
28.01.2019;09:17:05;82943203;82667818;275385;
28.01.2019;09:18:05;82943230;82667930;275300;
28.01.2019;09:19:04;82943275;82668047;275228;
28.01.2019;09:20:05;82943311;82668158;275153;
28.01.2019;09:21:05;82943352;82668284;275068;
28.01.2019;09:22:04;82943414;82668375;275039;
28.01.2019;09:23:04;82943456;82668472;274984;
28.01.2019;09:24:05;82943495;82668585;274910;
28.01.2019;09:25:04;82943545;82668680;274865;
28.01.2019;09:26:05;82943588;82668785;274803;
28.01.2019;09:27:05;82943638;82668906;274732;
28.01.2019;09:28:04;82943700;82669023;274677;
28.01.2019;09:29:04;82943757;82669109;274648;
28.01.2019;09:30:05;82943812;82669241;274571;
28.01.2019;09:31:05;82943870;82669332;274538;
28.01.2019;09:32:05;82943913;82669418;274495;
28.01.2019;09:33:05;82943964;82669506;274458;
28.01.2019;09:34:05;82943999;82669612;274387;
28.01.2019;09:35:04;82944057;82669704;274353;
28.01.2019;09:36:04;82944108;82669810;274298;
28.01.2019;09:37:04;82944150;82669934;274216;
28.01.2019;09:38:05;82944198;82670042;274156;
28.01.2019;09:39:07;82944243;82670142;274101;
28.01.2019;09:40:05;82944296;82670258;274038;
28.01.2019;09:41:04;82944320;82670320;274000;
28.01.2019;09:42:05;82944352;82670423;273929;
28.01.2019;09:43:05;82944406;82670527;273879;
28.01.2019;09:44:05;82944444;82670653;273791;
28.01.2019;09:45:04;82944484;82670767;273717;
28.01.2019;09:46:04;82944530;82670858;273672;
28.01.2019;09:47:05;82944578;82670976;273602;
28.01.2019;09:48:05;82944635;82671092;273543;
28.01.2019;09:49:04;82944673;82671205;273468;
28.01.2019;09:50:04;82944714;82671300;273414;
28.01.2019;09:51:05;82944777;82671406;273371;
28.01.2019;09:52:04;82944817;82671532;273285;
28.01.2019;09:53:05;82944882;82671667;273215;
28.01.2019;09:54:04;82944919;82671759;273160;
28.01.2019;09:55:04;82944966;82671872;273094;
28.01.2019;09:56:05;82945000;82671972;273028;
28.01.2019;09:57:05;82945051;82672055;272996;
28.01.2019;09:58:05;82945089;82672178;272911;
28.01.2019;09:59:05;82945131;82672309;272822;
28.01.2019;10:00:04;82945160;82672449;272711;
28.01.2019;10:01:05;82945198;82672587;272611;
28.01.2019;10:02:04;82945237;82672715;272522;
28.01.2019;10:03:04;82945278;82672841;272437;
28.01.2019;10:04:05;82945325;82672975;272350;
28.01.2019;10:05:05;82945382;82673107;272275;
28.01.2019;10:06:05;82945435;82673251;272184;
28.01.2019;10:07:04;82945484;82673379;272105;
28.01.2019;10:08:04;82945539;82673522;272017;
28.01.2019;10:09:07;82945589;82673629;271960;
28.01.2019;10:10:05;82945627;82673748;271879;
28.01.2019;10:11:05;82945674;82673877;271797;
28.01.2019;10:12:04;82945704;82673966;271738;
28.01.2019;10:13:04;82945721;82674086;271635;
28.01.2019;10:14:04;82945750;82674195;271555;
28.01.2019;10:15:05;82945776;82674309;271467;
28.01.2019;10:16:05;82945805;82674398;271407;
28.01.2019;10:17:05;82945839;82674522;271317;
28.01.2019;10:18:05;82945852;82674631;271221;
28.01.2019;10:19:04;82945881;82674750;271131;
28.01.2019;10:20:04;82945920;82674883;271037;
28.01.2019;10:21:05;82945949;82674997;270952;
28.01.2019;10:22:05;82945985;82675110;270875;
28.01.2019;10:23:05;82946030;82675235;270795;
28.01.2019;10:24:05;82946076;82675373;270703;
28.01.2019;10:25:04;82946114;82675496;270618;
28.01.2019;10:26:04;82946175;82675625;270550;
28.01.2019;10:27:05;82946217;82675765;270452;
28.01.2019;10:28:05;82946271;82675919;270352;
28.01.2019;10:29:05;82946326;82676050;270276;
28.01.2019;10:30:06;82946384;82676199;270185;
28.01.2019;10:31:05;82946444;82676336;270108;
28.01.2019;10:32:05;82946480;82676448;270032;
28.01.2019;10:33:04;82946530;82676574;269956;
28.01.2019;10:34:04;82946567;82676741;269826;
28.01.2019;10:35:05;82946612;82676900;269712;
28.01.2019;10:36:04;82946646;82677046;269600;
28.01.2019;10:37:05;82946694;82677166;269528;
28.01.2019;10:38:05;82946740;82677305;269435;
28.01.2019;10:39:05;82946798;82677447;269351;
28.01.2019;10:40:05;82946851;82677577;269274;
28.01.2019;10:41:05;82946902;82677726;269176;
28.01.2019;10:42:04;82946944;82677868;269076;
28.01.2019;10:43:04;82946979;82677998;268981;
28.01.2019;10:44:05;82947012;82678130;268882;
28.01.2019;10:45:04;82947047;82678272;268775;
28.01.2019;10:46:05;82947092;82678417;268675;
28.01.2019;10:47:05;82947131;82678561;268570;
28.01.2019;10:48:05;82947182;82678711;268471;
28.01.2019;10:49:07;82947226;82678823;268403;
28.01.2019;10:50:06;82947267;82678976;268291;
28.01.2019;10:51:11;82947329;82679116;268213;
28.01.2019;10:52:07;82947371;82679239;268132;
28.01.2019;10:53:06;82947412;82679376;268036;
28.01.2019;10:54:05;82947458;82679500;267958;
28.01.2019;10:55:05;82947503;82679641;267862;
28.01.2019;10:56:05;82947538;82679791;267747;
28.01.2019;10:57:04;82947590;82679941;267649;
28.01.2019;10:58:07;82947626;82680119;267507;
28.01.2019;10:59:05;82947682;82680274;267408;
28.01.2019;11:00:06;82947742;82680399;267343;
28.01.2019;11:01:05;82947791;82680532;267259;
28.01.2019;11:02:05;82947847;82680658;267189;
28.01.2019;11:03:06;82947898;82680820;267078;
28.01.2019;11:04:05;82947948;82680938;267010;
28.01.2019;11:05:05;82947999;82681091;266908;
28.01.2019;11:06:05;82948027;82681220;266807;
28.01.2019;11:07:05;82948080;82681357;266723;
28.01.2019;11:08:05;82948133;82681497;266636;
28.01.2019;11:09:11;82948205;82681651;266554;
28.01.2019;11:10:04;82948252;82681773;266479;
28.01.2019;11:11:05;82948299;82681924;266375;
28.01.2019;11:12:05;82948350;82682060;266290;
28.01.2019;11:13:04;82948392;82682182;266210;
28.01.2019;11:14:04;82948429;82682319;266110;
28.01.2019;11:15:05;82948466;82682449;266017;
28.01.2019;11:16:04;82948528;82682595;265933;
28.01.2019;11:17:05;82948576;82682736;265840;
28.01.2019;11:18:05;82948608;82682855;265753;
28.01.2019;11:19:05;82948656;82683004;265652;
28.01.2019;11:20:04;82948693;82683126;265567;
28.01.2019;11:21:05;82948733;82683263;265470;
28.01.2019;11:22:04;82948768;82683407;265361;
28.01.2019;11:23:04;82948801;82683538;265263;
28.01.2019;11:24:05;82948858;82683677;265181;
28.01.2019;11:25:05;82948906;82683819;265087;
28.01.2019;11:26:05;82948959;82683947;265012;
28.01.2019;11:27:05;82949009;82684093;264916;
28.01.2019;11:28:05;82949065;82684238;264827;
28.01.2019;11:29:04;82949125;82684383;264742;
28.01.2019;11:30:05;82949187;82684508;264679;
28.01.2019;11:31:05;82949231;82684651;264580;
28.01.2019;11:32:04;82949292;82684778;264514;
28.01.2019;11:33:04;82949336;82684914;264422;
28.01.2019;11:34:05;82949394;82685072;264322;
28.01.2019;11:35:04;82949431;82685202;264229;
28.01.2019;11:36:04;82949502;82685334;264168;
28.01.2019;11:37:05;82949547;82685464;264083;
28.01.2019;11:38:05;82949598;82685582;264016;
28.01.2019;11:39:04;82949656;82685706;263950;
28.01.2019;11:40:04;82949702;82685834;263868;
28.01.2019;11:41:05;82949744;82685983;263761;
28.01.2019;11:42:05;82949791;82686127;263664;
28.01.2019;11:43:04;82949852;82686275;263577;
28.01.2019;11:44:04;82949904;82686424;263480;
28.01.2019;11:45:10;82949959;82686579;263380;
28.01.2019;11:46:04;82950004;82686696;263308;
28.01.2019;11:47:05;82950047;82686813;263234;
28.01.2019;11:48:04;82950107;82686953;263154;
28.01.2019;11:49:04;82950165;82687069;263096;
28.01.2019;11:50:05;82950214;82687191;263023;
28.01.2019;11:51:04;82950269;82687322;262947;
28.01.2019;11:52:04;82950329;82687457;262872;
28.01.2019;11:53:05;82950377;82687568;262809;
28.01.2019;11:54:04;82950433;82687705;262728;
28.01.2019;11:55:04;82950499;82687853;262646;
28.01.2019;11:56:05;82950554;82687984;262570;
28.01.2019;11:57:05;82950597;82688128;262469;
28.01.2019;11:58:06;82950645;82688274;262371;
28.01.2019;11:59:04;82950700;82688388;262312;
28.01.2019;12:00:04;82950748;82688547;262201;
28.01.2019;12:01:06;82950796;82688681;262115;
28.01.2019;12:02:06;82950845;82688820;262025;
28.01.2019;12:03:05;82950899;82688961;261938;
28.01.2019;12:04:04;82950950;82689092;261858;
28.01.2019;12:05:10;82951016;82689217;261799;
28.01.2019;12:06:04;82951058;82689342;261716;
28.01.2019;12:07:04;82951119;82689463;261656;
28.01.2019;12:08:04;82951153;82689612;261541;
28.01.2019;12:09:04;82951211;82689734;261477;
28.01.2019;12:10:04;82951262;82689871;261391;
28.01.2019;12:11:05;82951320;82690009;261311;
28.01.2019;12:12:05;82951362;82690149;261213;
28.01.2019;12:13:04;82951417;82690268;261149;
28.01.2019;12:14:04;82951460;82690407;261053;
28.01.2019;12:15:05;82951509;82690550;260959;
28.01.2019;12:16:05;82951544;82690629;260915;
28.01.2019;12:17:05;82951585;82690744;260841;
28.01.2019;12:18:05;82951614;82690848;260766;
28.01.2019;12:19:04;82951626;82690935;260691;
28.01.2019;12:20:04;82951665;82691019;260646;
28.01.2019;12:21:05;82951719;82691147;260572;
28.01.2019;12:22:10;82951770;82691306;260464;
28.01.2019;12:23:04;82951816;82691436;260380;
28.01.2019;12:24:04;82951861;82691561;260300;
28.01.2019;12:25:05;82951916;82691712;260204;
28.01.2019;12:26:06;82951970;82691847;260123;
28.01.2019;12:27:05;82952035;82691997;260038;
28.01.2019;12:28:05;82952091;82692139;259952;
28.01.2019;12:29:04;82952149;82692293;259856;
28.01.2019;12:30:10;82952206;82692468;259738;
28.01.2019;12:31:06;82952283;82692605;259678;
28.01.2019;12:32:05;82952326;82692735;259591;
28.01.2019;12:33:10;82952400;82692911;259489;
28.01.2019;12:34:04;82952469;82693030;259439;
28.01.2019;12:35:05;82952521;82693177;259344;
28.01.2019;12:36:04;82952579;82693306;259273;
28.01.2019;12:37:04;82952645;82693444;259201;
28.01.2019;12:38:05;82952701;82693575;259126;
28.01.2019;12:39:05;82952774;82693733;259041;
28.01.2019;12:40:09;82952837;82693902;258935;
28.01.2019;12:41:05;82952755;82693932;258823;
28.01.2019;12:42:05;82952420;82693734;258686;
28.01.2019;12:43:05;82952385;82693788;258597;
28.01.2019;12:44:04;82952438;82693931;258507;
28.01.2019;12:45:05;82952481;82694071;258410;
28.01.2019;12:46:05;82952540;82694207;258333;
28.01.2019;12:47:05;82952598;82694360;258238;
28.01.2019;12:48:04;82952686;82694491;258195;
28.01.2019;12:49:04;82952753;82694616;258137;
28.01.2019;12:50:05;82952807;82694757;258050;
28.01.2019;12:51:04;82952855;82694896;257959;
28.01.2019;12:52:09;82952932;82695055;257877;
28.01.2019;12:53:05;82952989;82695194;257795;
28.01.2019;12:54:04;82953058;82695348;257710;
28.01.2019;12:55:05;82953133;82695475;257658;
28.01.2019;12:56:04;82953207;82695613;257594;
28.01.2019;12:57:04;82953263;82695743;257520;
28.01.2019;12:58:05;82953311;82695909;257402;
28.01.2019;12:59:05;82953361;82696066;257295;
28.01.2019;13:00:04;82953425;82696225;257200;
28.01.2019;13:01:04;82953487;82696373;257114;
28.01.2019;13:02:05;82953539;82696529;257010;
28.01.2019;13:03:04;82953584;82696666;256918;
28.01.2019;13:04:04;82953649;82696789;256860;
28.01.2019;13:05:05;82953722;82696949;256773;
28.01.2019;13:06:05;82953779;82697122;256657;
28.01.2019;13:07:09;82953849;82697264;256585;
28.01.2019;13:08:05;82953898;82697417;256481;
28.01.2019;13:09:07;82953942;82697542;256400;
28.01.2019;13:10:04;82954006;82697674;256332;
28.01.2019;13:11:04;82954077;82697829;256248;
28.01.2019;13:12:05;82954141;82697998;256143;
28.01.2019;13:13:04;82954200;82698128;256072;
28.01.2019;13:14:04;82954261;82698287;255974;
28.01.2019;13:15:05;82954328;82698423;255905;
28.01.2019;13:16:05;82954411;82698588;255823;
28.01.2019;13:17:05;82954468;82698747;255721;
28.01.2019;13:18:05;82954542;82698882;255660;
28.01.2019;13:19:04;82954620;82699007;255613;
28.01.2019;13:20:04;82954690;82699147;255543;
28.01.2019;13:21:05;82954759;82699298;255461;
28.01.2019;13:22:05;82954824;82699436;255388;
28.01.2019;13:23:05;82954887;82699584;255303;
28.01.2019;13:24:06;82954964;82699717;255247;
28.01.2019;13:25:08;82955018;82699865;255153;
28.01.2019;13:26:05;82955082;82700004;255078;
28.01.2019;13:27:04;82955159;82700151;255008;
28.01.2019;13:28:04;82955228;82700295;254933;
28.01.2019;13:29:04;82955301;82700453;254848;
28.01.2019;13:30:05;82955372;82700599;254773;
28.01.2019;13:31:05;82955447;82700732;254715;
28.01.2019;13:32:04;82955518;82700890;254628;
28.01.2019;13:33:05;82955585;82701038;254547;
28.01.2019;13:34:05;82955652;82701202;254450;
28.01.2019;13:35:04;82955698;82701332;254366;
28.01.2019;13:36:12;82955783;82701512;254271;
28.01.2019;13:37:05;82955858;82701610;254248;
28.01.2019;13:38:05;82955929;82701753;254176;
28.01.2019;13:39:05;82956003;82701906;254097;
28.01.2019;13:40:04;82956069;82702075;253994;
28.01.2019;13:41:04;82956135;82702218;253917;
28.01.2019;13:43:05;82956283;82702504;253779;
28.01.2019;13:44:05;82956362;82702651;253711;
28.01.2019;13:45:05;82956414;82702784;253630;
28.01.2019;13:46:04;82956489;82702934;253555;
28.01.2019;13:47:04;82956569;82703066;253503;
28.01.2019;13:48:12;82956642;82703230;253412;
28.01.2019;13:49:09;82956707;82703382;253325;
28.01.2019;13:50:06;82956797;82703504;253293;
28.01.2019;13:51:09;82956887;82703678;253209;
28.01.2019;13:52:06;82956968;82703799;253169;
28.01.2019;13:53:08;82957050;82703965;253085;
28.01.2019;13:54:09;82957121;82704127;252994;
28.01.2019;13:55:06;82957199;82704262;252937;
28.01.2019;13:56:06;82957267;82704403;252864;
28.01.2019;13:57:06;82957359;82704552;252807;
28.01.2019;13:58:10;82957430;82704717;252713;
28.01.2019;13:59:06;82957479;82704848;252631;
28.01.2019;14:00:05;82957555;82705002;252553;
28.01.2019;14:01:04;82957630;82705144;252486;
28.01.2019;14:02:04;82957713;82705301;252412;
28.01.2019;14:03:05;82957793;82705457;252336;
28.01.2019;14:04:06;82957864;82705589;252275;
28.01.2019;14:05:12;82957948;82705762;252186;
28.01.2019;14:06:08;82958005;82705931;252074;
28.01.2019;14:07:06;82958065;82706106;251959;
28.01.2019;14:08:06;82958131;82706269;251862;
28.01.2019;14:09:05;82958193;82706411;251782;
28.01.2019;14:10:06;82958274;82706577;251697;
28.01.2019;14:11:05;82958342;82706727;251615;
28.01.2019;14:12:08;82958418;82706899;251519;
28.01.2019;14:13:07;82958494;82707074;251420;
28.01.2019;14:14:07;82958549;82707216;251333;
28.01.2019;14:15:05;82958615;82707330;251285;
28.01.2019;14:16:08;82958676;82707496;251180;
28.01.2019;14:17:10;82958755;82707633;251122;
28.01.2019;14:18:09;82958811;82707757;251054;
28.01.2019;14:19:06;82958873;82707871;251002;
28.01.2019;14:20:12;82958959;82708046;250913;
28.01.2019;14:21:05;82959019;82708188;250831;
28.01.2019;14:22:05;82959058;82708320;250738;
28.01.2019;14:23:05;82959135;82708472;250663;
28.01.2019;14:24:07;82959210;82708612;250598;
28.01.2019;14:25:05;82959270;82708733;250537;
28.01.2019;14:26:10;82959343;82708892;250451;
28.01.2019;14:27:06;82959400;82709013;250387;
28.01.2019;14:28:11;82959480;82709179;250301;
28.01.2019;14:29:10;82959530;82709312;250218;
28.01.2019;14:30:05;82959601;82709437;250164;
28.01.2019;14:31:05;82959676;82709571;250105;
28.01.2019;14:32:08;82959755;82709713;250042;
28.01.2019;14:33:05;82959821;82709842;249979;
28.01.2019;14:34:05;82959902;82709986;249916;
28.01.2019;14:35:10;82959961;82710137;249824;
28.01.2019;14:36:05;82960034;82710270;249764;
28.01.2019;14:37:05;82960124;82710408;249716;
28.01.2019;14:38:05;82960196;82710565;249631;
28.01.2019;14:39:05;82960278;82710728;249550;
28.01.2019;14:40:05;82960361;82710871;249490;
28.01.2019;14:41:05;82960431;82710999;249432;
28.01.2019;14:42:05;82960503;82711165;249338;
28.01.2019;14:43:07;82960596;82711312;249284;
28.01.2019;14:44:05;82960671;82711444;249227;
28.01.2019;14:45:05;82960761;82711611;249150;
28.01.2019;14:46:06;82960851;82711761;249090;
28.01.2019;14:47:04;82960924;82711904;249020;
28.01.2019;14:48:06;82961010;82712061;248949;
28.01.2019;14:49:11;82961103;82712224;248879;
28.01.2019;14:50:09;82961198;82712367;248831;
28.01.2019;14:51:05;82961257;82712489;248768;
28.01.2019;14:52:09;82961342;82712660;248682;
28.01.2019;14:53:04;82961418;82712781;248637;
28.01.2019;14:54:05;82961510;82712942;248568;
28.01.2019;14:55:05;82961600;82713086;248514;
28.01.2019;14:56:06;82961668;82713257;248411;
28.01.2019;14:57:04;82961741;82713405;248336;
28.01.2019;14:58:05;82961834;82713548;248286;
28.01.2019;14:59:04;82961905;82713692;248213;
28.01.2019;15:00:08;82961981;82713849;248132;
28.01.2019;15:01:09;82962061;82714010;248051;
28.01.2019;15:02:08;82962161;82714158;248003;
28.01.2019;15:03:07;82962258;82714291;247967;
28.01.2019;15:04:08;82962339;82714448;247891;
28.01.2019;15:05:08;82962418;82714592;247826;
28.01.2019;15:06:08;82962501;82714733;247768;
28.01.2019;15:07:08;82962582;82714891;247691;
28.01.2019;15:08:08;82962634;82715051;247583;
28.01.2019;15:09:08;82962724;82715194;247530;
28.01.2019;15:10:07;82962818;82715339;247479;
28.01.2019;15:11:07;82962890;82715483;247407;
28.01.2019;15:12:07;82962983;82715639;247344;
28.01.2019;15:13:08;82963063;82715785;247278;
28.01.2019;15:14:08;82963138;82715941;247197;
28.01.2019;15:15:06;82963223;82716098;247125;
28.01.2019;15:16:13;82963317;82716260;247057;
28.01.2019;15:17:08;82963386;82716387;246999;
28.01.2019;15:18:08;82963473;82716527;246946;
28.01.2019;15:19:08;82963537;82716678;246859;
28.01.2019;15:20:08;82963619;82716839;246780;
28.01.2019;15:21:09;82963704;82717004;246700;
28.01.2019;15:22:08;82963780;82717161;246619;
28.01.2019;15:23:07;82963874;82717320;246554;
28.01.2019;15:24:08;82963962;82717467;246495;
28.01.2019;15:25:07;82964053;82717628;246425;
28.01.2019;15:26:08;82964142;82717759;246383;
28.01.2019;15:27:08;82964233;82717904;246329;
28.01.2019;15:28:07;82964322;82718048;246274;
28.01.2019;15:29:08;82964412;82718207;246205;
28.01.2019;15:30:07;82964495;82718363;246132;
28.01.2019;15:31:07;82964567;82718487;246080;
28.01.2019;15:32:08;82964677;82718621;246056;
28.01.2019;15:33:08;82964764;82718762;246002;
28.01.2019;15:34:07;82964853;82718915;245938;
28.01.2019;15:35:08;82964940;82719079;245861;
28.01.2019;15:36:08;82965051;82719243;245808;
28.01.2019;15:37:08;82965137;82719395;245742;
28.01.2019;15:38:07;82965212;82719548;245664;
28.01.2019;15:39:08;82965296;82719709;245587;
28.01.2019;15:40:13;82965412;82719904;245508;
28.01.2019;15:41:08;82965491;82720034;245457;
28.01.2019;15:42:08;82965571;82720181;245390;
28.01.2019;15:44:08;82965755;82720526;245229;
28.01.2019;15:45:08;82965847;82720697;245150;
28.01.2019;15:46:08;82965932;82720847;245085;
28.01.2019;15:47:08;82966018;82720991;245027;
28.01.2019;15:48:08;82966098;82721147;244951;
28.01.2019;15:49:08;82966206;82721316;244890;
28.01.2019;15:50:08;82966285;82721486;244799;
28.01.2019;15:51:08;82966370;82721633;244737;
28.01.2019;15:52:08;82966463;82721754;244709;
28.01.2019;15:53:07;82966567;82721908;244659;
28.01.2019;15:54:08;82966667;82722096;244571;
28.01.2019;15:55:08;82966755;82722250;244505;
28.01.2019;15:56:08;82966827;82722398;244429;
28.01.2019;15:57:08;82966914;82722533;244381;
28.01.2019;15:58:08;82966987;82722673;244314;
28.01.2019;15:59:08;82967095;82722825;244270;
28.01.2019;16:00:05;82967181;82722989;244192;
28.01.2019;16:01:04;82967262;82723130;244132;
28.01.2019;16:02:05;82967352;82723311;244041;
28.01.2019;16:03:05;82967440;82723460;243980;
28.01.2019;16:04:05;82967522;82723612;243910;
28.01.2019;16:05:05;82967591;82723761;243830;
28.01.2019;16:06:05;82967668;82723916;243752;
28.01.2019;16:07:05;82967762;82724071;243691;
28.01.2019;16:08:05;82967853;82724208;243645;
28.01.2019;16:09:04;82967957;82724383;243574;
28.01.2019;16:10:05;82968035;82724532;243503;
28.01.2019;16:11:05;82968138;82724673;243465;
28.01.2019;16:12:05;82968217;82724800;243417;
28.01.2019;16:13:05;82968297;82724978;243319;
28.01.2019;16:14:05;82968384;82725134;243250;
28.01.2019;16:15:05;82968459;82725248;243211;
28.01.2019;16:16:05;82968534;82725387;243147;
28.01.2019;16:17:05;82968605;82725519;243086;
28.01.2019;16:18:04;82968692;82725671;243021;
28.01.2019;16:19:04;82968749;82725824;242925;
28.01.2019;16:20:05;82968848;82725982;242866;
28.01.2019;16:21:05;82968932;82726147;242785;
28.01.2019;16:22:04;82968998;82726302;242696;
28.01.2019;16:23:04;82969065;82726445;242620;
28.01.2019;16:24:05;82969148;82726606;242542;
28.01.2019;16:25:05;82969217;82726741;242476;
28.01.2019;16:26:05;82969311;82726897;242414;
28.01.2019;16:27:05;82969387;82727058;242329;
28.01.2019;16:28:05;82969483;82727211;242272;
28.01.2019;16:29:04;82969571;82727379;242192;
28.01.2019;16:30:04;82969654;82727531;242123;
28.01.2019;16:31:04;82969752;82727674;242078;
28.01.2019;16:32:04;82969846;82727827;242019;
28.01.2019;16:33:04;82969922;82727968;241954;
28.01.2019;16:34:04;82969998;82728117;241881;
28.01.2019;16:35:05;82970073;82728267;241806;
28.01.2019;16:36:06;82970154;82728428;241726;
28.01.2019;16:37:05;82970254;82728559;241695;
28.01.2019;16:38:05;82970342;82728716;241626;
28.01.2019;16:39:06;82970421;82728864;241557;
28.01.2019;16:40:04;82970501;82728995;241506;
28.01.2019;16:41:04;82970624;82729132;241492;
28.01.2019;16:42:05;82970733;82729307;241426;
28.01.2019;16:43:05;82970826;82729437;241389;
28.01.2019;16:44:04;82970906;82729562;241344;
28.01.2019;16:45:04;82971001;82729726;241275;
28.01.2019;16:46:05;82971080;82729879;241201;
28.01.2019;16:47:05;82971175;82730035;241140;
28.01.2019;16:48:05;82971259;82730180;241079;
28.01.2019;16:49:05;82971361;82730347;241014;
28.01.2019;16:50:04;82971462;82730486;240976;
28.01.2019;16:51:05;82971563;82730632;240931;
28.01.2019;16:52:05;82971651;82730805;240846;
28.01.2019;16:53:10;82971732;82730994;240738;
28.01.2019;16:54:05;82971828;82731131;240697;
28.01.2019;16:55:05;82971929;82731289;240640;
28.01.2019;16:56:04;82972006;82731461;240545;
28.01.2019;16:57:04;82972103;82731641;240462;
28.01.2019;16:58:06;82972190;82731819;240371;
28.01.2019;16:59:05;82972276;82731979;240297;
28.01.2019;17:00:05;82972358;82732155;240203;
28.01.2019;17:01:05;82972434;82732317;240117;
28.01.2019;17:02:06;82972522;82732470;240052;
28.01.2019;17:03:06;82972601;82732636;239965;
28.01.2019;17:04:05;82972678;82732798;239880;
28.01.2019;17:05:08;82972773;82732962;239811;
28.01.2019;17:06:09;82972888;82733125;239763;
28.01.2019;17:07:06;82972964;82733266;239698;
28.01.2019;17:08:04;82973058;82733418;239640;
28.01.2019;17:09:07;82973148;82733588;239560;
28.01.2019;17:10:05;82973248;82733721;239527;
28.01.2019;17:11:06;82973336;82733875;239461;
28.01.2019;17:12:12;82973435;82734031;239404;
28.01.2019;17:13:05;82973537;82734182;239355;
28.01.2019;17:14:04;82973636;82734348;239288;
28.01.2019;17:15:06;82973726;82734510;239216;
28.01.2019;17:16:06;82973819;82734676;239143;
28.01.2019;17:17:06;82973903;82734826;239077;
28.01.2019;17:18:05;82973976;82734978;238998;
28.01.2019;17:19:05;82974079;82735132;238947;
28.01.2019;17:20:04;82974166;82735281;238885;
28.01.2019;17:21:04;82974274;82735455;238819;
28.01.2019;17:22:06;82974382;82735604;238778;
28.01.2019;17:23:05;82974459;82735752;238707;
28.01.2019;17:24:05;82974579;82735890;238689;
28.01.2019;17:25:05;82974675;82736036;238639;
28.01.2019;17:26:05;82974752;82736180;238572;
28.01.2019;17:27:05;82974851;82736340;238511;
28.01.2019;17:28:05;82974950;82736498;238452;
28.01.2019;17:29:05;82975059;82736644;238415;
28.01.2019;17:30:04;82975157;82736782;238375;
28.01.2019;17:31:05;82975270;82736938;238332;
28.01.2019;17:32:05;82975371;82737092;238279;
28.01.2019;17:33:05;82975468;82737235;238233;
28.01.2019;17:34:05;82975562;82737413;238149;
28.01.2019;17:35:04;82975659;82737580;238079;
28.01.2019;17:36:04;82975740;82737739;238001;
28.01.2019;17:37:04;82975855;82737887;237968;
28.01.2019;17:38:05;82975963;82738027;237936;
28.01.2019;17:39:06;82976068;82738183;237885;
28.01.2019;17:40:05;82976192;82738335;237857;
28.01.2019;17:41:05;82976282;82738467;237815;
28.01.2019;17:42:05;82976377;82738632;237745;
28.01.2019;17:43:05;82976494;82738754;237740;
28.01.2019;17:44:05;82976582;82738880;237702;
28.01.2019;17:45:05;82976682;82739020;237662;
28.01.2019;17:46:04;82976772;82739165;237607;
28.01.2019;17:47:04;82976854;82739314;237540;
28.01.2019;17:48:05;82976946;82739460;237486;
28.01.2019;17:49:04;82977031;82739598;237433;
28.01.2019;17:50:04;82977152;82739726;237426;
28.01.2019;17:51:06;82977234;82739891;237343;
28.01.2019;17:52:05;82977323;82740021;237302;
28.01.2019;17:53:04;82977421;82740179;237242;
28.01.2019;17:54:06;82977516;82740318;237198;
28.01.2019;17:55:04;82977629;82740454;237175;
28.01.2019;17:56:05;82977735;82740600;237135;
28.01.2019;17:57:04;82977816;82740756;237060;
28.01.2019;17:58:04;82977923;82740899;237024;
28.01.2019;17:59:04;82978007;82741021;236986;
28.01.2019;18:00:05;82978082;82741175;236907;
28.01.2019;18:01:04;82978175;82741308;236867;
28.01.2019;18:02:04;82978264;82741432;236832;
28.01.2019;18:03:05;82978360;82741572;236788;
28.01.2019;18:04:06;82978444;82741728;236716;
28.01.2019;18:05:05;82978587;82741839;236748;
28.01.2019;18:06:05;82978688;82741967;236721;
28.01.2019;18:07:05;82978791;82742107;236684;
28.01.2019;18:08:05;82978911;82742240;236671;
28.01.2019;18:09:07;82979027;82742397;236630;
28.01.2019;18:10:05;82979129;82742531;236598;
28.01.2019;18:11:05;82979212;82742678;236534;
28.01.2019;18:12:04;82979336;82742798;236538;
28.01.2019;18:13:04;82979421;82742947;236474;
28.01.2019;18:14:04;82979500;82743075;236425;
28.01.2019;18:15:05;82979582;82743200;236382;
28.01.2019;18:16:06;82979671;82743335;236336;
28.01.2019;18:17:05;82979754;82743461;236293;
28.01.2019;18:18:04;82979853;82743600;236253;
28.01.2019;18:19:04;82979924;82743715;236209;
28.01.2019;18:20:05;82980013;82743820;236193;
28.01.2019;18:21:05;82980089;82743954;236135;
28.01.2019;18:22:05;82980191;82744086;236105;
28.01.2019;18:23:04;82980277;82744204;236073;
28.01.2019;18:24:04;82980365;82744311;236054;
28.01.2019;18:25:05;82980474;82744431;236043;
28.01.2019;18:26:05;82980577;82744558;236019;
28.01.2019;18:27:04;82980666;82744696;235970;
28.01.2019;18:28:04;82980756;82744821;235935;
28.01.2019;18:29:06;82980842;82744911;235931;
28.01.2019;18:30:04;82980954;82745033;235921;
28.01.2019;18:31:04;82981028;82745152;235876;
28.01.2019;18:32:04;82981111;82745269;235842;
28.01.2019;18:33:05;82981210;82745379;235831;
28.01.2019;18:34:04;82981281;82745485;235796;
28.01.2019;18:35:04;82981385;82745617;235768;
28.01.2019;18:36:04;82981462;82745748;235714;
28.01.2019;18:37:05;82981562;82745867;235695;
28.01.2019;18:38:05;82981657;82745989;235668;
28.01.2019;18:39:05;82981766;82746079;235687;
28.01.2019;18:40:04;82981832;82746181;235651;
28.01.2019;18:41:04;82981936;82746293;235643;
28.01.2019;18:42:05;82982023;82746382;235641;
28.01.2019;18:43:05;82982120;82746484;235636;
28.01.2019;18:44:06;82982222;82746587;235635;
28.01.2019;18:45:05;82982321;82746679;235642;
28.01.2019;18:46:05;82982417;82746770;235647;
28.01.2019;18:47:05;82982496;82746873;235623;
28.01.2019;18:48:05;82982583;82746976;235607;
28.01.2019;18:49:04;82982683;82747076;235607;
28.01.2019;18:50:04;82982771;82747208;235563;
28.01.2019;18:51:05;82982866;82747329;235537;
28.01.2019;18:52:05;82982940;82747390;235550;
28.01.2019;18:53:05;82983017;82747490;235527;
28.01.2019;18:54:06;82983123;82747623;235500;
28.01.2019;18:55:05;82983223;82747706;235517;
28.01.2019;18:56:04;82983320;82747820;235500;
28.01.2019;18:57:04;82983404;82747954;235450;
28.01.2019;18:58:05;82983506;82748056;235450;
28.01.2019;18:59:05;82983589;82748158;235431;
28.01.2019;19:00:04;82983675;82748293;235382;
28.01.2019;19:01:04;82983756;82748408;235348;
28.01.2019;19:02:05;82983833;82748514;235319;
28.01.2019;19:03:05;82983928;82748603;235325;
28.01.2019;19:04:04;82984020;82748719;235301;
28.01.2019;19:05:04;82984109;82748836;235273;
28.01.2019;19:06:05;82984186;82748931;235255;
28.01.2019;19:07:05;82984258;82749028;235230;
28.01.2019;19:08:05;82984351;82749128;235223;
28.01.2019;19:09:05;82984429;82749235;235194;
28.01.2019;19:10:05;82984515;82749342;235173;
28.01.2019;19:11:05;82984609;82749417;235192;
28.01.2019;19:12:37;82984698;82749574;235124;
28.01.2019;19:13:05;82984752;82749621;235131;
28.01.2019;19:14:05;82984762;82749730;235032;
28.01.2019;19:15:05;82984818;82749806;235012;
28.01.2019;19:16:05;82984868;82749903;234965;
28.01.2019;19:17:05;82984936;82749986;234950;
28.01.2019;19:18:05;82985001;82750078;234923;
28.01.2019;19:19:05;82985052;82750182;234870;
28.01.2019;19:20:06;82985100;82750282;234818;
28.01.2019;19:21:05;82985164;82750399;234765;
28.01.2019;19:22:05;82985247;82750496;234751;
28.01.2019;19:23:04;82985330;82750593;234737;
28.01.2019;19:24:04;82985387;82750669;234718;
28.01.2019;19:25:04;82985440;82750757;234683;
28.01.2019;19:26:11;82985500;82750853;234647;
28.01.2019;19:27:05;82985587;82750946;234641;
28.01.2019;19:28:04;82985638;82751042;234596;
28.01.2019;19:29:05;82985687;82751134;234553;
28.01.2019;19:30:04;82985760;82751225;234535;
28.01.2019;19:31:04;82985834;82751317;234517;
28.01.2019;19:32:04;82985914;82751417;234497;
28.01.2019;19:33:04;82985978;82751497;234481;
28.01.2019;19:34:04;82986064;82751581;234483;
28.01.2019;19:35:05;82986164;82751674;234490;
28.01.2019;19:36:05;82986226;82751750;234476;
28.01.2019;19:37:05;82986281;82751837;234444;
28.01.2019;19:38:05;82986340;82751919;234421;
28.01.2019;19:39:07;82986420;82752006;234414;
28.01.2019;19:40:04;82986499;82752083;234416;
28.01.2019;19:41:04;82986572;82752166;234406;
28.01.2019;19:42:05;82986641;82752254;234387;
28.01.2019;19:43:05;82986717;82752332;234385;
28.01.2019;19:44:05;82986796;82752430;234366;
28.01.2019;19:45:04;82986875;82752500;234375;
28.01.2019;19:46:05;82986983;82752609;234374;
28.01.2019;19:47:04;82987039;82752692;234347;
28.01.2019;19:48:05;82987124;82752765;234359;
28.01.2019;19:49:05;82987204;82752838;234366;
28.01.2019;19:50:05;82987263;82752912;234351;
28.01.2019;19:51:05;82987327;82752977;234350;
28.01.2019;19:52:05;82987401;82753047;234354;
28.01.2019;19:53:04;82987448;82753107;234341;
28.01.2019;19:54:04;82987503;82753168;234335;
28.01.2019;19:55:05;82987568;82753228;234340;
28.01.2019;19:56:05;82987635;82753288;234347;
28.01.2019;19:57:05;82987695;82753355;234340;
28.01.2019;19:58:05;82987750;82753406;234344;
28.01.2019;19:59:04;82987804;82753470;234334;
28.01.2019;20:00:04;82987872;82753528;234344;
28.01.2019;20:01:04;82987972;82753587;234385;
28.01.2019;20:02:05;82988029;82753645;234384;
28.01.2019;20:03:04;82988101;82753704;234397;
28.01.2019;20:04:05;82988158;82753771;234387;
28.01.2019;20:05:05;82988206;82753837;234369;
28.01.2019;20:06:05;82988280;82753905;234375;
28.01.2019;20:07:05;82988384;82753966;234418;
28.01.2019;20:08:05;82988471;82754030;234441;
28.01.2019;20:09:07;82988567;82754118;234449;
28.01.2019;20:10:05;82988640;82754178;234462;
28.01.2019;20:11:05;82988717;82754257;234460;
28.01.2019;20:12:04;82988792;82754327;234465;
28.01.2019;20:13:04;82988885;82754394;234491;
28.01.2019;20:14:06;82988954;82754459;234495;
28.01.2019;20:15:06;82989037;82754519;234518;
28.01.2019;20:16:04;82989123;82754575;234548;
28.01.2019;20:17:05;82989187;82754646;234541;
28.01.2019;20:18:05;82989241;82754712;234529;
28.01.2019;20:19:05;82989288;82754769;234519;
28.01.2019;20:20:06;82989346;82754843;234503;
28.01.2019;20:21:05;82989406;82754893;234513;
28.01.2019;20:22:05;82989459;82754940;234519;
28.01.2019;20:23:06;82989515;82754969;234546;
28.01.2019;20:24:05;82989604;82755034;234570;
28.01.2019;20:25:04;82989674;82755090;234584;
28.01.2019;20:26:04;82989741;82755153;234588;
28.01.2019;20:27:08;82989808;82755228;234580;
28.01.2019;20:28:05;82989877;82755292;234585;
28.01.2019;20:29:05;82989959;82755354;234605;
28.01.2019;20:30:05;82990018;82755394;234624;
28.01.2019;20:31:05;82990095;82755431;234664;
28.01.2019;20:32:05;82990155;82755468;234687;
28.01.2019;20:33:05;82990226;82755536;234690;
28.01.2019;20:34:05;82990300;82755577;234723;
28.01.2019;20:35:05;82990374;82755640;234734;
28.01.2019;20:36:05;82990443;82755689;234754;
28.01.2019;20:37:05;82990520;82755750;234770;
28.01.2019;20:38:04;82990587;82755793;234794;
28.01.2019;20:39:06;82990642;82755859;234783;
28.01.2019;20:40:05;82990710;82755922;234788;
28.01.2019;20:41:05;82990798;82755988;234810;
28.01.2019;20:42:05;82990873;82756035;234838;
28.01.2019;20:43:12;82990932;82756089;234843;
28.01.2019;20:44:06;82990990;82756140;234850;
28.01.2019;20:45:07;82991070;82756199;234871;
28.01.2019;20:46:07;82991149;82756234;234915;
28.01.2019;20:47:06;82991223;82756278;234945;
28.01.2019;20:49:06;82991402;82756374;235028;
28.01.2019;20:50:13;82991480;82756436;235044;
28.01.2019;20:51:05;82991555;82756469;235086;
28.01.2019;20:52:05;82991635;82756509;235126;
28.01.2019;20:53:05;82991707;82756551;235156;
28.01.2019;20:54:05;82991788;82756611;235177;
28.01.2019;20:55:05;82991875;82756660;235215;
28.01.2019;20:56:05;82991948;82756702;235246;
28.01.2019;20:57:05;82992030;82756768;235262;
28.01.2019;20:58:05;82992108;82756826;235282;
28.01.2019;20:59:04;82992177;82756877;235300;
28.01.2019;21:00:05;82992264;82756939;235325;
28.01.2019;21:01:04;82992356;82756996;235360;
28.01.2019;21:02:05;82992452;82757037;235415;
28.01.2019;21:03:16;82992532;82757099;235433;
28.01.2019;21:04:13;82992593;82757169;235424;
28.01.2019;21:05:07;82992685;82757195;235490;
28.01.2019;21:06:04;82992752;82757244;235508;
28.01.2019;21:07:06;82992841;82757310;235531;
28.01.2019;21:08:10;82992915;82757372;235543;
28.01.2019;21:09:10;82992984;82757420;235564;
28.01.2019;21:10:05;82993072;82757464;235608;
28.01.2019;21:11:06;82993156;82757510;235646;
28.01.2019;21:12:05;82993237;82757568;235669;
28.01.2019;21:13:05;82993312;82757621;235691;
28.01.2019;21:14:05;82993381;82757675;235706;
28.01.2019;21:15:05;82993468;82757712;235756;
28.01.2019;21:16:06;82993573;82757764;235809;
28.01.2019;21:17:06;82993670;82757808;235862;
28.01.2019;21:18:04;82995587;82763347;232240;
28.01.2019;21:19:11;82995711;82763392;232319;
28.01.2019;21:20:06;82995810;82763425;232385;
28.01.2019;21:21:06;82995881;82763464;232417;
28.01.2019;21:22:05;82995958;82763510;232448;
28.01.2019;21:23:05;82996067;82763565;232502;
28.01.2019;21:24:06;82996157;82763600;232557;
28.01.2019;21:25:06;82996244;82763630;232614;
28.01.2019;21:26:06;82996332;82763676;232656;
28.01.2019;21:27:05;82996402;82763704;232698;
28.01.2019;21:28:06;82996502;82763742;232760;
28.01.2019;21:29:07;82996610;82763781;232829;
28.01.2019;21:30:06;82996706;82763835;232871;
28.01.2019;21:31:05;82996788;82763876;232912;
28.01.2019;21:32:06;82996879;82763914;232965;
28.01.2019;21:33:05;82996957;82763947;233010;
28.01.2019;21:34:05;82997060;82763980;233080;
28.01.2019;21:35:05;82997149;82764035;233114;
28.01.2019;21:36:05;82997235;82764093;233142;
28.01.2019;21:37:05;82997306;82764134;233172;
28.01.2019;21:38:05;82997382;82764169;233213;
28.01.2019;21:39:05;82997481;82764201;233280;
28.01.2019;21:40:06;82997568;82764244;233324;
28.01.2019;21:41:04;82997655;82764285;233370;
28.01.2019;21:42:05;82997744;82764309;233435;
28.01.2019;21:43:07;82997846;82764359;233487;
28.01.2019;21:44:05;82997935;82764393;233542;
28.01.2019;21:45:05;82997998;82764440;233558;
28.01.2019;21:46:05;82998111;82764488;233623;
28.01.2019;21:47:05;82998199;82764512;233687;
28.01.2019;21:48:05;82998312;82764545;233767;
28.01.2019;21:49:05;82998416;82764572;233844;
28.01.2019;21:50:04;82998485;82764616;233869;
28.01.2019;21:51:05;82998575;82764643;233932;
28.01.2019;21:52:05;82998690;82764687;234003;
28.01.2019;21:53:05;82998806;82764731;234075;
28.01.2019;21:54:05;82998877;82764768;234109;
28.01.2019;21:55:05;82998978;82764817;234161;
28.01.2019;21:56:05;82999070;82764862;234208;
28.01.2019;21:57:05;82999184;82764898;234286;
28.01.2019;21:58:05;82999307;82764922;234385;
28.01.2019;21:59:05;82999407;82764957;234450;
28.01.2019;22:00:04;82999494;82764997;234497;
28.01.2019;22:01:05;82999580;82765019;234561;
28.01.2019;22:02:05;82999611;82765004;234607;
28.01.2019;22:03:04;82999717;82765033;234684;
28.01.2019;22:04:04;82999817;82765067;234750;
28.01.2019;22:05:05;82999916;82765103;234813;
28.01.2019;22:06:05;83000072;82765128;234944;
28.01.2019;22:07:05;83000197;82765152;235045;
28.01.2019;22:08:04;83000301;82765184;235117;
28.01.2019;22:09:06;83000406;82765211;235195;
28.01.2019;22:10:04;83000486;82765229;235257;
28.01.2019;22:11:04;83000597;82765262;235335;
28.01.2019;22:12:05;83000695;82765291;235404;
28.01.2019;22:13:05;83000773;82765322;235451;
28.01.2019;22:14:04;83000869;82765356;235513;
28.01.2019;22:15:04;83000956;82765388;235568;
28.01.2019;22:16:06;83001023;82765423;235600;
28.01.2019;22:17:07;83001108;82765453;235655;
28.01.2019;22:18:10;83001189;82765478;235711;
28.01.2019;22:19:05;83001283;82765495;235788;
28.01.2019;22:20:05;83001367;82765514;235853;
28.01.2019;22:21:06;83001451;82765547;235904;
28.01.2019;22:22:05;83001542;82765569;235973;
28.01.2019;22:23:06;83001635;82765589;236046;
28.01.2019;22:24:06;83001730;82765622;236108;
28.01.2019;22:25:04;83001784;82765644;236140;
28.01.2019;22:26:07;83001866;82765661;236205;
28.01.2019;22:27:05;83001926;82765690;236236;
28.01.2019;22:28:05;83001993;82765720;236273;
28.01.2019;22:29:05;83002065;82765733;236332;
28.01.2019;22:30:06;83002146;82765742;236404;
28.01.2019;22:31:07;83002208;82765758;236450;
28.01.2019;22:32:07;83002274;82765769;236505;
28.01.2019;22:33:05;83002336;82765787;236549;
28.01.2019;22:34:06;83002415;82765806;236609;
28.01.2019;22:35:06;83002491;82765824;236667;
28.01.2019;22:36:12;83002570;82765856;236714;
28.01.2019;22:37:10;83002638;82765886;236752;
28.01.2019;22:38:05;83002704;82765904;236800;
28.01.2019;22:39:04;83002782;82765923;236859;
28.01.2019;22:40:07;83002845;82765951;236894;
28.01.2019;22:41:05;83002916;82765967;236949;
28.01.2019;22:42:06;83002992;82765993;236999;
28.01.2019;22:43:05;83003070;82766011;237059;
28.01.2019;22:44:07;83003105;82766033;237072;
28.01.2019;22:45:07;83003177;82766053;237124;
28.01.2019;22:46:08;83003241;82766068;237173;
28.01.2019;22:47:09;83003330;82766083;237247;
28.01.2019;22:48:12;83003398;82766112;237286;
28.01.2019;22:49:05;83003483;82766130;237353;
28.01.2019;22:50:06;83003571;82766168;237403;
28.01.2019;22:51:05;83003659;82766197;237462;
28.01.2019;22:52:11;83003744;82766222;237522;
28.01.2019;22:53:05;83003801;82766249;237552;
28.01.2019;22:54:05;83003908;82766265;237643;
28.01.2019;22:55:04;83003980;82766292;237688;
28.01.2019;22:56:10;83004058;82766312;237746;
28.01.2019;22:57:14;83004137;82766321;237816;
28.01.2019;22:58:06;83004213;82766341;237872;
28.01.2019;22:59:06;83004305;82766369;237936;
28.01.2019;23:00:05;83004381;82766394;237987;
28.01.2019;23:01:09;83004465;82766407;238058;
28.01.2019;23:02:04;83004565;82766420;238145;
28.01.2019;23:03:06;83004641;82766436;238205;
28.01.2019;23:04:04;83004703;82766454;238249;
28.01.2019;23:05:05;83004752;82766467;238285;
28.01.2019;23:06:10;83004823;82766494;238329;
28.01.2019;23:07:07;83004881;82766524;238357;
28.01.2019;23:08:06;83004963;82766530;238433;
28.01.2019;23:09:08;83005054;82766548;238506;
28.01.2019;23:10:06;83005132;82766568;238564;
28.01.2019;23:11:06;83005227;82766587;238640;
28.01.2019;23:12:06;83005323;82766620;238703;
28.01.2019;23:13:05;83005407;82766651;238756;
28.01.2019;23:14:05;83005485;82766663;238822;
28.01.2019;23:15:12;83005561;82766697;238864;
28.01.2019;23:16:07;83005639;82766716;238923;
28.01.2019;23:17:06;83005716;82766743;238973;
28.01.2019;23:18:11;83005783;82766779;239004;
28.01.2019;23:19:05;83005842;82766798;239044;
28.01.2019;23:20:06;83005928;82766817;239111;
28.01.2019;23:21:05;83006004;82766834;239170;
28.01.2019;23:22:06;83006076;82766866;239210;
28.01.2019;23:23:04;83006134;82766887;239247;
28.01.2019;23:24:06;83006190;82766901;239289;
28.01.2019;23:25:04;83006269;82766920;239349;
28.01.2019;23:26:10;83006344;82766934;239410;
28.01.2019;23:27:06;83006415;82766950;239465;
28.01.2019;23:28:05;83006494;82766968;239526;
28.01.2019;23:29:05;83006672;82766989;239683;
28.01.2019;23:30:06;83006779;82767012;239767;
28.01.2019;23:31:05;83006870;82767027;239843;
28.01.2019;23:32:07;83006968;82767048;239920;
28.01.2019;23:33:05;83007034;82767068;239966;
28.01.2019;23:34:06;83007114;82767084;240030;
28.01.2019;23:35:09;83007180;82767113;240067;
28.01.2019;23:36:05;83007258;82767133;240125;
28.01.2019;23:38:05;83007419;82767192;240227;
28.01.2019;23:39:07;83007498;82767214;240284;
28.01.2019;23:40:07;83007590;82767246;240344;
28.01.2019;23:41:07;83007683;82767266;240417;
28.01.2019;23:42:05;83007767;82767287;240480;
28.01.2019;23:43:14;83007844;82767310;240534;
28.01.2019;23:44:05;83007922;82767320;240602;
28.01.2019;23:45:05;83008002;82767340;240662;
28.01.2019;23:46:06;83008054;82767358;240696;
28.01.2019;23:47:05;83008134;82767382;240752;
28.01.2019;23:48:04;83008235;82767410;240825;
28.01.2019;23:49:04;83008319;82767432;240887;
28.01.2019;23:50:05;83008404;82767447;240957;
28.01.2019;23:51:06;83008487;82767463;241024;
28.01.2019;23:52:04;83008571;82767485;241086;
28.01.2019;23:53:07;83008647;82767506;241141;
28.01.2019;23:54:05;83008727;82767526;241201;
28.01.2019;23:55:10;83008806;82767552;241254;
28.01.2019;23:56:05;83008885;82767569;241316;
28.01.2019;23:57:05;83008969;82767591;241378;
28.01.2019;23:58:04;83009040;82767617;241423;
28.01.2019;23:59:04;83009109;82767646;241463;
29.01.2019;00:00:08;83009192;82767660;241532;
29.01.2019;00:01:13;83009269;82767685;241584;
29.01.2019;00:02:07;83009340;82767714;241626;
29.01.2019;00:03:09;83009399;82767734;241665;
29.01.2019;00:04:07;83009496;82767760;241736;
29.01.2019;00:05:07;83009578;82767772;241806;
29.01.2019;00:06:08;83009648;82767789;241859;
29.01.2019;00:07:13;83009710;82767809;241901;
29.01.2019;00:08:07;83009812;82767817;241995;
29.01.2019;00:09:08;83009904;82767834;242070;
29.01.2019;00:10:08;83009977;82767845;242132;
29.01.2019;00:11:09;83010063;82767856;242207;
29.01.2019;00:12:09;83010130;82767875;242255;
29.01.2019;00:13:10;83010185;82767896;242289;
29.01.2019;00:14:08;83010233;82767918;242315;
29.01.2019;00:15:07;83010301;82767933;242368;
29.01.2019;00:16:08;83010363;82767946;242417;
29.01.2019;00:17:08;83010434;82767967;242467;
29.01.2019;00:18:09;83010488;82767990;242498;
29.01.2019;00:20:09;83010642;82768025;242617;
29.01.2019;00:21:09;83010727;82768043;242684;
29.01.2019;00:22:11;83010802;82768058;242744;
29.01.2019;00:23:07;83010866;82768090;242776;
29.01.2019;00:24:08;83010935;82768102;242833;
29.01.2019;00:25:07;83011013;82768120;242893;
29.01.2019;00:26:08;83011086;82768141;242945;
29.01.2019;00:27:08;83011118;82768152;242966;
29.01.2019;00:28:09;83011164;82768163;243001;
29.01.2019;00:29:09;83011225;82768180;243045;
29.01.2019;00:30:08;83011271;82768201;243070;
29.01.2019;00:31:13;83011325;82768223;243102;
29.01.2019;00:32:11;83011373;82768233;243140;
29.01.2019;00:33:09;83011434;82768252;243182;
29.01.2019;00:34:07;83011482;82768262;243220;
29.01.2019;00:35:07;83011537;82768273;243264;
29.01.2019;00:36:11;83011598;82768288;243310;
29.01.2019;00:37:08;83011669;82768303;243366;
29.01.2019;00:38:10;83011735;82768319;243416;
29.01.2019;00:39:08;83011793;82768337;243456;
29.01.2019;00:40:08;83011859;82768356;243503;
29.01.2019;00:41:08;83011940;82768371;243569;
29.01.2019;00:42:10;83012009;82768393;243616;
29.01.2019;00:43:09;83012083;82768400;243683;
29.01.2019;00:44:07;83012152;82768418;243734;
29.01.2019;00:45:08;83012224;82768446;243778;
29.01.2019;00:46:08;83012284;82768471;243813;
29.01.2019;00:47:13;83012364;82768505;243859;
29.01.2019;00:48:13;83012414;82768529;243885;
29.01.2019;00:49:12;83012493;82768541;243952;
29.01.2019;00:51:09;83012667;82768575;244092;
29.01.2019;00:52:08;83012743;82768592;244151;
29.01.2019;00:53:08;83012815;82768615;244200;
29.01.2019;00:54:07;83012888;82768629;244259;
29.01.2019;00:55:09;83012968;82768644;244324;
29.01.2019;00:56:08;83013021;82768660;244361;
29.01.2019;00:57:08;83013072;82768655;244417;
29.01.2019;00:58:09;83013110;82768656;244454;
29.01.2019;00:59:08;83013169;82768670;244499;
29.01.2019;01:00:05;83013205;82768698;244507;
29.01.2019;01:01:10;83013294;82768718;244576;
29.01.2019;01:02:05;83013365;82768748;244617;
29.01.2019;01:03:06;83013445;82768770;244675;
29.01.2019;01:04:12;83013526;82768797;244729;
29.01.2019;01:05:05;83013603;82768811;244792;
29.01.2019;01:06:05;83013680;82768835;244845;
29.01.2019;01:07:06;83013738;82768860;244878;
29.01.2019;01:08:06;83013804;82768875;244929;
29.01.2019;01:09:06;83013877;82768910;244967;
29.01.2019;01:10:06;83013948;82768936;245012;
29.01.2019;01:11:04;83014018;82768966;245052;
29.01.2019;01:12:10;83014109;82768993;245116;
29.01.2019;01:13:05;83014185;82769020;245165;
29.01.2019;01:14:06;83014262;82769044;245218;
29.01.2019;01:15:06;83014353;82769076;245277;
29.01.2019;01:16:06;83014423;82769106;245317;
29.01.2019;01:17:10;83014508;82769126;245382;
29.01.2019;01:18:06;83014587;82769151;245436;
29.01.2019;01:19:05;83014648;82769170;245478;
29.01.2019;01:20:04;83014712;82769197;245515;
29.01.2019;01:21:05;83014789;82769217;245572;
29.01.2019;01:22:06;83014867;82769260;245607;
29.01.2019;01:23:06;83014942;82769298;245644;
29.01.2019;01:24:04;83015006;82769325;245681;
29.01.2019;01:25:04;83015086;82769355;245731;
29.01.2019;01:26:05;83015185;82769387;245798;
29.01.2019;01:27:05;83015256;82769399;245857;
29.01.2019;01:28:06;83015323;82769427;245896;
29.01.2019;01:29:05;83015377;82769461;245916;
29.01.2019;01:30:05;83015451;82769500;245951;
29.01.2019;01:31:05;83015532;82769530;246002;
29.01.2019;01:32:04;83015603;82769559;246044;
29.01.2019;01:33:05;83015674;82769579;246095;
29.01.2019;01:34:05;83015769;82769611;246158;
29.01.2019;01:35:06;83015862;82769642;246220;
29.01.2019;01:36:10;83015948;82769672;246276;
29.01.2019;01:37:06;83016027;82769706;246321;
29.01.2019;01:38:12;83016092;82769742;246350;
29.01.2019;01:39:10;83016169;82769774;246395;
29.01.2019;01:40:06;83016238;82769821;246417;
29.01.2019;01:41:10;83016303;82769842;246461;
29.01.2019;01:42:05;83016372;82769868;246504;
29.01.2019;01:43:08;83016461;82769906;246555;
29.01.2019;01:44:04;83016526;82769926;246600;
29.01.2019;01:45:10;83016614;82769969;246645;
29.01.2019;01:46:06;83016673;82769997;246676;
29.01.2019;01:47:05;83016748;82770035;246713;
29.01.2019;01:48:06;83016824;82770072;246752;
29.01.2019;01:49:06;83016881;82770107;246774;
29.01.2019;01:50:05;83016948;82770135;246813;
29.01.2019;01:51:05;83017017;82770165;246852;
29.01.2019;01:52:06;83017084;82770201;246883;
29.01.2019;01:53:05;83017161;82770232;246929;
29.01.2019;01:54:06;83017226;82770272;246954;
29.01.2019;01:55:09;83017316;82770314;247002;
29.01.2019;01:56:05;83017386;82770325;247061;
29.01.2019;01:57:05;83017464;82770349;247115;
29.01.2019;01:58:06;83017539;82770386;247153;
29.01.2019;01:59:04;83017594;82770420;247174;
29.01.2019;02:00:05;83017669;82770461;247208;
29.01.2019;02:01:13;83017752;82770529;247223;
29.01.2019;02:02:07;83017813;82770574;247239;
29.01.2019;02:03:10;83017876;82770623;247253;
29.01.2019;02:04:09;83017953;82770664;247289;
29.01.2019;02:05:11;83018030;82770697;247333;
29.01.2019;02:06:06;83018084;82770747;247337;
29.01.2019;02:07:08;83018157;82770797;247360;
29.01.2019;02:08:04;83018209;82770840;247369;
29.01.2019;02:09:08;83018288;82770896;247392;
29.01.2019;02:10:06;83018366;82770935;247431;
29.01.2019;02:11:07;83018434;82770986;247448;
29.01.2019;02:12:09;83018505;82771041;247464;
29.01.2019;02:13:05;83018578;82771069;247509;
29.01.2019;02:14:10;83018632;82771108;247524;
29.01.2019;02:15:05;83018707;82771150;247557;
29.01.2019;02:16:05;83018770;82771201;247569;
29.01.2019;02:17:09;83018825;82771244;247581;
29.01.2019;02:18:04;83018876;82771279;247597;
29.01.2019;02:19:10;83018930;82771326;247604;
29.01.2019;02:20:05;83018999;82771384;247615;
29.01.2019;02:21:06;83019061;82771427;247634;
29.01.2019;02:22:05;83019126;82771473;247653;
29.01.2019;02:23:05;83019173;82771530;247643;
29.01.2019;02:24:06;83019251;82771583;247668;
29.01.2019;02:25:04;83019330;82771621;247709;
29.01.2019;02:26:09;83019398;82771686;247712;
29.01.2019;02:27:05;83019463;82771739;247724;
29.01.2019;02:28:06;83019533;82771800;247733;
29.01.2019;02:29:05;83019625;82771840;247785;
29.01.2019;02:30:05;83019704;82771896;247808;
29.01.2019;02:31:06;83019775;82771961;247814;
29.01.2019;02:32:05;83019854;82772018;247836;
29.01.2019;02:33:09;83019923;82772070;247853;
29.01.2019;02:34:05;83019999;82772125;247874;
29.01.2019;02:35:05;83020076;82772186;247890;
29.01.2019;02:36:07;83020144;82772246;247898;
29.01.2019;02:37:05;83020215;82772304;247911;
29.01.2019;02:38:06;83020283;82772357;247926;
29.01.2019;02:39:06;83020349;82772419;247930;
29.01.2019;02:40:05;83020396;82772476;247920;
29.01.2019;02:41:06;83020461;82772547;247914;
29.01.2019;02:42:04;83020523;82772620;247903;
29.01.2019;02:43:05;83020597;82772674;247923;
29.01.2019;02:44:05;83020662;82772743;247919;
29.01.2019;02:45:04;83020727;82772802;247925;
29.01.2019;02:46:06;83020805;82772873;247932;
29.01.2019;02:47:06;83020870;82772947;247923;
29.01.2019;02:48:04;83020945;82773010;247935;
29.01.2019;02:49:05;83021004;82773073;247931;
29.01.2019;02:50:05;83021070;82773139;247931;
29.01.2019;02:51:05;83021147;82773215;247932;
29.01.2019;02:52:06;83021226;82773282;247944;
29.01.2019;02:53:04;83021299;82773361;247938;
29.01.2019;02:54:10;83021373;82773434;247939;
29.01.2019;02:55:05;83021446;82773511;247935;
29.01.2019;02:56:05;83021527;82773592;247935;
29.01.2019;02:57:06;83021601;82773661;247940;
29.01.2019;02:58:06;83021672;82773732;247940;
29.01.2019;02:59:05;83021752;82773808;247944;
29.01.2019;03:00:04;83021844;82773890;247954;
29.01.2019;03:01:06;83021935;82773991;247944;
29.01.2019;03:02:06;83021991;82774067;247924;
29.01.2019;03:03:06;83022051;82774143;247908;
29.01.2019;03:04:09;83022129;82774216;247913;
29.01.2019;03:05:05;83022202;82774279;247923;
29.01.2019;03:06:07;83022277;82774345;247932;
29.01.2019;03:07:05;83022354;82774424;247930;
29.01.2019;03:08:06;83022436;82774488;247948;
29.01.2019;03:09:05;83022509;82774574;247935;
29.01.2019;03:10:05;83022582;82774659;247923;
29.01.2019;03:11:06;83022663;82774734;247929;
29.01.2019;03:12:04;83022742;82774813;247929;
29.01.2019;03:13:06;83022843;82774901;247942;
29.01.2019;03:14:05;83022925;82774957;247968;
29.01.2019;03:15:05;83023008;82775041;247967;
29.01.2019;03:16:09;83023099;82775139;247960;
29.01.2019;03:17:05;83023172;82775200;247972;
29.01.2019;03:18:05;83023254;82775281;247973;
29.01.2019;03:19:04;83023336;82775370;247966;
29.01.2019;03:20:04;83023384;82775446;247938;
29.01.2019;03:21:06;83023485;82775534;247951;
29.01.2019;03:22:05;83023553;82775636;247917;
29.01.2019;03:23:05;83023636;82775718;247918;
29.01.2019;03:24:06;83023708;82775803;247905;
29.01.2019;03:25:11;83023780;82775899;247881;
29.01.2019;03:26:06;83023842;82775968;247874;
29.01.2019;03:27:06;83023924;82776065;247859;
29.01.2019;03:28:11;83024016;82776167;247849;
29.01.2019;03:29:05;83024067;82776263;247804;
29.01.2019;03:30:06;83024129;82776369;247760;
29.01.2019;03:32:06;83024308;82776570;247738;
29.01.2019;03:33:05;83024400;82776663;247737;
29.01.2019;03:34:07;83024471;82776740;247731;
29.01.2019;03:35:12;83024572;82776833;247739;
29.01.2019;03:36:04;83024636;82776917;247719;
29.01.2019;03:37:04;83024716;82776983;247733;
29.01.2019;03:38:06;83024804;82777098;247706;
29.01.2019;03:39:13;83024897;82777218;247679;
29.01.2019;03:40:05;83024948;82777307;247641;
29.01.2019;03:41:05;83025041;82777403;247638;
29.01.2019;03:42:04;83025141;82777504;247637;
29.01.2019;03:43:06;83025226;82777599;247627;
29.01.2019;03:44:10;83025321;82777724;247597;
29.01.2019;03:45:05;83025376;82777794;247582;
29.01.2019;03:46:04;83025446;82777866;247580;
29.01.2019;03:47:05;83025530;82777956;247574;
29.01.2019;03:48:05;83025603;82778046;247557;
29.01.2019;03:49:05;83025663;82778144;247519;
29.01.2019;03:51:11;83025846;82778340;247506;
29.01.2019;03:52:09;83025924;82778440;247484;
29.01.2019;03:53:05;83026027;82778533;247494;
29.01.2019;03:54:10;83026103;82778646;247457;
29.01.2019;03:55:05;83026185;82778718;247467;
29.01.2019;03:56:10;83026284;82778806;247478;
29.01.2019;03:57:07;83026346;82778902;247444;
29.01.2019;03:58:10;83026452;82778978;247474;
29.01.2019;03:59:06;83026518;82779090;247428;
29.01.2019;04:00:07;83026606;82779184;247422;
29.01.2019;04:01:04;83026683;82779271;247412;
29.01.2019;04:02:06;83026720;82779325;247395;
29.01.2019;04:03:12;83026820;82779427;247393;
29.01.2019;04:04:07;83026886;82779502;247384;
29.01.2019;04:05:10;83026959;82779586;247373;
29.01.2019;04:06:09;83027040;82779681;247359;
29.01.2019;04:07:05;83027101;82779775;247326;
29.01.2019;04:08:10;83027192;82779871;247321;
29.01.2019;04:09:08;83027236;82779976;247260;
29.01.2019;04:10:11;83027299;82780087;247212;
29.01.2019;04:11:05;83027353;82780179;247174;
29.01.2019;04:12:04;83027432;82780276;247156;
29.01.2019;04:13:06;83027492;82780373;247119;
29.01.2019;04:14:07;83027546;82780464;247082;
29.01.2019;04:15:06;83027600;82780565;247035;
29.01.2019;04:16:04;83027667;82780665;247002;
29.01.2019;04:17:06;83027746;82780762;246984;
29.01.2019;04:18:04;83027808;82780848;246960;
29.01.2019;04:19:05;83027890;82780933;246957;
29.01.2019;04:20:05;83027956;82781040;246916;
29.01.2019;04:21:05;83028032;82781127;246905;
29.01.2019;04:22:05;83028104;82781232;246872;
29.01.2019;04:23:05;83028172;82781347;246825;
29.01.2019;04:24:05;83028239;82781451;246788;
29.01.2019;04:25:04;83028305;82781537;246768;
29.01.2019;04:26:06;83028372;82781653;246719;
29.01.2019;04:27:05;83028451;82781745;246706;
29.01.2019;04:28:05;83028522;82781849;246673;
29.01.2019;04:29:11;83028605;82781957;246648;
29.01.2019;04:30:10;83028674;82782072;246602;
29.01.2019;04:31:05;83028747;82782169;246578;
29.01.2019;04:32:04;83028825;82782281;246544;
29.01.2019;04:33:05;83028905;82782381;246524;
29.01.2019;04:34:05;83028966;82782475;246491;
29.01.2019;04:35:04;83029035;82782566;246469;
29.01.2019;04:36:05;83029117;82782662;246455;
29.01.2019;04:37:05;83029183;82782763;246420;
29.01.2019;04:38:04;83029267;82782866;246401;
29.01.2019;04:39:10;83029362;82782968;246394;
29.01.2019;04:40:06;83029442;82783072;246370;
29.01.2019;04:41:06;83029527;82783150;246377;
29.01.2019;04:42:05;83029582;82783249;246333;
29.01.2019;04:43:06;83029655;82783355;246300;
29.01.2019;04:44:07;83029734;82783447;246287;
29.01.2019;04:45:06;83029811;82783546;246265;
29.01.2019;04:46:06;83029888;82783635;246253;
29.01.2019;04:47:10;83029967;82783742;246225;
29.01.2019;04:48:06;83030047;82783850;246197;
29.01.2019;04:49:05;83030118;82783955;246163;
29.01.2019;04:50:04;83030203;82784054;246149;
29.01.2019;04:51:04;83030294;82784162;246132;
29.01.2019;04:52:10;83030351;82784291;246060;
29.01.2019;04:53:12;83030434;82784397;246037;
29.01.2019;04:54:06;83030505;82784475;246030;
29.01.2019;04:55:04;83030573;82784576;245997;
29.01.2019;04:56:06;83030648;82784685;245963;
29.01.2019;04:57:05;83030718;82784789;245929;
29.01.2019;04:58:05;83030791;82784899;245892;
29.01.2019;04:59:05;83030853;82784996;245857;
29.01.2019;05:00:11;83030935;82785094;245841;
29.01.2019;05:01:07;83030989;82785199;245790;
29.01.2019;05:02:05;83031058;82785292;245766;
29.01.2019;05:03:09;83031120;82785403;245717;
29.01.2019;05:04:06;83031197;82785486;245711;
29.01.2019;05:05:06;83031286;82785587;245699;
29.01.2019;05:06:09;83031353;82785702;245651;
29.01.2019;05:07:04;83031420;82785792;245628;
29.01.2019;05:08:05;83031508;82785892;245616;
29.01.2019;05:09:05;83031579;82785994;245585;
29.01.2019;05:10:10;83031659;82786142;245517;
29.01.2019;05:11:08;83031729;82786241;245488;
29.01.2019;05:12:06;83031791;82786345;245446;
29.01.2019;05:13:05;83031846;82786453;245393;
29.01.2019;05:14:05;83031929;82786542;245387;
29.01.2019;05:15:06;83032012;82786648;245364;
29.01.2019;05:16:05;83032095;82786744;245351;
29.01.2019;05:17:06;83032166;82786862;245304;
29.01.2019;05:18:06;83032240;82786956;245284;
29.01.2019;05:19:06;83032309;82787060;245249;
29.01.2019;05:20:09;83032365;82787157;245208;
29.01.2019;05:21:06;83032450;82787253;245197;
29.01.2019;05:22:06;83032523;82787357;245166;
29.01.2019;05:23:04;83032585;82787458;245127;
29.01.2019;05:24:04;83032647;82787554;245093;
29.01.2019;05:25:05;83032720;82787662;245058;
29.01.2019;05:26:05;83032786;82787769;245017;
29.01.2019;05:27:05;83032859;82787891;244968;
29.01.2019;05:28:04;83032914;82787981;244933;
29.01.2019;05:29:05;83032990;82788061;244929;
29.01.2019;05:30:06;83033058;82788160;244898;
29.01.2019;05:31:04;83033118;82788262;244856;
29.01.2019;05:32:05;83033199;82788371;244828;
29.01.2019;05:33:05;83033260;82788462;244798;
29.01.2019;05:34:06;83033353;82788555;244798;
29.01.2019;05:35:07;83033426;82788683;244743;
29.01.2019;05:36:06;83033497;82788801;244696;
29.01.2019;05:37:04;83033550;82788894;244656;
29.01.2019;05:38:06;83033637;82788984;244653;
29.01.2019;05:39:07;83033711;82789087;244624;
29.01.2019;05:40:05;83033784;82789204;244580;
29.01.2019;05:41:06;83033866;82789293;244573;
29.01.2019;05:42:05;83033931;82789396;244535;
29.01.2019;05:43:04;83033999;82789504;244495;
29.01.2019;05:44:04;83034044;82789620;244424;
29.01.2019;05:45:06;83034108;82789716;244392;
29.01.2019;05:46:04;83034167;82789814;244353;
29.01.2019;05:47:05;83034231;82789926;244305;
29.01.2019;05:48:06;83034295;82790040;244255;
29.01.2019;05:49:05;83034356;82790144;244212;
29.01.2019;05:50:04;83034421;82790241;244180;
29.01.2019;05:51:04;83034489;82790355;244134;
29.01.2019;05:52:05;83034541;82790468;244073;
29.01.2019;05:53:07;83034595;82790565;244030;
29.01.2019;05:54:05;83034672;82790669;244003;
29.01.2019;05:55:04;83034758;82790764;243994;
29.01.2019;05:56:06;83034820;82790867;243953;
29.01.2019;05:57:04;83034884;82790981;243903;
29.01.2019;05:58:04;83034942;82791087;243855;
29.01.2019;05:59:06;83035001;82791183;243818;
29.01.2019;06:00:06;83035066;82791291;243775;
29.01.2019;06:01:07;83035142;82791413;243729;
29.01.2019;06:02:05;83035207;82791505;243702;
29.01.2019;06:03:04;83035269;82791590;243679;
29.01.2019;06:04:05;83035308;82791697;243611;
29.01.2019;06:05:10;83035356;82791804;243552;
29.01.2019;06:06:04;83035406;82791883;243523;
29.01.2019;06:07:06;83035459;82791988;243471;
29.01.2019;06:08:05;83035520;82792081;243439;
29.01.2019;06:09:07;83035574;82792195;243379;
29.01.2019;06:10:06;83035632;82792294;243338;
29.01.2019;06:11:07;83035689;82792382;243307;
29.01.2019;06:12:06;83035760;82792470;243290;
29.01.2019;06:13:06;83035801;82792591;243210;
29.01.2019;06:14:06;83035855;82792673;243182;
29.01.2019;06:15:04;83035895;82792775;243120;
29.01.2019;06:16:05;83035933;82792891;243042;
29.01.2019;06:17:05;83035977;82792990;242987;
29.01.2019;06:18:06;83036015;82793096;242919;
29.01.2019;06:19:05;83036071;82793183;242888;
29.01.2019;06:20:04;83036114;82793283;242831;
29.01.2019;06:21:04;83036176;82793368;242808;
29.01.2019;06:22:05;83036224;82793459;242765;
29.01.2019;06:23:05;83036275;82793544;242731;
29.01.2019;06:24:04;83036307;82793638;242669;
29.01.2019;06:25:08;83036360;82793747;242613;
29.01.2019;06:26:04;83036400;82793861;242539;
29.01.2019;06:27:05;83036453;82793978;242475;
29.01.2019;06:28:05;83036496;82794094;242402;
29.01.2019;06:29:04;83036541;82794187;242354;
29.01.2019;06:30:05;83036583;82794290;242293;
29.01.2019;06:31:05;83036651;82794410;242241;
29.01.2019;06:32:04;83036697;82794522;242175;
29.01.2019;06:33:04;83036761;82794636;242125;
29.01.2019;06:34:05;83036810;82794707;242103;
29.01.2019;06:35:05;83036877;82794796;242081;
29.01.2019;06:36:04;83036937;82794887;242050;
29.01.2019;06:37:04;83036988;82795013;241975;
29.01.2019;06:38:04;83037033;82795098;241935;
29.01.2019;06:39:07;83037078;82795208;241870;
29.01.2019;06:40:05;83037129;82795281;241848;
29.01.2019;06:41:05;83037178;82795373;241805;
29.01.2019;06:42:05;83037241;82795455;241786;
29.01.2019;06:43:05;83037290;82795548;241742;
29.01.2019;06:44:05;83037350;82795646;241704;
29.01.2019;06:45:05;83037398;82795747;241651;
29.01.2019;06:46:05;83037464;82795832;241632;
29.01.2019;06:47:05;83037547;82795927;241620;
29.01.2019;06:48:11;83037608;82796047;241561;
29.01.2019;06:49:05;83037677;82796154;241523;
29.01.2019;06:50:09;83037738;82796255;241483;
29.01.2019;06:51:05;83037801;82796357;241444;
29.01.2019;06:52:05;83037873;82796463;241410;
29.01.2019;06:53:04;83037945;82796573;241372;
29.01.2019;06:54:05;83038020;82796686;241334;
29.01.2019;06:55:05;83038064;82796783;241281;
29.01.2019;06:56:05;83038109;82796897;241212;
29.01.2019;06:57:05;83038163;82796998;241165;
29.01.2019;06:58:10;83038214;82797112;241102;
29.01.2019;06:59:05;83038252;82797202;241050;
29.01.2019;07:00:04;83038293;82797324;240969;
29.01.2019;07:01:04;83038308;82797381;240927;
29.01.2019;07:02:05;83038335;82797472;240863;
29.01.2019;07:03:04;83038377;82797568;240809;
29.01.2019;07:04:06;83038420;82797682;240738;
29.01.2019;07:05:06;83038479;82797785;240694;
29.01.2019;07:06:05;83038521;82797877;240644;
29.01.2019;07:07:06;83038568;82797994;240574;
29.01.2019;07:08:05;83038628;82798100;240528;
29.01.2019;07:09:05;83038684;82798216;240468;
29.01.2019;07:10:05;83038737;82798304;240433;
29.01.2019;07:11:06;83038783;82798441;240342;
29.01.2019;07:12:04;83038826;82798525;240301;
29.01.2019;07:13:09;83038889;82798636;240253;
29.01.2019;07:14:04;83038944;82798759;240185;
29.01.2019;07:15:04;83038988;82798878;240110;
29.01.2019;07:16:05;83039047;82799000;240047;
29.01.2019;07:17:10;83039087;82799143;239944;
29.01.2019;07:18:06;83039153;82799253;239900;
29.01.2019;07:19:04;83039189;82799354;239835;
29.01.2019;07:20:05;83039260;82799468;239792;
29.01.2019;07:21:06;83039306;82799564;239742;
29.01.2019;07:22:04;83039366;82799678;239688;
29.01.2019;07:23:04;83039416;82799769;239647;
29.01.2019;07:24:05;83039460;82799877;239583;
29.01.2019;07:25:05;83039514;82799985;239529;
29.01.2019;07:26:04;83039569;82800099;239470;
29.01.2019;07:27:04;83039608;82800191;239417;
29.01.2019;07:28:05;83039654;82800283;239371;
29.01.2019;07:29:04;83039710;82800400;239310;
29.01.2019;07:30:04;83039758;82800516;239242;
29.01.2019;07:31:05;83039808;82800633;239175;
29.01.2019;07:32:05;83039859;82800744;239115;
29.01.2019;07:33:04;83039916;82800862;239054;
29.01.2019;07:34:05;83039972;82800958;239014;
29.01.2019;07:35:04;83040023;82801043;238980;
29.01.2019;07:36:04;83040080;82801136;238944;
29.01.2019;07:37:05;83040128;82801261;238867;
29.01.2019;07:38:04;83040180;82801362;238818;
29.01.2019;07:39:05;83040234;82801477;238757;
29.01.2019;07:40:04;83040285;82801601;238684;
29.01.2019;07:41:05;83040347;82801713;238634;
29.01.2019;07:42:04;83040410;82801814;238596;
29.01.2019;07:43:04;83040466;82801924;238542;
29.01.2019;07:44:05;83040522;82802023;238499;
29.01.2019;07:45:04;83040573;82802132;238441;
29.01.2019;07:46:05;83040607;82802249;238358;
29.01.2019;07:47:05;83040654;82802348;238306;
29.01.2019;07:48:04;83040722;82802463;238259;
29.01.2019;07:49:05;83040778;82802581;238197;
29.01.2019;07:50:04;83040841;82802691;238150;
29.01.2019;07:51:05;83040901;82802814;238087;
29.01.2019;07:52:05;83040939;82802936;238003;
29.01.2019;07:53:04;83041000;82803038;237962;
29.01.2019;07:54:04;83041047;82803148;237899;
29.01.2019;07:55:05;83041086;82803263;237823;
29.01.2019;07:56:05;83041155;82803368;237787;
29.01.2019;07:57:04;83041204;82803489;237715;
29.01.2019;07:58:04;83041261;82803583;237678;
29.01.2019;07:59:04;83041319;82803707;237612;
29.01.2019;08:00:04;83041356;82803825;237531;
29.01.2019;08:01:05;83041414;82803928;237486;
29.01.2019;08:02:05;83041447;82804032;237415;
29.01.2019;08:03:04;83041496;82804141;237355;
29.01.2019;08:04:04;83041538;82804264;237274;
29.01.2019;08:05:05;83041593;82804374;237219;
29.01.2019;08:06:04;83041637;82804495;237142;
29.01.2019;08:07:04;83041673;82804618;237055;
29.01.2019;08:08:04;83041728;82804714;237014;
29.01.2019;08:09:06;83041768;82804849;236919;
29.01.2019;08:10:04;83041798;82804939;236859;
29.01.2019;08:11:04;83041821;82805023;236798;
29.01.2019;08:12:05;83041853;82805129;236724;
29.01.2019;08:13:04;83041880;82805220;236660;
29.01.2019;08:14:05;83041916;82805306;236610;
29.01.2019;08:15:04;83041949;82805408;236541;
29.01.2019;08:16:05;83041965;82805496;236469;
29.01.2019;08:17:05;83041991;82805605;236386;
29.01.2019;08:18:04;83042041;82805704;236337;
29.01.2019;08:19:05;83042078;82805814;236264;
29.01.2019;08:21:05;83042150;82806025;236125;
29.01.2019;08:22:05;83042205;82806119;236086;
29.01.2019;08:23:05;83042243;82806222;236021;
29.01.2019;08:24:04;83042280;82806363;235917;
29.01.2019;08:25:04;83042329;82806471;235858;
29.01.2019;08:26:05;83042360;82806593;235767;
29.01.2019;08:27:04;83042395;82806712;235683;
29.01.2019;08:28:04;83042441;82806829;235612;
29.01.2019;08:29:05;83042476;82806953;235523;
29.01.2019;08:30:05;83042538;82807046;235492;
29.01.2019;08:31:05;83042579;82807152;235427;
29.01.2019;08:32:05;83042619;82807250;235369;
29.01.2019;08:33:04;83042663;82807370;235293;
29.01.2019;08:34:04;83042703;82807467;235236;
29.01.2019;08:35:05;83042756;82807575;235181;
29.01.2019;08:36:04;83042805;82807688;235117;
29.01.2019;08:37:04;83042845;82807808;235037;
29.01.2019;08:38:05;83042902;82807898;235004;
29.01.2019;08:39:06;83042943;82808012;234931;
29.01.2019;08:40:05;83042985;82808123;234862;
29.01.2019;08:41:04;83043023;82808211;234812;
29.01.2019;08:42:05;83043077;82808310;234767;
29.01.2019;08:43:05;83043126;82808401;234725;
29.01.2019;08:44:04;83043155;82808510;234645;
29.01.2019;08:45:04;83043207;82808628;234579;
29.01.2019;08:46:05;83043260;82808750;234510;
29.01.2019;08:47:05;83043311;82808867;234444;
29.01.2019;08:48:04;83043377;82808988;234389;
29.01.2019;08:49:04;83043434;82809104;234330;
29.01.2019;08:50:05;83043479;82809215;234264;
29.01.2019;08:51:04;83043544;82809317;234227;
29.01.2019;08:52:05;83043599;82809414;234185;
29.01.2019;08:53:04;83043653;82809529;234124;
29.01.2019;08:54:04;83043707;82809650;234057;
29.01.2019;08:55:05;83043765;82809780;233985;
29.01.2019;08:56:04;83043807;82809896;233911;
29.01.2019;08:57:04;83043856;82810001;233855;
29.01.2019;08:58:05;83043905;82810098;233807;
29.01.2019;08:59:04;83043945;82810198;233747;
29.01.2019;09:00:04;83043989;82810320;233669;
29.01.2019;09:01:05;83044045;82810452;233593;
29.01.2019;09:02:05;83044087;82810571;233516;
29.01.2019;09:03:04;83044141;82810693;233448;
29.01.2019;09:04:04;83044178;82810810;233368;
29.01.2019;09:05:05;83044226;82810945;233281;
29.01.2019;09:06:04;83044262;82811062;233200;
29.01.2019;09:07:04;83044313;82811152;233161;
29.01.2019;09:08:04;83044364;82811276;233088;
29.01.2019;09:09:04;83044404;82811399;233005;
29.01.2019;09:10:04;83044451;82811519;232932;
29.01.2019;09:11:10;83044494;82811652;232842;
29.01.2019;09:12:04;83044549;82811736;232813;
29.01.2019;09:13:09;83044605;82811841;232764;
29.01.2019;09:14:04;83044648;82811967;232681;
29.01.2019;09:15:05;83044703;82812113;232590;
29.01.2019;09:16:05;83044749;82812232;232517;
29.01.2019;09:17:05;83044794;82812331;232463;
29.01.2019;09:18:11;83044841;82812462;232379;
29.01.2019;09:19:04;83044877;82812581;232296;
29.01.2019;09:20:06;83044934;82812701;232233;
29.01.2019;09:21:05;83045008;82812827;232181;
29.01.2019;09:22:10;83045053;82812953;232100;
29.01.2019;09:23:05;83045090;82813062;232028;
29.01.2019;09:24:10;83045131;82813200;231931;
29.01.2019;09:25:04;83045192;82813294;231898;
29.01.2019;09:26:05;83045230;82813420;231810;
29.01.2019;09:27:04;83045270;82813514;231756;
29.01.2019;09:28:04;83045320;82813644;231676;
29.01.2019;09:29:11;83045373;82813797;231576;
29.01.2019;09:30:05;83045405;82813886;231519;
29.01.2019;09:31:04;83045438;82813996;231442;
29.01.2019;09:32:04;83045481;82814125;231356;
29.01.2019;09:33:05;83045520;82814251;231269;
29.01.2019;09:34:04;83045570;82814359;231211;
29.01.2019;09:35:05;83045622;82814487;231135;
29.01.2019;09:36:06;83045675;82814605;231070;
29.01.2019;09:37:04;83045719;82814716;231003;
29.01.2019;09:38:05;83045771;82814839;230932;
29.01.2019;09:39:05;83045805;82814976;230829;
29.01.2019;09:40:06;83045847;82815091;230756;
29.01.2019;09:41:04;83045893;82815220;230673;
29.01.2019;09:42:04;83045933;82815325;230608;
29.01.2019;09:43:05;83045970;82815439;230531;
29.01.2019;09:44:04;83046018;82815569;230449;
29.01.2019;09:45:04;83046056;82815695;230361;
29.01.2019;09:46:05;83046095;82815786;230309;
29.01.2019;09:47:04;83046140;82815913;230227;
29.01.2019;09:48:04;83046175;82816032;230143;
29.01.2019;09:49:05;83046218;82816150;230068;
29.01.2019;09:50:12;83046289;82816303;229986;
29.01.2019;09:51:04;83046336;82816410;229926;
29.01.2019;09:52:06;83046363;82816520;229843;
29.01.2019;09:53:04;83046398;82816647;229751;
29.01.2019;09:54:04;83046431;82816747;229684;
29.01.2019;09:55:05;83046477;82816866;229611;
29.01.2019;09:56:05;83046514;82816956;229558;
29.01.2019;09:57:12;83046561;82817094;229467;
29.01.2019;09:58:04;83046553;82817161;229392;
29.01.2019;09:59:06;83046586;82817277;229309;
29.01.2019;10:00:05;83046614;82817427;229187;
29.01.2019;10:01:04;83046664;82817540;229124;
29.01.2019;10:02:04;83046707;82817654;229053;
29.01.2019;10:03:04;83046759;82817768;228991;
29.01.2019;10:04:04;83046803;82817901;228902;
29.01.2019;10:05:05;83046851;82818022;228829;
29.01.2019;10:06:05;83046907;82818136;228771;
29.01.2019;10:07:04;83046946;82818261;228685;
29.01.2019;10:08:05;83046988;82818386;228602;
29.01.2019;10:09:05;83047035;82818489;228546;
29.01.2019;10:10:06;83047057;82818610;228447;
29.01.2019;10:11:04;83047097;82818708;228389;
29.01.2019;10:12:05;83047131;82818813;228318;
29.01.2019;10:13:06;83047176;82818932;228244;
29.01.2019;10:14:05;83047191;82819032;228159;
29.01.2019;10:15:04;83047203;82819127;228076;
29.01.2019;10:16:04;83047231;82819239;227992;
29.01.2019;10:17:05;83047245;82819344;227901;
29.01.2019;10:18:05;83047276;82819452;227824;
29.01.2019;10:19:05;83047312;82819554;227758;
29.01.2019;10:20:06;83047337;82819652;227685;
29.01.2019;10:21:04;83047362;82819752;227610;
29.01.2019;10:22:05;83047396;82819878;227518;
29.01.2019;10:23:05;83047430;82819969;227461;
29.01.2019;10:24:05;83047485;82820112;227373;
29.01.2019;10:25:04;83047520;82820220;227300;
29.01.2019;10:29:06;83047685;82820708;226977;
29.01.2019;10:29:19;83047695;82820745;226950;
29.01.2019;10:29:22;83047700;82820742;226958;
29.01.2019;10:30:04;83047739;82820827;226912;
29.01.2019;10:31:05;83047796;82820969;226827;
29.01.2019;10:32:10;83047840;82821105;226735;
29.01.2019;10:33:05;83047883;82821202;226681;
29.01.2019;10:34:04;83047932;82821345;226587;
29.01.2019;10:35:05;83047963;82821443;226520;
29.01.2019;10:36:04;83048003;82821555;226448;
29.01.2019;10:37:05;83048038;82821673;226365;
29.01.2019;10:38:04;83048086;82821786;226300;
29.01.2019;10:39:05;83048143;82821881;226262;
29.01.2019;10:40:04;83048187;82821975;226212;
29.01.2019;10:41:05;83048227;82822039;226188;
29.01.2019;10:42:06;83048285;82822119;226166;
29.01.2019;10:43:04;83048321;82822214;226107;
29.01.2019;10:44:04;83048357;82822309;226048;
29.01.2019;10:47:05;83048498;82822589;225909;
29.01.2019;10:47:09;83048496;82822602;225894;
29.01.2019;10:47:14;83048505;82822610;225895;
29.01.2019;10:48:06;83048546;82822702;225844;
29.01.2019;10:49:04;83048597;82822789;225808;
29.01.2019;10:50:04;83048632;82822880;225752;
29.01.2019;10:51:05;83048690;82822989;225701;
29.01.2019;10:55:48;83048917;82823525;225392;
29.01.2019;10:56:05;83048927;82823548;225379;
29.01.2019;10:57:05;83048973;82823640;225333;
29.01.2019;10:58:04;83049013;82823733;225280;
29.01.2019;10:59:05;83049066;82823847;225219;
29.01.2019;11:00:07;83049104;82823963;225141;
29.01.2019;11:01:04;83049161;82824053;225108;
29.01.2019;11:02:05;83049201;82824179;225022;
29.01.2019;11:03:05;83049249;82824321;224928;
29.01.2019;11:04:04;83049297;82824432;224865;
29.01.2019;11:05:04;83049348;82824543;224805;
29.01.2019;11:06:05;83049403;82824641;224762;
29.01.2019;11:07:05;83049451;82824749;224702;
29.01.2019;11:08:04;83049512;82824866;224646;
29.01.2019;11:09:04;83049558;82824958;224600;
29.01.2019;11:10:08;83049615;82825070;224545;
29.01.2019;11:11:04;83049664;82825182;224482;
29.01.2019;11:12:09;83049705;82825307;224398;
29.01.2019;11:13:05;83049751;82825443;224308;
29.01.2019;11:14:05;83049794;82825536;224258;
29.01.2019;11:15:04;83049846;82825645;224201;
29.01.2019;11:16:04;83049896;82825741;224155;
29.01.2019;11:17:05;83049946;82825855;224091;
29.01.2019;11:18:05;83049999;82825952;224047;
29.01.2019;11:19:04;83050041;82826060;223981;
29.01.2019;11:20:04;83050091;82826187;223904;
29.01.2019;11:21:04;83050130;82826315;223815;
29.01.2019;11:22:05;83050168;82826425;223743;
29.01.2019;11:23:10;83050215;82826553;223662;
29.01.2019;11:24:04;83050269;82826659;223610;
29.01.2019;11:25:04;83050308;82826768;223540;
29.01.2019;11:26:05;83050346;82826872;223474;
29.01.2019;11:27:05;83050382;82826981;223401;
29.01.2019;11:28:04;83050434;82827099;223335;
29.01.2019;11:29:05;83050485;82827205;223280;
29.01.2019;11:30:06;83050535;82827322;223213;
29.01.2019;11:31:08;83050591;82827433;223158;
29.01.2019;11:32:05;83050639;82827558;223081;
29.01.2019;11:33:05;83050695;82827667;223028;
29.01.2019;11:34:04;83050735;82827773;222962;
29.01.2019;11:35:09;83050780;82827885;222895;
29.01.2019;11:36:05;83050813;82828003;222810;
29.01.2019;11:37:06;83050862;82828136;222726;
29.01.2019;11:38:05;83050901;82828223;222678;
29.01.2019;11:39:04;83050949;82828330;222619;
29.01.2019;11:40:04;83050982;82828453;222529;
29.01.2019;11:41:09;83051027;82828580;222447;
29.01.2019;11:42:04;83051080;82828683;222397;
29.01.2019;11:43:05;83051127;82828795;222332;
29.01.2019;11:44:04;83051185;82828920;222265;
29.01.2019;11:45:05;83051225;82829009;222216;
29.01.2019;11:46:04;83051270;82829101;222169;
29.01.2019;11:47:04;83051328;82829216;222112;
29.01.2019;11:48:05;83051374;82829336;222038;
29.01.2019;11:49:04;83051428;82829467;221961;
29.01.2019;11:50:05;83051487;82829573;221914;
29.01.2019;11:51:05;83051542;82829671;221871;
29.01.2019;11:52:10;83051604;82829805;221799;
29.01.2019;11:53:04;83051643;82829912;221731;
29.01.2019;11:54:05;83051690;82830042;221648;
29.01.2019;11:55:05;83051730;82830132;221598;
29.01.2019;11:56:05;83051779;82830249;221530;
29.01.2019;11:57:04;83051832;82830389;221443;
29.01.2019;11:58:04;83051883;82830502;221381;
29.01.2019;11:59:05;83051927;82830632;221295;
29.01.2019;12:00:05;83051967;82830726;221241;
29.01.2019;12:01:06;83052003;82830846;221157;
29.01.2019;12:02:05;83052052;82830978;221074;
29.01.2019;12:03:06;83052106;82831095;221011;
29.01.2019;12:04:05;83052157;82831202;220955;
29.01.2019;12:05:08;83052230;82831324;220906;
29.01.2019;12:06:04;83052278;82831430;220848;
29.01.2019;12:07:05;83052323;82831553;220770;
29.01.2019;12:08:05;83052364;82831676;220688;
29.01.2019;12:09:05;83052401;82831766;220635;
29.01.2019;12:10:05;83052427;82831881;220546;
29.01.2019;12:11:11;83052478;82831972;220506;
29.01.2019;12:12:14;83052524;82832084;220440;
29.01.2019;12:13:06;83052555;82832183;220372;
29.01.2019;12:14:04;83052591;82832274;220317;
29.01.2019;12:15:06;83052615;82832365;220250;
29.01.2019;12:16:11;83052635;82832451;220184;
29.01.2019;12:17:05;83052670;82832538;220132;
29.01.2019;12:18:05;83052702;82832610;220092;
29.01.2019;12:19:04;83052738;82832752;219986;
29.01.2019;12:20:05;83052780;82832873;219907;
29.01.2019;12:21:06;83052816;82832961;219855;
29.01.2019;12:22:06;83052866;82833091;219775;
29.01.2019;12:23:09;83052912;82833200;219712;
29.01.2019;12:24:11;83052965;82833335;219630;
29.01.2019;12:25:06;83052995;82833443;219552;
29.01.2019;12:26:07;83053046;82833557;219489;
29.01.2019;12:27:04;83053103;82833662;219441;
29.01.2019;12:28:11;83053150;82833799;219351;
29.01.2019;12:29:05;83053194;82833901;219293;
29.01.2019;12:30:12;83053240;82834029;219211;
29.01.2019;12:31:04;83053307;82834124;219183;
29.01.2019;12:32:04;83053352;82834251;219101;
29.01.2019;12:33:05;83053412;82834387;219025;
29.01.2019;12:34:11;83053468;82834503;218965;
29.01.2019;12:35:08;83053529;82834609;218920;
29.01.2019;12:36:07;83053576;82834753;218823;
29.01.2019;12:37:06;83053623;82834866;218757;
29.01.2019;12:38:05;83053678;82834972;218706;
29.01.2019;12:39:08;83053739;82835077;218662;
29.01.2019;12:40:05;83053787;82835195;218592;
29.01.2019;12:41:06;83053831;82835325;218506;
29.01.2019;12:42:05;83053870;82835455;218415;
29.01.2019;12:43:05;83053933;82835592;218341;
29.01.2019;12:44:07;83053992;82835743;218249;
29.01.2019;12:45:06;83054022;82835878;218144;
29.01.2019;12:46:05;83054068;82835993;218075;
29.01.2019;12:47:04;83054110;82836105;218005;
29.01.2019;12:48:05;83054160;82836220;217940;
29.01.2019;12:49:05;83054221;82836340;217881;
29.01.2019;12:50:09;83054255;82836443;217812;
29.01.2019;12:51:04;83054308;82836535;217773;
29.01.2019;12:52:06;83054361;82836643;217718;
29.01.2019;12:53:05;83054419;82836782;217637;
29.01.2019;12:54:04;83054473;82836930;217543;
29.01.2019;12:55:04;83054390;82836923;217467;
29.01.2019;12:56:10;83054051;82836706;217345;
29.01.2019;12:57:04;83054105;82836820;217285;
29.01.2019;12:58:04;83054160;82836937;217223;
29.01.2019;12:59:04;83054201;82837051;217150;
29.01.2019;13:00:06;83054258;82837176;217082;
29.01.2019;13:01:05;83054319;82837306;217013;
29.01.2019;13:02:04;83054369;82837419;216950;
29.01.2019;13:03:06;83054431;82837532;216899;
29.01.2019;13:04:06;83054466;82837645;216821;
29.01.2019;13:05:04;83054512;82837781;216731;
29.01.2019;13:06:04;83054555;82837866;216689;
29.01.2019;13:07:06;83054601;82837946;216655;
29.01.2019;13:08:05;83054661;82838040;216621;
29.01.2019;13:09:06;83054714;82838148;216566;
29.01.2019;13:10:11;83054766;82838249;216517;
29.01.2019;13:11:04;83054827;82838329;216498;
29.01.2019;13:12:04;83054881;82838420;216461;
29.01.2019;13:13:05;83054953;82838532;216421;
29.01.2019;13:14:05;83055007;82838660;216347;
29.01.2019;13:15:07;83055055;82838784;216271;
29.01.2019;13:16:04;83055130;82838891;216239;
29.01.2019;13:17:05;83055191;82839010;216181;
29.01.2019;13:18:05;83055253;82839099;216154;
29.01.2019;13:19:06;83055321;82839235;216086;
29.01.2019;13:20:05;83055380;82839341;216039;
29.01.2019;13:21:04;83055459;82839449;216010;
29.01.2019;13:22:04;83055515;82839562;215953;
29.01.2019;13:23:05;83055570;82839675;215895;
29.01.2019;13:24:10;83055622;82839806;215816;
29.01.2019;13:25:05;83055672;82839920;215752;
29.01.2019;13:26:04;83055723;82840024;215699;
29.01.2019;13:27:07;83055797;82840180;215617;
29.01.2019;13:28:05;83055848;82840287;215561;
29.01.2019;13:29:09;83055908;82840419;215489;
29.01.2019;13:30:04;83055987;82840516;215471;
29.01.2019;13:31:05;83056045;82840639;215406;
29.01.2019;13:32:05;83056107;82840751;215356;
29.01.2019;13:33:04;83056179;82840861;215318;
29.01.2019;13:34:06;83056234;82840965;215269;
29.01.2019;13:35:05;83056305;82841067;215238;
29.01.2019;13:36:06;83056365;82841203;215162;
29.01.2019;13:37:05;83056432;82841322;215110;
29.01.2019;13:38:06;83056485;82841429;215056;
29.01.2019;13:39:06;83056543;82841552;214991;
29.01.2019;13:40:05;83056594;82841665;214929;
29.01.2019;13:41:05;83056665;82841787;214878;
29.01.2019;13:42:05;83056726;82841912;214814;
29.01.2019;13:43:04;83056805;82842030;214775;
29.01.2019;13:44:05;83056879;82842155;214724;
29.01.2019;13:45:06;83056931;82842283;214648;
29.01.2019;13:46:06;83056991;82842404;214587;
29.01.2019;13:47:04;83057065;82842519;214546;
29.01.2019;13:48:10;83057145;82842668;214477;
29.01.2019;13:49:04;83057216;82842808;214408;
29.01.2019;13:50:06;83057307;82842927;214380;
29.01.2019;13:51:04;83057373;82843046;214327;
29.01.2019;13:52:05;83057433;82843173;214260;
29.01.2019;13:53:09;83057503;82843299;214204;
29.01.2019;13:54:04;83057570;82843435;214135;
29.01.2019;13:55:04;83057634;82843562;214072;
29.01.2019;13:56:04;83057698;82843673;214025;
29.01.2019;13:57:04;83057767;82843790;213977;
29.01.2019;13:58:06;83057837;82843950;213887;
29.01.2019;13:59:06;83057912;82844090;213822;
29.01.2019;14:00:06;83057988;82844221;213767;
29.01.2019;14:01:05;83058071;82844313;213758;
29.01.2019;14:02:04;83058132;82844448;213684;
29.01.2019;14:03:05;83058198;82844566;213632;
29.01.2019;14:04:05;83058262;82844688;213574;
29.01.2019;14:05:05;83058341;82844828;213513;
29.01.2019;14:06:05;83058413;82844958;213455;
29.01.2019;14:07:10;83058491;82845096;213395;
29.01.2019;14:08:11;83058585;82845198;213387;
29.01.2019;14:09:05;83058639;82845292;213347;
29.01.2019;14:10:05;83058727;82845393;213334;
29.01.2019;14:11:05;83058787;82845517;213270;
29.01.2019;14:12:04;83058854;82845644;213210;
29.01.2019;14:13:05;83058925;82845775;213150;
29.01.2019;14:14:05;83058983;82845915;213068;
29.01.2019;14:15:11;83059064;82846061;213003;
29.01.2019;14:16:04;83059104;82846210;212894;
29.01.2019;14:17:04;83059167;82846324;212843;
29.01.2019;14:18:05;83059213;82846459;212754;
29.01.2019;14:19:05;83059292;82846564;212728;
29.01.2019;14:20:05;83059366;82846673;212693;
29.01.2019;14:21:05;83059431;82846800;212631;
29.01.2019;14:22:05;83059487;82846949;212538;
29.01.2019;14:23:05;83059550;82847076;212474;
29.01.2019;14:24:06;83059608;82847238;212370;
29.01.2019;14:25:05;83059658;82847355;212303;
29.01.2019;14:26:11;83059717;82847488;212229;
29.01.2019;14:27:05;83059775;82847602;212173;
29.01.2019;14:28:05;83059837;82847706;212131;
29.01.2019;14:29:06;83059895;82847838;212057;
29.01.2019;14:30:05;83059955;82847981;211974;
29.01.2019;14:31:04;83060014;82848098;211916;
29.01.2019;14:32:05;83060100;82848238;211862;
29.01.2019;14:33:04;83060171;82848362;211809;
29.01.2019;14:34:05;83060214;82848499;211715;
29.01.2019;14:35:04;83060275;82848629;211646;
29.01.2019;14:36:05;83060345;82848762;211583;
29.01.2019;14:37:05;83060422;82848887;211535;
29.01.2019;14:38:05;83060486;82849035;211451;
29.01.2019;14:39:07;83060551;82849158;211393;
29.01.2019;14:40:05;83060629;82849226;211403;
29.01.2019;14:41:04;83060716;82849469;211247;
29.01.2019;14:42:05;83060795;82849584;211211;
29.01.2019;14:43:11;83060887;82849736;211151;
29.01.2019;14:44:04;83060957;82849854;211103;
29.01.2019;14:45:04;83061029;82850009;211020;
29.01.2019;14:46:04;83061114;82850152;210962;
29.01.2019;14:47:04;83061213;82850286;210927;
29.01.2019;14:48:05;83061282;82850434;210848;
29.01.2019;14:49:05;83061354;82850546;210808;
29.01.2019;14:50:05;83061429;82850713;210716;
29.01.2019;14:51:04;83061494;82850834;210660;
29.01.2019;14:52:05;83061560;82851000;210560;
29.01.2019;14:53:11;83061638;82851144;210494;
29.01.2019;14:54:05;83061689;82851263;210426;
29.01.2019;14:55:05;83061769;82851400;210369;
29.01.2019;14:56:06;83061850;82851533;210317;
29.01.2019;14:57:05;83061936;82851653;210283;
29.01.2019;14:58:05;83062013;82851785;210228;
29.01.2019;14:59:11;83062085;82851962;210123;
29.01.2019;15:00:08;83062178;82852114;210064;
29.01.2019;15:01:08;83062246;82852264;209982;
29.01.2019;15:02:09;83062326;82852411;209915;
29.01.2019;15:03:13;83062384;82852567;209817;
29.01.2019;15:04:08;83062482;82852695;209787;
29.01.2019;15:05:08;83062566;82852840;209726;
29.01.2019;15:06:08;83062658;82852961;209697;
29.01.2019;15:07:13;83062755;82853125;209630;
29.01.2019;15:08:07;83062829;82853275;209554;
29.01.2019;15:09:09;83062906;82853419;209487;
29.01.2019;15:10:08;83062984;82853579;209405;
29.01.2019;15:11:07;83063068;82853750;209318;
29.01.2019;15:12:18;83063148;82853925;209223;
29.01.2019;15:13:08;83063208;82854061;209147;
29.01.2019;15:14:15;83063312;82854217;209095;
29.01.2019;15:15:09;83063396;82854341;209055;
29.01.2019;15:16:08;83063454;82854491;208963;
29.01.2019;15:17:14;83063551;82854647;208904;
29.01.2019;15:18:08;83063609;82854789;208820;
29.01.2019;15:19:08;83063673;82854937;208736;
29.01.2019;15:20:13;83063742;82855087;208655;
29.01.2019;15:21:07;83063836;82855198;208638;
29.01.2019;15:22:07;83063881;82855346;208535;
29.01.2019;15:23:08;83063955;82855473;208482;
29.01.2019;15:24:08;83064023;82855584;208439;
29.01.2019;15:25:09;83064085;82855750;208335;
29.01.2019;15:26:08;83064144;82855898;208246;
29.01.2019;15:27:08;83064210;82856038;208172;
29.01.2019;15:28:08;83064298;82856220;208078;
29.01.2019;15:29:08;83064369;82856383;207986;
29.01.2019;15:30:07;83064445;82856508;207937;
29.01.2019;15:31:07;83064529;82856667;207862;
29.01.2019;15:32:07;83064605;82856838;207767;
29.01.2019;15:33:07;83064671;82856943;207728;
29.01.2019;15:34:08;83064758;82857104;207654;
29.01.2019;15:35:08;83064827;82857254;207573;
29.01.2019;15:36:09;83064904;82857403;207501;
29.01.2019;15:37:09;83064995;82857557;207438;
29.01.2019;15:38:09;83065053;82857686;207367;
29.01.2019;15:39:08;83065147;82857839;207308;
29.01.2019;15:40:13;83065240;82858016;207224;
29.01.2019;15:41:07;83065321;82858155;207166;
29.01.2019;15:42:08;83065401;82858325;207076;
29.01.2019;15:43:08;83065487;82858475;207012;
29.01.2019;15:44:08;83065549;82858621;206928;
29.01.2019;15:45:08;83065621;82858770;206851;
29.01.2019;15:46:07;83065689;82858908;206781;
29.01.2019;15:47:07;83065776;82859077;206699;
29.01.2019;15:48:07;83065865;82859232;206633;
29.01.2019;15:49:07;83065961;82859353;206608;
29.01.2019;15:50:08;83066039;82859528;206511;
29.01.2019;15:51:08;83066115;82859678;206437;
29.01.2019;15:52:13;83066194;82859844;206350;
29.01.2019;15:53:07;83066274;82859993;206281;
29.01.2019;15:54:08;83066358;82860138;206220;
29.01.2019;15:55:08;83066447;82860286;206161;
29.01.2019;15:56:09;83066527;82860419;206108;
29.01.2019;15:57:08;83066596;82860558;206038;
29.01.2019;15:58:08;83066670;82860719;205951;
29.01.2019;15:59:07;83066747;82860908;205839;
29.01.2019;16:00:05;83066822;82861033;205789;
29.01.2019;16:01:06;83066899;82861200;205699;
29.01.2019;16:02:07;83066964;82861389;205575;
29.01.2019;16:03:05;83067064;82861526;205538;
29.01.2019;16:04:05;83067149;82861677;205472;
29.01.2019;16:05:06;83067246;82861821;205425;
29.01.2019;16:06:05;83067326;82861980;205346;
29.01.2019;16:07:11;83067428;82862154;205274;
29.01.2019;16:08:05;83067488;82862289;205199;
29.01.2019;16:09:07;83067572;82862459;205113;
29.01.2019;16:10:05;83067652;82862621;205031;
29.01.2019;16:11:06;83067744;82862752;204992;
29.01.2019;16:12:05;83067819;82862877;204942;
29.01.2019;16:13:05;83067908;82863030;204878;
29.01.2019;16:14:04;83067989;82863213;204776;
29.01.2019;16:15:05;83068065;82863351;204714;
29.01.2019;16:16:05;83068113;82863507;204606;
29.01.2019;16:17:11;83068178;82863673;204505;
29.01.2019;16:18:12;83068246;82863799;204447;
29.01.2019;16:19:05;83068327;82863933;204394;
29.01.2019;16:20:05;83068385;82864070;204315;
29.01.2019;16:21:07;83068467;82864228;204239;
29.01.2019;16:22:04;83068526;82864386;204140;
29.01.2019;16:23:05;83068606;82864538;204068;
29.01.2019;16:24:04;83068666;82864661;204005;
29.01.2019;16:25:09;83068746;82864831;203915;
29.01.2019;16:26:05;83068801;82864968;203833;
29.01.2019;16:27:05;83068853;82865130;203723;
29.01.2019;16:28:05;83068919;82865300;203619;
29.01.2019;16:29:10;83068980;82865466;203514;
29.01.2019;16:30:05;83069062;82865585;203477;
29.01.2019;16:31:12;83069138;82865759;203379;
29.01.2019;16:32:06;83069209;82865887;203322;
29.01.2019;16:33:05;83069260;82866040;203220;
29.01.2019;16:34:07;83069354;82866189;203165;
29.01.2019;16:35:06;83069426;82866340;203086;
29.01.2019;16:36:05;83069514;82866466;203048;
29.01.2019;16:37:05;83069601;82866601;203000;
29.01.2019;16:38:05;83069668;82866776;202892;
29.01.2019;16:39:16;83069752;82866944;202808;
29.01.2019;16:40:05;83069811;82867081;202730;
29.01.2019;16:41:05;83069888;82867223;202665;
29.01.2019;16:42:07;83069971;82867385;202586;
29.01.2019;16:43:06;83070040;82867529;202511;
29.01.2019;16:44:05;83070119;82867667;202452;
29.01.2019;16:45:07;83070190;82867816;202374;
29.01.2019;16:46:06;83070275;82867967;202308;
29.01.2019;16:47:05;83070350;82868141;202209;
29.01.2019;16:48:06;83070449;82868296;202153;
29.01.2019;16:49:05;83070528;82868440;202088;
29.01.2019;16:50:11;83070601;82868597;202004;
29.01.2019;16:51:10;83070694;82868778;201916;
29.01.2019;16:52:05;83070765;82868935;201830;
29.01.2019;16:53:04;83070844;82869083;201761;
29.01.2019;16:54:10;83070951;82869291;201660;
29.01.2019;16:55:05;83071024;82869430;201594;
29.01.2019;16:56:07;83071122;82869629;201493;
29.01.2019;16:57:06;83071204;82869774;201430;
29.01.2019;16:58:05;83071296;82869936;201360;
29.01.2019;16:59:06;83071411;82870094;201317;
29.01.2019;17:00:06;83071504;82870264;201240;
29.01.2019;17:01:04;83071586;82870408;201178;
29.01.2019;17:02:06;83071694;82870568;201126;
29.01.2019;17:03:04;83071793;82870698;201095;
29.01.2019;17:04:06;83071877;82870868;201009;
29.01.2019;17:05:05;83071953;82871030;200923;
29.01.2019;17:06:05;83072043;82871186;200857;
29.01.2019;17:07:09;83072141;82871355;200786;
29.01.2019;17:08:04;83072227;82871496;200731;
29.01.2019;17:09:06;83072310;82871678;200632;
29.01.2019;17:10:12;83072410;82871818;200592;
29.01.2019;17:11:07;83072478;82871955;200523;
29.01.2019;17:12:07;83072595;82872113;200482;
29.01.2019;17:13:06;83072694;82872266;200428;
29.01.2019;17:14:06;83072778;82872424;200354;
29.01.2019;17:15:16;83072865;82872589;200276;
29.01.2019;17:16:05;83072943;82872741;200202;
29.01.2019;17:17:10;83073031;82872907;200124;
29.01.2019;17:18:05;83073124;82873045;200079;
29.01.2019;17:19:11;83073221;82873211;200010;
29.01.2019;17:20:06;83073295;82873353;199942;
29.01.2019;17:21:12;83073388;82873522;199866;
29.01.2019;17:22:06;83073483;82873669;199814;
29.01.2019;17:23:05;83073593;82873823;199770;
29.01.2019;17:24:07;83073685;82873986;199699;
29.01.2019;17:25:05;83073764;82874124;199640;
29.01.2019;17:26:12;83073887;82874305;199582;
29.01.2019;17:27:04;83073959;82874442;199517;
29.01.2019;17:28:05;83074064;82874616;199448;
29.01.2019;17:29:10;83074140;82874791;199349;
29.01.2019;17:30:06;83074237;82874928;199309;
29.01.2019;17:31:05;83074325;82875094;199231;
29.01.2019;17:32:06;83074430;82875251;199179;
29.01.2019;17:33:06;83074492;82875424;199068;
29.01.2019;17:34:05;83074585;82875577;199008;
29.01.2019;17:35:06;83074688;82875724;198964;
29.01.2019;17:36:05;83074786;82875877;198909;
29.01.2019;17:37:05;83074889;82876057;198832;
29.01.2019;17:38:05;83074992;82876194;198798;
29.01.2019;17:39:05;83075086;82876335;198751;
29.01.2019;17:40:05;83075179;82876480;198699;
29.01.2019;17:41:05;83075281;82876631;198650;
29.01.2019;17:42:05;83075376;82876780;198596;
29.01.2019;17:43:05;83075448;82876944;198504;
29.01.2019;17:44:04;83075540;82877084;198456;
29.01.2019;17:45:05;83075639;82877227;198412;
29.01.2019;17:46:06;83075732;82877367;198365;
29.01.2019;17:47:06;83075833;82877522;198311;
29.01.2019;17:48:05;83075911;82877668;198243;
29.01.2019;17:49:10;83076026;82877825;198201;
29.01.2019;17:50:05;83076109;82877953;198156;
29.01.2019;17:51:05;83076218;82878114;198104;
29.01.2019;17:52:05;83076321;82878243;198078;
29.01.2019;17:53:05;83076414;82878428;197986;
29.01.2019;17:54:06;83076511;82878564;197947;
29.01.2019;17:55:11;83076615;82878712;197903;
29.01.2019;17:56:04;83076724;82878869;197855;
29.01.2019;17:57:04;83076814;82879022;197792;
29.01.2019;17:58:07;83076924;82879145;197779;
29.01.2019;17:59:06;83077024;82879291;197733;
29.01.2019;18:00:06;83077136;82879424;197712;
29.01.2019;18:01:04;83077261;82879549;197712;
29.01.2019;18:02:04;83077377;82879667;197710;
29.01.2019;18:03:05;83077481;82879832;197649;
29.01.2019;18:04:04;83077579;82879985;197594;
29.01.2019;18:05:06;83077690;82880119;197571;
29.01.2019;18:06:06;83077814;82880275;197539;
29.01.2019;18:07:05;83077930;82880420;197510;
29.01.2019;18:08:05;83078071;82880553;197518;
29.01.2019;18:09:07;83078170;82880700;197470;
29.01.2019;18:10:05;83078260;82880811;197449;
29.01.2019;18:11:05;83078377;82880940;197437;
29.01.2019;18:12:05;83078499;82881082;197417;
29.01.2019;18:13:06;83078614;82881210;197404;
29.01.2019;18:14:06;83078733;82881336;197397;
29.01.2019;18:15:04;83078830;82881433;197397;
29.01.2019;18:16:04;83078951;82881578;197373;
29.01.2019;18:17:07;83079048;82881715;197333;
29.01.2019;18:18:06;83079179;82881840;197339;
29.01.2019;18:19:07;83079299;82881991;197308;
29.01.2019;18:20:04;83079405;82882103;197302;
29.01.2019;18:21:04;83079531;82882227;197304;
29.01.2019;18:22:06;83079647;82882350;197297;
29.01.2019;18:23:05;83079784;82882475;197309;
29.01.2019;18:24:05;83079905;82882607;197298;
29.01.2019;18:25:10;83080030;82882755;197275;
29.01.2019;18:26:05;83080147;82882852;197295;
29.01.2019;18:27:04;83080289;82882954;197335;
29.01.2019;18:28:04;83080406;82883069;197337;
29.01.2019;18:29:05;83080492;82883186;197306;
29.01.2019;18:30:06;83080598;82883304;197294;
29.01.2019;18:31:11;83080717;82883432;197285;
29.01.2019;18:32:06;83080813;82883513;197300;
29.01.2019;18:33:05;83080924;82883621;197303;
29.01.2019;18:34:05;83081033;82883717;197316;
29.01.2019;18:35:09;83081155;82883808;197347;
29.01.2019;18:36:04;83081261;82883914;197347;
29.01.2019;18:37:05;83081381;82884030;197351;
29.01.2019;18:38:09;83081500;82884138;197362;
29.01.2019;18:39:04;83081628;82884231;197397;
29.01.2019;18:40:05;83081763;82884346;197417;
29.01.2019;18:41:10;83081880;82884468;197412;
29.01.2019;18:42:05;83081899;82884512;197387;
29.01.2019;18:43:05;83082044;82884602;197442;
29.01.2019;18:44:05;83082158;82884711;197447;
29.01.2019;18:45:04;83082260;82884834;197426;
29.01.2019;18:46:10;83082390;82884938;197452;
29.01.2019;18:47:04;83082480;82885021;197459;
29.01.2019;18:48:05;83082602;82885134;197468;
29.01.2019;18:49:05;83082685;82885228;197457;
29.01.2019;18:50:11;83082809;82885353;197456;
29.01.2019;18:51:05;83082925;82885443;197482;
29.01.2019;18:52:04;83083028;82885568;197460;
29.01.2019;18:53:04;83083144;82885668;197476;
29.01.2019;18:54:11;83083283;82885779;197504;
29.01.2019;18:55:11;83083390;82885899;197491;
29.01.2019;18:56:05;83083528;82885986;197542;
29.01.2019;18:57:04;83083650;82886100;197550;
29.01.2019;18:58:10;83083773;82886226;197547;
29.01.2019;18:59:10;83083935;82886358;197577;
29.01.2019;19:00:04;83084047;82886452;197595;
29.01.2019;19:01:05;83084189;82886543;197646;
29.01.2019;19:02:05;83084315;82886656;197659;
29.01.2019;19:03:11;83084426;82886770;197656;
29.01.2019;19:04:12;83084559;82886869;197690;
29.01.2019;19:05:06;83084684;82886971;197713;
29.01.2019;19:06:10;83084810;82887062;197748;
29.01.2019;19:07:10;83084944;82887166;197778;
29.01.2019;19:08:04;83085066;82887250;197816;
29.01.2019;19:09:04;83085175;82887365;197810;
29.01.2019;19:10:05;83085324;82887464;197860;
29.01.2019;19:11:08;83085430;82887580;197850;
29.01.2019;19:12:05;83085529;82887670;197859;
29.01.2019;19:13:11;83085639;82887782;197857;
29.01.2019;19:14:05;83085753;82887872;197881;
29.01.2019;19:15:04;83085864;82887974;197890;
29.01.2019;19:16:04;83085959;82888084;197875;
29.01.2019;19:17:07;83085992;82888200;197792;
29.01.2019;19:18:05;83086061;82888289;197772;
29.01.2019;19:19:06;83086141;82888382;197759;
29.01.2019;19:20:07;83086230;82888498;197732;
29.01.2019;19:21:11;83086320;82888619;197701;
29.01.2019;19:22:07;83086376;82888695;197681;
29.01.2019;19:23:06;83086466;82888800;197666;
29.01.2019;19:24:07;83086562;82888900;197662;
29.01.2019;19:25:06;83086671;82888995;197676;
29.01.2019;19:26:07;83086781;82889074;197707;
29.01.2019;19:27:05;83086882;82889149;197733;
29.01.2019;19:28:07;83086974;82889265;197709;
29.01.2019;19:29:14;83087073;82889377;197696;
29.01.2019;19:30:07;83087191;82889443;197748;
29.01.2019;19:31:04;83087264;82889512;197752;
29.01.2019;19:32:04;83087359;82889599;197760;
29.01.2019;19:33:05;83087470;82889690;197780;
29.01.2019;19:34:05;83087589;82889772;197817;
29.01.2019;19:35:05;83087723;82889849;197874;
29.01.2019;19:36:04;83087832;82889939;197893;
29.01.2019;19:37:05;83087930;82890024;197906;
29.01.2019;19:38:05;83088021;82890113;197908;
29.01.2019;19:39:06;83088131;82890181;197950;
29.01.2019;19:40:06;83088230;82890262;197968;
29.01.2019;19:42:05;83088434;82890430;198004;
29.01.2019;19:43:06;83088557;82890511;198046;
29.01.2019;19:44:06;83088660;82890577;198083;
29.01.2019;19:45:06;83088766;82890647;198119;
29.01.2019;19:46:05;83088857;82890727;198130;
29.01.2019;19:47:05;83088953;82890791;198162;
29.01.2019;19:48:05;83089074;82890868;198206;
29.01.2019;19:49:04;83089191;82890934;198257;
29.01.2019;19:50:05;83089304;82891016;198288;
29.01.2019;19:51:04;83089402;82891069;198333;
29.01.2019;19:52:04;83089495;82891122;198373;
29.01.2019;19:53:04;83089614;82891206;198408;
29.01.2019;19:54:04;83089711;82891275;198436;
29.01.2019;19:55:05;83089819;82891357;198462;
29.01.2019;19:56:04;83089909;82891422;198487;
29.01.2019;19:57:05;83090036;82891485;198551;
29.01.2019;19:58:05;83090148;82891550;198598;
29.01.2019;19:59:05;83090258;82891621;198637;
29.01.2019;20:00:05;83090369;82891692;198677;
29.01.2019;20:01:05;83090488;82891751;198737;
29.01.2019;20:02:05;83090606;82891819;198787;
29.01.2019;20:03:05;83090719;82891873;198846;
29.01.2019;20:04:04;83090824;82891940;198884;
29.01.2019;20:05:05;83090927;82892032;198895;
29.01.2019;20:06:05;83091047;82892107;198940;
29.01.2019;20:07:05;83091147;82892168;198979;
29.01.2019;20:08:05;83091238;82892254;198984;
29.01.2019;20:09:06;83091377;82892313;199064;
29.01.2019;20:10:05;83091523;82892383;199140;
29.01.2019;20:11:05;83091665;82892461;199204;
29.01.2019;20:12:06;83091767;82892533;199234;
29.01.2019;20:13:05;83091878;82892607;199271;
29.01.2019;20:14:06;83091991;82892666;199325;
29.01.2019;20:15:05;83092079;82892726;199353;
29.01.2019;20:16:10;83092187;82892808;199379;
29.01.2019;20:17:04;83092286;82892875;199411;
29.01.2019;20:18:05;83092378;82892937;199441;
29.01.2019;20:19:05;83092480;82893005;199475;
29.01.2019;20:20:05;83092596;82893055;199541;
29.01.2019;20:21:06;83092707;82893126;199581;
29.01.2019;20:22:13;83092811;82893199;199612;
29.01.2019;20:23:05;83092927;82893233;199694;
29.01.2019;20:24:05;83093036;82893287;199749;
29.01.2019;20:25:07;83093161;82893331;199830;
29.01.2019;20:26:05;83093284;82893381;199903;
29.01.2019;20:27:04;83093365;82893441;199924;
29.01.2019;20:28:04;83093478;82893483;199995;
29.01.2019;20:29:05;83093571;82893543;200028;
29.01.2019;20:30:07;83093677;82893582;200095;
29.01.2019;20:31:18;83093800;82893660;200140;
29.01.2019;20:32:06;83093879;82893703;200176;
29.01.2019;20:33:05;83093967;82893773;200194;
29.01.2019;20:34:06;83094087;82893814;200273;
29.01.2019;20:35:10;83094176;82893866;200310;
29.01.2019;20:36:11;83094264;82893912;200352;
29.01.2019;20:37:05;83094364;82893978;200386;
29.01.2019;20:38:05;83094452;82894042;200410;
29.01.2019;20:39:07;83094543;82894083;200460;
29.01.2019;20:40:11;83094662;82894127;200535;
29.01.2019;20:41:08;83094760;82894173;200587;
29.01.2019;20:42:11;83094872;82894211;200661;
29.01.2019;20:43:04;83094962;82894255;200707;
29.01.2019;20:44:04;83095072;82894291;200781;
29.01.2019;20:45:09;83095222;82894326;200896;
29.01.2019;20:46:05;83095345;82894369;200976;
29.01.2019;20:47:10;83095456;82894420;201036;
29.01.2019;20:48:05;83095554;82894462;201092;
29.01.2019;20:49:05;83095668;82894509;201159;
29.01.2019;20:50:11;83095781;82894542;201239;
29.01.2019;20:51:06;83095904;82894582;201322;
29.01.2019;20:52:06;83096024;82894632;201392;
29.01.2019;20:53:05;83096173;82894668;201505;
29.01.2019;20:54:05;83096313;82894718;201595;
29.01.2019;20:55:06;83096436;82894777;201659;
29.01.2019;20:56:09;83096558;82894827;201731;
29.01.2019;20:57:05;83096680;82894867;201813;
29.01.2019;20:58:05;83096807;82894922;201885;
29.01.2019;20:59:05;83096939;82894970;201969;
29.01.2019;21:00:06;83097067;82895010;202057;
29.01.2019;21:01:11;83097183;82895072;202111;
29.01.2019;21:02:05;83097309;82895113;202196;
29.01.2019;21:03:05;83097441;82895153;202288;
29.01.2019;21:04:05;83097548;82895204;202344;
29.01.2019;21:05:05;83097679;82895242;202437;
29.01.2019;21:06:05;83097796;82895292;202504;
29.01.2019;21:07:06;83097906;82895335;202571;
29.01.2019;21:08:05;83098011;82895373;202638;
29.01.2019;21:09:05;83098144;82895411;202733;
29.01.2019;21:10:07;83098251;82895454;202797;
29.01.2019;21:11:15;83098379;82895501;202878;
29.01.2019;21:12:06;83098481;82895538;202943;
29.01.2019;21:13:05;83098583;82895583;203000;
29.01.2019;21:14:05;83098705;82895616;203089;
29.01.2019;21:15:10;83098814;82895670;203144;
29.01.2019;21:16:07;83098946;82895705;203241;
29.01.2019;21:17:06;83099088;82895742;203346;
29.01.2019;21:18:05;83099226;82895773;203453;
29.01.2019;21:19:05;83099350;82895816;203534;
29.01.2019;21:20:06;83099472;82895862;203610;
29.01.2019;21:21:06;83099602;82895911;203691;
29.01.2019;21:22:05;83098791;82895942;202849;
29.01.2019;21:23:06;83098915;82895989;202926;
29.01.2019;21:24:05;83099057;82896029;203028;
29.01.2019;21:25:11;83099143;82901513;197630;
29.01.2019;21:26:05;83099263;82901550;197713;
29.01.2019;21:27:05;83099406;82901599;197807;
29.01.2019;21:28:06;83099529;82901649;197880;
29.01.2019;21:29:05;83099645;82901696;197949;
29.01.2019;21:30:05;83099744;82901746;197998;
29.01.2019;21:31:05;83099874;82901772;198102;
29.01.2019;21:32:05;83099991;82901799;198192;
29.01.2019;21:33:11;83100148;82901845;198303;
29.01.2019;21:34:05;83100261;82901874;198387;
29.01.2019;21:35:06;83100362;82901908;198454;
29.01.2019;21:36:11;83100494;82901940;198554;
29.01.2019;21:37:05;83100596;82901983;198613;
29.01.2019;21:38:06;83100717;82902017;198700;
29.01.2019;21:39:07;83100838;82902045;198793;
29.01.2019;21:40:05;83100964;82902065;198899;
29.01.2019;21:41:04;83101084;82902100;198984;
29.01.2019;21:42:06;83101225;82902128;199097;
29.01.2019;21:43:05;83101342;82902159;199183;
29.01.2019;21:44:05;83101471;82902182;199289;
29.01.2019;21:45:09;83101578;82902208;199370;
29.01.2019;21:46:10;83101644;82902207;199437;
29.01.2019;21:47:05;83101719;82902217;199502;
29.01.2019;21:48:11;83101842;82902253;199589;
29.01.2019;21:49:05;83101956;82902280;199676;
29.01.2019;21:50:06;83102073;82902319;199754;
29.01.2019;21:51:04;83102170;82902349;199821;
29.01.2019;21:52:11;83102301;82902380;199921;
29.01.2019;21:53:06;83102407;82902411;199996;
29.01.2019;21:54:05;83102498;82902439;200059;
29.01.2019;21:55:10;83102609;82902485;200124;
29.01.2019;21:56:05;83102703;82902528;200175;
29.01.2019;21:57:06;83102823;82902575;200248;
29.01.2019;21:58:06;83102949;82902619;200330;
29.01.2019;21:59:05;83103051;82902653;200398;
29.01.2019;22:00:05;83103179;82902703;200476;
29.01.2019;22:01:06;83103284;82902737;200547;
29.01.2019;22:02:04;83103421;82902763;200658;
29.01.2019;22:03:05;83103533;82902784;200749;
29.01.2019;22:04:05;83103624;82902817;200807;
29.01.2019;22:05:06;83103719;82902849;200870;
29.01.2019;22:06:14;83103851;82902883;200968;
29.01.2019;22:07:06;83103942;82902909;201033;
29.01.2019;22:08:04;83104051;82902937;201114;
29.01.2019;22:09:07;83104147;82902975;201172;
29.01.2019;22:10:06;83104234;82903001;201233;
29.01.2019;22:11:07;83104343;82903045;201298;
29.01.2019;22:12:07;83104435;82903079;201356;
29.01.2019;22:13:05;83104526;82903102;201424;
29.01.2019;22:14:05;83104625;82903121;201504;
29.01.2019;22:15:12;83104738;82903149;201589;
29.01.2019;22:16:07;83104833;82903175;201658;
29.01.2019;22:17:06;83104921;82903197;201724;
29.01.2019;22:18:04;83105023;82903214;201809;
29.01.2019;22:19:10;83105105;82903268;201837;
29.01.2019;22:20:11;83105219;82903302;201917;
29.01.2019;22:21:07;83105309;82903320;201989;
29.01.2019;22:22:12;83105405;82903350;202055;
29.01.2019;22:23:05;83105479;82903367;202112;
29.01.2019;22:24:05;83105556;82903381;202175;
29.01.2019;22:25:05;83105639;82903394;202245;
29.01.2019;22:26:06;83105718;82903409;202309;
29.01.2019;22:27:05;83105799;82903427;202372;
29.01.2019;22:28:05;83105882;82903450;202432;
29.01.2019;22:29:06;83105983;82903462;202521;
29.01.2019;22:30:11;83106073;82903476;202597;
29.01.2019;22:31:08;83106160;82903497;202663;
29.01.2019;22:32:06;83106246;82903514;202732;
29.01.2019;22:33:06;83106352;82903537;202815;
29.01.2019;22:34:05;83106450;82903548;202902;
29.01.2019;22:35:05;83106525;82903564;202961;
29.01.2019;22:36:05;83106599;82903589;203010;
29.01.2019;22:37:06;83106698;82903598;203100;
29.01.2019;22:38:09;83106834;82903607;203227;
29.01.2019;22:39:05;83106908;82903625;203283;
29.01.2019;22:40:05;83106984;82903648;203336;
29.01.2019;22:41:07;83107064;82903661;203403;
29.01.2019;22:42:07;83107158;82903685;203473;
29.01.2019;22:43:04;83107229;82903705;203524;
29.01.2019;22:44:05;83107347;82903725;203622;
29.01.2019;22:45:05;83107428;82903747;203681;
29.01.2019;22:46:10;83107522;82903780;203742;
29.01.2019;22:47:05;83107615;82903791;203824;
29.01.2019;22:48:05;83107718;82903821;203897;
29.01.2019;22:49:05;83107833;82903847;203986;
29.01.2019;22:50:05;83107937;82903867;204070;
29.01.2019;22:51:11;83108066;82903890;204176;
29.01.2019;22:52:06;83108153;82903898;204255;
29.01.2019;22:53:05;83108250;82903928;204322;
29.01.2019;22:54:06;83108367;82903954;204413;
29.01.2019;22:55:04;83108458;82903979;204479;
29.01.2019;22:56:05;83108548;82903997;204551;
29.01.2019;22:57:11;83108669;82904013;204656;
29.01.2019;22:58:05;83108761;82904045;204716;
29.01.2019;22:59:06;83108872;82904071;204801;
29.01.2019;23:00:05;83108949;82904092;204857;
29.01.2019;23:01:05;83109045;82904118;204927;
29.01.2019;23:02:05;83109126;82904138;204988;
29.01.2019;23:03:06;83109204;82904160;205044;
29.01.2019;23:04:09;83109320;82904192;205128;
29.01.2019;23:05:07;83109415;82904215;205200;
29.01.2019;23:06:05;83109502;82904241;205261;
29.01.2019;23:07:06;83109621;82904269;205352;
29.01.2019;23:08:04;83109722;82904294;205428;
29.01.2019;23:09:06;83109799;82904312;205487;
29.01.2019;23:10:08;83109881;82904335;205546;
29.01.2019;23:11:05;83109952;82904360;205592;
29.01.2019;23:12:06;83110097;82904381;205716;
29.01.2019;23:13:05;83110202;82904401;205801;
29.01.2019;23:14:05;83110304;82904422;205882;
29.01.2019;23:15:08;83110409;82904440;205969;
29.01.2019;23:16:05;83110511;82904458;206053;
29.01.2019;23:17:05;83110637;82904490;206147;
29.01.2019;23:18:06;83110738;82904523;206215;
29.01.2019;23:19:05;83110824;82904543;206281;
29.01.2019;23:20:05;83110914;82904558;206356;
29.01.2019;23:21:10;83111009;82904580;206429;
29.01.2019;23:22:04;83111099;82904612;206487;
29.01.2019;23:23:05;83111219;82904641;206578;
29.01.2019;23:24:05;83111318;82904663;206655;
29.01.2019;23:25:05;83111430;82904675;206755;
29.01.2019;23:26:10;83111515;82904690;206825;
29.01.2019;23:27:12;83111606;82904715;206891;
29.01.2019;23:28:07;83111698;82904744;206954;
29.01.2019;23:29:04;83111773;82904760;207013;
29.01.2019;23:30:04;83111883;82904778;207105;
29.01.2019;23:31:04;83111983;82904797;207186;
29.01.2019;23:32:06;83112109;82904828;207281;
29.01.2019;23:33:05;83112223;82904858;207365;
29.01.2019;23:34:05;83112312;82904883;207429;
29.01.2019;23:35:12;83112407;82904905;207502;
29.01.2019;23:36:06;83112497;82904918;207579;
29.01.2019;23:37:12;83112600;82904934;207666;
29.01.2019;23:38:05;83112712;82904951;207761;
29.01.2019;23:39:08;83112815;82904977;207838;
29.01.2019;23:40:09;83112898;82904991;207907;
29.01.2019;23:41:05;83112981;82905018;207963;
29.01.2019;23:42:06;83113093;82905036;208057;
29.01.2019;23:43:06;83113188;82905047;208141;
29.01.2019;23:44:05;83113265;82905058;208207;
29.01.2019;23:45:05;83113356;82905081;208275;
29.01.2019;23:46:06;83113449;82905101;208348;
29.01.2019;23:47:05;83113540;82905119;208421;
29.01.2019;23:48:04;83113654;82905145;208509;
29.01.2019;23:49:06;83113734;82905174;208560;
29.01.2019;23:50:05;83113819;82905204;208615;
29.01.2019;23:51:10;83113906;82905218;208688;
29.01.2019;23:52:06;83114013;82905241;208772;
29.01.2019;23:53:07;83114104;82905261;208843;
29.01.2019;23:54:06;83114192;82905283;208909;
29.01.2019;23:55:06;83114290;82905307;208983;
29.01.2019;23:56:06;83114381;82905325;209056;
29.01.2019;23:57:06;83114458;82905347;209111;
29.01.2019;23:58:05;83114549;82905370;209179;
29.01.2019;23:59:05;83114632;82905386;209246;
30.01.2019;00:00:08;83114742;82905405;209337;
30.01.2019;00:01:08;83114851;82905432;209419;
30.01.2019;00:02:12;83114955;82905457;209498;
30.01.2019;00:03:08;83115021;82905480;209541;
30.01.2019;00:04:08;83115114;82905495;209619;
30.01.2019;00:05:09;83115203;82905513;209690;
30.01.2019;00:06:09;83115283;82905526;209757;
30.01.2019;00:07:08;83115386;82905533;209853;
30.01.2019;00:08:09;83115442;82905560;209882;
30.01.2019;00:09:08;83115569;82905578;209991;
30.01.2019;00:11:08;83115750;82905612;210138;
30.01.2019;00:12:08;83115848;82905634;210214;
30.01.2019;00:13:12;83115938;82905665;210273;
30.01.2019;00:14:07;83116037;82905690;210347;
30.01.2019;00:15:07;83116119;82905707;210412;
30.01.2019;00:16:08;83116213;82905725;210488;
30.01.2019;00:17:13;83116296;82905751;210545;
30.01.2019;00:18:08;83116370;82905768;210602;
30.01.2019;00:19:09;83116444;82905781;210663;
30.01.2019;00:20:08;83116516;82905793;210723;
30.01.2019;00:21:07;83116569;82905814;210755;
30.01.2019;00:22:08;83116651;82905837;210814;
30.01.2019;00:23:07;83116710;82905841;210869;
30.01.2019;00:24:08;83116781;82905854;210927;
30.01.2019;00:25:09;83116842;82905872;210970;
30.01.2019;00:26:08;83116917;82905890;211027;
30.01.2019;00:27:07;83116995;82905894;211101;
30.01.2019;00:28:08;83117057;82905913;211144;
30.01.2019;00:29:07;83117127;82905930;211197;
30.01.2019;00:30:08;83117181;82905945;211236;
30.01.2019;00:31:09;83117247;82905957;211290;
30.01.2019;00:32:08;83117315;82905973;211342;
30.01.2019;00:33:16;83117406;82905993;211413;
30.01.2019;00:34:08;83117457;82905999;211458;
30.01.2019;00:35:14;83117536;82906013;211523;
30.01.2019;00:36:09;83117607;82906027;211580;
30.01.2019;00:37:11;83117696;82906050;211646;
30.01.2019;00:38:12;83117786;82906063;211723;
30.01.2019;00:39:09;83117845;82906078;211767;
30.01.2019;00:40:08;83117938;82906093;211845;
30.01.2019;00:41:12;83118050;82906112;211938;
30.01.2019;00:42:07;83118126;82906129;211997;
30.01.2019;00:43:13;83118230;82906144;212086;
30.01.2019;00:44:09;83118306;82906154;212152;
30.01.2019;00:45:09;83118415;82906188;212227;
30.01.2019;00:46:12;83118521;82906206;212315;
30.01.2019;00:47:07;83118582;82906229;212353;
30.01.2019;00:48:08;83118670;82906246;212424;
30.01.2019;00:49:07;83118689;82906228;212461;
30.01.2019;00:50:10;83118771;82906249;212522;
30.01.2019;00:51:08;83118841;82906264;212577;
30.01.2019;00:52:09;83118926;82906282;212644;
30.01.2019;00:53:07;83118999;82906301;212698;
30.01.2019;00:54:07;83119087;82906321;212766;
30.01.2019;00:55:09;83119177;82906344;212833;
30.01.2019;00:56:12;83119290;82906368;212922;
30.01.2019;00:57:17;83119384;82906397;212987;
30.01.2019;00:58:07;83119453;82906425;213028;
30.01.2019;00:59:07;83119573;82906447;213126;
30.01.2019;01:00:06;83119648;82906481;213167;
30.01.2019;01:01:05;83119739;82906486;213253;
30.01.2019;01:02:13;83119834;82906509;213325;
30.01.2019;01:03:04;83119911;82906523;213388;
30.01.2019;01:04:06;83119996;82906553;213443;
30.01.2019;01:05:05;83120079;82906581;213498;
30.01.2019;01:06:05;83120165;82906606;213559;
30.01.2019;01:07:05;83120253;82906646;213607;
30.01.2019;01:08:06;83120323;82906683;213640;
30.01.2019;01:09:10;83120418;82906689;213729;
30.01.2019;01:10:11;83120515;82906709;213806;
30.01.2019;01:11:05;83120602;82906720;213882;
30.01.2019;01:12:08;83120689;82906742;213947;
30.01.2019;01:13:05;83120773;82906768;214005;
30.01.2019;01:14:11;83120852;82906800;214052;
30.01.2019;01:15:06;83120927;82906820;214107;
30.01.2019;01:16:06;83121021;82906834;214187;
30.01.2019;01:17:06;83121115;82906859;214256;
30.01.2019;01:18:06;83121207;82906886;214321;
30.01.2019;01:19:06;83121287;82906918;214369;
30.01.2019;01:20:06;83121379;82906942;214437;
30.01.2019;01:21:06;83121483;82906979;214504;
30.01.2019;01:22:07;83121562;82907010;214552;
30.01.2019;01:23:09;83121631;82907039;214592;
30.01.2019;01:24:05;83121728;82907053;214675;
30.01.2019;01:25:05;83121827;82907091;214736;
30.01.2019;01:26:05;83121919;82907106;214813;
30.01.2019;01:27:05;83121985;82907131;214854;
30.01.2019;01:28:07;83122056;82907151;214905;
30.01.2019;01:29:04;83122149;82907197;214952;
30.01.2019;01:30:05;83122230;82907227;215003;
30.01.2019;01:31:04;83122324;82907253;215071;
30.01.2019;01:32:05;83122398;82907270;215128;
30.01.2019;01:33:11;83122507;82907310;215197;
30.01.2019;01:34:05;83122580;82907343;215237;
30.01.2019;01:35:05;83122653;82907372;215281;
30.01.2019;01:36:04;83122729;82907389;215340;
30.01.2019;01:37:06;83122823;82907426;215397;
30.01.2019;01:38:07;83122911;82907449;215462;
30.01.2019;01:39:07;83122996;82907481;215515;
30.01.2019;01:40:05;83123081;82907501;215580;
30.01.2019;01:41:09;83123176;82907546;215630;
30.01.2019;01:42:06;83123253;82907569;215684;
30.01.2019;01:43:06;83123339;82907602;215737;
30.01.2019;01:44:06;83123436;82907639;215797;
30.01.2019;01:45:05;83123525;82907670;215855;
30.01.2019;01:46:04;83123615;82907711;215904;
30.01.2019;01:47:06;83123710;82907749;215961;
30.01.2019;01:48:06;83123802;82907800;216002;
30.01.2019;01:49:06;83123893;82907841;216052;
30.01.2019;01:50:04;83123985;82907872;216113;
30.01.2019;01:51:06;83124097;82907913;216184;
30.01.2019;01:52:06;83124172;82907945;216227;
30.01.2019;01:53:06;83124259;82907985;216274;
30.01.2019;01:54:05;83124318;82908026;216292;
30.01.2019;01:55:12;83124430;82908062;216368;
30.01.2019;01:56:07;83124508;82908101;216407;
30.01.2019;01:57:05;83124600;82908133;216467;
30.01.2019;01:58:05;83124675;82908187;216488;
30.01.2019;01:59:05;83124775;82908209;216566;
30.01.2019;02:00:04;83124863;82908243;216620;
30.01.2019;02:01:05;83124960;82908294;216666;
30.01.2019;02:02:06;83125045;82908337;216708;
30.01.2019;02:03:04;83125124;82908369;216755;
30.01.2019;02:04:05;83125201;82908422;216779;
30.01.2019;02:05:05;83125297;82908467;216830;
30.01.2019;02:06:06;83125386;82908499;216887;
30.01.2019;02:07:06;83125446;82908565;216881;
30.01.2019;02:08:06;83125504;82908620;216884;
30.01.2019;02:09:08;83125589;82908653;216936;
30.01.2019;02:10:06;83125670;82908690;216980;
30.01.2019;02:11:10;83125743;82908745;216998;
30.01.2019;02:12:06;83125825;82908793;217032;
30.01.2019;02:13:06;83125901;82908835;217066;
30.01.2019;02:14:06;83125989;82908884;217105;
30.01.2019;02:15:06;83126092;82908923;217169;
30.01.2019;02:16:13;83126179;82908964;217215;
30.01.2019;02:17:05;83126259;82908997;217262;
30.01.2019;02:18:06;83126325;82909038;217287;
30.01.2019;02:19:06;83126387;82909064;217323;
30.01.2019;02:20:05;83126468;82909116;217352;
30.01.2019;02:21:10;83126524;82909178;217346;
30.01.2019;02:22:04;83126607;82909227;217380;
30.01.2019;02:23:05;83126657;82909276;217381;
30.01.2019;02:24:06;83126725;82909324;217401;
30.01.2019;02:25:06;83126800;82909369;217431;
30.01.2019;02:26:10;83126874;82909414;217460;
30.01.2019;02:27:05;83126942;82909442;217500;
30.01.2019;02:28:07;83127000;82909516;217484;
30.01.2019;02:29:06;83127083;82909580;217503;
30.01.2019;02:30:06;83127161;82909634;217527;
30.01.2019;02:31:07;83127226;82909692;217534;
30.01.2019;02:32:06;83127316;82909756;217560;
30.01.2019;02:33:04;83127407;82909812;217595;
30.01.2019;02:34:05;83127490;82909866;217624;
30.01.2019;02:35:05;83127575;82909934;217641;
30.01.2019;02:36:10;83127648;82909994;217654;
30.01.2019;02:37:06;83127729;82910044;217685;
30.01.2019;02:38:06;83127798;82910102;217696;
30.01.2019;02:39:06;83127883;82910151;217732;
30.01.2019;02:40:05;83127980;82910204;217776;
30.01.2019;02:41:11;83128077;82910278;217799;
30.01.2019;02:42:06;83128170;82910342;217828;
30.01.2019;02:43:05;83128256;82910413;217843;
30.01.2019;02:44:05;83128339;82910468;217871;
30.01.2019;02:45:06;83128435;82910528;217907;
30.01.2019;02:46:07;83128515;82910590;217925;
30.01.2019;02:47:07;83128598;82910660;217938;
30.01.2019;02:48:05;83128683;82910715;217968;
30.01.2019;02:49:05;83128768;82910773;217995;
30.01.2019;02:50:09;83128843;82910850;217993;
30.01.2019;02:51:06;83128944;82910906;218038;
30.01.2019;02:52:07;83129037;82910980;218057;
30.01.2019;02:53:04;83129125;82911065;218060;
30.01.2019;02:54:06;83129220;82911144;218076;
30.01.2019;02:55:05;83129328;82911205;218123;
30.01.2019;02:56:04;83129410;82911280;218130;
30.01.2019;02:57:05;83129508;82911344;218164;
30.01.2019;02:58:05;83129594;82911420;218174;
30.01.2019;02:59:05;83129683;82911486;218197;
30.01.2019;03:00:06;83129771;82911551;218220;
30.01.2019;03:01:05;83129846;82911625;218221;
30.01.2019;03:02:05;83129923;82911702;218221;
30.01.2019;03:03:04;83130009;82911791;218218;
30.01.2019;03:04:04;83130113;82911862;218251;
30.01.2019;03:05:06;83130207;82911948;218259;
30.01.2019;03:06:09;83130293;82912031;218262;
30.01.2019;03:07:05;83130385;82912119;218266;
30.01.2019;03:08:11;83130472;82912200;218272;
30.01.2019;03:09:05;83130529;82912272;218257;
30.01.2019;03:10:05;83130620;82912347;218273;
30.01.2019;03:11:04;83130710;82912431;218279;
30.01.2019;03:12:06;83130812;82912504;218308;
30.01.2019;03:13:05;83130898;82912580;218318;
30.01.2019;03:14:10;83131017;82912681;218336;
30.01.2019;03:15:09;83131119;82912791;218328;
30.01.2019;03:16:10;83131237;82912872;218365;
30.01.2019;03:17:06;83131310;82912957;218353;
30.01.2019;03:18:05;83131410;82913035;218375;
30.01.2019;03:19:04;83131521;82913135;218386;
30.01.2019;03:20:05;83131623;82913217;218406;
30.01.2019;03:21:05;83131703;82913315;218388;
30.01.2019;03:22:05;83131795;82913416;218379;
30.01.2019;03:23:04;83131884;82913489;218395;
30.01.2019;03:24:04;83131977;82913576;218401;
30.01.2019;03:25:06;83132081;82913644;218437;
30.01.2019;03:26:06;83132171;82913728;218443;
30.01.2019;03:27:06;83132277;82913812;218465;
30.01.2019;03:28:05;83132356;82913908;218448;
30.01.2019;03:29:06;83132429;82914007;218422;
30.01.2019;03:30:06;83132546;82914092;218454;
30.01.2019;03:31:05;83132644;82914191;218453;
30.01.2019;03:32:04;83132757;82914273;218484;
30.01.2019;03:33:07;83132865;82914363;218502;
30.01.2019;03:34:05;83132961;82914435;218526;
30.01.2019;03:35:05;83133054;82914524;218530;
30.01.2019;03:36:04;83133152;82914604;218548;
30.01.2019;03:37:06;83133267;82914696;218571;
30.01.2019;03:38:05;83133366;82914802;218564;
30.01.2019;03:39:08;83133469;82914875;218594;
30.01.2019;03:40:08;83133556;82914973;218583;
30.01.2019;03:41:06;83133639;82915076;218563;
30.01.2019;03:42:05;83133739;82915180;218559;
30.01.2019;03:43:05;83133808;82915283;218525;
30.01.2019;03:44:06;83133868;82915372;218496;
30.01.2019;03:45:06;83133958;82915468;218490;
30.01.2019;03:46:05;83134056;82915569;218487;
30.01.2019;03:47:06;83134171;82915655;218516;
30.01.2019;03:48:05;83134257;82915732;218525;
30.01.2019;03:49:11;83134361;82915835;218526;
30.01.2019;03:50:06;83134455;82915892;218563;
30.01.2019;03:51:07;83134509;82915957;218552;
30.01.2019;03:52:07;83134626;82916055;218571;
30.01.2019;03:53:06;83134708;82916153;218555;
30.01.2019;03:54:05;83134804;82916197;218607;
30.01.2019;03:55:05;83134890;82916324;218566;
30.01.2019;03:56:06;83134986;82916420;218566;
30.01.2019;03:57:10;83135082;82916510;218572;
30.01.2019;03:58:05;83135189;82916586;218603;
30.01.2019;03:59:05;83135283;82916678;218605;
30.01.2019;04:00:05;83135369;82916787;218582;
30.01.2019;04:01:06;83135470;82916889;218581;
30.01.2019;04:02:05;83135569;82916981;218588;
30.01.2019;04:03:06;83135679;82917072;218607;
30.01.2019;04:04:06;83135772;82917161;218611;
30.01.2019;04:05:04;83135860;82917251;218609;
30.01.2019;04:06:05;83135960;82917349;218611;
30.01.2019;04:07:16;83136044;82917474;218570;
30.01.2019;04:08:04;83136152;82917552;218600;
30.01.2019;04:09:06;83136240;82917645;218595;
30.01.2019;04:10:11;83136352;82917762;218590;
30.01.2019;04:11:11;83136475;82917852;218623;
30.01.2019;04:12:04;83136558;82917927;218631;
30.01.2019;04:13:04;83136657;82918012;218645;
30.01.2019;04:14:06;83136761;82918094;218667;
30.01.2019;04:15:04;83136858;82918186;218672;
30.01.2019;04:16:06;83136955;82918300;218655;
30.01.2019;04:17:06;83137058;82918417;218641;
30.01.2019;04:18:05;83137140;82918505;218635;
30.01.2019;04:19:06;83137226;82918612;218614;
30.01.2019;04:20:04;83137307;82918700;218607;
30.01.2019;04:21:06;83137389;82918800;218589;
30.01.2019;04:22:11;83137497;82918910;218587;
30.01.2019;04:23:05;83137588;82918996;218592;
30.01.2019;04:24:10;83137661;82919087;218574;
30.01.2019;04:25:11;83137765;82919190;218575;
30.01.2019;04:26:11;83137835;82919290;218545;
30.01.2019;04:27:05;83137888;82919379;218509;
30.01.2019;04:28:09;83137975;82919483;218492;
30.01.2019;04:29:05;83138037;82919575;218462;
30.01.2019;04:30:04;83138126;82919659;218467;
30.01.2019;04:31:11;83138213;82919777;218436;
30.01.2019;04:32:05;83138296;82919866;218430;
30.01.2019;04:33:06;83138384;82919982;218402;
30.01.2019;04:34:06;83138462;82920067;218395;
30.01.2019;04:35:06;83138557;82920149;218408;
30.01.2019;04:36:05;83138643;82920253;218390;
30.01.2019;04:37:06;83138736;82920351;218385;
30.01.2019;04:38:05;83138822;82920429;218393;
30.01.2019;04:39:05;83138920;82920542;218378;
30.01.2019;04:40:07;83139015;82920645;218370;
30.01.2019;04:41:04;83139091;82920742;218349;
30.01.2019;04:42:05;83139181;82920834;218347;
30.01.2019;04:43:11;83139290;82920958;218332;
30.01.2019;04:44:05;83139384;82921039;218345;
30.01.2019;04:45:06;83139484;82921128;218356;
30.01.2019;04:46:06;83139574;82921232;218342;
30.01.2019;04:47:06;83139684;82921343;218341;
30.01.2019;04:48:11;83139784;82921467;218317;
30.01.2019;04:49:05;83139860;82921564;218296;
30.01.2019;04:50:06;83139952;82921669;218283;
30.01.2019;04:52:05;83140146;82921866;218280;
30.01.2019;04:53:05;83140220;82921971;218249;
30.01.2019;04:54:08;83140306;82922075;218231;
30.01.2019;04:55:06;83140382;82922172;218210;
30.01.2019;04:56:06;83140491;82922284;218207;
30.01.2019;04:57:06;83140565;82922395;218170;
30.01.2019;04:58:05;83140676;82922510;218166;
30.01.2019;04:59:05;83140760;82922611;218149;
30.01.2019;05:00:06;83140862;82922704;218158;
30.01.2019;05:01:07;83140980;82922813;218167;
30.01.2019;05:02:04;83141068;82922909;218159;
30.01.2019;05:03:06;83141178;82923009;218169;
30.01.2019;05:04:08;83141281;82923113;218168;
30.01.2019;05:05:06;83141374;82923225;218149;
30.01.2019;05:06:05;83141451;82923316;218135;
30.01.2019;05:07:05;83141539;82923427;218112;
30.01.2019;05:08:06;83141610;82923529;218081;
30.01.2019;05:09:06;83141706;82923634;218072;
30.01.2019;05:10:10;83141803;82923756;218047;
30.01.2019;05:11:05;83141877;82923835;218042;
30.01.2019;05:12:06;83141981;82923914;218067;
30.01.2019;05:13:06;83142061;82924043;218018;
30.01.2019;05:14:06;83142144;82924132;218012;
30.01.2019;05:15:05;83142239;82924239;218000;
30.01.2019;05:16:05;83142300;82924328;217972;
30.01.2019;05:17:11;83142406;82924442;217964;
30.01.2019;05:18:07;83142491;82924544;217947;
30.01.2019;05:19:10;83142580;82924653;217927;
30.01.2019;05:20:06;83142685;82924750;217935;
30.01.2019;05:21:06;83142774;82924846;217928;
30.01.2019;05:22:05;83142867;82924956;217911;
30.01.2019;05:23:06;83142965;82925073;217892;
30.01.2019;05:24:04;83143035;82925175;217860;
30.01.2019;05:25:04;83143107;82925258;217849;
30.01.2019;05:26:05;83143211;82925361;217850;
30.01.2019;05:27:05;83143291;82925459;217832;
30.01.2019;05:28:05;83143365;82925561;217804;
30.01.2019;05:29:05;83143473;82925681;217792;
30.01.2019;05:30:04;83143555;82925778;217777;
30.01.2019;05:31:05;83143644;82925868;217776;
30.01.2019;05:32:04;83143738;82925975;217763;
30.01.2019;05:33:04;83143828;82926086;217742;
30.01.2019;05:34:04;83143899;82926182;217717;
30.01.2019;05:35:05;83143993;82926281;217712;
30.01.2019;05:36:05;83144066;82926379;217687;
30.01.2019;05:37:04;83144154;82926471;217683;
30.01.2019;05:38:04;83144243;82926556;217687;
30.01.2019;05:39:04;83144326;82926645;217681;
30.01.2019;05:40:05;83144408;82926767;217641;
30.01.2019;05:41:04;83144483;82926875;217608;
30.01.2019;05:42:05;83144583;82926981;217602;
30.01.2019;05:43:06;83144665;82927062;217603;
30.01.2019;05:44:04;83144748;82927146;217602;
30.01.2019;05:45:05;83144841;82927247;217594;
30.01.2019;05:46:04;83144912;82927357;217555;
30.01.2019;05:47:04;83144996;82927461;217535;
30.01.2019;05:48:05;83145075;82927565;217510;
30.01.2019;05:49:05;83145158;82927669;217489;
30.01.2019;05:50:04;83145262;82927777;217485;
30.01.2019;05:51:04;83145339;82927883;217456;
30.01.2019;05:52:05;83145432;82927982;217450;
30.01.2019;05:53:05;83145515;82928111;217404;
30.01.2019;05:54:05;83145572;82928216;217356;
30.01.2019;05:55:04;83145648;82928289;217359;
30.01.2019;05:56:05;83145737;82928402;217335;
30.01.2019;05:57:05;83145829;82928509;217320;
30.01.2019;05:58:05;83145911;82928612;217299;
30.01.2019;05:59:04;83145994;82928722;217272;
30.01.2019;06:00:04;83146054;82928814;217240;
30.01.2019;06:01:05;83146121;82928910;217211;
30.01.2019;06:02:04;83146199;82929003;217196;
30.01.2019;06:03:04;83146282;82929105;217177;
30.01.2019;06:04:04;83146354;82929207;217147;
30.01.2019;06:05:05;83146434;82929323;217111;
30.01.2019;06:06:05;83146492;82929422;217070;
30.01.2019;06:07:05;83146600;82929526;217074;
30.01.2019;06:08:05;83146659;82929633;217026;
30.01.2019;06:09:06;83146735;82929759;216976;
30.01.2019;06:10:04;83146808;82929867;216941;
30.01.2019;06:11:06;83146876;82929980;216896;
30.01.2019;06:12:04;83146951;82930055;216896;
30.01.2019;06:13:04;83147010;82930165;216845;
30.01.2019;06:14:05;83147065;82930253;216812;
30.01.2019;06:15:04;83147128;82930348;216780;
30.01.2019;06:16:04;83147167;82930449;216718;
30.01.2019;06:17:05;83147210;82930565;216645;
30.01.2019;06:18:04;83147251;82930672;216579;
30.01.2019;06:19:05;83147327;82930764;216563;
30.01.2019;06:20:04;83147392;82930858;216534;
30.01.2019;06:21:04;83147451;82930962;216489;
30.01.2019;06:22:05;83147517;82931078;216439;
30.01.2019;06:23:10;83147587;82931192;216395;
30.01.2019;06:24:05;83147638;82931263;216375;
30.01.2019;06:25:08;83147710;82931365;216345;
30.01.2019;06:26:05;83147770;82931452;216318;
30.01.2019;06:27:05;83147829;82931569;216260;
30.01.2019;06:28:04;83147915;82931662;216253;
30.01.2019;06:29:04;83147987;82931767;216220;
30.01.2019;06:30:05;83148054;82931865;216189;
30.01.2019;06:31:04;83148132;82931956;216176;
30.01.2019;06:32:04;83148212;82932053;216159;
30.01.2019;06:33:05;83148287;82932165;216122;
30.01.2019;06:34:06;83148372;82932256;216116;
30.01.2019;06:35:04;83148428;82932369;216059;
30.01.2019;06:36:04;83148490;82932470;216020;
30.01.2019;06:37:05;83148578;82932565;216013;
30.01.2019;06:38:07;83148646;82932684;215962;
30.01.2019;06:39:10;83148710;82932798;215912;
30.01.2019;06:40:10;83148793;82932901;215892;
30.01.2019;06:41:05;83148855;82932972;215883;
30.01.2019;06:42:06;83148922;82933079;215843;
30.01.2019;06:43:05;83148982;82933192;215790;
30.01.2019;06:44:04;83149049;82933293;215756;
30.01.2019;06:45:04;83149124;82933402;215722;
30.01.2019;06:46:05;83149188;82933500;215688;
30.01.2019;06:47:05;83149267;82933606;215661;
30.01.2019;06:48:10;83149338;82933732;215606;
30.01.2019;06:49:05;83149405;82933837;215568;
30.01.2019;06:50:04;83149473;82933940;215533;
30.01.2019;06:51:04;83149540;82934030;215510;
30.01.2019;06:52:04;83149601;82934143;215458;
30.01.2019;06:53:04;83149680;82934269;215411;
30.01.2019;06:54:04;83149745;82934363;215382;
30.01.2019;06:55:05;83149811;82934474;215337;
30.01.2019;06:56:04;83149892;82934579;215313;
30.01.2019;06:57:05;83149964;82934690;215274;
30.01.2019;06:58:05;83150021;82934795;215226;
30.01.2019;06:59:04;83150020;82934880;215140;
30.01.2019;07:00:05;83150087;82934990;215097;
30.01.2019;07:01:05;83150157;82935102;215055;
30.01.2019;07:02:05;83150206;82935204;215002;
30.01.2019;07:03:04;83150265;82935307;214958;
30.01.2019;07:04:05;83150301;82935398;214903;
30.01.2019;07:05:05;83150383;82935491;214892;
30.01.2019;07:06:04;83150460;82935616;214844;
30.01.2019;07:07:04;83150526;82935704;214822;
30.01.2019;07:08:05;83150600;82935815;214785;
30.01.2019;07:09:04;83150663;82935903;214760;
30.01.2019;07:10:05;83150736;82935990;214746;
30.01.2019;07:11:05;83150811;82936066;214745;
30.01.2019;07:12:04;83150885;82936142;214743;
30.01.2019;07:13:05;83150944;82936212;214732;
30.01.2019;07:14:04;83151012;82936305;214707;
30.01.2019;07:15:04;83151090;82936403;214687;
30.01.2019;07:16:04;83151158;82936493;214665;
30.01.2019;07:17:05;83151224;82936575;214649;
30.01.2019;07:18:05;83151302;82936674;214628;
30.01.2019;07:19:04;83151355;82936774;214581;
30.01.2019;07:20:05;83151445;82936878;214567;
30.01.2019;07:21:10;83151531;82936961;214570;
30.01.2019;07:22:05;83151588;82937055;214533;
30.01.2019;07:23:04;83151664;82937150;214514;
30.01.2019;07:24:04;83151729;82937257;214472;
30.01.2019;07:25:05;83151794;82937361;214433;
30.01.2019;07:26:04;83151842;82937458;214384;
30.01.2019;07:27:04;83151900;82937540;214360;
30.01.2019;07:28:05;83151951;82937655;214296;
30.01.2019;07:29:05;83152006;82937766;214240;
30.01.2019;07:30:04;83152074;82937851;214223;
30.01.2019;07:31:05;83152127;82937939;214188;
30.01.2019;07:32:17;83152198;82938052;214146;
30.01.2019;07:33:27;83152281;82938164;214117;
30.01.2019;07:34:04;83152342;82938238;214104;
30.01.2019;07:35:04;83152420;82938344;214076;
30.01.2019;07:36:05;83152484;82938461;214023;
30.01.2019;07:37:05;83152537;82938566;213971;
30.01.2019;07:38:05;83152606;82938665;213941;
30.01.2019;07:39:04;83152658;82938763;213895;
30.01.2019;07:40:04;83152720;82938855;213865;
30.01.2019;07:41:05;83152800;82938976;213824;
30.01.2019;07:42:05;83152881;82939084;213797;
30.01.2019;07:43:05;83152950;82939181;213769;
30.01.2019;07:44:05;83152999;82939289;213710;
30.01.2019;07:45:04;83153053;82939397;213656;
30.01.2019;07:46:08;83153112;82939514;213598;
30.01.2019;07:47:08;83153170;82939594;213576;
30.01.2019;07:48:04;83153237;82939703;213534;
30.01.2019;07:49:04;83153303;82939797;213506;
30.01.2019;07:50:05;83153379;82939923;213456;
30.01.2019;07:51:04;83153439;82940021;213418;
30.01.2019;07:52:04;83153495;82940118;213377;
30.01.2019;07:53:10;83153588;82940238;213350;
30.01.2019;07:54:04;83153638;82940324;213314;
30.01.2019;07:55:04;83153705;82940414;213291;
30.01.2019;07:56:08;83153768;82940522;213246;
30.01.2019;07:57:04;83153821;82940620;213201;
30.01.2019;07:58:05;83153888;82940724;213164;
30.01.2019;07:59:05;83153946;82940806;213140;
30.01.2019;08:00:04;83154006;82940905;213101;
30.01.2019;08:01:04;83154065;82941023;213042;
30.01.2019;08:02:04;83154134;82941111;213023;
30.01.2019;08:03:06;83154189;82941212;212977;
30.01.2019;08:04:04;83154252;82941299;212953;
30.01.2019;08:05:05;83154311;82941409;212902;
30.01.2019;08:06:05;83154383;82941523;212860;
30.01.2019;08:07:05;83154431;82941633;212798;
30.01.2019;08:08:04;83154513;82941722;212791;
30.01.2019;08:09:05;83154575;82941806;212769;
30.01.2019;08:10:09;83154642;82941931;212711;
30.01.2019;08:11:05;83154698;82942037;212661;
30.01.2019;08:12:04;83154756;82942146;212610;
30.01.2019;08:13:04;83154831;82942238;212593;
30.01.2019;08:14:05;83154905;82942358;212547;
30.01.2019;08:15:04;83154959;82942449;212510;
30.01.2019;08:16:04;83155009;82942540;212469;
30.01.2019;08:17:05;83155039;82942623;212416;
30.01.2019;08:18:05;83155090;82942721;212369;
30.01.2019;08:19:04;83155140;82942817;212323;
30.01.2019;08:20:05;83155201;82942906;212295;
30.01.2019;08:21:04;83155252;82943008;212244;
30.01.2019;08:22:04;83155301;82943104;212197;
30.01.2019;08:23:05;83155367;82943203;212164;
30.01.2019;08:24:04;83155415;82943289;212126;
30.01.2019;08:25:04;83155468;82943393;212075;
30.01.2019;08:26:04;83155503;82943477;212026;
30.01.2019;08:27:05;83155548;82943561;211987;
30.01.2019;08:28:05;83155592;82943659;211933;
30.01.2019;08:29:04;83155673;82943762;211911;
30.01.2019;08:30:04;83155740;82943864;211876;
30.01.2019;08:31:04;83155793;82943965;211828;
30.01.2019;08:32:05;83155854;82944064;211790;
30.01.2019;08:33:04;83155909;82944162;211747;
30.01.2019;08:34:05;83155967;82944249;211718;
30.01.2019;08:35:05;83156019;82944321;211698;
30.01.2019;08:36:05;83156067;82944420;211647;
30.01.2019;08:37:04;83156122;82944534;211588;
30.01.2019;08:38:05;83156177;82944607;211570;
30.01.2019;08:39:06;83156233;82944711;211522;
30.01.2019;08:40:04;83156293;82944830;211463;
30.01.2019;08:41:05;83156354;82944915;211439;
30.01.2019;08:42:04;83156403;82945000;211403;
30.01.2019;08:43:04;83156462;82945105;211357;
30.01.2019;08:44:05;83156528;82945213;211315;
30.01.2019;08:45:05;83156582;82945307;211275;
30.01.2019;08:46:04;83156653;82945418;211235;
30.01.2019;08:47:05;83156710;82945559;211151;
30.01.2019;08:48:04;83156762;82945659;211103;
30.01.2019;08:49:06;83156819;82945783;211036;
30.01.2019;08:50:05;83156886;82945897;210989;
30.01.2019;08:51:04;83156942;82945996;210946;
30.01.2019;08:52:04;83157011;82946098;210913;
30.01.2019;08:53:05;83157059;82946231;210828;
30.01.2019;08:54:05;83157130;82946329;210801;
30.01.2019;08:55:04;83157221;82946445;210776;
30.01.2019;08:56:04;83157294;82946564;210730;
30.01.2019;08:57:07;83157349;82946677;210672;
30.01.2019;08:58:11;83157401;82946794;210607;
30.01.2019;08:59:04;83157466;82946869;210597;
30.01.2019;09:00:05;83157529;82946975;210554;
30.01.2019;09:01:05;83157607;82947085;210522;
30.01.2019;09:02:04;83157676;82947192;210484;
30.01.2019;09:03:06;83157761;82947296;210465;
30.01.2019;09:04:05;83157822;82947394;210428;
30.01.2019;09:05:04;83157885;82947497;210388;
30.01.2019;09:06:06;83157943;82947608;210335;
30.01.2019;09:07:05;83158003;82947718;210285;
30.01.2019;09:08:04;83158064;82947814;210250;
30.01.2019;09:09:04;83158116;82947919;210197;
30.01.2019;09:10:05;83158185;82948061;210124;
30.01.2019;09:11:04;83158258;82948179;210079;
30.01.2019;09:12:04;83158307;82948279;210028;
30.01.2019;09:13:05;83158373;82948385;209988;
30.01.2019;09:14:04;83158437;82948494;209943;
30.01.2019;09:15:04;83158485;82948609;209876;
30.01.2019;09:16:06;83158548;82948739;209809;
30.01.2019;09:17:05;83158615;82948858;209757;
30.01.2019;09:18:04;83158679;82948958;209721;
30.01.2019;09:19:04;83158730;82949070;209660;
30.01.2019;09:20:05;83158792;82949167;209625;
30.01.2019;09:21:04;83158841;82949294;209547;
30.01.2019;09:22:04;83158888;82949410;209478;
30.01.2019;09:23:05;83158947;82949510;209437;
30.01.2019;09:24:04;83159010;82949619;209391;
30.01.2019;09:25:04;83159066;82949724;209342;
30.01.2019;09:26:05;83159122;82949836;209286;
30.01.2019;09:27:04;83159196;82949932;209264;
30.01.2019;09:28:04;83159239;82950056;209183;
30.01.2019;09:29:05;83159302;82950170;209132;
30.01.2019;09:30:04;83159366;82950272;209094;
30.01.2019;09:31:04;83159421;82950384;209037;
30.01.2019;09:32:05;83159495;82950492;209003;
30.01.2019;09:33:05;83159546;82950587;208959;
30.01.2019;09:34:04;83159604;82950690;208914;
30.01.2019;09:35:05;83159660;82950793;208867;
30.01.2019;09:36:05;83159732;82950896;208836;
30.01.2019;09:37:05;83159771;82950986;208785;
30.01.2019;09:38:05;83159838;82951083;208755;
30.01.2019;09:39:07;83159900;82951190;208710;
30.01.2019;09:40:04;83159951;82951305;208646;
30.01.2019;09:41:04;83159999;82951413;208586;
30.01.2019;09:42:05;83160055;82951521;208534;
30.01.2019;09:43:04;83160120;82951640;208480;
30.01.2019;09:44:04;83160169;82951765;208404;
30.01.2019;09:45:05;83160233;82951876;208357;
30.01.2019;09:46:05;83160292;82951994;208298;
30.01.2019;09:47:05;83160345;82952110;208235;
30.01.2019;09:48:09;83160405;82952232;208173;
30.01.2019;09:49:04;83160456;82952351;208105;
30.01.2019;09:50:05;83160509;82952461;208048;
30.01.2019;09:51:04;83160561;82952559;208002;
30.01.2019;09:52:04;83160613;82952674;207939;
30.01.2019;09:53:06;83160658;82952736;207922;
30.01.2019;09:54:05;83160683;82952822;207861;
30.01.2019;09:55:05;83160743;82952944;207799;
30.01.2019;09:56:04;83160786;82953059;207727;
30.01.2019;09:57:04;83160838;82953188;207650;
30.01.2019;09:58:06;83160885;82953292;207593;
30.01.2019;09:59:06;83160953;82953395;207558;
30.01.2019;10:00:05;83161007;82953482;207525;
30.01.2019;10:01:04;83161083;82953622;207461;
30.01.2019;10:02:04;83161133;82953726;207407;
30.01.2019;10:03:05;83161188;82953838;207350;
30.01.2019;10:04:04;83161231;82953950;207281;
30.01.2019;10:05:04;83161280;82954069;207211;
30.01.2019;10:06:05;83161330;82954184;207146;
30.01.2019;10:07:04;83161378;82954302;207076;
30.01.2019;10:08:04;83161441;82954431;207010;
30.01.2019;10:09:06;83161511;82954566;206945;
30.01.2019;10:10:05;83161571;82954661;206910;
30.01.2019;10:11:05;83161630;82954774;206856;
30.01.2019;10:12:04;83161689;82954878;206811;
30.01.2019;10:13:05;83161762;82954985;206777;
30.01.2019;10:14:05;83161824;82955071;206753;
30.01.2019;10:15:06;83161871;82955200;206671;
30.01.2019;10:16:04;83161915;82955317;206598;
30.01.2019;10:17:04;83161977;82955415;206562;
30.01.2019;10:18:04;83162030;82955526;206504;
30.01.2019;10:19:04;83162075;82955648;206427;
30.01.2019;10:20:04;83162108;82955737;206371;
30.01.2019;10:21:05;83162145;82955831;206314;
30.01.2019;10:22:04;83162211;82955949;206262;
30.01.2019;10:23:04;83162260;82956056;206204;
30.01.2019;10:24:05;83162302;82956162;206140;
30.01.2019;10:25:05;83162330;82956275;206055;
30.01.2019;10:26:04;83162403;82956398;206005;
30.01.2019;10:27:04;83162452;82956514;205938;
30.01.2019;10:28:04;83162487;82956623;205864;
30.01.2019;10:29:04;83162512;82956720;205792;
30.01.2019;10:30:05;83162551;82956836;205715;
30.01.2019;10:31:05;83162588;82956900;205688;
30.01.2019;10:32:04;83162613;82957056;205557;
30.01.2019;10:33:04;83162672;82957162;205510;
30.01.2019;10:34:11;83162715;82957281;205434;
30.01.2019;10:35:05;83162793;82957403;205390;
30.01.2019;10:36:04;83162851;82957497;205354;
30.01.2019;10:37:06;83162891;82957608;205283;
30.01.2019;10:38:05;83162936;82957709;205227;
30.01.2019;10:39:06;83162997;82957803;205194;
30.01.2019;10:40:05;83163046;82957911;205135;
30.01.2019;10:41:04;83163096;82958000;205096;
30.01.2019;10:42:05;83163141;82958111;205030;
30.01.2019;10:43:06;83163188;82958237;204951;
30.01.2019;10:44:04;83163249;82958366;204883;
30.01.2019;10:45:04;83163302;82958467;204835;
30.01.2019;10:46:06;83163347;82958591;204756;
30.01.2019;10:47:11;83163408;82958682;204726;
30.01.2019;10:48:04;83163476;82958785;204691;
30.01.2019;10:49:05;83163535;82958904;204631;
30.01.2019;10:50:05;83163584;82959017;204567;
30.01.2019;10:51:04;83163651;82959135;204516;
30.01.2019;10:52:06;83163694;82959268;204426;
30.01.2019;10:53:05;83163754;82959369;204385;
30.01.2019;10:54:04;83163813;82959502;204311;
30.01.2019;10:55:05;83163884;82959599;204285;
30.01.2019;10:56:04;83163948;82959709;204239;
30.01.2019;10:57:04;83164011;82959841;204170;
30.01.2019;10:58:05;83164045;82959981;204064;
30.01.2019;10:59:04;83164120;82960102;204018;
30.01.2019;11:00:04;83164173;82960213;203960;
30.01.2019;11:01:05;83164224;82960335;203889;
30.01.2019;11:02:04;83164267;82960441;203826;
30.01.2019;11:03:05;83164310;82960575;203735;
30.01.2019;11:04:05;83164367;82960670;203697;
30.01.2019;11:05:04;83164423;82960787;203636;
30.01.2019;11:06:05;83164475;82960921;203554;
30.01.2019;11:07:05;83164530;82961044;203486;
30.01.2019;11:08:04;83164586;82961161;203425;
30.01.2019;11:09:05;83164654;82961266;203388;
30.01.2019;11:10:05;83164704;82961394;203310;
30.01.2019;11:11:04;83164773;82961545;203228;
30.01.2019;11:12:04;83164823;82961649;203174;
30.01.2019;11:13:05;83164881;82961755;203126;
30.01.2019;11:14:05;83164933;82961889;203044;
30.01.2019;11:15:04;83164993;82962025;202968;
30.01.2019;11:16:05;83165044;82962141;202903;
30.01.2019;11:17:04;83165083;82962245;202838;
30.01.2019;11:18:04;83165144;82962360;202784;
30.01.2019;11:19:05;83165198;82962462;202736;
30.01.2019;11:20:05;83165262;82962600;202662;
30.01.2019;11:21:04;83165329;82962733;202596;
30.01.2019;11:22:05;83165399;82962844;202555;
30.01.2019;11:23:04;83165465;82962949;202516;
30.01.2019;11:24:04;83165514;82963077;202437;
30.01.2019;11:25:05;83165557;82963182;202375;
30.01.2019;11:26:04;83165610;82963296;202314;
30.01.2019;11:27:04;83165664;82963401;202263;
30.01.2019;11:28:06;83165703;82963525;202178;
30.01.2019;11:29:09;83165769;82963629;202140;
30.01.2019;11:30:06;83165831;82963731;202100;
30.01.2019;11:31:04;83165898;82963852;202046;
30.01.2019;11:32:04;83165944;82963955;201989;
30.01.2019;11:33:05;83165988;82964091;201897;
30.01.2019;11:34:05;83166050;82964221;201829;
30.01.2019;11:35:10;83166122;82964342;201780;
30.01.2019;11:36:04;83166166;82964401;201765;
30.01.2019;11:37:05;83166226;82964500;201726;
30.01.2019;11:38:05;83166282;82964607;201675;
30.01.2019;11:39:05;83166339;82964711;201628;
30.01.2019;11:40:06;83166389;82964802;201587;
30.01.2019;11:41:04;83166448;82964886;201562;
30.01.2019;11:42:04;83166514;82964965;201549;
30.01.2019;11:43:05;83166580;82965084;201496;
30.01.2019;11:44:05;83166640;82965192;201448;
30.01.2019;11:45:04;83166711;82965295;201416;
30.01.2019;11:46:05;83166768;82965383;201385;
30.01.2019;11:47:05;83166837;82965476;201361;
30.01.2019;11:48:09;83166891;82965609;201282;
30.01.2019;11:49:04;83166976;82965727;201249;
30.01.2019;11:50:05;83167053;82965847;201206;
30.01.2019;11:51:04;83167109;82965953;201156;
30.01.2019;11:52:04;83167166;82966080;201086;
30.01.2019;11:53:05;83167237;82966191;201046;
30.01.2019;11:54:04;83167300;82966302;200998;
30.01.2019;11:55:04;83167364;82966405;200959;
30.01.2019;11:56:05;83167416;82966494;200922;
30.01.2019;11:57:04;83167468;82966586;200882;
30.01.2019;11:58:04;83167544;82966686;200858;
30.01.2019;11:59:05;83167597;82966805;200792;
30.01.2019;12:00:04;83167670;82966934;200736;
30.01.2019;12:01:04;83167741;82967046;200695;
30.01.2019;12:02:05;83167796;82967144;200652;
30.01.2019;12:03:04;83167828;82967268;200560;
30.01.2019;12:04:05;83167894;82967387;200507;
30.01.2019;12:05:05;83167960;82967491;200469;
30.01.2019;12:06:04;83168016;82967608;200408;
30.01.2019;12:07:04;83168078;82967705;200373;
30.01.2019;12:08:05;83168134;82967824;200310;
30.01.2019;12:09:06;83168211;82967947;200264;
30.01.2019;12:10:04;83168281;82968060;200221;
30.01.2019;12:11:05;83168337;82968182;200155;
30.01.2019;12:12:04;83168395;82968290;200105;
30.01.2019;12:13:04;83168425;82968405;200020;
30.01.2019;12:14:04;83168463;82968501;199962;
30.01.2019;12:15:04;83168501;82968597;199904;
30.01.2019;12:16:05;83168532;82968670;199862;
30.01.2019;12:17:05;83168572;82968775;199797;
30.01.2019;12:18:04;83168607;82968866;199741;
30.01.2019;12:19:04;83168649;82968975;199674;
30.01.2019;12:20:05;83168682;82969070;199612;
30.01.2019;12:21:04;83168729;82969165;199564;
30.01.2019;12:22:04;83168795;82969253;199542;
30.01.2019;12:23:04;83168839;82969355;199484;
30.01.2019;12:24:05;83168894;82969468;199426;
30.01.2019;12:25:04;83168952;82969573;199379;
30.01.2019;12:26:04;83169019;82969663;199356;
30.01.2019;12:27:05;83169072;82969765;199307;
30.01.2019;12:28:04;83169145;82969868;199277;
30.01.2019;12:29:04;83169216;82969979;199237;
30.01.2019;12:30:05;83169281;82970082;199199;
30.01.2019;12:31:04;83169341;82970180;199161;
30.01.2019;12:32:05;83169417;82970308;199109;
30.01.2019;12:33:04;83169470;82970418;199052;
30.01.2019;12:34:04;83169531;82970536;198995;
30.01.2019;12:35:05;83169590;82970656;198934;
30.01.2019;12:36:04;83169649;82970756;198893;
30.01.2019;12:37:04;83169713;82970871;198842;
30.01.2019;12:38:05;83169771;82970983;198788;
30.01.2019;12:39:06;83169844;82971108;198736;
30.01.2019;12:40:04;83169907;82971207;198700;
30.01.2019;12:41:05;83169975;82971325;198650;
30.01.2019;12:42:04;83170047;82971436;198611;
30.01.2019;12:43:04;83170112;82971606;198506;
30.01.2019;12:44:05;83170168;82971712;198456;
30.01.2019;12:45:05;83170208;82971835;198373;
30.01.2019;12:46:04;83170296;82971970;198326;
30.01.2019;12:47:04;83170358;82972075;198283;
30.01.2019;12:48:04;83170452;82972197;198255;
30.01.2019;12:49:06;83170540;82972311;198229;
30.01.2019;12:50:05;83170612;82972457;198155;
30.01.2019;12:51:05;83170654;82972552;198102;
30.01.2019;12:52:05;83170475;82972474;198001;
30.01.2019;12:53:05;83170155;82972256;197899;
30.01.2019;12:54:04;83170226;82972357;197869;
30.01.2019;12:55:05;83170293;82972473;197820;
30.01.2019;12:56:06;83170376;82972576;197800;
30.01.2019;12:57:04;83170454;82972667;197787;
30.01.2019;12:58:04;83170503;82972781;197722;
30.01.2019;12:59:11;83170589;82972901;197688;
30.01.2019;13:00:05;83170649;82973018;197631;
30.01.2019;13:01:04;83170699;82973135;197564;
30.01.2019;13:02:04;83170775;82973286;197489;
30.01.2019;13:03:05;83170849;82973403;197446;
30.01.2019;13:04:04;83170906;82973514;197392;
30.01.2019;13:05:04;83170991;82973638;197353;
30.01.2019;13:06:05;83171056;82973762;197294;
30.01.2019;13:07:04;83171145;82973889;197256;
30.01.2019;13:08:04;83171218;82973989;197229;
30.01.2019;13:09:06;83171290;82974130;197160;
30.01.2019;13:10:04;83171367;82974256;197111;
30.01.2019;13:11:05;83171437;82974392;197045;
30.01.2019;13:12:04;83171506;82974512;196994;
30.01.2019;13:13:05;83171598;82974634;196964;
30.01.2019;13:14:05;83171661;82974780;196881;
30.01.2019;13:15:04;83171737;82974897;196840;
30.01.2019;13:16:04;83171806;82975025;196781;
30.01.2019;13:17:05;83171875;82975144;196731;
30.01.2019;13:18:04;83171967;82975266;196701;
30.01.2019;13:19:04;83172043;82975387;196656;
30.01.2019;13:20:05;83172108;82975512;196596;
30.01.2019;13:21:05;83172184;82975639;196545;
30.01.2019;13:22:04;83172264;82975756;196508;
30.01.2019;13:23:05;83172350;82975894;196456;
30.01.2019;13:24:05;83172439;82976018;196421;
30.01.2019;13:25:04;83172505;82976128;196377;
30.01.2019;13:26:05;83172598;82976250;196348;
30.01.2019;13:27:05;83172649;82976372;196277;
30.01.2019;13:28:04;83172736;82976493;196243;
30.01.2019;13:29:05;83172802;82976611;196191;
30.01.2019;13:30:04;83172892;82976738;196154;
30.01.2019;13:31:04;83172985;82976841;196144;
30.01.2019;13:32:05;83173073;82976984;196089;
30.01.2019;13:33:05;83173145;82977101;196044;
30.01.2019;13:34:04;83173225;82977206;196019;
30.01.2019;13:35:05;83173310;82977311;195999;
30.01.2019;13:36:04;83173384;82977407;195977;
30.01.2019;13:37:04;83173466;82977531;195935;
30.01.2019;13:38:04;83173553;82977657;195896;
30.01.2019;13:39:07;83173623;82977781;195842;
30.01.2019;13:40:04;83173691;82977946;195745;
30.01.2019;13:41:05;83173765;82978033;195732;
30.01.2019;13:42:05;83173833;82978147;195686;
30.01.2019;13:43:05;83173918;82978269;195649;
30.01.2019;13:44:04;83173991;82978382;195609;
30.01.2019;13:45:05;83174083;82978527;195556;
30.01.2019;13:46:05;83174154;82978642;195512;
30.01.2019;13:47:04;83174225;82978768;195457;
30.01.2019;13:48:04;83174305;82978870;195435;
30.01.2019;13:49:05;83174411;82978997;195414;
30.01.2019;13:50:04;83174500;82979091;195409;
30.01.2019;13:51:05;83174590;82979208;195382;
30.01.2019;13:52:05;83174673;82979353;195320;
30.01.2019;13:53:05;83174745;82979492;195253;
30.01.2019;13:54:05;83174814;82979598;195216;
30.01.2019;13:55:04;83174932;82979743;195189;
30.01.2019;13:56:04;83175008;82979895;195113;
30.01.2019;13:57:04;83175083;82980020;195063;
30.01.2019;13:58:05;83175179;82980149;195030;
30.01.2019;13:59:04;83175255;82980280;194975;
30.01.2019;14:00:04;83175348;82980413;194935;
30.01.2019;14:01:05;83175428;82980530;194898;
30.01.2019;14:02:05;83175537;82980659;194878;
30.01.2019;14:03:04;83175627;82980789;194838;
30.01.2019;14:04:05;83175726;82980908;194818;
30.01.2019;14:05:05;83175799;82981019;194780;
30.01.2019;14:06:05;83175888;82981168;194720;
30.01.2019;14:07:04;83175974;82981318;194656;
30.01.2019;14:08:04;83176073;82981445;194628;
30.01.2019;14:09:04;83176149;82981568;194581;
30.01.2019;14:10:05;83176239;82981720;194519;
30.01.2019;14:11:04;83176327;82981870;194457;
30.01.2019;14:12:04;83176415;82982015;194400;
30.01.2019;14:13:05;83176523;82982138;194385;
30.01.2019;14:14:07;83176612;82982276;194336;
30.01.2019;14:15:05;83176711;82982373;194338;
30.01.2019;14:16:04;83176793;82982496;194297;
30.01.2019;14:17:04;83176894;82982634;194260;
30.01.2019;14:18:05;83177016;82982769;194247;
30.01.2019;14:19:07;83177098;82982887;194211;
30.01.2019;14:20:04;83177164;82983012;194152;
30.01.2019;14:21:08;83177247;82983124;194123;
30.01.2019;14:22:05;83177294;82983247;194047;
30.01.2019;14:23:07;83177380;82983370;194010;
30.01.2019;14:25:08;83177581;82983650;193931;
30.01.2019;14:26:18;83177676;82983802;193874;
30.01.2019;14:27:05;83177752;82983908;193844;
30.01.2019;14:28:05;83177833;82984062;193771;
30.01.2019;14:29:04;83177901;82984197;193704;
30.01.2019;14:30:04;83177981;82984328;193653;
30.01.2019;14:31:04;83178062;82984444;193618;
30.01.2019;14:32:05;83178127;82984584;193543;
30.01.2019;14:33:05;83178219;82984702;193517;
30.01.2019;14:34:04;83178308;82984850;193458;
30.01.2019;14:35:04;83178387;82984998;193389;
30.01.2019;14:36:05;83178489;82985141;193348;
30.01.2019;14:37:05;83178578;82985262;193316;
30.01.2019;14:38:04;83178668;82985387;193281;
30.01.2019;14:39:04;83178766;82985524;193242;
30.01.2019;14:40:04;83178853;82985676;193177;
30.01.2019;14:41:05;83178912;82985814;193098;
30.01.2019;14:42:05;83179000;82985969;193031;
30.01.2019;14:43:04;83179087;82986126;192961;
30.01.2019;14:44:04;83179160;82986263;192897;
30.01.2019;14:45:05;83179252;82986426;192826;
30.01.2019;14:46:04;83179329;82986581;192748;
30.01.2019;14:47:05;83179412;82986729;192683;
30.01.2019;14:48:04;83179506;82986850;192656;
30.01.2019;14:49:05;83179610;82987003;192607;
30.01.2019;14:50:05;83179697;82987139;192558;
30.01.2019;14:51:05;83179802;82987290;192512;
30.01.2019;14:52:04;83179911;82987409;192502;
30.01.2019;14:53:04;83180009;82987570;192439;
30.01.2019;14:54:05;83180097;82987694;192403;
30.01.2019;14:55:05;83180198;82987843;192355;
30.01.2019;14:56:04;83180289;82987993;192296;
30.01.2019;14:57:04;83180373;82988155;192218;
30.01.2019;14:58:05;83180469;82988313;192156;
30.01.2019;14:59:05;83180542;82988436;192106;
30.01.2019;15:00:08;83180645;82988591;192054;
30.01.2019;15:01:08;83180741;82988730;192011;
30.01.2019;15:02:08;83180837;82988870;191967;
30.01.2019;15:03:07;83180906;82989005;191901;
30.01.2019;15:04:08;83180983;82989147;191836;
30.01.2019;15:05:07;83181075;82989282;191793;
30.01.2019;15:06:08;83181160;82989451;191709;
30.01.2019;15:07:07;83181254;82989582;191672;
30.01.2019;15:08:07;83181352;82989699;191653;
30.01.2019;15:09:08;83181445;82989872;191573;
30.01.2019;15:10:08;83181517;82990005;191512;
30.01.2019;15:11:08;83181594;82990166;191428;
30.01.2019;15:12:07;83181689;82990299;191390;
30.01.2019;15:13:08;83181767;82990430;191337;
30.01.2019;15:14:07;83181863;82990592;191271;
30.01.2019;15:15:07;83181943;82990760;191183;
30.01.2019;15:16:07;83182033;82990880;191153;
30.01.2019;15:17:07;83182106;82991031;191075;
30.01.2019;15:18:07;83182198;82991170;191028;
30.01.2019;15:19:07;83182306;82991320;190986;
30.01.2019;15:20:07;83182396;82991449;190947;
30.01.2019;15:21:08;83182500;82991580;190920;
30.01.2019;15:22:07;83182594;82991719;190875;
30.01.2019;15:23:08;83182690;82991885;190805;
30.01.2019;15:24:07;83182773;82992016;190757;
30.01.2019;15:25:07;83182873;82992184;190689;
30.01.2019;15:26:08;83182981;82992321;190660;
30.01.2019;15:27:08;83183054;82992481;190573;
30.01.2019;15:28:07;83183147;82992652;190495;
30.01.2019;15:29:07;83183268;82992772;190496;
30.01.2019;15:30:07;83183383;82992899;190484;
30.01.2019;15:31:08;83183468;82993071;190397;
30.01.2019;15:32:07;83183613;82993218;190395;
30.01.2019;15:33:07;83183707;82993376;190331;
30.01.2019;15:34:08;83183831;82993528;190303;
30.01.2019;15:35:08;83183919;82993688;190231;
30.01.2019;15:36:07;83184012;82993834;190178;
30.01.2019;15:37:08;83184127;82994010;190117;
30.01.2019;15:38:08;83184218;82994169;190049;
30.01.2019;15:39:10;83184313;82994339;189974;
30.01.2019;15:40:08;83184415;82994504;189911;
30.01.2019;15:41:07;83184509;82994678;189831;
30.01.2019;15:42:08;83184611;82994829;189782;
30.01.2019;15:43:07;83184711;82994997;189714;
30.01.2019;15:44:08;83184811;82995185;189626;
30.01.2019;15:45:07;83184899;82995324;189575;
30.01.2019;15:46:07;83184970;82995457;189513;
30.01.2019;15:47:07;83185062;82995617;189445;
30.01.2019;15:48:07;83185157;82995746;189411;
30.01.2019;15:49:07;83185237;82995912;189325;
30.01.2019;15:50:07;83185338;82996069;189269;
30.01.2019;15:51:08;83185410;82996210;189200;
30.01.2019;15:52:08;83185525;82996370;189155;
30.01.2019;15:53:06;83185625;82996511;189114;
30.01.2019;15:54:07;83185710;82996663;189047;
30.01.2019;15:55:08;83185808;82996838;188970;
30.01.2019;15:56:07;83185898;82996989;188909;
30.01.2019;15:57:08;83186031;82997165;188866;
30.01.2019;15:58:07;83186114;82997295;188819;
30.01.2019;15:59:08;83186213;82997425;188788;
30.01.2019;16:00:04;83186296;82997567;188729;
30.01.2019;16:01:05;83186390;82997710;188680;
30.01.2019;16:02:05;83186494;82997885;188609;
30.01.2019;16:03:04;83186596;82998058;188538;
30.01.2019;16:04:04;83186694;82998200;188494;
30.01.2019;16:05:05;83186788;82998352;188436;
30.01.2019;16:06:04;83186882;82998503;188379;
30.01.2019;16:07:04;83186985;82998676;188309;
30.01.2019;16:08:05;83187090;82998824;188266;
30.01.2019;16:09:07;83187185;82998959;188226;
30.01.2019;16:10:04;83187289;82999135;188154;
30.01.2019;16:11:04;83187389;82999294;188095;
30.01.2019;16:12:05;83187488;82999420;188068;
30.01.2019;16:13:05;83187594;82999561;188033;
30.01.2019;16:14:04;83187679;82999714;187965;
30.01.2019;16:15:04;83187772;82999860;187912;
30.01.2019;16:16:04;83187871;83000045;187826;
30.01.2019;16:17:04;83187989;83000209;187780;
30.01.2019;16:18:05;83188109;83000381;187728;
30.01.2019;16:19:05;83188228;83000552;187676;
30.01.2019;16:20:05;83188331;83000665;187666;
30.01.2019;16:21:04;83188427;83000798;187629;
30.01.2019;16:22:04;83188520;83000949;187571;
30.01.2019;16:23:05;83188646;83001073;187573;
30.01.2019;16:24:05;83188755;83001205;187550;
30.01.2019;16:25:06;83188827;83001345;187482;
30.01.2019;16:26:05;83188902;83001472;187430;
30.01.2019;16:27:05;83189000;83001615;187385;
30.01.2019;16:28:05;83189110;83001771;187339;
30.01.2019;16:29:05;83189219;83001933;187286;
30.01.2019;16:30:05;83189289;83002070;187219;
30.01.2019;16:31:04;83189396;83002221;187175;
30.01.2019;16:32:04;83189480;83002362;187118;
30.01.2019;16:33:04;83189596;83002491;187105;
30.01.2019;16:34:04;83189696;83002617;187079;
30.01.2019;16:35:05;83189818;83002740;187078;
30.01.2019;16:36:05;83189920;83002895;187025;
30.01.2019;16:37:04;83190015;83003047;186968;
30.01.2019;16:38:04;83190129;83003186;186943;
30.01.2019;16:39:07;83190247;83003342;186905;
30.01.2019;16:40:05;83190337;83003472;186865;
30.01.2019;16:41:04;83190408;83003620;186788;
30.01.2019;16:42:04;83190481;83003745;186736;
30.01.2019;16:43:06;83190605;83003888;186717;
30.01.2019;16:44:04;83190687;83004040;186647;
30.01.2019;16:45:05;83190820;83004189;186631;
30.01.2019;16:46:04;83190943;83004321;186622;
30.01.2019;16:47:05;83191068;83004467;186601;
30.01.2019;16:48:04;83191181;83004617;186564;
30.01.2019;16:49:04;83191294;83004749;186545;
30.01.2019;16:50:05;83191394;83004903;186491;
30.01.2019;16:51:04;83191458;83005061;186397;
30.01.2019;16:52:05;83191542;83005222;186320;
30.01.2019;16:53:05;83191653;83005377;186276;
30.01.2019;16:54:05;83191767;83005519;186248;
30.01.2019;16:55:05;83191854;83005679;186175;
30.01.2019;16:56:05;83191980;83005844;186136;
30.01.2019;16:57:05;83192091;83006018;186073;
30.01.2019;16:58:04;83192206;83006205;186001;
30.01.2019;16:59:04;83192338;83006379;185959;
30.01.2019;17:00:05;83192428;83006535;185893;
30.01.2019;17:01:05;83192542;83006723;185819;
30.01.2019;17:02:05;83192624;83006885;185739;
30.01.2019;17:03:05;83192730;83007046;185684;
30.01.2019;17:04:04;83192818;83007211;185607;
30.01.2019;17:05:04;83192912;83007346;185566;
30.01.2019;17:06:05;83193019;83007505;185514;
30.01.2019;17:07:05;83193135;83007644;185491;
30.01.2019;17:08:05;83193219;83007784;185435;
30.01.2019;17:09:05;83193313;83007916;185397;
30.01.2019;17:10:04;83193414;83008080;185334;
30.01.2019;17:11:04;83193519;83008226;185293;
30.01.2019;17:12:05;83193619;83008405;185214;
30.01.2019;17:13:05;83193718;83008558;185160;
30.01.2019;17:14:05;83193809;83008691;185118;
30.01.2019;17:15:05;83193911;83008835;185076;
30.01.2019;17:16:05;83194005;83009003;185002;
30.01.2019;17:17:05;83194098;83009150;184948;
30.01.2019;17:18:05;83194209;83009311;184898;
30.01.2019;17:19:05;83194308;83009470;184838;
30.01.2019;17:20:05;83194410;83009608;184802;
30.01.2019;17:21:04;83194516;83009755;184761;
30.01.2019;17:22:04;83194613;83009900;184713;
30.01.2019;17:23:05;83194732;83010061;184671;
30.01.2019;17:24:05;83194830;83010206;184624;
30.01.2019;17:25:05;83194944;83010345;184599;
30.01.2019;17:26:05;83195059;83010476;184583;
30.01.2019;17:27:06;83195169;83010614;184555;
30.01.2019;17:28:04;83195260;83010783;184477;
30.01.2019;17:29:05;83195371;83010938;184433;
30.01.2019;17:30:05;83195472;83011107;184365;
30.01.2019;17:31:05;83195577;83011255;184322;
30.01.2019;17:32:04;83195666;83011394;184272;
30.01.2019;17:33:04;83195779;83011511;184268;
30.01.2019;17:34:05;83195894;83011649;184245;
30.01.2019;17:35:05;83195996;83011789;184207;
30.01.2019;17:36:05;83196077;83011940;184137;
30.01.2019;17:37:10;83196175;83012107;184068;
30.01.2019;17:38:04;83196314;83012260;184054;
30.01.2019;17:39:06;83196450;83012424;184026;
30.01.2019;17:40:05;83196537;83012559;183978;
30.01.2019;17:41:05;83196654;83012735;183919;
30.01.2019;17:42:05;83196763;83012888;183875;
30.01.2019;17:43:05;83196880;83013036;183844;
30.01.2019;17:44:05;83196991;83013165;183826;
30.01.2019;17:45:05;83197098;83013321;183777;
30.01.2019;17:46:05;83197185;83013451;183734;
30.01.2019;17:47:05;83197312;83013582;183730;
30.01.2019;17:48:05;83197407;83013693;183714;
30.01.2019;17:49:04;83197512;83013833;183679;
30.01.2019;17:50:04;83197620;83013976;183644;
30.01.2019;17:51:04;83197734;83014122;183612;
30.01.2019;17:52:05;83197863;83014289;183574;
30.01.2019;17:53:05;83197973;83014402;183571;
30.01.2019;17:54:05;83198093;83014556;183537;
30.01.2019;17:55:05;83198199;83014691;183508;
30.01.2019;17:56:05;83198305;83014838;183467;
30.01.2019;17:57:05;83198425;83014968;183457;
30.01.2019;17:58:05;83198541;83015100;183441;
30.01.2019;17:59:05;83198649;83015238;183411;
30.01.2019;18:00:05;83198769;83015375;183394;
30.01.2019;18:01:05;83198855;83015519;183336;
30.01.2019;18:02:05;83198958;83015650;183308;
30.01.2019;18:03:05;83199073;83015796;183277;
30.01.2019;18:04:06;83199198;83015931;183267;
30.01.2019;18:05:05;83199267;83016077;183190;
30.01.2019;18:06:05;83199410;83016196;183214;
30.01.2019;18:07:05;83199526;83016309;183217;
30.01.2019;18:08:04;83199621;83016453;183168;
30.01.2019;18:09:06;83199748;83016587;183161;
30.01.2019;18:10:05;83199878;83016721;183157;
30.01.2019;18:11:05;83199970;83016845;183125;
30.01.2019;18:12:05;83200080;83016968;183112;
30.01.2019;18:13:05;83200186;83017092;183094;
30.01.2019;18:14:05;83200286;83017203;183083;
30.01.2019;18:15:05;83200365;83017330;183035;
30.01.2019;18:16:05;83200471;83017448;183023;
30.01.2019;18:17:05;83200573;83017572;183001;
30.01.2019;18:18:04;83200649;83017680;182969;
30.01.2019;18:19:04;83200754;83017824;182930;
30.01.2019;18:20:05;83200867;83017950;182917;
30.01.2019;18:21:04;83200968;83018067;182901;
30.01.2019;18:22:05;83201070;83018200;182870;
30.01.2019;18:23:04;83201160;83018297;182863;
30.01.2019;18:24:04;83201258;83018400;182858;
30.01.2019;18:25:05;83201354;83018531;182823;
30.01.2019;18:26:05;83201432;83018667;182765;
30.01.2019;18:27:05;83201504;83018793;182711;
30.01.2019;18:28:05;83201559;83018910;182649;
30.01.2019;18:29:05;83201637;83019006;182631;
30.01.2019;18:30:05;83201727;83019123;182604;
30.01.2019;18:31:05;83201791;83019225;182566;
30.01.2019;18:32:05;83201899;83019328;182571;
30.01.2019;18:33:04;83201993;83019424;182569;
30.01.2019;18:34:04;83202083;83019504;182579;
30.01.2019;18:35:05;83202158;83019639;182519;
30.01.2019;18:36:05;83202248;83019741;182507;
30.01.2019;18:37:05;83202331;83019875;182456;
30.01.2019;18:38:05;83202434;83019983;182451;
30.01.2019;18:39:05;83202516;83020118;182398;
30.01.2019;18:40:05;83202613;83020208;182405;
30.01.2019;18:41:05;83202706;83020298;182408;
30.01.2019;18:42:06;83202803;83020416;182387;
30.01.2019;18:43:05;83202798;83020441;182357;
30.01.2019;18:44:07;83202886;83020569;182317;
30.01.2019;18:45:06;83202981;83020675;182306;
30.01.2019;18:46:04;83203061;83020790;182271;
30.01.2019;18:47:05;83203170;83020917;182253;
30.01.2019;18:48:05;83203280;83021052;182228;
30.01.2019;18:49:05;83203365;83021137;182228;
30.01.2019;18:50:04;83203432;83021246;182186;
30.01.2019;18:51:04;83203552;83021356;182196;
30.01.2019;18:52:04;83203639;83021449;182190;
30.01.2019;18:53:05;83203720;83021557;182163;
30.01.2019;18:54:07;83203835;83021671;182164;
30.01.2019;18:55:05;83203899;83021735;182164;
30.01.2019;18:56:06;83204025;83021844;182181;
30.01.2019;18:57:05;83204143;83021941;182202;
30.01.2019;18:58:04;83204244;83022036;182208;
30.01.2019;18:59:05;83204358;83022142;182216;
30.01.2019;19:00:05;83204443;83022245;182198;
30.01.2019;19:01:05;83204556;83022319;182237;
30.01.2019;19:02:06;83204660;83022436;182224;
30.01.2019;19:03:05;83204759;83022546;182213;
30.01.2019;19:04:05;83204863;83022645;182218;
30.01.2019;19:05:05;83204946;83022749;182197;
30.01.2019;19:06:05;83205060;83022855;182205;
30.01.2019;19:07:06;83205174;83022974;182200;
30.01.2019;19:08:08;83205294;83023065;182229;
30.01.2019;19:09:05;83205390;83023154;182236;
30.01.2019;19:10:05;83205500;83023231;182269;
30.01.2019;19:11:05;83205598;83023335;182263;
30.01.2019;19:12:05;83205709;83023441;182268;
30.01.2019;19:13:05;83205812;83023536;182276;
30.01.2019;19:14:05;83205927;83023645;182282;
30.01.2019;19:15:06;83206040;83023743;182297;
30.01.2019;19:16:04;83206135;83023819;182316;
30.01.2019;19:17:06;83206252;83023935;182317;
30.01.2019;19:18:05;83206354;83024018;182336;
30.01.2019;19:19:04;83206463;83024105;182358;
30.01.2019;19:20:05;83206557;83024188;182369;
30.01.2019;19:21:04;83206663;83024274;182389;
30.01.2019;19:22:04;83206751;83024359;182392;
30.01.2019;19:23:06;83206846;83024455;182391;
30.01.2019;19:24:05;83206929;83024536;182393;
30.01.2019;19:25:05;83207037;83024641;182396;
30.01.2019;19:26:04;83207134;83024739;182395;
30.01.2019;19:27:05;83207245;83024838;182407;
30.01.2019;19:28:05;83207372;83024927;182445;
30.01.2019;19:29:05;83207473;83025016;182457;
30.01.2019;19:30:05;83207601;83025099;182502;
30.01.2019;19:31:06;83207746;83025171;182575;
30.01.2019;19:32:06;83207856;83025270;182586;
30.01.2019;19:33:05;83207953;83025358;182595;
30.01.2019;19:34:10;83208061;83025418;182643;
30.01.2019;19:35:05;83208162;83025504;182658;
30.01.2019;19:36:04;83208259;83025573;182686;
30.01.2019;19:37:05;83208369;83025651;182718;
30.01.2019;19:38:04;83208483;83025714;182769;
30.01.2019;19:39:04;83208591;83025768;182823;
30.01.2019;19:40:05;83208689;83025828;182861;
30.01.2019;19:41:05;83208791;83025898;182893;
30.01.2019;19:42:05;83208891;83025967;182924;
30.01.2019;19:43:05;83209005;83026047;182958;
30.01.2019;19:44:06;83209110;83026108;183002;
30.01.2019;19:45:05;83209192;83026190;183002;
30.01.2019;19:46:06;83209309;83026262;183047;
30.01.2019;19:47:05;83209420;83026343;183077;
30.01.2019;19:48:05;83209513;83026411;183102;
30.01.2019;19:49:05;83209615;83026496;183119;
30.01.2019;19:50:05;83209721;83026554;183167;
30.01.2019;19:51:05;83209831;83026616;183215;
30.01.2019;19:52:05;83209948;83026695;183253;
30.01.2019;19:53:04;83210051;83026766;183285;
30.01.2019;19:54:10;83210177;83026830;183347;
30.01.2019;19:55:04;83210278;83026894;183384;
30.01.2019;19:56:04;83210352;83026952;183400;
30.01.2019;19:57:04;83210495;83027028;183467;
30.01.2019;19:58:04;83210616;83027101;183515;
30.01.2019;19:59:04;83210724;83027169;183555;
30.01.2019;20:00:05;83210834;83027258;183576;
30.01.2019;20:01:05;83210956;83027318;183638;
30.01.2019;20:02:05;83211038;83027388;183650;
30.01.2019;20:03:05;83211128;83027448;183680;
30.01.2019;20:04:06;83211213;83027514;183699;
30.01.2019;20:05:04;83211320;83027565;183755;
30.01.2019;20:06:04;83211430;83027624;183806;
30.01.2019;20:07:04;83211525;83027652;183873;
30.01.2019;20:08:04;83211609;83027738;183871;
30.01.2019;20:09:04;83211727;83027793;183934;
30.01.2019;20:10:04;83211833;83027861;183972;
30.01.2019;20:11:05;83211949;83027928;184021;
30.01.2019;20:12:05;83212047;83027976;184071;
30.01.2019;20:13:04;83212153;83028037;184116;
30.01.2019;20:14:04;83212252;83028102;184150;
30.01.2019;20:15:05;83212360;83028180;184180;
30.01.2019;20:16:04;83212467;83028228;184239;
30.01.2019;20:17:05;83212553;83028288;184265;
30.01.2019;20:18:04;83212659;83028348;184311;
30.01.2019;20:19:05;83212754;83028406;184348;
30.01.2019;20:20:05;83212845;83028471;184374;
30.01.2019;20:21:05;83212968;83028514;184454;
30.01.2019;20:22:04;83213053;83028569;184484;
30.01.2019;20:23:05;83213139;83028623;184516;
30.01.2019;20:24:05;83213222;83028673;184549;
30.01.2019;20:25:05;83213304;83028704;184600;
30.01.2019;20:26:05;83213390;83028740;184650;
30.01.2019;20:27:05;83213460;83028784;184676;
30.01.2019;20:28:04;83213548;83028800;184748;
30.01.2019;20:29:05;83213630;83028819;184811;
30.01.2019;20:30:04;83213708;83028846;184862;
30.01.2019;20:31:04;83213793;83028874;184919;
30.01.2019;20:32:04;83213895;83028921;184974;
30.01.2019;20:33:04;83213989;83028937;185052;
30.01.2019;20:34:05;83214099;83028974;185125;
30.01.2019;20:35:04;83214208;83029013;185195;
30.01.2019;20:36:05;83214298;83029073;185225;
30.01.2019;20:37:05;83214400;83029131;185269;
30.01.2019;20:38:05;83214470;83029169;185301;
30.01.2019;20:39:08;83214561;83029221;185340;
30.01.2019;20:40:06;83214651;83029262;185389;
30.01.2019;20:41:04;83214742;83029289;185453;
30.01.2019;20:42:04;83214842;83029342;185500;
30.01.2019;20:43:04;83214948;83029392;185556;
30.01.2019;20:44:05;83215008;83029442;185566;
30.01.2019;20:45:04;83215106;83029486;185620;
30.01.2019;20:46:04;83215200;83029539;185661;
30.01.2019;20:47:05;83215305;83029579;185726;
30.01.2019;20:48:05;83215405;83029617;185788;
30.01.2019;20:49:05;83215503;83029663;185840;
30.01.2019;20:50:05;83215603;83029711;185892;
30.01.2019;20:51:05;83215721;83029725;185996;
30.01.2019;20:52:04;83215818;83029793;186025;
30.01.2019;20:53:06;83215923;83029830;186093;
30.01.2019;20:54:05;83216015;83029870;186145;
30.01.2019;20:55:05;83216111;83029910;186201;
30.01.2019;20:56:05;83216184;83029961;186223;
30.01.2019;20:57:05;83216287;83030000;186287;
30.01.2019;20:58:05;83216376;83030050;186326;
30.01.2019;20:59:06;83216484;83030097;186387;
30.01.2019;21:00:05;83216582;83030147;186435;
30.01.2019;21:02:04;83216801;83030208;186593;
30.01.2019;21:03:11;83216915;83030246;186669;
30.01.2019;21:04:04;83217003;83030275;186728;
30.01.2019;21:05:06;83217117;83030319;186798;
30.01.2019;21:06:05;83217222;83030356;186866;
30.01.2019;21:07:05;83217318;83030384;186934;
30.01.2019;21:08:05;83217413;83030423;186990;
30.01.2019;21:09:06;83217455;83030473;186982;
30.01.2019;21:10:11;83217461;83030514;186947;
30.01.2019;21:11:05;83216632;83030542;186090;
30.01.2019;21:12:04;83216707;83034857;181850;
30.01.2019;21:13:04;83216779;83034902;181877;
30.01.2019;21:14:06;83216861;83034944;181917;
30.01.2019;21:15:05;83216944;83034983;181961;
30.01.2019;21:16:05;83216991;83035021;181970;
30.01.2019;21:17:05;83217106;83035054;182052;
30.01.2019;21:18:06;83217189;83035097;182092;
30.01.2019;21:19:05;83217267;83035137;182130;
30.01.2019;21:20:04;83217361;83035180;182181;
30.01.2019;21:21:05;83217423;83035198;182225;
30.01.2019;21:22:05;83217482;83035230;182252;
30.01.2019;21:23:05;83217574;83035270;182304;
30.01.2019;21:24:05;83217673;83035307;182366;
30.01.2019;21:25:05;83217772;83035348;182424;
30.01.2019;21:26:05;83217871;83035390;182481;
30.01.2019;21:27:05;83217955;83035405;182550;
30.01.2019;21:28:05;83218034;83035426;182608;
30.01.2019;21:29:06;83218120;83035470;182650;
30.01.2019;21:30:04;83218192;83035502;182690;
30.01.2019;21:31:05;83218268;83035535;182733;
30.01.2019;21:32:05;83218367;83035583;182784;
30.01.2019;21:33:05;83218420;83035610;182810;
30.01.2019;21:34:05;83218486;83035649;182837;
30.01.2019;21:35:05;83218555;83035685;182870;
30.01.2019;21:36:06;83218607;83035724;182883;
30.01.2019;21:37:05;83218684;83035767;182917;
30.01.2019;21:38:05;83218780;83035807;182973;
30.01.2019;21:39:10;83218877;83035858;183019;
30.01.2019;21:40:05;83218962;83035888;183074;
30.01.2019;21:41:05;83219039;83035903;183136;
30.01.2019;21:42:04;83219125;83035953;183172;
30.01.2019;21:43:04;83219171;83035991;183180;
30.01.2019;21:44:09;83219283;83036029;183254;
30.01.2019;21:45:04;83219372;83036052;183320;
30.01.2019;21:46:05;83219444;83036087;183357;
30.01.2019;21:47:05;83219523;83036119;183404;
30.01.2019;21:48:04;83219612;83036142;183470;
30.01.2019;21:49:04;83219688;83036167;183521;
30.01.2019;21:50:05;83219744;83036190;183554;
30.01.2019;21:51:06;83219769;83036168;183601;
30.01.2019;21:52:05;83219848;83036215;183633;
30.01.2019;21:53:06;83219929;83036247;183682;
30.01.2019;21:54:04;83220009;83036272;183737;
30.01.2019;21:55:04;83220067;83036292;183775;
30.01.2019;21:56:11;83220140;83036317;183823;
30.01.2019;21:57:05;83220233;83036347;183886;
30.01.2019;21:58:05;83220298;83036399;183899;
30.01.2019;21:59:05;83220366;83036430;183936;
30.01.2019;22:00:05;83220460;83036458;184002;
30.01.2019;22:01:05;83220555;83036474;184081;
30.01.2019;22:02:05;83220653;83036499;184154;
30.01.2019;22:03:05;83220705;83036535;184170;
30.01.2019;22:04:05;83220833;83036560;184273;
30.01.2019;22:05:06;83220918;83036598;184320;
30.01.2019;22:06:05;83221032;83036621;184411;
30.01.2019;22:07:06;83221108;83036660;184448;
30.01.2019;22:08:05;83221181;83036688;184493;
30.01.2019;22:09:05;83221278;83036716;184562;
30.01.2019;22:10:05;83221370;83036743;184627;
30.01.2019;22:11:06;83221449;83036760;184689;
30.01.2019;22:12:04;83221539;83036801;184738;
30.01.2019;22:13:05;83221630;83036822;184808;
30.01.2019;22:14:05;83221712;83036857;184855;
30.01.2019;22:15:06;83221819;83036885;184934;
30.01.2019;22:16:05;83221916;83036922;184994;
30.01.2019;22:17:06;83222018;83036950;185068;
30.01.2019;22:18:06;83222111;83036980;185131;
30.01.2019;22:19:05;83222175;83037014;185161;
30.01.2019;22:20:05;83222249;83037056;185193;
30.01.2019;22:21:05;83222317;83037086;185231;
30.01.2019;22:22:11;83222395;83037115;185280;
30.01.2019;22:23:04;83222458;83037149;185309;
30.01.2019;22:24:05;83222544;83037173;185371;
30.01.2019;22:25:05;83222619;83037199;185420;
30.01.2019;22:26:06;83222706;83037236;185470;
30.01.2019;22:27:04;83222783;83037259;185524;
30.01.2019;22:28:04;83222855;83037284;185571;
30.01.2019;22:29:06;83222924;83037313;185611;
30.01.2019;22:30:04;83223013;83037331;185682;
30.01.2019;22:31:04;83223102;83037361;185741;
30.01.2019;22:32:05;83223161;83037375;185786;
30.01.2019;22:33:06;83223263;83037391;185872;
30.01.2019;22:34:04;83223325;83037400;185925;
30.01.2019;22:35:04;83223401;83037416;185985;
30.01.2019;22:36:05;83223485;83037428;186057;
30.01.2019;22:37:06;83223553;83037449;186104;
30.01.2019;22:38:05;83223650;83037469;186181;
30.01.2019;22:39:06;83223723;83037498;186225;
30.01.2019;22:40:05;83223811;83037519;186292;
30.01.2019;22:41:06;83223885;83037534;186351;
30.01.2019;22:42:05;83223961;83037557;186404;
30.01.2019;22:43:05;83224062;83037566;186496;
30.01.2019;22:44:06;83224160;83037597;186563;
30.01.2019;22:45:05;83224258;83037627;186631;
30.01.2019;22:46:05;83224332;83037634;186698;
30.01.2019;22:47:05;83224421;83037650;186771;
30.01.2019;22:48:05;83224500;83037669;186831;
30.01.2019;22:49:11;83224585;83037689;186896;
30.01.2019;22:50:06;83224651;83037709;186942;
30.01.2019;22:51:05;83224751;83037727;187024;
30.01.2019;22:52:04;83224819;83037742;187077;
30.01.2019;22:53:04;83224907;83037762;187145;
30.01.2019;22:54:05;83224999;83037803;187196;
30.01.2019;22:55:06;83225093;83037823;187270;
30.01.2019;22:56:05;83225178;83037837;187341;
30.01.2019;22:57:04;83225247;83037863;187384;
30.01.2019;22:58:04;83225340;83037890;187450;
30.01.2019;22:59:05;83225437;83037914;187523;
30.01.2019;23:00:05;83225508;83037944;187564;
30.01.2019;23:01:04;83225575;83037948;187627;
30.01.2019;23:02:04;83225638;83037962;187676;
30.01.2019;23:03:06;83225718;83037981;187737;
30.01.2019;23:04:04;83225789;83038002;187787;
30.01.2019;23:05:06;83225888;83038025;187863;
30.01.2019;23:06:07;83225967;83038045;187922;
30.01.2019;23:07:05;83226064;83038067;187997;
30.01.2019;23:08:06;83226150;83038103;188047;
30.01.2019;23:09:06;83226234;83038122;188112;
30.01.2019;23:10:05;83226319;83038152;188167;
30.01.2019;23:11:04;83226397;83038175;188222;
30.01.2019;23:12:06;83226463;83038191;188272;
30.01.2019;23:13:05;83226549;83038227;188322;
30.01.2019;23:14:05;83226624;83038243;188381;
30.01.2019;23:15:05;83226710;83038260;188450;
30.01.2019;23:16:06;83226780;83038284;188496;
30.01.2019;23:17:05;83226858;83038309;188549;
30.01.2019;23:18:05;83226922;83038321;188601;
30.01.2019;23:19:04;83227022;83038339;188683;
30.01.2019;23:20:04;83227110;83038344;188766;
30.01.2019;23:21:06;83227182;83038368;188814;
30.01.2019;23:22:05;83227263;83038388;188875;
30.01.2019;23:23:05;83227360;83038411;188949;
30.01.2019;23:24:05;83227444;83038440;189004;
30.01.2019;23:25:05;83227545;83038463;189082;
30.01.2019;23:26:10;83227624;83038481;189143;
30.01.2019;23:27:04;83227699;83038505;189194;
30.01.2019;23:28:05;83227759;83038517;189242;
30.01.2019;23:29:04;83227837;83038529;189308;
30.01.2019;23:30:04;83227926;83038543;189383;
30.01.2019;23:31:06;83228026;83038556;189470;
30.01.2019;23:32:05;83228104;83038579;189525;
30.01.2019;23:33:04;83228178;83038600;189578;
30.01.2019;23:34:06;83228268;83038613;189655;
30.01.2019;23:35:05;83228340;83038632;189708;
30.01.2019;23:36:04;83228419;83038658;189761;
30.01.2019;23:37:04;83228518;83038685;189833;
30.01.2019;23:38:04;83228599;83038703;189896;
30.01.2019;23:39:05;83228671;83038726;189945;
30.01.2019;23:40:05;83228756;83038751;190005;
30.01.2019;23:41:06;83228829;83038769;190060;
30.01.2019;23:42:04;83228902;83038789;190113;
30.01.2019;23:43:05;83229009;83038810;190199;
30.01.2019;23:44:04;83229079;83038823;190256;
30.01.2019;23:45:05;83229156;83038847;190309;
30.01.2019;23:46:05;83229260;83038865;190395;
30.01.2019;23:47:04;83229348;83038881;190467;
30.01.2019;23:48:04;83229432;83038895;190537;
30.01.2019;23:49:05;83229521;83038919;190602;
30.01.2019;23:50:05;83229607;83038941;190666;
30.01.2019;23:51:05;83229698;83038963;190735;
30.01.2019;23:52:04;83229774;83038972;190802;
30.01.2019;23:53:04;83229837;83038988;190849;
30.01.2019;23:54:04;83229909;83039000;190909;
30.01.2019;23:55:05;83229972;83039022;190950;
30.01.2019;23:56:05;83230067;83039044;191023;
30.01.2019;23:57:05;83230133;83039067;191066;
30.01.2019;23:58:04;83230255;83039085;191170;
30.01.2019;23:59:09;83230317;83039116;191201;
31.01.2019;00:00:08;83230408;83039134;191274;
31.01.2019;00:01:09;83230486;83039153;191333;
31.01.2019;00:02:07;83230556;83039169;191387;
31.01.2019;00:03:08;83230624;83039196;191428;
31.01.2019;00:04:08;83230707;83039216;191491;
31.01.2019;00:05:07;83230762;83039243;191519;
31.01.2019;00:06:07;83230830;83039255;191575;
31.01.2019;00:07:08;83230903;83039276;191627;
31.01.2019;00:08:08;83230953;83039289;191664;
31.01.2019;00:09:07;83231048;83039313;191735;
31.01.2019;00:10:09;83231131;83039340;191791;
31.01.2019;00:11:08;83231203;83039366;191837;
31.01.2019;00:12:08;83231246;83039385;191861;
31.01.2019;00:13:11;83231366;83039406;191960;
31.01.2019;00:14:07;83231454;83039428;192026;
31.01.2019;00:15:08;83231510;83039449;192061;
31.01.2019;00:16:07;83231569;83039468;192101;
31.01.2019;00:17:07;83231624;83039479;192145;
31.01.2019;00:18:09;83231702;83039499;192203;
31.01.2019;00:19:06;83231762;83039506;192256;
31.01.2019;00:20:07;83231803;83039525;192278;
31.01.2019;00:21:07;83231872;83039554;192318;
31.01.2019;00:22:08;83231934;83039571;192363;
31.01.2019;00:23:07;83232007;83039582;192425;
31.01.2019;00:24:08;83232081;83039606;192475;
31.01.2019;00:25:07;83232142;83039614;192528;
31.01.2019;00:26:08;83232194;83039624;192570;
31.01.2019;00:27:14;83232250;83039642;192608;
31.01.2019;00:28:08;83232312;83039660;192652;
31.01.2019;00:29:07;83232345;83039657;192688;
31.01.2019;00:30:07;83232393;83039663;192730;
31.01.2019;00:31:07;83232424;83039670;192754;
31.01.2019;00:32:09;83232457;83039677;192780;
31.01.2019;00:33:08;83232532;83039700;192832;
31.01.2019;00:34:07;83232620;83039720;192900;
31.01.2019;00:35:09;83232687;83039726;192961;
31.01.2019;00:36:08;83232741;83039744;192997;
31.01.2019;00:37:07;83232797;83039765;193032;
31.01.2019;00:38:08;83232865;83039786;193079;
31.01.2019;00:39:10;83232931;83039804;193127;
31.01.2019;00:40:08;83232984;83039809;193175;
31.01.2019;00:41:08;83233068;83039821;193247;
31.01.2019;00:42:08;83233144;83039840;193304;
31.01.2019;00:43:08;83233218;83039865;193353;
31.01.2019;00:44:08;83233289;83039894;193395;
31.01.2019;00:45:07;83233350;83039911;193439;
31.01.2019;00:46:08;83233436;83039921;193515;
31.01.2019;00:47:07;83233513;83039943;193570;
31.01.2019;00:48:07;83233562;83039966;193596;
31.01.2019;00:49:08;83233648;83039998;193650;
31.01.2019;00:50:08;83233703;83040031;193672;
31.01.2019;00:51:08;83233777;83040051;193726;
31.01.2019;00:52:08;83233836;83040069;193767;
31.01.2019;00:53:07;83233899;83040084;193815;
31.01.2019;00:54:09;83233983;83040105;193878;
31.01.2019;00:55:08;83234059;83040115;193944;
31.01.2019;00:56:08;83234074;83040102;193972;
31.01.2019;00:57:06;83234129;83040127;194002;
31.01.2019;00:58:07;83234196;83040152;194044;
31.01.2019;00:59:08;83234270;83040172;194098;
31.01.2019;01:00:04;83234351;83040195;194156;
31.01.2019;01:01:04;83234397;83040220;194177;
31.01.2019;01:02:05;83234481;83040259;194222;
31.01.2019;01:03:05;83234543;83040288;194255;
31.01.2019;01:04:04;83234602;83040322;194280;
31.01.2019;01:05:04;83234672;83040342;194330;
31.01.2019;01:06:05;83234769;83040363;194406;
31.01.2019;01:07:05;83234829;83040393;194436;
31.01.2019;01:08:05;83234901;83040412;194489;
31.01.2019;01:09:06;83234988;83040434;194554;
31.01.2019;01:10:04;83235052;83040450;194602;
31.01.2019;01:11:05;83235111;83040472;194639;
31.01.2019;01:12:05;83235167;83040487;194680;
31.01.2019;01:13:05;83235256;83040494;194762;
31.01.2019;01:14:04;83235327;83040529;194798;
31.01.2019;01:15:04;83235402;83040556;194846;
31.01.2019;01:16:05;83235482;83040576;194906;
31.01.2019;01:17:05;83235556;83040597;194959;
31.01.2019;01:18:05;83235617;83040618;194999;
31.01.2019;01:19:04;83235680;83040643;195037;
31.01.2019;01:20:04;83235754;83040664;195090;
31.01.2019;01:21:05;83235815;83040686;195129;
31.01.2019;01:22:05;83235880;83040716;195164;
31.01.2019;01:23:05;83235950;83040735;195215;
31.01.2019;01:24:05;83236024;83040758;195266;
31.01.2019;01:25:04;83236080;83040799;195281;
31.01.2019;01:26:04;83236153;83040821;195332;
31.01.2019;01:27:04;83236217;83040846;195371;
31.01.2019;01:28:05;83236293;83040896;195397;
31.01.2019;01:29:04;83236355;83040928;195427;
31.01.2019;01:30:04;83236433;83040959;195474;
31.01.2019;01:31:05;83236495;83040983;195512;
31.01.2019;01:32:04;83236570;83041016;195554;
31.01.2019;01:33:05;83236626;83041041;195585;
31.01.2019;01:34:04;83236682;83041069;195613;
31.01.2019;01:35:04;83236739;83041109;195630;
31.01.2019;01:36:05;83236799;83041146;195653;
31.01.2019;01:37:05;83236861;83041188;195673;
31.01.2019;01:38:04;83236910;83041218;195692;
31.01.2019;01:39:05;83236982;83041247;195735;
31.01.2019;01:40:05;83237061;83041272;195789;
31.01.2019;01:41:05;83237118;83041299;195819;
31.01.2019;01:42:05;83237188;83041316;195872;
31.01.2019;01:43:04;83237253;83041353;195900;
31.01.2019;01:44:05;83237314;83041392;195922;
31.01.2019;01:45:05;83237364;83041431;195933;
31.01.2019;01:46:05;83237430;83041467;195963;
31.01.2019;01:47:04;83237494;83041505;195989;
31.01.2019;01:48:04;83237556;83041542;196014;
31.01.2019;01:49:05;83237638;83041574;196064;
31.01.2019;01:50:04;83237714;83041610;196104;
31.01.2019;01:51:05;83237778;83041651;196127;
31.01.2019;01:52:05;83237847;83041686;196161;
31.01.2019;01:53:05;83237925;83041721;196204;
31.01.2019;01:54:06;83237990;83041766;196224;
31.01.2019;01:55:04;83238063;83041807;196256;
31.01.2019;01:56:04;83238133;83041857;196276;
31.01.2019;01:57:05;83238214;83041895;196319;
31.01.2019;01:58:04;83238286;83041939;196347;
31.01.2019;01:59:04;83238348;83041975;196373;
31.01.2019;02:00:04;83238413;83042033;196380;
31.01.2019;02:01:05;83238485;83042078;196407;
31.01.2019;02:02:05;83238542;83042114;196428;
31.01.2019;02:03:05;83238614;83042161;196453;
31.01.2019;02:04:04;83238682;83042228;196454;
31.01.2019;02:05:04;83238729;83042264;196465;
31.01.2019;02:06:04;83238786;83042297;196489;
31.01.2019;02:07:05;83238871;83042352;196519;
31.01.2019;02:08:05;83238927;83042404;196523;
31.01.2019;02:09:05;83239015;83042450;196565;
31.01.2019;02:10:05;83239057;83042509;196548;
31.01.2019;02:11:05;83239121;83042542;196579;
31.01.2019;02:12:04;83239172;83042586;196586;
31.01.2019;02:13:04;83239241;83042630;196611;
31.01.2019;02:14:05;83239314;83042692;196622;
31.01.2019;02:15:05;83239390;83042750;196640;
31.01.2019;02:16:05;83239450;83042815;196635;
31.01.2019;02:17:06;83239507;83042853;196654;
31.01.2019;02:18:05;83239569;83042905;196664;
31.01.2019;02:19:05;83239629;83042960;196669;
31.01.2019;02:20:04;83239691;83043023;196668;
31.01.2019;02:21:05;83239741;83043093;196648;
31.01.2019;02:22:05;83239779;83043150;196629;
31.01.2019;02:23:04;83239820;83043186;196634;
31.01.2019;02:24:05;83239851;83043238;196613;
31.01.2019;02:25:05;83239900;83043302;196598;
31.01.2019;02:26:04;83239949;83043355;196594;
31.01.2019;02:27:04;83240002;83043403;196599;
31.01.2019;02:28:05;83240049;83043472;196577;
31.01.2019;02:29:05;83240098;83043533;196565;
31.01.2019;02:30:04;83240151;83043596;196555;
31.01.2019;02:31:04;83240214;83043659;196555;
31.01.2019;02:32:05;83240262;83043726;196536;
31.01.2019;02:33:05;83240298;83043782;196516;
31.01.2019;02:34:04;83240347;83043803;196544;
31.01.2019;02:35:04;83240400;83043873;196527;
31.01.2019;02:36:05;83240458;83043950;196508;
31.01.2019;02:37:05;83240535;83044011;196524;
31.01.2019;02:38:05;83240578;83044075;196503;
31.01.2019;02:39:04;83240630;83044132;196498;
31.01.2019;02:40:04;83240705;83044182;196523;
31.01.2019;02:41:05;83240780;83044263;196517;
31.01.2019;02:42:05;83240837;83044320;196517;
31.01.2019;02:43:04;83240910;83044390;196520;
31.01.2019;02:44:04;83240966;83044442;196524;
31.01.2019;02:45:05;83241022;83044504;196518;
31.01.2019;02:46:05;83241094;83044566;196528;
31.01.2019;02:47:05;83241159;83044626;196533;
31.01.2019;02:48:05;83241231;83044687;196544;
31.01.2019;02:49:04;83241288;83044761;196527;
31.01.2019;02:50:07;83241363;83044838;196525;
31.01.2019;02:51:04;83241451;83044905;196546;
31.01.2019;02:52:05;83241523;83044985;196538;
31.01.2019;02:53:05;83241576;83045067;196509;
31.01.2019;02:54:04;83241653;83045138;196515;
31.01.2019;02:55:04;83241730;83045200;196530;
31.01.2019;02:56:05;83241810;83045290;196520;
31.01.2019;02:57:04;83241874;83045368;196506;
31.01.2019;02:58:04;83241930;83045450;196480;
31.01.2019;02:59:05;83241993;83045522;196471;
31.01.2019;03:00:05;83242067;83045583;196484;
31.01.2019;03:01:04;83242153;83045660;196493;
31.01.2019;03:02:04;83242215;83045741;196474;
31.01.2019;03:03:05;83242281;83045823;196458;
31.01.2019;03:04:05;83242357;83045918;196439;
31.01.2019;03:05:06;83242417;83046024;196393;
31.01.2019;03:06:04;83242492;83046101;196391;
31.01.2019;03:07:04;83242564;83046171;196393;
31.01.2019;03:08:04;83242634;83046259;196375;
31.01.2019;03:09:07;83242683;83046336;196347;
31.01.2019;03:10:04;83242738;83046409;196329;
31.01.2019;03:11:05;83242818;83046477;196341;
31.01.2019;03:12:05;83242883;83046552;196331;
31.01.2019;03:13:05;83242953;83046634;196319;
31.01.2019;03:14:04;83243016;83046720;196296;
31.01.2019;03:15:04;83243090;83046806;196284;
31.01.2019;03:16:08;83243172;83046886;196286;
31.01.2019;03:17:05;83243248;83046973;196275;
31.01.2019;03:18:05;83243329;83047058;196271;
31.01.2019;03:19:04;83243399;83047152;196247;
31.01.2019;03:20:04;83243486;83047228;196258;
31.01.2019;03:21:05;83243545;83047319;196226;
31.01.2019;03:22:05;83243609;83047388;196221;
31.01.2019;03:23:04;83243683;83047487;196196;
31.01.2019;03:24:04;83243759;83047572;196187;
31.01.2019;03:25:05;83243839;83047608;196231;
31.01.2019;03:26:05;83243907;83047727;196180;
31.01.2019;03:27:04;83243974;83047804;196170;
31.01.2019;03:28:04;83244037;83047884;196153;
31.01.2019;03:29:05;83244113;83047979;196134;
31.01.2019;03:30:05;83244196;83048066;196130;
31.01.2019;03:31:05;83244275;83048149;196126;
31.01.2019;03:32:05;83244346;83048226;196120;
31.01.2019;03:33:04;83244418;83048312;196106;
31.01.2019;03:34:05;83244491;83048398;196093;
31.01.2019;03:35:04;83244581;83048500;196081;
31.01.2019;03:36:05;83244671;83048598;196073;
31.01.2019;03:37:05;83244744;83048693;196051;
31.01.2019;03:38:04;83244819;83048790;196029;
31.01.2019;03:39:06;83244891;83048876;196015;
31.01.2019;03:40:05;83244959;83048980;195979;
31.01.2019;03:41:04;83245029;83049096;195933;
31.01.2019;03:42:04;83245085;83049178;195907;
31.01.2019;03:43:05;83245159;83049268;195891;
31.01.2019;03:44:05;83245249;83049358;195891;
31.01.2019;03:45:04;83245316;83049459;195857;
31.01.2019;03:46:04;83245389;83049563;195826;
31.01.2019;03:47:06;83245475;83049662;195813;
31.01.2019;03:48:04;83245552;83049758;195794;
31.01.2019;03:49:05;83245609;83049849;195760;
31.01.2019;03:50:04;83245695;83049961;195734;
31.01.2019;03:51:04;83245761;83050054;195707;
31.01.2019;03:52:05;83245848;83050151;195697;
31.01.2019;03:53:04;83245930;83050250;195680;
31.01.2019;03:54:04;83245993;83050342;195651;
31.01.2019;03:55:05;83246062;83050424;195638;
31.01.2019;03:56:05;83246128;83050506;195622;
31.01.2019;03:57:04;83246193;83050628;195565;
31.01.2019;03:58:04;83246257;83050719;195538;
31.01.2019;03:59:05;83246317;83050816;195501;
31.01.2019;04:00:05;83246390;83050908;195482;
31.01.2019;04:01:04;83246452;83051007;195445;
31.01.2019;04:02:04;83246540;83051088;195452;
31.01.2019;04:03:04;83246609;83051180;195429;
31.01.2019;04:04:05;83246689;83051300;195389;
31.01.2019;04:05:05;83246776;83051397;195379;
31.01.2019;04:06:05;83246849;83051506;195343;
31.01.2019;04:07:04;83246859;83051595;195264;
31.01.2019;04:08:04;83246919;83051701;195218;
31.01.2019;04:09:05;83246984;83051799;195185;
31.01.2019;04:10:04;83247058;83051891;195167;
31.01.2019;04:11:04;83247125;83051994;195131;
31.01.2019;04:12:05;83247199;83052092;195107;
31.01.2019;04:13:05;83247247;83052197;195050;
31.01.2019;04:14:04;83247299;83052323;194976;
31.01.2019;04:15:04;83247341;83052424;194917;
31.01.2019;04:16:05;83247394;83052527;194867;
31.01.2019;04:17:05;83247440;83052621;194819;
31.01.2019;04:18:04;83247498;83052719;194779;
31.01.2019;04:19:04;83247552;83052811;194741;
31.01.2019;04:20:05;83247600;83052891;194709;
31.01.2019;04:21:05;83247668;83052968;194700;
31.01.2019;04:22:04;83247717;83053063;194654;
31.01.2019;04:23:04;83247795;83053153;194642;
31.01.2019;04:24:05;83247852;83053226;194626;
31.01.2019;04:25:04;83247893;83053322;194571;
31.01.2019;04:26:04;83247952;83053431;194521;
31.01.2019;04:27:04;83247985;83053531;194454;
31.01.2019;04:28:05;83248053;83053612;194441;
31.01.2019;04:29:05;83248102;83053717;194385;
31.01.2019;04:30:04;83248165;83053815;194350;
31.01.2019;04:31:04;83248227;83053911;194316;
31.01.2019;04:32:05;83248293;83054000;194293;
31.01.2019;04:33:04;83248366;83054087;194279;
31.01.2019;04:34:05;83248439;83054203;194236;
31.01.2019;04:35:04;83248493;83054294;194199;
31.01.2019;04:36:04;83248558;83054373;194185;
31.01.2019;04:37:05;83248620;83054467;194153;
31.01.2019;04:38:05;83248695;83054568;194127;
31.01.2019;04:39:07;83248764;83054671;194093;
31.01.2019;04:40:04;83248837;83054768;194069;
31.01.2019;04:41:05;83248905;83054864;194041;
31.01.2019;04:42:05;83248969;83054946;194023;
31.01.2019;04:43:04;83249026;83055051;193975;
31.01.2019;04:44:05;83249097;83055145;193952;
31.01.2019;04:45:05;83249170;83055237;193933;
31.01.2019;04:46:04;83249246;83055348;193898;
31.01.2019;04:47:05;83249310;83055468;193842;
31.01.2019;04:48:05;83249388;83055554;193834;
31.01.2019;04:49:04;83249490;83055654;193836;
31.01.2019;04:50:04;83249558;83055738;193820;
31.01.2019;04:51:05;83249613;83055832;193781;
31.01.2019;04:52:04;83249684;83055933;193751;
31.01.2019;04:53:04;83249756;83056040;193716;
31.01.2019;04:54:05;83249841;83056134;193707;
31.01.2019;04:55:05;83249905;83056221;193684;
31.01.2019;04:56:05;83249991;83056342;193649;
31.01.2019;04:57:04;83250059;83056437;193622;
31.01.2019;04:58:04;83250115;83056537;193578;
31.01.2019;04:59:05;83250191;83056633;193558;
31.01.2019;05:00:04;83250245;83056728;193517;
31.01.2019;05:01:05;83250315;83056836;193479;
31.01.2019;05:02:05;83250371;83056936;193435;
31.01.2019;05:03:04;83250436;83057025;193411;
31.01.2019;05:04:05;83250502;83057136;193366;
31.01.2019;05:05:04;83250560;83057226;193334;
31.01.2019;05:06:05;83250628;83057318;193310;
31.01.2019;05:07:04;83250711;83057407;193304;
31.01.2019;05:08:04;83250784;83057510;193274;
31.01.2019;05:09:04;83250845;83057629;193216;
31.01.2019;05:10:04;83250932;83057740;193192;
31.01.2019;05:11:05;83251001;83057848;193153;
31.01.2019;05:12:04;83251064;83057943;193121;
31.01.2019;05:13:04;83251155;83058027;193128;
31.01.2019;05:14:05;83251223;83058128;193095;
31.01.2019;05:15:04;83251295;83058217;193078;
31.01.2019;05:16:04;83251377;83058338;193039;
31.01.2019;05:17:05;83251430;83058437;192993;
31.01.2019;05:18:05;83251501;83058530;192971;
31.01.2019;05:19:04;83251574;83058633;192941;
31.01.2019;05:20:04;83251643;83058731;192912;
31.01.2019;05:21:04;83251707;83058838;192869;
31.01.2019;05:22:05;83251759;83058944;192815;
31.01.2019;05:23:05;83251834;83059063;192771;
31.01.2019;05:24:04;83251903;83059170;192733;
31.01.2019;05:25:05;83251966;83059290;192676;
31.01.2019;05:26:05;83252029;83059383;192646;
31.01.2019;05:27:04;83252076;83059485;192591;
31.01.2019;05:28:04;83252136;83059584;192552;
31.01.2019;05:29:05;83252194;83059684;192510;
31.01.2019;05:30:05;83252254;83059783;192471;
31.01.2019;05:31:04;83252333;83059906;192427;
31.01.2019;05:32:04;83252392;83060015;192377;
31.01.2019;05:33:05;83252477;83060116;192361;
31.01.2019;05:34:05;83252536;83060212;192324;
31.01.2019;05:35:04;83252616;83060318;192298;
31.01.2019;05:36:04;83252696;83060394;192302;
31.01.2019;05:37:05;83252756;83060492;192264;
31.01.2019;05:38:05;83252821;83060596;192225;
31.01.2019;05:39:04;83252872;83060689;192183;
31.01.2019;05:40:04;83252913;83060779;192134;
31.01.2019;05:41:05;83252951;83060873;192078;
31.01.2019;05:42:05;83252998;83060980;192018;
31.01.2019;05:43:05;83253075;83061083;191992;
31.01.2019;05:44:05;83253127;83061192;191935;
31.01.2019;05:45:04;83253206;83061308;191898;
31.01.2019;05:46:05;83253281;83061404;191877;
31.01.2019;05:47:05;83253353;83061505;191848;
31.01.2019;05:48:05;83253410;83061614;191796;
31.01.2019;05:49:04;83253477;83061717;191760;
31.01.2019;05:50:04;83253540;83061835;191705;
31.01.2019;05:51:05;83253591;83061904;191687;
31.01.2019;05:52:05;83253653;83062011;191642;
31.01.2019;05:53:04;83253724;83062125;191599;
31.01.2019;05:54:05;83253796;83062241;191555;
31.01.2019;05:55:05;83253866;83062351;191515;
31.01.2019;05:56:05;83253924;83062461;191463;
31.01.2019;05:57:04;83253993;83062567;191426;
31.01.2019;05:58:04;83254053;83062658;191395;
31.01.2019;05:59:05;83254113;83062770;191343;
31.01.2019;06:00:05;83254186;83062860;191326;
31.01.2019;06:01:04;83254238;83062952;191286;
31.01.2019;06:02:04;83254305;83063046;191259;
31.01.2019;06:03:05;83254368;83063142;191226;
31.01.2019;06:04:05;83254427;83063246;191181;
31.01.2019;06:05:05;83254493;83063347;191146;
31.01.2019;06:06:05;83254547;83063446;191101;
31.01.2019;06:08:05;83254673;83063663;191010;
31.01.2019;06:09:06;83254735;83063751;190984;
31.01.2019;06:10:05;83254810;83063862;190948;
31.01.2019;06:11:05;83254862;83063947;190915;
31.01.2019;06:12:05;83254925;83064036;190889;
31.01.2019;06:13:04;83254974;83064118;190856;
31.01.2019;06:14:04;83255026;83064207;190819;
31.01.2019;06:15:05;83255091;83064303;190788;
31.01.2019;06:16:04;83255141;83064404;190737;
31.01.2019;06:17:05;83255191;83064496;190695;
31.01.2019;06:18:04;83255240;83064590;190650;
31.01.2019;06:19:04;83255274;83064689;190585;
31.01.2019;06:20:05;83255331;83064801;190530;
31.01.2019;06:21:04;83255391;83064919;190472;
31.01.2019;06:22:04;83255439;83065020;190419;
31.01.2019;06:23:05;83255510;83065112;190398;
31.01.2019;06:24:05;83255568;83065196;190372;
31.01.2019;06:25:07;83255638;83065300;190338;
31.01.2019;06:26:04;83255700;83065400;190300;
31.01.2019;06:27:05;83255766;83065507;190259;
31.01.2019;06:28:05;83255821;83065612;190209;
31.01.2019;06:29:05;83255891;83065718;190173;
31.01.2019;06:30:04;83255964;83065822;190142;
31.01.2019;06:31:07;83256022;83065919;190103;
31.01.2019;06:32:05;83256085;83066020;190065;
31.01.2019;06:33:05;83256139;83066134;190005;
31.01.2019;06:34:04;83256207;83066255;189952;
31.01.2019;06:35:04;83256280;83066376;189904;
31.01.2019;06:36:05;83256342;83066497;189845;
31.01.2019;06:37:05;83256409;83066594;189815;
31.01.2019;06:38:04;83256477;83066703;189774;
31.01.2019;06:39:06;83256540;83066807;189733;
31.01.2019;06:40:05;83256607;83066898;189709;
31.01.2019;06:41:04;83256651;83067016;189635;
31.01.2019;06:42:05;83256727;83067095;189632;
31.01.2019;06:43:05;83256772;83067187;189585;
31.01.2019;06:44:05;83256826;83067294;189532;
31.01.2019;06:45:04;83256876;83067415;189461;
31.01.2019;06:46:04;83256931;83067513;189418;
31.01.2019;06:47:05;83256980;83067621;189359;
31.01.2019;06:48:04;83257044;83067701;189343;
31.01.2019;06:49:04;83257116;83067824;189292;
31.01.2019;06:50:05;83257163;83067918;189245;
31.01.2019;06:51:04;83257225;83068017;189208;
31.01.2019;06:52:04;83257285;83068124;189161;
31.01.2019;06:53:05;83257335;83068235;189100;
31.01.2019;06:54:05;83257403;83068341;189062;
31.01.2019;06:55:04;83257470;83068457;189013;
31.01.2019;06:56:04;83257530;83068563;188967;
31.01.2019;06:57:05;83257581;83068672;188909;
31.01.2019;06:58:05;83257634;83068774;188860;
31.01.2019;06:59:04;83257695;83068883;188812;
31.01.2019;07:00:05;83257760;83068982;188778;
31.01.2019;07:01:04;83257816;83069085;188731;
31.01.2019;07:02:04;83257882;83069188;188694;
31.01.2019;07:03:04;83257937;83069273;188664;
31.01.2019;07:04:05;83257996;83069375;188621;
31.01.2019;07:05:04;83258046;83069458;188588;
31.01.2019;07:06:04;83258106;83069583;188523;
31.01.2019;07:07:05;83258165;83069709;188456;
31.01.2019;07:08:05;83258207;83069828;188379;
31.01.2019;07:09:06;83258265;83069940;188325;
31.01.2019;07:10:04;83258322;83070043;188279;
31.01.2019;07:11:04;83258369;83070177;188192;
31.01.2019;07:12:05;83258431;83070275;188156;
31.01.2019;07:13:05;83258485;83070385;188100;
31.01.2019;07:14:05;83258543;83070504;188039;
31.01.2019;07:15:05;83258599;83070610;187989;
31.01.2019;07:16:05;83258653;83070729;187924;
31.01.2019;07:17:05;83258697;83070848;187849;
31.01.2019;07:18:04;83258727;83070949;187778;
31.01.2019;07:19:04;83258832;83071073;187759;
31.01.2019;07:20:05;83258899;83071194;187705;
31.01.2019;07:21:04;83258957;83071312;187645;
31.01.2019;07:22:04;83259019;83071432;187587;
31.01.2019;07:23:05;83259058;83071568;187490;
31.01.2019;07:24:04;83259097;83071661;187436;
31.01.2019;07:25:05;83259163;83071785;187378;
31.01.2019;07:26:05;83259207;83071884;187323;
31.01.2019;07:27:04;83259252;83071988;187264;
31.01.2019;07:28:04;83259304;83072099;187205;
31.01.2019;07:29:05;83259364;83072216;187148;
31.01.2019;07:30:05;83259429;83072318;187111;
31.01.2019;07:31:04;83259498;83072367;187131;
31.01.2019;07:32:10;83259551;83072549;187002;
31.01.2019;07:33:05;83259606;83072630;186976;
31.01.2019;07:34:05;83259654;83072749;186905;
31.01.2019;07:35:05;83259725;83072861;186864;
31.01.2019;07:36:05;83259768;83072971;186797;
31.01.2019;07:37:04;83259813;83073074;186739;
31.01.2019;07:38:05;83259873;83073194;186679;
31.01.2019;07:39:05;83259930;83073281;186649;
31.01.2019;07:40:05;83259982;83073399;186583;
31.01.2019;07:41:05;83259995;83073503;186492;
31.01.2019;07:42:04;83260011;83073591;186420;
31.01.2019;07:43:04;83260058;83073692;186366;
31.01.2019;07:44:04;83260123;83073809;186314;
31.01.2019;07:45:05;83260177;83073946;186231;
31.01.2019;07:46:05;83260222;83074046;186176;
31.01.2019;07:47:05;83260285;83074152;186133;
31.01.2019;07:48:05;83260337;83074251;186086;
31.01.2019;07:49:04;83260394;83074365;186029;
31.01.2019;07:50:04;83260445;83074474;185971;
31.01.2019;07:51:05;83260496;83074590;185906;
31.01.2019;07:52:05;83260557;83074692;185865;
31.01.2019;07:53:05;83260616;83074786;185830;
31.01.2019;07:54:04;83260663;83074890;185773;
31.01.2019;07:55:05;83260716;83075002;185714;
31.01.2019;07:56:05;83260789;83075131;185658;
31.01.2019;07:57:05;83260846;83075243;185603;
31.01.2019;07:58:05;83260912;83075329;185583;
31.01.2019;07:59:04;83260963;83075436;185527;
31.01.2019;08:00:05;83261017;83075568;185449;
31.01.2019;08:01:05;83261054;83075686;185368;
31.01.2019;08:02:04;83261097;83075797;185300;
31.01.2019;08:03:04;83261168;83075895;185273;
31.01.2019;08:04:05;83261215;83076009;185206;
31.01.2019;08:05:05;83261273;83076099;185174;
31.01.2019;08:06:04;83261327;83076214;185113;
31.01.2019;08:07:05;83261374;83076329;185045;
31.01.2019;08:08:05;83261421;83076433;184988;
31.01.2019;08:09:05;83261484;83076566;184918;
31.01.2019;08:10:05;83261522;83076687;184835;
31.01.2019;08:11:04;83261569;83076794;184775;
31.01.2019;08:12:04;83261614;83076880;184734;
31.01.2019;08:13:05;83261650;83076983;184667;
31.01.2019;08:14:04;83261681;83077046;184635;
31.01.2019;08:15:05;83261720;83077146;184574;
31.01.2019;08:16:04;83261757;83077237;184520;
31.01.2019;08:17:04;83261800;83077335;184465;
31.01.2019;08:18:04;83261820;83077410;184410;
31.01.2019;08:19:05;83261871;83077511;184360;
31.01.2019;08:20:05;83261898;83077614;184284;
31.01.2019;08:21:04;83261935;83077712;184223;
31.01.2019;08:22:04;83261984;83077827;184157;
31.01.2019;08:23:05;83262024;83077941;184083;
31.01.2019;08:24:05;83262068;83078062;184006;
31.01.2019;08:25:05;83262109;83078163;183946;
31.01.2019;08:26:04;83262155;83078262;183893;
31.01.2019;08:27:05;83262207;83078386;183821;
31.01.2019;08:28:04;83262261;83078492;183769;
31.01.2019;08:29:05;83262300;83078590;183710;
31.01.2019;08:30:05;83262344;83078711;183633;
31.01.2019;08:31:05;83262387;83078838;183549;
31.01.2019;08:32:05;83262431;83078958;183473;
31.01.2019;08:33:05;83262473;83079075;183398;
31.01.2019;08:34:05;83262526;83079190;183336;
31.01.2019;08:35:04;83262567;83079290;183277;
31.01.2019;08:36:04;83262609;83079396;183213;
31.01.2019;08:37:04;83262652;83079522;183130;
31.01.2019;08:38:04;83262689;83079610;183079;
31.01.2019;08:39:05;83262740;83079706;183034;
31.01.2019;08:40:05;83262795;83079827;182968;
31.01.2019;08:41:04;83262832;83079943;182889;
31.01.2019;08:42:05;83262880;83080037;182843;
31.01.2019;08:43:05;83262927;83080134;182793;
31.01.2019;08:44:04;83262982;83080226;182756;
31.01.2019;08:45:04;83263023;83080340;182683;
31.01.2019;08:46:05;83263081;83080436;182645;
31.01.2019;08:47:05;83263136;83080567;182569;
31.01.2019;08:48:05;83263178;83080674;182504;
31.01.2019;08:49:04;83263221;83080768;182453;
31.01.2019;08:50:05;83263291;83080878;182413;
31.01.2019;08:51:05;83263330;83080989;182341;
31.01.2019;08:52:05;83263379;83081102;182277;
31.01.2019;08:53:05;83263418;83081214;182204;
31.01.2019;08:54:05;83263470;83081333;182137;
31.01.2019;08:55:05;83263524;83081447;182077;
31.01.2019;08:56:05;83263567;83081542;182025;
31.01.2019;08:57:05;83263620;83081649;181971;
31.01.2019;08:58:04;83263677;83081751;181926;
31.01.2019;08:59:04;83263731;83081866;181865;
31.01.2019;09:00:05;83263780;83081979;181801;
31.01.2019;09:01:05;83263839;83082090;181749;
31.01.2019;09:02:05;83263870;83082193;181677;
31.01.2019;09:03:04;83263905;83082319;181586;
31.01.2019;09:04:05;83263967;83082443;181524;
31.01.2019;09:05:05;83264018;83082560;181458;
31.01.2019;09:06:05;83264083;83082682;181401;
31.01.2019;09:07:04;83264140;83082790;181350;
31.01.2019;09:08:04;83264183;83082883;181300;
31.01.2019;09:09:07;83264241;83083018;181223;
31.01.2019;09:10:05;83264279;83083121;181158;
31.01.2019;09:11:04;83264346;83083245;181101;
31.01.2019;09:12:04;83264385;83083377;181008;
31.01.2019;09:13:04;83264443;83083509;180934;
31.01.2019;09:14:05;83264489;83083624;180865;
31.01.2019;09:15:05;83264542;83083731;180811;
31.01.2019;09:16:04;83264580;83083851;180729;
31.01.2019;09:17:04;83264632;83083961;180671;
31.01.2019;09:18:04;83264685;83084078;180607;
31.01.2019;09:19:05;83264735;83084200;180535;
31.01.2019;09:20:05;83264776;83084318;180458;
31.01.2019;09:21:05;83264821;83084455;180366;
31.01.2019;09:22:05;83264874;83084572;180302;
31.01.2019;09:23:05;83264934;83084701;180233;
31.01.2019;09:24:05;83264988;83084825;180163;
31.01.2019;09:25:05;83265032;83084939;180093;
31.01.2019;09:26:04;83265079;83085044;180035;
31.01.2019;09:27:05;83265133;83085150;179983;
31.01.2019;09:28:05;83265202;83085279;179923;
31.01.2019;09:29:04;83265252;83085401;179851;
31.01.2019;09:30:04;83265316;83085524;179792;
31.01.2019;09:31:04;83265384;83085650;179734;
31.01.2019;09:32:05;83265438;83085769;179669;
31.01.2019;09:33:05;83265494;83085889;179605;
31.01.2019;09:34:05;83265546;83085942;179604;
31.01.2019;09:35:04;83265596;83086042;179554;
31.01.2019;09:36:04;83265639;83086086;179553;
31.01.2019;09:37:04;83265698;83086154;179544;
31.01.2019;09:38:05;83265750;83086257;179493;
31.01.2019;09:39:05;83265794;83086354;179440;
31.01.2019;09:40:07;83265830;83086449;179381;
31.01.2019;09:41:07;83265881;83086534;179347;
31.01.2019;09:42:06;83265936;83086622;179314;
31.01.2019;09:43:05;83265991;83086713;179278;
31.01.2019;09:44:05;83266035;83086813;179222;
31.01.2019;09:45:06;83266073;83086899;179174;
31.01.2019;09:46:05;83266117;83086991;179126;
31.01.2019;09:47:04;83266166;83087096;179070;
31.01.2019;09:48:05;83266209;83087210;178999;
31.01.2019;09:49:05;83266248;83087295;178953;
31.01.2019;09:50:05;83266285;83087409;178876;
31.01.2019;09:51:05;83266322;83087520;178802;
31.01.2019;09:52:05;83266355;83087625;178730;
31.01.2019;09:53:04;83266404;83087739;178665;
31.01.2019;09:54:04;83266455;83087849;178606;
31.01.2019;09:55:04;83266514;83087944;178570;
31.01.2019;09:56:05;83266550;83088039;178511;
31.01.2019;09:57:05;83266594;83088145;178449;
31.01.2019;09:58:04;83266610;83088242;178368;
31.01.2019;09:59:05;83266660;83088351;178309;
31.01.2019;10:00:04;83266698;83088447;178251;
31.01.2019;10:01:04;83266737;83088570;178167;
31.01.2019;10:02:05;83266774;83088676;178098;
31.01.2019;10:03:05;83266838;83088780;178058;
31.01.2019;10:04:05;83266886;83088907;177979;
31.01.2019;10:05:04;83266926;83089021;177905;
31.01.2019;10:06:05;83266960;83089140;177820;
31.01.2019;10:07:05;83267024;83089235;177789;
31.01.2019;10:08:04;83267050;83089347;177703;
31.01.2019;10:09:04;83267076;83089422;177654;
31.01.2019;10:10:05;83267110;83089506;177604;
31.01.2019;10:11:05;83267167;83089648;177519;
31.01.2019;10:12:05;83267216;83089754;177462;
31.01.2019;10:13:05;83267272;83089883;177389;
31.01.2019;10:14:05;83267300;83090012;177288;
31.01.2019;10:15:04;83267343;83090116;177227;
31.01.2019;10:16:04;83267369;83090231;177138;
31.01.2019;10:17:06;83267402;83090337;177065;
31.01.2019;10:18:05;83267425;83090427;176998;
31.01.2019;10:19:05;83267467;83090533;176934;
31.01.2019;10:20:05;83267492;83090623;176869;
31.01.2019;10:21:05;83267518;83090700;176818;
31.01.2019;10:22:05;83267535;83090807;176728;
31.01.2019;10:23:05;83267577;83090922;176655;
31.01.2019;10:24:05;83267608;83091026;176582;
31.01.2019;10:25:05;83267637;83091127;176510;
31.01.2019;10:26:05;83267677;83091225;176452;
31.01.2019;10:27:05;83267712;83091316;176396;
31.01.2019;10:28:05;83267755;83091412;176343;
31.01.2019;10:29:04;83267791;83091521;176270;
31.01.2019;10:30:04;83267840;83091640;176200;
31.01.2019;10:31:04;83267895;83091731;176164;
31.01.2019;10:32:05;83267935;83091844;176091;
31.01.2019;10:33:06;83267987;83091980;176007;
31.01.2019;10:34:05;83268030;83092096;175934;
31.01.2019;10:35:04;83268075;83092196;175879;
31.01.2019;10:36:06;83268126;83092322;175804;
31.01.2019;10:37:05;83268184;83092448;175736;
31.01.2019;10:38:05;83268241;83092550;175691;
31.01.2019;10:39:06;83268293;83092669;175624;
31.01.2019;10:40:05;83268330;83092794;175536;
31.01.2019;10:41:05;83268378;83092910;175468;
31.01.2019;10:42:06;83268430;83093028;175402;
31.01.2019;10:43:04;83268481;83093156;175325;
31.01.2019;10:44:04;83268539;83093276;175263;
31.01.2019;10:45:04;83268587;83093394;175193;
31.01.2019;10:46:06;83268634;83093524;175110;
31.01.2019;10:47:05;83268686;83093633;175053;
31.01.2019;10:48:05;83268738;83093782;174956;
31.01.2019;10:49:05;83268776;83093915;174861;
31.01.2019;10:50:04;83268819;83094013;174806;
31.01.2019;10:51:04;83268860;83094126;174734;
31.01.2019;10:52:05;83268917;83094248;174669;
31.01.2019;10:53:05;83268958;83094369;174589;
31.01.2019;10:54:04;83269022;83094471;174551;
31.01.2019;10:55:04;83269073;83094592;174481;
31.01.2019;10:56:05;83269112;83094731;174381;
31.01.2019;10:57:05;83269162;83094854;174308;
31.01.2019;10:58:04;83269206;83094986;174220;
31.01.2019;10:59:04;83269251;83095083;174168;
31.01.2019;11:00:05;83269293;83095207;174086;
31.01.2019;11:01:04;83269337;83095340;173997;
31.01.2019;11:02:05;83269389;83095457;173932;
31.01.2019;11:03:05;83269429;83095603;173826;
31.01.2019;11:04:04;83269474;83095733;173741;
31.01.2019;11:05:04;83269518;83095856;173662;
31.01.2019;11:06:04;83269569;83095962;173607;
31.01.2019;11:07:05;83269625;83096078;173547;
31.01.2019;11:08:04;83269683;83096174;173509;
31.01.2019;11:09:06;83269729;83096294;173435;
31.01.2019;11:10:05;83269759;83096394;173365;
31.01.2019;11:11:05;83269814;83096518;173296;
31.01.2019;11:12:05;83269865;83096639;173226;
31.01.2019;11:13:05;83269919;83096757;173162;
31.01.2019;11:14:10;83269963;83096892;173071;
31.01.2019;11:15:05;83270010;83097010;173000;
31.01.2019;11:16:04;83270068;83097135;172933;
31.01.2019;11:17:04;83270117;83097245;172872;
31.01.2019;11:18:04;83270159;83097357;172802;
31.01.2019;11:19:05;83270210;83097489;172721;
31.01.2019;11:20:05;83270264;83097609;172655;
31.01.2019;11:21:04;83270298;83097728;172570;
31.01.2019;11:22:04;83270367;83097858;172509;
31.01.2019;11:23:05;83270423;83097959;172464;
31.01.2019;11:24:05;83270481;83098081;172400;
31.01.2019;11:25:05;83270510;83098231;172279;
31.01.2019;11:26:05;83270551;83098343;172208;
31.01.2019;11:27:04;83270606;83098460;172146;
31.01.2019;11:28:05;83270647;83098557;172090;
31.01.2019;11:29:05;83270690;83098659;172031;
31.01.2019;11:30:04;83270736;83098786;171950;
31.01.2019;11:31:05;83270789;83098886;171903;
31.01.2019;11:32:05;83270839;83099005;171834;
31.01.2019;11:33:04;83270903;83099120;171783;
31.01.2019;11:34:04;83270942;83099247;171695;
31.01.2019;11:35:05;83270993;83099346;171647;
31.01.2019;11:36:04;83271047;83099461;171586;
31.01.2019;11:37:04;83271097;83099571;171526;
31.01.2019;11:38:05;83271143;83099671;171472;
31.01.2019;11:39:05;83271207;83099777;171430;
31.01.2019;11:40:05;83271245;83099889;171356;
31.01.2019;11:41:05;83271288;83099983;171305;
31.01.2019;11:42:04;83271325;83100103;171222;
31.01.2019;11:43:04;83271376;83100216;171160;
31.01.2019;11:44:06;83271425;83100330;171095;
31.01.2019;11:45:04;83271452;83100455;170997;
31.01.2019;11:46:05;83271495;83100559;170936;
31.01.2019;11:47:05;83271543;83100674;170869;
31.01.2019;11:48:04;83271600;83100796;170804;
31.01.2019;11:49:04;83271657;83100920;170737;
31.01.2019;11:50:05;83271685;83101032;170653;
31.01.2019;11:51:05;83271730;83101164;170566;
31.01.2019;11:52:05;83271784;83101296;170488;
31.01.2019;11:53:04;83271825;83101392;170433;
31.01.2019;11:54:05;83271881;83101518;170363;
31.01.2019;11:55:04;83271931;83101636;170295;
31.01.2019;11:56:05;83271963;83101752;170211;
31.01.2019;11:57:04;83272025;83101881;170144;
31.01.2019;11:58:05;83272056;83102000;170056;
31.01.2019;11:59:05;83272111;83102109;170002;
31.01.2019;12:00:04;83272163;83102220;169943;
31.01.2019;12:01:04;83272212;83102349;169863;
31.01.2019;12:02:04;83272264;83102467;169797;
31.01.2019;12:03:05;83272316;83102580;169736;
31.01.2019;12:04:04;83272364;83102681;169683;
31.01.2019;12:05:04;83272423;83102779;169644;
31.01.2019;12:06:05;83272486;83102910;169576;
31.01.2019;12:07:05;83272544;83103010;169534;
31.01.2019;12:08:04;83272609;83103138;169471;
31.01.2019;12:09:04;83272658;83103245;169413;
31.01.2019;12:10:04;83272703;83103326;169377;
31.01.2019;12:11:05;83272726;83103416;169310;
31.01.2019;12:12:05;83272735;83103506;169229;
31.01.2019;12:13:04;83272755;83103600;169155;
31.01.2019;12:14:04;83272777;83103693;169084;
31.01.2019;12:15:04;83272802;83103810;168992;
31.01.2019;12:16:05;83272857;83103930;168927;
31.01.2019;12:17:04;83272902;83104048;168854;
31.01.2019;12:18:04;83272941;83104150;168791;
31.01.2019;12:19:05;83272985;83104260;168725;
31.01.2019;12:20:05;83273047;83104370;168677;
31.01.2019;12:21:04;83273098;83104496;168602;
31.01.2019;12:22:04;83273170;83104620;168550;
31.01.2019;12:23:05;83273223;83104763;168460;
31.01.2019;12:24:05;83273252;83104878;168374;
31.01.2019;12:25:05;83273307;83105007;168300;
31.01.2019;12:26:05;83273347;83105137;168210;
31.01.2019;12:27:04;83273389;83105228;168161;
31.01.2019;12:28:04;83273435;83105320;168115;
31.01.2019;12:29:05;83273494;83105446;168048;
31.01.2019;12:30:04;83273539;83105571;167968;
31.01.2019;12:31:04;83273582;83105673;167909;
31.01.2019;12:32:04;83273634;83105787;167847;
31.01.2019;12:33:05;83273683;83105883;167800;
31.01.2019;12:34:05;83273715;83105972;167743;
31.01.2019;12:35:06;83273785;83106071;167714;
31.01.2019;12:36:04;83273836;83106149;167687;
31.01.2019;12:37:05;83273893;83106271;167622;
31.01.2019;12:38:04;83273950;83106364;167586;
31.01.2019;12:39:07;83274005;83106467;167538;
31.01.2019;12:40:07;83274058;83106575;167483;
31.01.2019;12:41:04;83274108;83106658;167450;
31.01.2019;12:42:05;83274156;83106775;167381;
31.01.2019;12:43:04;83274210;83106847;167363;
31.01.2019;12:44:04;83274278;83106961;167317;
31.01.2019;12:45:05;83274337;83107066;167271;
31.01.2019;12:46:04;83274390;83107193;167197;
31.01.2019;12:47:04;83274456;83107309;167147;
31.01.2019;12:48:05;83274524;83107410;167114;
31.01.2019;12:49:05;83274583;83107527;167056;
31.01.2019;12:50:04;83274644;83107655;166989;
31.01.2019;12:51:04;83274699;83107775;166924;
31.01.2019;12:52:05;83274764;83107898;166866;
31.01.2019;12:53:05;83274811;83107998;166813;
31.01.2019;12:54:04;83274875;83108113;166762;
31.01.2019;12:55:04;83274930;83108217;166713;
31.01.2019;12:56:04;83274978;83108321;166657;
31.01.2019;12:57:05;83275058;83108420;166638;
31.01.2019;12:58:05;83275118;83108548;166570;
31.01.2019;12:59:04;83275177;83108660;166517;
31.01.2019;13:00:04;83275240;83108748;166492;
31.01.2019;13:01:05;83275305;83108847;166458;
31.01.2019;13:02:09;83275367;83108987;166380;
31.01.2019;13:03:04;83275414;83109072;166342;
31.01.2019;13:04:04;83275482;83109188;166294;
31.01.2019;13:05:05;83275548;83109294;166254;
31.01.2019;13:06:04;83275609;83109390;166219;
31.01.2019;13:07:04;83275674;83109511;166163;
31.01.2019;13:08:04;83275708;83109630;166078;
31.01.2019;13:09:04;83275655;83109645;166010;
31.01.2019;13:10:05;83275253;83109331;165922;
31.01.2019;13:11:05;83275294;83109438;165856;
31.01.2019;13:12:04;83275348;83109576;165772;
31.01.2019;13:13:04;83275417;83109700;165717;
31.01.2019;13:14:05;83275475;83109845;165630;
31.01.2019;13:15:04;83275542;83109956;165586;
31.01.2019;13:16:05;83275605;83110087;165518;
31.01.2019;13:17:05;83275668;83110206;165462;
31.01.2019;13:18:05;83275734;83110314;165420;
31.01.2019;13:19:05;83275791;83110420;165371;
31.01.2019;13:20:05;83275857;83110539;165318;
31.01.2019;13:21:05;83275909;83110655;165254;
31.01.2019;13:22:05;83275979;83110769;165210;
31.01.2019;13:23:05;83276026;83110876;165150;
31.01.2019;13:24:05;83276080;83111015;165065;
31.01.2019;13:25:05;83276163;83111135;165028;
31.01.2019;13:26:04;83276241;83111248;164993;
31.01.2019;13:27:05;83276299;83111372;164927;
31.01.2019;13:28:05;83276364;83111492;164872;
31.01.2019;13:29:05;83276445;83111597;164848;
31.01.2019;13:30:04;83276501;83111721;164780;
31.01.2019;13:31:04;83276561;83111815;164746;
31.01.2019;13:32:05;83276623;83111935;164688;
31.01.2019;13:33:06;83276683;83112063;164620;
31.01.2019;13:34:05;83276729;83112176;164553;
31.01.2019;13:35:05;83276796;83112290;164506;
31.01.2019;13:36:05;83276868;83112399;164469;
31.01.2019;13:37:05;83276933;83112529;164404;
31.01.2019;13:38:10;83276994;83112672;164322;
31.01.2019;13:39:05;83277054;83112778;164276;
31.01.2019;13:40:04;83277122;83112902;164220;
31.01.2019;13:41:05;83277180;83113030;164150;
31.01.2019;13:42:05;83277239;83113168;164071;
31.01.2019;13:43:04;83277307;83113282;164025;
31.01.2019;13:44:04;83277373;83113396;163977;
31.01.2019;13:45:05;83277433;83113515;163918;
31.01.2019;13:46:05;83277506;83113644;163862;
31.01.2019;13:47:05;83277553;83113773;163780;
31.01.2019;13:48:04;83277635;83113891;163744;
31.01.2019;13:49:04;83277698;83114011;163687;
31.01.2019;13:50:04;83277766;83114151;163615;
31.01.2019;13:51:05;83277837;83114277;163560;
31.01.2019;13:52:05;83277909;83114391;163518;
31.01.2019;13:53:05;83277979;83114519;163460;
31.01.2019;13:54:05;83278052;83114627;163425;
31.01.2019;13:55:05;83278124;83114755;163369;
31.01.2019;13:56:05;83278207;83114886;163321;
31.01.2019;13:57:04;83278276;83114999;163277;
31.01.2019;13:58:04;83278350;83115134;163216;
31.01.2019;13:59:05;83278430;83115262;163168;
31.01.2019;14:00:05;83278503;83115376;163127;
31.01.2019;14:01:05;83278592;83115502;163090;
31.01.2019;14:02:05;83278676;83115646;163030;
31.01.2019;14:03:04;83278754;83115796;162958;
31.01.2019;14:04:04;83278782;83115922;162860;
31.01.2019;14:05:05;83278891;83116069;162822;
31.01.2019;14:06:05;83278958;83116170;162788;
31.01.2019;14:07:04;83279037;83116290;162747;
31.01.2019;14:08:04;83279124;83116429;162695;
31.01.2019;14:09:05;83279207;83116552;162655;
31.01.2019;14:10:05;83279300;83116688;162612;
31.01.2019;14:11:05;83279380;83116811;162569;
31.01.2019;14:12:05;83279451;83116958;162493;
31.01.2019;14:13:05;83279514;83117068;162446;
31.01.2019;14:14:10;83279581;83117218;162363;
31.01.2019;14:15:05;83279613;83117332;162281;
31.01.2019;14:16:06;83279692;83117460;162232;
31.01.2019;14:17:06;83279767;83117585;162182;
31.01.2019;14:18:05;83279816;83117714;162102;
31.01.2019;14:19:15;83279857;83117843;162014;
31.01.2019;14:20:06;83279901;83117904;161997;
31.01.2019;14:21:05;83279947;83118025;161922;
31.01.2019;14:22:05;83280017;83118097;161920;
31.01.2019;14:23:05;83280051;83118198;161853;
31.01.2019;14:24:05;83280126;83118333;161793;
31.01.2019;14:25:06;83280203;83118455;161748;
31.01.2019;14:26:05;83280266;83118570;161696;
31.01.2019;14:27:13;83280337;83118711;161626;
31.01.2019;14:28:05;83280357;83118801;161556;
31.01.2019;14:29:10;83280410;83118926;161484;
31.01.2019;14:30:06;83280475;83119048;161427;
31.01.2019;14:31:05;83280530;83119161;161369;
31.01.2019;14:32:07;83280589;83119263;161326;
31.01.2019;14:33:14;83280665;83119398;161267;
31.01.2019;14:34:05;83280730;83119512;161218;
31.01.2019;14:35:06;83280792;83119650;161142;
31.01.2019;14:36:06;83280860;83119769;161091;
31.01.2019;14:37:05;83280925;83119907;161018;
31.01.2019;14:38:05;83281002;83120000;161002;
31.01.2019;14:39:09;83281101;83120146;160955;
31.01.2019;14:40:05;83281184;83120288;160896;
31.01.2019;14:41:10;83281286;83120423;160863;
31.01.2019;14:42:06;83281359;83120559;160800;
31.01.2019;14:43:05;83281420;83120692;160728;
31.01.2019;14:44:05;83281506;83120839;160667;
31.01.2019;14:45:06;83281566;83120988;160578;
31.01.2019;14:46:10;83281632;83121166;160466;
31.01.2019;14:47:06;83281699;83121287;160412;
31.01.2019;14:48:05;83281776;83121402;160374;
31.01.2019;14:49:15;83281867;83121575;160292;
31.01.2019;14:50:06;83281943;83121680;160263;
31.01.2019;14:51:06;83282013;83121844;160169;
31.01.2019;14:52:05;83282079;83121976;160103;
31.01.2019;14:53:04;83282168;83122110;160058;
31.01.2019;14:54:05;83282253;83122248;160005;
31.01.2019;14:55:05;83282344;83122380;159964;
31.01.2019;14:56:05;83282427;83122515;159912;
31.01.2019;14:57:05;83282517;83122648;159869;
31.01.2019;14:58:06;83282589;83122784;159805;
31.01.2019;14:59:05;83282666;83122912;159754;
31.01.2019;15:00:08;83282755;83123035;159720;
31.01.2019;15:01:08;83282857;83123162;159695;
31.01.2019;15:02:08;83282922;83123277;159645;
31.01.2019;15:03:09;83283008;83123412;159596;
31.01.2019;15:04:12;83283119;83123550;159569;
31.01.2019;15:05:08;83283196;83123665;159531;
31.01.2019;15:06:09;83283274;83123807;159467;
31.01.2019;15:07:08;83283354;83123924;159430;
31.01.2019;15:08:08;83283416;83124059;159357;
31.01.2019;15:09:07;83283497;83124223;159274;
31.01.2019;15:10:08;83283576;83124375;159201;
31.01.2019;15:11:08;83283653;83124510;159143;
31.01.2019;15:12:09;83283729;83124639;159090;
31.01.2019;15:13:09;83283807;83124782;159025;
31.01.2019;15:14:13;83283888;83124957;158931;
31.01.2019;15:15:10;83283966;83125106;158860;
31.01.2019;15:16:08;83284044;83125237;158807;
31.01.2019;15:17:08;83284132;83125373;158759;
31.01.2019;15:18:08;83284214;83125507;158707;
31.01.2019;15:19:08;83284278;83125633;158645;
31.01.2019;15:20:11;83284354;83125798;158556;
31.01.2019;15:21:11;83284434;83125921;158513;
31.01.2019;15:22:10;83284519;83126075;158444;
31.01.2019;15:23:06;83284577;83126196;158381;
31.01.2019;15:24:18;83284656;83126370;158286;
31.01.2019;15:25:10;83284744;83126490;158254;
31.01.2019;15:26:08;83284824;83126633;158191;
31.01.2019;15:27:08;83284895;83126729;158166;
31.01.2019;15:28:08;83284969;83126895;158074;
31.01.2019;15:29:09;83285076;83127043;158033;
31.01.2019;15:30:07;83285146;83127188;157958;
31.01.2019;15:31:07;83285225;83127312;157913;
31.01.2019;15:32:07;83285310;83127457;157853;
31.01.2019;15:33:08;83285363;83127602;157761;
31.01.2019;15:34:13;83285445;83127733;157712;
31.01.2019;15:35:13;83285519;83127871;157648;
31.01.2019;15:36:12;83285619;83128000;157619;
31.01.2019;15:37:11;83285698;83128131;157567;
31.01.2019;15:38:12;83285790;83128274;157516;
31.01.2019;15:39:10;83285864;83128420;157444;
31.01.2019;15:40:08;83285964;83128547;157417;
31.01.2019;15:41:09;83286033;83128687;157346;
31.01.2019;15:42:09;83286092;83128820;157272;
31.01.2019;15:43:09;83286181;83128962;157219;
31.01.2019;15:44:08;83286249;83129116;157133;
31.01.2019;15:45:08;83286347;83129279;157068;
31.01.2019;15:46:17;83286433;83129433;157000;
31.01.2019;15:47:08;83286495;83129547;156948;
31.01.2019;15:48:08;83286595;83129670;156925;
31.01.2019;15:49:09;83286676;83129821;156855;
31.01.2019;15:50:09;83286731;83129960;156771;
31.01.2019;15:51:07;83286813;83130105;156708;
31.01.2019;15:52:08;83286899;83130236;156663;
31.01.2019;15:53:09;83286970;83130386;156584;
31.01.2019;15:54:08;83287053;83130532;156521;
31.01.2019;15:55:09;83287109;83130675;156434;
31.01.2019;15:56:10;83287197;83130832;156365;
31.01.2019;15:57:13;83287290;83130997;156293;
31.01.2019;15:58:08;83287362;83131134;156228;
31.01.2019;15:59:09;83287455;83131274;156181;
31.01.2019;16:00:06;83287523;83131398;156125;
31.01.2019;16:01:04;83287627;83131525;156102;
31.01.2019;16:02:05;83287693;83131679;156014;
31.01.2019;16:03:07;83287755;83131819;155936;
31.01.2019;16:04:11;83287842;83131966;155876;
31.01.2019;16:05:06;83287914;83132092;155822;
31.01.2019;16:06:05;83287993;83132238;155755;
31.01.2019;16:07:05;83288104;83132392;155712;
31.01.2019;16:08:06;83288200;83132560;155640;
31.01.2019;16:09:08;83288270;83132719;155551;
31.01.2019;16:10:05;83288349;83132850;155499;
31.01.2019;16:11:05;83288436;83132997;155439;
31.01.2019;16:12:07;83288540;83133135;155405;
31.01.2019;16:13:05;83288618;83133266;155352;
31.01.2019;16:14:05;83288709;83133421;155288;
31.01.2019;16:15:06;83288798;83133555;155243;
31.01.2019;16:16:05;83288879;83133723;155156;
31.01.2019;16:17:16;83288999;83133883;155116;
31.01.2019;16:18:06;83289051;83134010;155041;
31.01.2019;16:19:06;83289124;83134158;154966;
31.01.2019;16:20:05;83289185;83134292;154893;
31.01.2019;16:21:04;83289266;83134428;154838;
31.01.2019;16:22:05;83289332;83134590;154742;
31.01.2019;16:23:05;83289395;83134730;154665;
31.01.2019;16:24:05;83289475;83134870;154605;
31.01.2019;16:25:10;83289523;83135026;154497;
31.01.2019;16:26:06;83289557;83135141;154416;
31.01.2019;16:27:05;83289652;83135291;154361;
31.01.2019;16:28:06;83289727;83135419;154308;
31.01.2019;16:29:11;83289800;83135579;154221;
31.01.2019;16:30:08;83289892;83135715;154177;
31.01.2019;16:31:08;83289955;83135862;154093;
31.01.2019;16:32:05;83290031;83136009;154022;
31.01.2019;16:33:06;83290108;83136133;153975;
31.01.2019;16:34:04;83290180;83136255;153925;
31.01.2019;16:35:10;83290254;83136389;153865;
31.01.2019;16:36:05;83290306;83136519;153787;
31.01.2019;16:37:05;83290396;83136647;153749;
31.01.2019;16:38:07;83290499;83136775;153724;
31.01.2019;16:39:06;83290572;83136925;153647;
31.01.2019;16:40:20;83290657;83137098;153559;
31.01.2019;16:41:06;83290744;83137216;153528;
31.01.2019;16:42:07;83290833;83137347;153486;
31.01.2019;16:43:06;83290932;83137500;153432;
31.01.2019;16:44:12;83291025;83137675;153350;
31.01.2019;16:45:05;83291094;83137793;153301;
31.01.2019;16:46:06;83291184;83137945;153239;
31.01.2019;16:47:10;83291274;83138092;153182;
31.01.2019;16:48:05;83291340;83138209;153131;
31.01.2019;16:50:05;83291507;83138520;152987;
31.01.2019;16:51:05;83291605;83138648;152957;
31.01.2019;16:52:05;83291696;83138782;152914;
31.01.2019;16:53:05;83291788;83138942;152846;
31.01.2019;16:54:06;83291877;83139066;152811;
31.01.2019;16:55:05;83291975;83139207;152768;
31.01.2019;16:56:05;83292062;83139334;152728;
31.01.2019;16:57:05;83292139;83139466;152673;
31.01.2019;16:58:05;83292220;83139623;152597;
31.01.2019;16:59:06;83292315;83139772;152543;
31.01.2019;17:00:06;83292419;83139917;152502;
31.01.2019;17:01:05;83292529;83140063;152466;
31.01.2019;17:02:05;83292589;83140211;152378;
31.01.2019;17:03:06;83292677;83140343;152334;
31.01.2019;17:04:05;83292761;83140496;152265;
31.01.2019;17:05:14;83292855;83140667;152188;
31.01.2019;17:06:05;83292923;83140788;152135;
31.01.2019;17:07:08;83292997;83140962;152035;
31.01.2019;17:08:05;83293070;83141120;151950;
31.01.2019;17:09:05;83293170;83141272;151898;
31.01.2019;17:10:05;83293245;83141414;151831;
31.01.2019;17:11:06;83293338;83141561;151777;
31.01.2019;17:12:07;83293412;83141738;151674;
31.01.2019;17:13:04;83293484;83141853;151631;
31.01.2019;17:14:07;83293577;83142007;151570;
31.01.2019;17:15:07;83293677;83142137;151540;
31.01.2019;17:16:06;83293772;83142292;151480;
31.01.2019;17:17:15;83293870;83142441;151429;
31.01.2019;17:18:05;83293938;83142572;151366;
31.01.2019;17:19:06;83294052;83142744;151308;
31.01.2019;17:20:05;83294131;83142885;151246;
31.01.2019;17:21:06;83294245;83143004;151241;
31.01.2019;17:22:07;83294344;83143125;151219;
31.01.2019;17:23:05;83294434;83143284;151150;
31.01.2019;17:24:07;83294541;83143432;151109;
31.01.2019;17:25:06;83294614;83143550;151064;
31.01.2019;17:26:06;83294697;83143680;151017;
31.01.2019;17:27:06;83294789;83143817;150972;
31.01.2019;17:28:06;83294903;83143951;150952;
31.01.2019;17:29:05;83294981;83144075;150906;
31.01.2019;17:30:06;83295076;83144218;150858;
31.01.2019;17:31:08;83295167;83144381;150786;
31.01.2019;17:32:05;83295246;83144515;150731;
31.01.2019;17:33:06;83295340;83144659;150681;
31.01.2019;17:34:05;83295418;83144813;150605;
31.01.2019;17:35:06;83295521;83144964;150557;
31.01.2019;17:36:06;83295605;83145089;150516;
31.01.2019;17:37:07;83295701;83145234;150467;
31.01.2019;17:38:06;83295788;83145385;150403;
31.01.2019;17:39:07;83295864;83145510;150354;
31.01.2019;17:40:09;83295968;83145692;150276;
31.01.2019;17:41:05;83296053;83145799;150254;
31.01.2019;17:42:05;83296145;83145927;150218;
31.01.2019;17:43:05;83296230;83146073;150157;
31.01.2019;17:44:11;83296329;83146221;150108;
31.01.2019;17:45:05;83296410;83146334;150076;
31.01.2019;17:46:05;83296517;83146490;150027;
31.01.2019;17:47:06;83296599;83146630;149969;
31.01.2019;17:48:06;83296719;83146774;149945;
31.01.2019;17:49:06;83296812;83146949;149863;
31.01.2019;17:50:06;83296883;83147065;149818;
31.01.2019;17:51:07;83296989;83147199;149790;
31.01.2019;17:52:07;83297084;83147357;149727;
31.01.2019;17:53:06;83297192;83147500;149692;
31.01.2019;17:54:05;83297238;83147640;149598;
31.01.2019;17:55:05;83297365;83147770;149595;
31.01.2019;17:56:05;83297445;83147891;149554;
31.01.2019;17:57:05;83297528;83148036;149492;
31.01.2019;17:58:04;83297627;83148178;149449;
31.01.2019;17:59:05;83297721;83148329;149392;
31.01.2019;18:00:05;83297805;83148482;149323;
31.01.2019;18:01:06;83297875;83148637;149238;
31.01.2019;18:02:04;83297950;83148739;149211;
31.01.2019;18:03:04;83298039;83148883;149156;
31.01.2019;18:04:05;83298122;83149010;149112;
31.01.2019;18:05:05;83298219;83149148;149071;
31.01.2019;18:06:04;83298321;83149280;149041;
31.01.2019;18:07:05;83298410;83149406;149004;
31.01.2019;18:08:05;83298513;83149515;148998;
31.01.2019;18:09:05;83298622;83149653;148969;
31.01.2019;18:10:04;83298690;83149785;148905;
31.01.2019;18:11:05;83298786;83149936;148850;
31.01.2019;18:12:10;83298894;83150071;148823;
31.01.2019;18:13:04;83298989;83150202;148787;
31.01.2019;18:14:04;83299086;83150316;148770;
31.01.2019;18:15:05;83299165;83150465;148700;
31.01.2019;18:16:05;83299259;83150597;148662;
31.01.2019;18:17:05;83299361;83150742;148619;
31.01.2019;18:18:05;83299454;83150891;148563;
31.01.2019;18:19:05;83299554;83151052;148502;
31.01.2019;18:20:05;83299635;83151174;148461;
31.01.2019;18:21:04;83299722;83151311;148411;
31.01.2019;18:22:04;83299828;83151443;148385;
31.01.2019;18:23:04;83299906;83151541;148365;
31.01.2019;18:24:05;83299989;83151676;148313;
31.01.2019;18:25:05;83300069;83151773;148296;
31.01.2019;18:26:05;83300148;83151885;148263;
31.01.2019;18:27:05;83300234;83151997;148237;
31.01.2019;18:28:05;83300305;83152120;148185;
31.01.2019;18:29:05;83300402;83152171;148231;
31.01.2019;18:30:05;83300477;83152364;148113;
31.01.2019;18:31:04;83300537;83152473;148064;
31.01.2019;18:32:05;83300620;83152591;148029;
31.01.2019;18:33:05;83300712;83152688;148024;
31.01.2019;18:34:05;83300795;83152773;148022;
31.01.2019;18:35:05;83300858;83152914;147944;
31.01.2019;18:36:04;83300937;83153009;147928;
31.01.2019;18:37:04;83301005;83153116;147889;
31.01.2019;18:38:05;83301084;83153222;147862;
31.01.2019;18:39:05;83301158;83153329;147829;
31.01.2019;18:40:05;83301249;83153415;147834;
31.01.2019;18:41:06;83301249;83153410;147839;
31.01.2019;18:42:05;83301341;83153511;147830;
31.01.2019;18:43:04;83301414;83153584;147830;
31.01.2019;18:44:05;83301468;83153678;147790;
31.01.2019;18:45:05;83301523;83153787;147736;
31.01.2019;18:46:06;83301600;83153871;147729;
31.01.2019;18:47:05;83301670;83153958;147712;
31.01.2019;18:48:05;83301755;83154044;147711;
31.01.2019;18:49:04;83301791;83154148;147643;
31.01.2019;18:50:05;83301891;83154250;147641;
31.01.2019;18:51:05;83301989;83154358;147631;
31.01.2019;18:52:05;83302076;83154462;147614;
31.01.2019;18:53:05;83302156;83154559;147597;
31.01.2019;18:54:05;83302231;83154646;147585;
31.01.2019;18:55:05;83302283;83154720;147563;
31.01.2019;18:56:05;83302399;83154803;147596;
31.01.2019;18:57:06;83302494;83154914;147580;
31.01.2019;18:58:05;83302569;83154997;147572;
31.01.2019;18:59:04;83302635;83155098;147537;
31.01.2019;19:00:04;83302712;83155189;147523;
31.01.2019;19:01:05;83302778;83155287;147491;
31.01.2019;19:02:04;83302860;83155374;147486;
31.01.2019;19:03:05;83302945;83155470;147475;
31.01.2019;19:04:06;83303029;83155585;147444;
31.01.2019;19:05:05;83303122;83155658;147464;
31.01.2019;19:06:05;83303204;83155760;147444;
31.01.2019;19:07:04;83303309;83155865;147444;
31.01.2019;19:08:05;83303384;83155968;147416;
31.01.2019;19:09:05;83303475;83156078;147397;
31.01.2019;19:10:04;83303568;83156177;147391;
31.01.2019;19:11:04;83303672;83156276;147396;
31.01.2019;19:12:05;83303750;83156375;147375;
31.01.2019;19:13:05;83303843;83156492;147351;
31.01.2019;19:14:10;83303911;83156579;147332;
31.01.2019;19:15:10;83303985;83156670;147315;
31.01.2019;19:16:11;83304067;83156757;147310;
31.01.2019;19:17:07;83304169;83156828;147341;
31.01.2019;19:18:05;83304260;83156918;147342;
31.01.2019;19:19:06;83304363;83156996;147367;
31.01.2019;19:20:12;83304385;83157109;147276;
31.01.2019;19:21:05;83304398;83157193;147205;
31.01.2019;19:22:06;83304475;83157286;147189;
31.01.2019;19:23:06;83304552;83157357;147195;
31.01.2019;19:24:04;83304613;83157451;147162;
31.01.2019;19:25:05;83304669;83157557;147112;
31.01.2019;19:26:07;83304747;83157644;147103;
31.01.2019;19:27:06;83304808;83157748;147060;
31.01.2019;19:28:10;83304859;83157858;147001;
31.01.2019;19:29:05;83304915;83157930;146985;
31.01.2019;19:30:05;83304982;83158024;146958;
31.01.2019;19:31:06;83305054;83158106;146948;
31.01.2019;19:32:05;83305122;83158188;146934;
31.01.2019;19:33:05;83305193;83158262;146931;
31.01.2019;19:34:04;83305270;83158345;146925;
31.01.2019;19:35:04;83305328;83158422;146906;
31.01.2019;19:36:05;83305391;83158507;146884;
31.01.2019;19:37:04;83305478;83158579;146899;
31.01.2019;19:38:05;83305555;83158648;146907;
31.01.2019;19:39:07;83305635;83158718;146917;
31.01.2019;19:40:04;83305707;83158782;146925;
31.01.2019;19:41:05;83305776;83158860;146916;
31.01.2019;19:42:05;83305834;83158946;146888;
31.01.2019;19:43:06;83305916;83159001;146915;
31.01.2019;19:44:05;83305997;83159079;146918;
31.01.2019;19:45:05;83306086;83159158;146928;
31.01.2019;19:46:06;83306160;83159237;146923;
31.01.2019;19:47:05;83306241;83159304;146937;
31.01.2019;19:48:05;83306326;83159366;146960;
31.01.2019;19:49:05;83306418;83159431;146987;
31.01.2019;19:50:05;83306521;83159485;147036;
31.01.2019;19:51:05;83306613;83159551;147062;
31.01.2019;19:52:04;83306703;83159624;147079;
31.01.2019;19:53:04;83306781;83159691;147090;
31.01.2019;19:54:06;83306848;83159758;147090;
31.01.2019;19:55:10;83306926;83159830;147096;
31.01.2019;19:56:05;83306999;83159895;147104;
31.01.2019;19:57:04;83307068;83159958;147110;
31.01.2019;19:58:11;83307155;83160038;147117;
31.01.2019;19:59:05;83307215;83160103;147112;
31.01.2019;20:00:06;83307314;83160174;147140;
31.01.2019;20:01:11;83307359;83160245;147114;
31.01.2019;20:02:05;83307428;83160302;147126;
31.01.2019;20:03:06;83307510;83160371;147139;
31.01.2019;20:04:05;83307581;83160437;147144;
31.01.2019;20:05:05;83307673;83160509;147164;
31.01.2019;20:06:05;83307731;83160553;147178;
31.01.2019;20:07:06;83307826;83160607;147219;
31.01.2019;20:08:05;83307891;83160678;147213;
31.01.2019;20:09:05;83307971;83160745;147226;
31.01.2019;20:10:05;83308050;83160821;147229;
31.01.2019;20:11:05;83308128;83160885;147243;
31.01.2019;20:12:05;83308193;83160942;147251;
31.01.2019;20:13:06;83308276;83160996;147280;
31.01.2019;20:14:04;83308355;83161067;147288;
31.01.2019;20:15:11;83308438;83161129;147309;
31.01.2019;20:16:04;83308522;83161188;147334;
31.01.2019;20:17:05;83308614;83161249;147365;
31.01.2019;20:18:05;83308691;83161312;147379;
31.01.2019;20:19:11;83308764;83161364;147400;
31.01.2019;20:20:05;83308849;83161406;147443;
31.01.2019;20:21:04;83308956;83161452;147504;
31.01.2019;20:22:06;83309047;83161496;147551;
31.01.2019;20:23:05;83309125;83161542;147583;
31.01.2019;20:24:05;83309217;83161588;147629;
31.01.2019;20:25:07;83309298;83161623;147675;
31.01.2019;20:26:06;83309390;83161673;147717;
31.01.2019;20:27:05;83309462;83161722;147740;
31.01.2019;20:28:04;83309539;83161780;147759;
31.01.2019;20:29:05;83309632;83161821;147811;
31.01.2019;20:30:05;83309709;83161888;147821;
31.01.2019;20:31:06;83309758;83161934;147824;
31.01.2019;20:32:06;83309826;83161980;147846;
31.01.2019;20:33:11;83309886;83162030;147856;
31.01.2019;20:34:04;83309946;83162084;147862;
31.01.2019;20:35:04;83309999;83162120;147879;
31.01.2019;20:36:05;83310079;83162165;147914;
31.01.2019;20:37:11;83310125;83162205;147920;
31.01.2019;20:38:11;83310209;83162246;147963;
31.01.2019;20:39:06;83310282;83162295;147987;
31.01.2019;20:40:05;83310358;83162340;148018;
31.01.2019;20:41:05;83310444;83162389;148055;
31.01.2019;20:42:05;83310532;83162424;148108;
31.01.2019;20:43:06;83310601;83162460;148141;
31.01.2019;20:44:06;83310677;83162508;148169;
31.01.2019;20:45:06;83310750;83162533;148217;
31.01.2019;20:46:06;83310836;83162584;148252;
31.01.2019;20:47:05;83310924;83162635;148289;
31.01.2019;20:48:05;83311012;83162672;148340;
31.01.2019;20:49:05;83311102;83162714;148388;
31.01.2019;20:50:08;83311190;83162762;148428;
31.01.2019;20:51:06;83311262;83162790;148472;
31.01.2019;20:52:04;83311335;83162849;148486;
31.01.2019;20:53:12;83311430;83162903;148527;
31.01.2019;20:54:04;83311499;83162952;148547;
31.01.2019;20:55:05;83311582;83162988;148594;
31.01.2019;20:56:07;83311652;83163039;148613;
31.01.2019;20:57:06;83311738;83163070;148668;
31.01.2019;20:58:05;83311827;83163112;148715;
31.01.2019;20:59:12;83311919;83163174;148745;
31.01.2019;21:00:05;83312019;83163218;148801;
31.01.2019;21:01:05;83312103;83163270;148833;
31.01.2019;21:02:13;83312180;83163347;148833;
31.01.2019;21:03:12;83312264;83163397;148867;
31.01.2019;21:04:07;83312360;83163436;148924;
31.01.2019;21:05:12;83312444;83163488;148956;
31.01.2019;21:06:06;83312537;83163525;149012;
31.01.2019;21:07:05;83312622;83163563;149059;
31.01.2019;21:08:12;83312726;83163603;149123;
31.01.2019;21:09:08;83312816;83163637;149179;
31.01.2019;21:10:17;83312897;83163705;149192;
31.01.2019;21:11:06;83312988;83163730;149258;
31.01.2019;21:12:11;83313067;83163775;149292;
31.01.2019;21:13:05;83313151;83163805;149346;
31.01.2019;21:14:05;83313223;83163845;149378;
31.01.2019;21:15:07;83313304;83163887;149417;
31.01.2019;21:16:06;83313381;83163924;149457;
31.01.2019;21:17:05;83313466;83163969;149497;
31.01.2019;21:18:06;83313555;83164019;149536;
31.01.2019;21:19:11;83313648;83164055;149593;
31.01.2019;21:20:05;83313731;83164093;149638;
31.01.2019;21:21:05;83313835;83164142;149693;
31.01.2019;21:22:06;83313925;83164191;149734;
31.01.2019;21:23:09;83314019;83164227;149792;
31.01.2019;21:24:05;83312931;83164262;148669;
31.01.2019;21:25:05;83312992;83164302;148690;
31.01.2019;21:26:05;83313085;83164342;148743;
31.01.2019;21:27:06;83313208;83164389;148819;
31.01.2019;21:28:12;83313288;83164434;148854;
31.01.2019;21:29:05;83313354;83164466;148888;
31.01.2019;21:30:05;83313451;83164509;148942;
31.01.2019;21:31:05;83313556;83164547;149009;
31.01.2019;21:32:05;83313643;83164595;149048;
31.01.2019;21:33:08;83313730;83164633;149097;
31.01.2019;21:34:11;83313815;83164678;149137;
31.01.2019;21:35:12;83313915;83168415;145500;
31.01.2019;21:36:06;83314005;83168449;145556;
31.01.2019;21:37:05;83314083;83168482;145601;
31.01.2019;21:38:17;83314186;83168539;145647;
31.01.2019;21:39:07;83314272;83168556;145716;
31.01.2019;21:40:05;83314369;83168592;145777;
31.01.2019;21:41:06;83314460;83168623;145837;
31.01.2019;21:42:13;83314550;83168657;145893;
31.01.2019;21:43:10;83314627;83168690;145937;
31.01.2019;21:44:08;83314708;83168719;145989;
31.01.2019;21:45:05;83314785;83168756;146029;
31.01.2019;21:46:05;83314873;83168789;146084;
31.01.2019;21:47:05;83314973;83168828;146145;
31.01.2019;21:48:09;83315051;83168874;146177;
31.01.2019;21:49:05;83315120;83168914;146206;
31.01.2019;21:50:05;83315233;83168939;146294;
31.01.2019;21:51:04;83315309;83168967;146342;
31.01.2019;21:52:05;83315326;83168962;146364;
31.01.2019;21:53:06;83315412;83169005;146407;
31.01.2019;21:54:04;83315478;83169025;146453;
31.01.2019;21:55:07;83315585;83169063;146522;
31.01.2019;21:56:12;83315675;83169110;146565;
31.01.2019;21:57:06;83315714;83169134;146580;
31.01.2019;21:58:07;83315848;83169171;146677;
31.01.2019;21:59:05;83315931;83169199;146732;
31.01.2019;22:00:14;83316030;83169245;146785;
31.01.2019;22:01:05;83316117;83169258;146859;
31.01.2019;22:02:07;83316193;83169302;146891;
31.01.2019;22:03:05;83316266;83169330;146936;
31.01.2019;22:04:05;83316366;83169363;147003;
31.01.2019;22:05:05;83316455;83169397;147058;
31.01.2019;22:06:05;83316547;83169419;147128;
31.01.2019;22:07:06;83316623;83169439;147184;
31.01.2019;22:08:12;83316703;83169472;147231;
31.01.2019;22:09:05;83316771;83169494;147277;
31.01.2019;22:10:05;83316842;83169534;147308;
31.01.2019;22:11:08;83316941;83169560;147381;
31.01.2019;22:12:05;83317031;83169597;147434;
31.01.2019;22:13:07;83317106;83169631;147475;
31.01.2019;22:14:14;83317195;83169652;147543;
31.01.2019;22:15:07;83317253;83169675;147578;
31.01.2019;22:16:14;83317336;83169700;147636;
31.01.2019;22:17:08;83317398;83169728;147670;
31.01.2019;22:18:04;83317468;83169751;147717;
31.01.2019;22:19:06;83317537;83169775;147762;
31.01.2019;22:20:05;83317607;83169785;147822;
31.01.2019;22:21:08;83317681;83169833;147848;
31.01.2019;22:22:05;83317722;83169860;147862;
31.01.2019;22:23:08;83317788;83169878;147910;
31.01.2019;22:24:06;83317871;83169885;147986;
31.01.2019;22:25:05;83317915;83169917;147998;
31.01.2019;22:26:08;83317994;83169940;148054;
31.01.2019;22:27:05;83318088;83169966;148122;
31.01.2019;22:28:08;83318151;83169978;148173;
31.01.2019;22:29:07;83318245;83170005;148240;
31.01.2019;22:30:04;83318308;83170030;148278;
31.01.2019;22:31:05;83318417;83170050;148367;
31.01.2019;22:32:07;83318519;83170081;148438;
31.01.2019;22:33:06;83318607;83170120;148487;
31.01.2019;22:34:06;83318680;83170141;148539;
31.01.2019;22:35:04;83318760;83170170;148590;
31.01.2019;22:36:11;83318845;83170189;148656;
31.01.2019;22:37:07;83318915;83170208;148707;
31.01.2019;22:38:05;83319003;83170225;148778;
31.01.2019;22:39:05;83319103;83170232;148871;
31.01.2019;22:40:05;83319180;83170270;148910;
31.01.2019;22:41:05;83319240;83170276;148964;
31.01.2019;22:42:08;83319326;83170291;149035;
31.01.2019;22:43:06;83319406;83170317;149089;
31.01.2019;22:44:05;83319493;83170341;149152;
31.01.2019;22:45:06;83319565;83170369;149196;
31.01.2019;22:46:06;83319667;83170399;149268;
31.01.2019;22:47:10;83319752;83170424;149328;
31.01.2019;22:48:06;83319834;83170442;149392;
31.01.2019;22:49:05;83319908;83170474;149434;
31.01.2019;22:50:06;83319992;83170495;149497;
31.01.2019;22:51:05;83320093;83170511;149582;
31.01.2019;22:52:09;83320181;83170534;149647;
31.01.2019;22:53:06;83320268;83170553;149715;
31.01.2019;22:54:04;83320341;83170571;149770;
31.01.2019;22:55:09;83320414;83170597;149817;
31.01.2019;22:56:04;83320476;83170628;149848;
31.01.2019;22:57:09;83320560;83170650;149910;
31.01.2019;22:58:05;83320617;83170668;149949;
31.01.2019;22:59:04;83320710;83170701;150009;
31.01.2019;23:00:07;83320791;83170712;150079;
31.01.2019;23:01:05;83320880;83170742;150138;
31.01.2019;23:02:12;83320958;83170772;150186;
31.01.2019;23:03:10;83321007;83170798;150209;
31.01.2019;23:04:10;83321080;83170824;150256;
31.01.2019;23:06:08;83321282;83170866;150416;
31.01.2019;23:07:04;83321359;83170893;150466;
31.01.2019;23:08:11;83321465;83170932;150533;
31.01.2019;23:09:07;83321557;83170960;150597;
31.01.2019;23:10:06;83321647;83170990;150657;
31.01.2019;23:11:09;83321736;83171031;150705;
31.01.2019;23:12:05;83321826;83171054;150772;
31.01.2019;23:13:05;83321902;83171072;150830;
31.01.2019;23:14:05;83321980;83171083;150897;
31.01.2019;23:15:10;83322065;83171118;150947;
31.01.2019;23:16:09;83322162;83171135;151027;
31.01.2019;23:17:07;83322224;83171154;151070;
31.01.2019;23:18:05;83322317;83171177;151140;
31.01.2019;23:19:05;83322398;83171198;151200;
31.01.2019;23:20:06;83322494;83171213;151281;
31.01.2019;23:21:08;83322565;83171232;151333;
31.01.2019;23:22:04;83322657;83171243;151414;
31.01.2019;23:23:06;83322754;83171270;151484;
31.01.2019;23:24:05;83322828;83171297;151531;
31.01.2019;23:25:04;83322905;83171317;151588;
31.01.2019;23:26:07;83323004;83171346;151658;
31.01.2019;23:27:07;83323068;83171367;151701;
31.01.2019;23:28:11;83323174;83171385;151789;
31.01.2019;23:29:05;83323239;83171409;151830;
31.01.2019;23:30:06;83323319;83171429;151890;
31.01.2019;23:31:07;83323403;83171456;151947;
31.01.2019;23:32:04;83323477;83171483;151994;
31.01.2019;23:33:04;83323558;83171497;152061;
31.01.2019;23:34:06;83323634;83171520;152114;
31.01.2019;23:35:05;83323713;83171535;152178;
31.01.2019;23:36:18;83323816;83171561;152255;
31.01.2019;23:37:07;83323865;83171584;152281;
31.01.2019;23:38:04;83323938;83171600;152338;
31.01.2019;23:39:05;83324018;83171614;152404;
31.01.2019;23:40:05;83324087;83171625;152462;
31.01.2019;23:41:05;83324151;83171628;152523;
31.01.2019;23:42:08;83324242;83171664;152578;
31.01.2019;23:43:06;83324307;83171690;152617;
31.01.2019;23:44:05;83324386;83171711;152675;
31.01.2019;23:45:04;83324464;83171739;152725;
31.01.2019;23:46:06;83324541;83171753;152788;
31.01.2019;23:47:08;83324616;83171773;152843;
31.01.2019;23:48:09;83324712;83171787;152925;
31.01.2019;23:49:04;83324802;83171815;152987;
31.01.2019;23:50:06;83324870;83171834;153036;
31.01.2019;23:51:05;83324957;83171860;153097;
31.01.2019;23:52:09;83325032;83171877;153155;
31.01.2019;23:53:06;83325117;83171895;153222;
31.01.2019;23:54:05;83325192;83171920;153272;
31.01.2019;23:55:05;83325259;83171948;153311;
31.01.2019;23:56:10;83325344;83171982;153362;
31.01.2019;23:57:07;83325425;83172001;153424;
31.01.2019;23:58:11;83325502;83172029;153473;
31.01.2019;23:59:04;83325566;83172048;153518;
01.02.2019;00:00:07;83325652;83172065;153587;
01.02.2019;00:01:08;83325744;83172088;153656;
01.02.2019;00:02:08;83325832;83172109;153723;
01.02.2019;00:03:14;83325944;83172137;153807;
01.02.2019;00:04:07;83326010;83172140;153870;
01.02.2019;00:05:12;83326078;83172180;153898;
01.02.2019;00:06:07;83326163;83172199;153964;
01.02.2019;00:07:07;83326242;83172212;154030;
01.02.2019;00:08:08;83326317;83172227;154090;
01.02.2019;00:09:07;83326392;83172248;154144;
01.02.2019;00:10:08;83326460;83172276;154184;
01.02.2019;00:11:18;83326539;83172298;154241;
01.02.2019;00:12:09;83326603;83172321;154282;
01.02.2019;00:13:13;83326692;83172359;154333;
01.02.2019;00:14:09;83326783;83172376;154407;
01.02.2019;00:15:07;83326844;83172400;154444;
01.02.2019;00:16:08;83326905;83172421;154484;
01.02.2019;00:17:08;83326985;83172431;154554;
01.02.2019;00:18:07;83327068;83172454;154614;
01.02.2019;00:19:07;83327123;83172480;154643;
01.02.2019;00:20:07;83327182;83172494;154688;
01.02.2019;00:21:07;83327228;83172507;154721;
01.02.2019;00:22:07;83327283;83172522;154761;
01.02.2019;00:23:09;83327352;83172541;154811;
01.02.2019;00:24:08;83327410;83172551;154859;
01.02.2019;00:25:07;83327477;83172574;154903;
01.02.2019;00:26:07;83327546;83172586;154960;
01.02.2019;00:27:07;83327609;83172596;155013;
01.02.2019;00:28:07;83327673;83172621;155052;
01.02.2019;00:29:07;83327752;83172643;155109;
01.02.2019;00:30:08;83327812;83172656;155156;
01.02.2019;00:31:08;83327882;83172671;155211;
01.02.2019;00:32:09;83327958;83172684;155274;
01.02.2019;00:33:07;83328024;83172711;155313;
01.02.2019;00:34:08;83328079;83172736;155343;
01.02.2019;00:35:08;83328154;83172759;155395;
01.02.2019;00:36:08;83328208;83172777;155431;
01.02.2019;00:37:08;83328284;83172801;155483;
01.02.2019;00:38:07;83328364;83172813;155551;
01.02.2019;00:39:08;83328445;83172829;155616;
01.02.2019;00:40:09;83328513;83172848;155665;
01.02.2019;00:41:07;83328583;83172867;155716;
01.02.2019;00:42:07;83328660;83172894;155766;
01.02.2019;00:43:07;83328670;83172896;155774;
01.02.2019;00:44:10;83328743;83172910;155833;
01.02.2019;00:45:07;83328800;83172936;155864;
01.02.2019;00:46:08;83328924;83172958;155966;
01.02.2019;00:47:07;83328985;83172977;156008;
01.02.2019;00:48:07;83329073;83173012;156061;
01.02.2019;00:49:08;83329156;83173036;156120;
01.02.2019;00:50:07;83329231;83173068;156163;
01.02.2019;00:51:07;83329319;83173087;156232;
01.02.2019;00:52:09;83329409;83173108;156301;
01.02.2019;00:53:07;83329478;83173128;156350;
01.02.2019;00:54:12;83329577;83173148;156429;
01.02.2019;00:55:07;83329648;83173160;156488;
01.02.2019;00:56:07;83329745;83173190;156555;
01.02.2019;00:57:07;83329836;83173212;156624;
01.02.2019;00:58:13;83329907;83173244;156663;
01.02.2019;00:59:08;83329982;83173266;156716;
01.02.2019;01:00:11;83330039;83173293;156746;
01.02.2019;01:01:06;83330124;83173314;156810;
01.02.2019;01:02:05;83330189;83173349;156840;
01.02.2019;01:03:04;83330261;83173379;156882;
01.02.2019;01:04:05;83330319;83173406;156913;
01.02.2019;01:05:04;83330388;83173434;156954;
01.02.2019;01:06:05;83330477;83173460;157017;
01.02.2019;01:07:06;83330537;83173471;157066;
01.02.2019;01:08:05;83330601;83173507;157094;
01.02.2019;01:09:04;83330661;83173532;157129;
01.02.2019;01:10:05;83330732;83173552;157180;
01.02.2019;01:11:07;83330804;83173574;157230;
01.02.2019;01:12:11;83330882;83173601;157281;
01.02.2019;01:13:05;83330969;83173616;157353;
01.02.2019;01:14:04;83331066;83173647;157419;
01.02.2019;01:15:04;83331145;83173662;157483;
01.02.2019;01:16:05;83331232;83173689;157543;
01.02.2019;01:17:04;83331294;83173708;157586;
01.02.2019;01:18:04;83331357;83173725;157632;
01.02.2019;01:19:04;83331441;83173743;157698;
01.02.2019;01:20:05;83331504;83173783;157721;
01.02.2019;01:21:05;83331588;83173813;157775;
01.02.2019;01:22:04;83331676;83173845;157831;
01.02.2019;01:23:05;83331753;83173866;157887;
01.02.2019;01:24:05;83331833;83173883;157950;
01.02.2019;01:25:04;83331902;83173918;157984;
01.02.2019;01:26:04;83331972;83173947;158025;
01.02.2019;01:27:05;83332061;83173983;158078;
01.02.2019;01:28:06;83332134;83174020;158114;
01.02.2019;01:29:04;83332192;83174037;158155;
01.02.2019;01:30:04;83332270;83174063;158207;
01.02.2019;01:32:11;83332418;83174115;158303;
01.02.2019;01:33:05;83332487;83174130;158357;
01.02.2019;01:34:04;83332540;83174169;158371;
01.02.2019;01:35:04;83332632;83174208;158424;
01.02.2019;01:36:05;83332705;83174237;158468;
01.02.2019;01:37:05;83332781;83174261;158520;
01.02.2019;01:38:05;83332861;83174297;158564;
01.02.2019;01:39:04;83332961;83174335;158626;
01.02.2019;01:40:04;83333040;83174363;158677;
01.02.2019;01:41:15;83333116;83174397;158719;
01.02.2019;01:42:05;83333193;83174428;158765;
01.02.2019;01:43:04;83333271;83174469;158802;
01.02.2019;01:44:05;83333361;83174506;158855;
01.02.2019;01:45:05;83333445;83174535;158910;
01.02.2019;01:46:05;83333510;83174573;158937;
01.02.2019;01:47:09;83333585;83174624;158961;
01.02.2019;01:48:05;83333670;83174657;159013;
01.02.2019;01:49:05;83333749;83174689;159060;
01.02.2019;01:50:10;83333849;83174735;159114;
01.02.2019;01:51:05;83333930;83174771;159159;
01.02.2019;01:52:04;83333998;83174820;159178;
01.02.2019;01:53:07;83334080;83174861;159219;
01.02.2019;01:54:05;83334141;83174895;159246;
01.02.2019;01:55:10;83334222;83174933;159289;
01.02.2019;01:56:05;83334297;83174965;159332;
01.02.2019;01:57:05;83334382;83175016;159366;
01.02.2019;01:58:05;83334463;83175049;159414;
01.02.2019;01:59:05;83334551;83175097;159454;
01.02.2019;02:00:04;83334626;83175138;159488;
01.02.2019;02:01:05;83334706;83175173;159533;
01.02.2019;02:02:04;83334776;83175215;159561;
01.02.2019;02:03:05;83334853;83175262;159591;
01.02.2019;02:04:05;83334947;83175304;159643;
01.02.2019;02:05:14;83335008;83175367;159641;
01.02.2019;02:06:06;83335089;83175405;159684;
01.02.2019;02:07:05;83335171;83175449;159722;
01.02.2019;02:08:05;83335253;83175488;159765;
01.02.2019;02:09:04;83335349;83175534;159815;
01.02.2019;02:10:04;83335424;83175586;159838;
01.02.2019;02:11:04;83335518;83175633;159885;
01.02.2019;02:12:05;83335598;83175686;159912;
01.02.2019;02:13:05;83335685;83175739;159946;
01.02.2019;02:14:04;83335777;83175781;159996;
01.02.2019;02:15:11;83335847;83175835;160012;
01.02.2019;02:16:04;83335947;83175897;160050;
01.02.2019;02:17:06;83336009;83175955;160054;
01.02.2019;02:18:05;83336075;83175992;160083;
01.02.2019;02:19:05;83336163;83176028;160135;
01.02.2019;02:20:06;83336240;83176089;160151;
01.02.2019;02:21:05;83336311;83176140;160171;
01.02.2019;02:22:04;83336382;83176191;160191;
01.02.2019;02:23:05;83336438;83176252;160186;
01.02.2019;02:24:05;83336505;83176303;160202;
01.02.2019;02:25:05;83336569;83176356;160213;
01.02.2019;02:26:05;83336638;83176408;160230;
01.02.2019;02:27:04;83336689;83176474;160215;
01.02.2019;02:28:05;83336756;83176525;160231;
01.02.2019;02:29:05;83336806;83176567;160239;
01.02.2019;02:30:05;83336856;83176613;160243;
01.02.2019;02:31:05;83336920;83176670;160250;
01.02.2019;02:32:07;83336972;83176727;160245;
01.02.2019;02:33:05;83337051;83176772;160279;
01.02.2019;02:34:05;83337112;83176812;160300;
01.02.2019;02:35:05;83337187;83176867;160320;
01.02.2019;02:36:04;83337267;83176927;160340;
01.02.2019;02:37:05;83337329;83176972;160357;
01.02.2019;02:38:04;83337400;83177039;160361;
01.02.2019;02:39:05;83337454;83177095;160359;
01.02.2019;02:40:04;83337529;83177155;160374;
01.02.2019;02:41:04;83337602;83177235;160367;
01.02.2019;02:42:05;83337687;83177291;160396;
01.02.2019;02:43:10;83337763;83177359;160404;
01.02.2019;02:44:05;83337845;83177421;160424;
01.02.2019;02:45:04;83337928;83177483;160445;
01.02.2019;02:46:10;83337971;83177569;160402;
01.02.2019;02:47:05;83338010;83177650;160360;
01.02.2019;02:48:04;83338088;83177716;160372;
01.02.2019;02:49:10;83338170;83177777;160393;
01.02.2019;02:50:06;83338243;83177852;160391;
01.02.2019;02:51:05;83338313;83177921;160392;
01.02.2019;02:52:04;83338420;83177989;160431;
01.02.2019;02:53:05;83338484;83178064;160420;
01.02.2019;02:54:10;83338603;83178149;160454;
01.02.2019;02:55:04;83338688;83178226;160462;
01.02.2019;02:56:10;83338770;83178302;160468;
01.02.2019;02:57:05;83338840;83178380;160460;
01.02.2019;02:58:04;83338921;83178447;160474;
01.02.2019;02:59:05;83339016;83178532;160484;
01.02.2019;03:00:05;83339110;83178611;160499;
01.02.2019;03:01:04;83339183;83178691;160492;
01.02.2019;03:02:05;83339271;83178750;160521;
01.02.2019;03:03:05;83339339;83178820;160519;
01.02.2019;03:04:04;83339423;83178893;160530;
01.02.2019;03:05:05;83339484;83178958;160526;
01.02.2019;03:06:04;83339562;83179048;160514;
01.02.2019;03:07:04;83339631;83179130;160501;
01.02.2019;03:08:04;83339687;83179200;160487;
01.02.2019;03:09:05;83339763;83179293;160470;
01.02.2019;03:10:05;83339835;83179370;160465;
01.02.2019;03:11:05;83339921;83179442;160479;
01.02.2019;03:12:04;83339987;83179522;160465;
01.02.2019;03:13:05;83340070;83179608;160462;
01.02.2019;03:14:05;83340153;83179692;160461;
01.02.2019;03:15:05;83340238;83179783;160455;
01.02.2019;03:16:04;83340323;83179864;160459;
01.02.2019;03:17:05;83340398;83179951;160447;
01.02.2019;03:18:05;83340457;83180037;160420;
01.02.2019;03:19:04;83340515;83180133;160382;
01.02.2019;03:20:05;83340585;83180232;160353;
01.02.2019;03:21:05;83340675;83180312;160363;
01.02.2019;03:22:10;83340753;83180387;160366;
01.02.2019;03:23:04;83340818;83180470;160348;
01.02.2019;03:24:05;83340905;83180547;160358;
01.02.2019;03:25:04;83340971;83180636;160335;
01.02.2019;03:26:05;83341064;83180725;160339;
01.02.2019;03:27:05;83341153;83180823;160330;
01.02.2019;03:28:06;83341242;83180918;160324;
01.02.2019;03:29:05;83341319;83181006;160313;
01.02.2019;03:30:06;83341406;83181110;160296;
01.02.2019;03:31:04;83341487;83181188;160299;
01.02.2019;03:32:05;83341572;83181280;160292;
01.02.2019;03:33:05;83341658;83181363;160295;
01.02.2019;03:34:05;83341733;83181454;160279;
01.02.2019;03:35:05;83341807;83181539;160268;
01.02.2019;03:36:04;83341880;83181640;160240;
01.02.2019;03:37:04;83341961;83181719;160242;
01.02.2019;03:38:05;83342032;83181795;160237;
01.02.2019;03:39:05;83342098;83181899;160199;
01.02.2019;03:40:05;83342189;83181992;160197;
01.02.2019;03:41:06;83342277;83182093;160184;
01.02.2019;03:42:04;83342345;83182188;160157;
01.02.2019;03:43:10;83342428;83182290;160138;
01.02.2019;03:44:11;83342518;83182388;160130;
01.02.2019;03:45:04;83342605;83182468;160137;
01.02.2019;03:46:04;83342656;83182563;160093;
01.02.2019;03:47:09;83342725;83182657;160068;
01.02.2019;03:48:05;83342810;83182726;160084;
01.02.2019;03:49:05;83342875;83182825;160050;
01.02.2019;03:50:05;83342951;83182913;160038;
01.02.2019;03:51:04;83343023;83183001;160022;
01.02.2019;03:52:04;83343098;83183085;160013;
01.02.2019;03:53:05;83343176;83183184;159992;
01.02.2019;03:54:05;83343242;83183290;159952;
01.02.2019;03:55:05;83343317;83183390;159927;
01.02.2019;03:56:04;83343415;83183465;159950;
01.02.2019;03:57:04;83343501;83183573;159928;
01.02.2019;03:58:05;83343522;83183628;159894;
01.02.2019;03:59:04;83343601;83183724;159877;
01.02.2019;04:00:04;83343677;83183814;159863;
01.02.2019;04:01:05;83343752;83183915;159837;
01.02.2019;04:02:05;83343840;83184014;159826;
01.02.2019;04:03:04;83343925;83184104;159821;
01.02.2019;04:04:04;83343999;83184201;159798;
01.02.2019;04:05:05;83344075;83184287;159788;
01.02.2019;04:06:05;83344153;83184387;159766;
01.02.2019;04:07:04;83344229;83184483;159746;
01.02.2019;04:08:05;83344288;83184598;159690;
01.02.2019;04:09:06;83344392;83184675;159717;
01.02.2019;04:10:06;83344472;83184779;159693;
01.02.2019;04:11:04;83344576;83184886;159690;
01.02.2019;04:12:04;83344646;83185004;159642;
01.02.2019;04:13:05;83344732;83185089;159643;
01.02.2019;04:14:04;83344803;83185202;159601;
01.02.2019;04:15:05;83344881;83185317;159564;
01.02.2019;04:16:05;83344950;83185403;159547;
01.02.2019;04:17:05;83345028;83185496;159532;
01.02.2019;04:18:04;83345087;83185597;159490;
01.02.2019;04:19:06;83345157;83185707;159450;
01.02.2019;04:20:05;83345256;83185804;159452;
01.02.2019;04:21:04;83345324;83185883;159441;
01.02.2019;04:22:04;83345379;83185985;159394;
01.02.2019;04:23:05;83345412;83186068;159344;
01.02.2019;04:24:06;83345456;83186156;159300;
01.02.2019;04:25:05;83345538;83186253;159285;
01.02.2019;04:26:05;83345635;83186363;159272;
01.02.2019;04:27:09;83345697;83186477;159220;
01.02.2019;04:28:04;83345754;83186556;159198;
01.02.2019;04:29:06;83345820;83186650;159170;
01.02.2019;04:30:05;83345901;83186740;159161;
01.02.2019;04:31:04;83345959;83186851;159108;
01.02.2019;04:32:05;83346024;83186968;159056;
01.02.2019;04:33:06;83346104;83187067;159037;
01.02.2019;04:34:06;83346195;83187158;159037;
01.02.2019;04:35:06;83346259;83187271;158988;
01.02.2019;04:36:06;83346337;83187362;158975;
01.02.2019;04:37:04;83346417;83187468;158949;
01.02.2019;04:38:04;83346498;83187589;158909;
01.02.2019;04:39:07;83346570;83187703;158867;
01.02.2019;04:40:06;83346656;83187771;158885;
01.02.2019;04:41:12;83346717;83187903;158814;
01.02.2019;04:42:06;83346788;83187998;158790;
01.02.2019;04:44:04;83346927;83188180;158747;
01.02.2019;04:45:05;83346993;83188287;158706;
01.02.2019;04:46:05;83347045;83188372;158673;
01.02.2019;04:47:06;83347120;83188458;158662;
01.02.2019;04:48:10;83347194;83188585;158609;
01.02.2019;04:49:10;83347261;83188684;158577;
01.02.2019;04:50:06;83347321;83188763;158558;
01.02.2019;04:51:05;83347383;83188847;158536;
01.02.2019;04:52:05;83347471;83188970;158501;
01.02.2019;04:53:10;83347531;83189080;158451;
01.02.2019;04:54:04;83347597;83189187;158410;
01.02.2019;04:55:05;83347677;83189293;158384;
01.02.2019;04:56:04;83347751;83189397;158354;
01.02.2019;04:57:04;83347834;83189504;158330;
01.02.2019;04:58:05;83347900;83189586;158314;
01.02.2019;04:59:07;83347983;83189694;158289;
01.02.2019;05:00:05;83348045;83189779;158266;
01.02.2019;05:01:04;83348119;83189886;158233;
01.02.2019;05:02:05;83348200;83189980;158220;
01.02.2019;05:03:04;83348281;83190071;158210;
01.02.2019;05:04:04;83348372;83190179;158193;
01.02.2019;05:05:05;83348447;83190264;158183;
01.02.2019;05:06:05;83348505;83190355;158150;
01.02.2019;05:07:04;83348576;83190452;158124;
01.02.2019;05:08:04;83348641;83190570;158071;
01.02.2019;05:09:05;83348711;83190695;158016;
01.02.2019;05:10:05;83348784;83190807;157977;
01.02.2019;05:11:04;83348854;83190911;157943;
01.02.2019;05:12:10;83348937;83191012;157925;
01.02.2019;05:13:05;83348987;83191116;157871;
01.02.2019;05:14:05;83349036;83191243;157793;
01.02.2019;05:15:04;83349110;83191326;157784;
01.02.2019;05:16:07;83349153;83191438;157715;
01.02.2019;05:17:05;83349247;83191538;157709;
01.02.2019;05:18:05;83349313;83191638;157675;
01.02.2019;05:19:10;83349393;83191754;157639;
01.02.2019;05:20:04;83349438;83191849;157589;
01.02.2019;05:21:10;83349519;83191968;157551;
01.02.2019;05:22:05;83349602;83192061;157541;
01.02.2019;05:23:06;83349658;83192160;157498;
01.02.2019;05:24:04;83349722;83192267;157455;
01.02.2019;05:25:04;83349782;83192362;157420;
01.02.2019;05:26:04;83349844;83192472;157372;
01.02.2019;05:27:05;83349921;83192575;157346;
01.02.2019;05:28:04;83349984;83192669;157315;
01.02.2019;05:29:10;83350065;83192793;157272;
01.02.2019;05:30:05;83350140;83192893;157247;
01.02.2019;05:31:04;83350198;83192975;157223;
01.02.2019;05:32:04;83350274;83193102;157172;
01.02.2019;05:33:04;83350354;83193197;157157;
01.02.2019;05:34:04;83350426;83193296;157130;
01.02.2019;05:35:04;83350475;83193390;157085;
01.02.2019;05:36:05;83350560;83193505;157055;
01.02.2019;05:37:11;83350619;83193601;157018;
01.02.2019;05:38:04;83350696;83193707;156989;
01.02.2019;05:39:06;83350772;83193814;156958;
01.02.2019;05:40:04;83350841;83193904;156937;
01.02.2019;05:41:05;83350908;83194000;156908;
01.02.2019;05:42:05;83350977;83194119;156858;
01.02.2019;05:43:05;83351048;83194236;156812;
01.02.2019;05:44:04;83351117;83194336;156781;
01.02.2019;05:45:05;83351179;83194457;156722;
01.02.2019;05:46:05;83351251;83194573;156678;
01.02.2019;05:47:05;83351316;83194677;156639;
01.02.2019;05:48:05;83351366;83194788;156578;
01.02.2019;05:49:05;83351441;83194879;156562;
01.02.2019;05:50:04;83351508;83194976;156532;
01.02.2019;05:51:04;83351585;83195091;156494;
01.02.2019;05:52:05;83351649;83195201;156448;
01.02.2019;05:53:05;83351705;83195292;156413;
01.02.2019;05:54:06;83351766;83195411;156355;
01.02.2019;05:55:04;83351829;83195520;156309;
01.02.2019;05:56:05;83351883;83195634;156249;
01.02.2019;05:57:04;83351951;83195741;156210;
01.02.2019;05:58:04;83352022;83195841;156181;
01.02.2019;05:59:05;83352086;83195949;156137;
01.02.2019;06:00:04;83352157;83196048;156109;
01.02.2019;06:01:04;83352216;83196164;156052;
01.02.2019;06:02:10;83352291;83196261;156030;
01.02.2019;06:03:05;83352361;83196342;156019;
01.02.2019;06:04:04;83352424;83196474;155950;
01.02.2019;06:05:06;83352490;83196571;155919;
01.02.2019;06:06:04;83352552;83196688;155864;
01.02.2019;06:07:05;83352637;83196805;155832;
01.02.2019;06:08:05;83352701;83196902;155799;
01.02.2019;06:09:06;83352752;83196998;155754;
01.02.2019;06:10:04;83352812;83197116;155696;
01.02.2019;06:11:05;83352879;83197220;155659;
01.02.2019;06:12:04;83352922;83197300;155622;
01.02.2019;06:13:10;83352937;83197393;155544;
01.02.2019;06:14:04;83352988;83197473;155515;
01.02.2019;06:15:05;83353035;83197587;155448;
01.02.2019;06:16:04;83353089;83197677;155412;
01.02.2019;06:17:04;83353152;83197789;155363;
01.02.2019;06:18:05;83353213;83197884;155329;
01.02.2019;06:19:06;83353260;83197996;155264;
01.02.2019;06:20:11;83353323;83198104;155219;
01.02.2019;06:21:04;83353368;83198188;155180;
01.02.2019;06:22:05;83353423;83198262;155161;
01.02.2019;06:23:05;83353483;83198411;155072;
01.02.2019;06:24:04;83353540;83198517;155023;
01.02.2019;06:25:08;83353612;83198633;154979;
01.02.2019;06:26:04;83353666;83198725;154941;
01.02.2019;06:27:06;83353711;83198832;154879;
01.02.2019;06:28:06;83353765;83198926;154839;
01.02.2019;06:29:05;83353821;83199031;154790;
01.02.2019;06:30:05;83353886;83199138;154748;
01.02.2019;06:31:05;83353957;83199245;154712;
01.02.2019;06:32:04;83354002;83199342;154660;
01.02.2019;06:33:10;83354056;83199458;154598;
01.02.2019;06:34:04;83354116;83199548;154568;
01.02.2019;06:35:05;83354194;83199657;154537;
01.02.2019;06:36:04;83354263;83199782;154481;
01.02.2019;06:37:05;83354328;83199897;154431;
01.02.2019;06:38:10;83354407;83200002;154405;
01.02.2019;06:39:06;83354460;83200098;154362;
01.02.2019;06:40:12;83354523;83200225;154298;
01.02.2019;06:41:05;83354583;83200331;154252;
01.02.2019;06:42:04;83354651;83200441;154210;
01.02.2019;06:43:06;83354713;83200540;154173;
01.02.2019;06:44:04;83354772;83200657;154115;
01.02.2019;06:45:11;83354831;83200770;154061;
01.02.2019;06:46:05;83354877;83200856;154021;
01.02.2019;06:47:12;83354922;83200980;153942;
01.02.2019;06:48:04;83354980;83201085;153895;
01.02.2019;06:49:05;83355039;83201206;153833;
01.02.2019;06:50:04;83355103;83201307;153796;
01.02.2019;06:51:06;83355158;83201436;153722;
01.02.2019;06:52:04;83355233;83201558;153675;
01.02.2019;06:53:04;83355290;83201664;153626;
01.02.2019;06:54:05;83355342;83201774;153568;
01.02.2019;06:55:05;83355411;83201868;153543;
01.02.2019;06:56:05;83355457;83201992;153465;
01.02.2019;06:57:05;83355530;83202100;153430;
01.02.2019;06:58:04;83355583;83202212;153371;
01.02.2019;06:59:04;83355637;83202317;153320;
01.02.2019;07:00:05;83355690;83202436;153254;
01.02.2019;07:01:05;83355740;83202543;153197;
01.02.2019;07:02:06;83355821;83202654;153167;
01.02.2019;07:03:04;83355876;83202748;153128;
01.02.2019;07:04:05;83355919;83202829;153090;
01.02.2019;07:05:05;83355966;83202919;153047;
01.02.2019;07:06:05;83355974;83203001;152973;
01.02.2019;07:07:05;83356017;83203107;152910;
01.02.2019;07:08:04;83356081;83203218;152863;
01.02.2019;07:09:05;83356142;83203328;152814;
01.02.2019;07:10:05;83356207;83203437;152770;
01.02.2019;07:11:11;83356280;83203573;152707;
01.02.2019;07:12:04;83356339;83203669;152670;
01.02.2019;07:13:10;83356412;83203803;152609;
01.02.2019;07:14:10;83356466;83203927;152539;
01.02.2019;07:15:05;83356511;83204014;152497;
01.02.2019;07:16:05;83356565;83204119;152446;
01.02.2019;07:17:05;83356626;83204210;152416;
01.02.2019;07:18:10;83356688;83204347;152341;
01.02.2019;07:19:05;83356753;83204445;152308;
01.02.2019;07:20:05;83356796;83204579;152217;
01.02.2019;07:21:04;83356848;83204682;152166;
01.02.2019;07:22:04;83356894;83204771;152123;
01.02.2019;07:23:07;83356955;83204900;152055;
01.02.2019;07:24:06;83357006;83205010;151996;
01.02.2019;07:25:04;83357057;83205104;151953;
01.02.2019;07:26:04;83357110;83205206;151904;
01.02.2019;07:27:05;83357174;83205305;151869;
01.02.2019;07:28:11;83357230;83205433;151797;
01.02.2019;07:29:04;83357287;83205544;151743;
01.02.2019;07:30:04;83357347;83205679;151668;
01.02.2019;07:31:05;83357410;83205796;151614;
01.02.2019;07:32:17;83357486;83205906;151580;
01.02.2019;07:33:10;83357526;83205994;151532;
01.02.2019;07:34:04;83357589;83206096;151493;
01.02.2019;07:35:05;83357649;83206216;151433;
01.02.2019;07:36:05;83357700;83206311;151389;
01.02.2019;07:37:12;83357766;83206418;151348;
01.02.2019;07:38:04;83357814;83206510;151304;
01.02.2019;07:39:05;83357870;83206620;151250;
01.02.2019;07:40:05;83357937;83206747;151190;
01.02.2019;07:41:06;83358004;83206850;151154;
01.02.2019;07:42:04;83358056;83206950;151106;
01.02.2019;07:43:05;83358119;83207077;151042;
01.02.2019;07:44:05;83358175;83207182;150993;
01.02.2019;07:45:04;83358248;83207275;150973;
01.02.2019;07:46:04;83358304;83207394;150910;
01.02.2019;07:47:05;83358377;83207496;150881;
01.02.2019;07:48:04;83358434;83207601;150833;
01.02.2019;07:49:04;83358497;83207715;150782;
01.02.2019;07:50:05;83358546;83207825;150721;
01.02.2019;07:51:10;83358593;83207932;150661;
01.02.2019;07:52:04;83358652;83208020;150632;
01.02.2019;07:53:05;83358697;83208114;150583;
01.02.2019;07:54:04;83358754;83208219;150535;
01.02.2019;07:55:04;83358815;83208338;150477;
01.02.2019;07:56:05;83358861;83208457;150404;
01.02.2019;07:57:05;83358924;83208556;150368;
01.02.2019;07:58:05;83358971;83208674;150297;
01.02.2019;07:59:06;83359033;83208764;150269;
01.02.2019;08:00:05;83359091;83208885;150206;
01.02.2019;08:01:04;83359140;83208983;150157;
01.02.2019;08:02:11;83359211;83209103;150108;
01.02.2019;08:03:10;83359269;83209222;150047;
01.02.2019;08:04:07;83359305;83209316;149989;
01.02.2019;08:05:10;83359348;83209438;149910;
01.02.2019;08:06:06;83359421;83209549;149872;
01.02.2019;08:07:13;83359466;83209680;149786;
01.02.2019;08:08:06;83359522;83209764;149758;
01.02.2019;08:09:07;83359571;83209859;149712;
01.02.2019;08:10:04;83359604;83209963;149641;
01.02.2019;08:11:05;83359657;83210071;149586;
01.02.2019;08:12:04;83359710;83210182;149528;
01.02.2019;08:13:05;83359754;83210288;149466;
01.02.2019;08:14:06;83359790;83210385;149405;
01.02.2019;08:15:10;83359826;83210506;149320;
01.02.2019;08:16:16;83359839;83210607;149232;
01.02.2019;08:17:05;83359889;83210680;149209;
01.02.2019;08:18:05;83359919;83210776;149143;
01.02.2019;08:19:04;83359972;83210869;149103;
01.02.2019;08:20:06;83360009;83210980;149029;
01.02.2019;08:21:06;83360036;83211088;148948;
01.02.2019;08:22:12;83360075;83211175;148900;
01.02.2019;08:23:05;83360118;83211251;148867;
01.02.2019;08:24:11;83360166;83211360;148806;
01.02.2019;08:25:05;83360214;83211429;148785;
01.02.2019;08:26:04;83360272;83211527;148745;
01.02.2019;08:27:05;83360325;83211633;148692;
01.02.2019;08:28:06;83360365;83211738;148627;
01.02.2019;08:29:11;83360405;83211853;148552;
01.02.2019;08:30:06;83360447;83211941;148506;
01.02.2019;08:31:04;83360490;83212015;148475;
01.02.2019;08:32:04;83360544;83212116;148428;
01.02.2019;08:33:05;83360590;83212245;148345;
01.02.2019;08:34:10;83360641;83212352;148289;
01.02.2019;08:35:04;83360676;83212468;148208;
01.02.2019;08:36:11;83360747;83212579;148168;
01.02.2019;08:37:05;83360806;83212692;148114;
01.02.2019;08:38:05;83360873;83212781;148092;
01.02.2019;08:39:05;83360937;83212883;148054;
01.02.2019;08:40:04;83361012;83212963;148049;
01.02.2019;08:41:05;83361070;83213078;147992;
01.02.2019;08:42:05;83361107;83213194;147913;
01.02.2019;08:43:10;83361147;83213306;147841;
01.02.2019;08:44:05;83361197;83213400;147797;
01.02.2019;08:45:05;83361261;83213485;147776;
01.02.2019;08:46:07;83361331;83213616;147715;
01.02.2019;08:47:05;83361387;83213692;147695;
01.02.2019;08:48:04;83361435;83213839;147596;
01.02.2019;08:49:07;83361488;83213954;147534;
01.02.2019;08:50:06;83361532;83214081;147451;
01.02.2019;08:51:06;83361595;83214172;147423;
01.02.2019;08:52:10;83361651;83214278;147373;
01.02.2019;08:53:05;83361702;83214379;147323;
01.02.2019;08:54:06;83361744;83214489;147255;
01.02.2019;08:55:06;83361786;83214607;147179;
01.02.2019;08:56:05;83361832;83214718;147114;
01.02.2019;08:57:11;83361888;83214833;147055;
01.02.2019;08:58:06;83361945;83214950;146995;
01.02.2019;08:59:04;83361986;83215052;146934;
01.02.2019;09:00:05;83362047;83215158;146889;
01.02.2019;09:01:04;83362090;83215278;146812;
01.02.2019;09:02:07;83362145;83215416;146729;
01.02.2019;09:03:05;83362198;83215515;146683;
01.02.2019;09:04:06;83362257;83215629;146628;
01.02.2019;09:05:05;83362305;83215722;146583;
01.02.2019;09:06:04;83362360;83215831;146529;
01.02.2019;09:07:04;83362408;83215920;146488;
01.02.2019;09:08:11;83362458;83216023;146435;
01.02.2019;09:09:05;83362504;83216114;146390;
01.02.2019;09:10:05;83362558;83216236;146322;
01.02.2019;09:11:04;83362616;83216324;146292;
01.02.2019;09:12:10;83362668;83216444;146224;
01.02.2019;09:13:04;83362720;83216534;146186;
01.02.2019;09:14:05;83362774;83216670;146104;
01.02.2019;09:15:05;83362847;83216730;146117;
01.02.2019;09:16:05;83362914;83216840;146074;
01.02.2019;09:17:11;83362977;83216945;146032;
01.02.2019;09:18:06;83363024;83217050;145974;
01.02.2019;09:19:11;83363073;83217185;145888;
01.02.2019;09:20:04;83363129;83217278;145851;
01.02.2019;09:21:04;83363183;83217388;145795;
01.02.2019;09:22:05;83363226;83217487;145739;
01.02.2019;09:23:06;83363279;83217607;145672;
01.02.2019;09:24:06;83363341;83217717;145624;
01.02.2019;09:25:06;83363399;83217848;145551;
01.02.2019;09:26:05;83363460;83217946;145514;
01.02.2019;09:27:05;83363506;83218053;145453;
01.02.2019;09:28:05;83363552;83218151;145401;
01.02.2019;09:29:05;83363600;83218267;145333;
01.02.2019;09:30:04;83363646;83218366;145280;
01.02.2019;09:31:05;83363700;83218482;145218;
01.02.2019;09:32:05;83363759;83218580;145179;
01.02.2019;09:33:04;83363805;83218677;145128;
01.02.2019;09:34:07;83363861;83218801;145060;
01.02.2019;09:35:05;83363911;83218899;145012;
01.02.2019;09:36:06;83363959;83219037;144922;
01.02.2019;09:37:04;83363988;83219138;144850;
01.02.2019;09:38:04;83364032;83219236;144796;
01.02.2019;09:39:06;83364094;83219353;144741;
01.02.2019;09:40:05;83364156;83219470;144686;
01.02.2019;09:41:05;83364211;83219563;144648;
01.02.2019;17:10:10;83393454;83276561;116893;
01.02.2019;17:11:05;83393547;83276691;116856;
01.02.2019;17:12:05;83393638;83276856;116782;
01.02.2019;17:13:04;83393737;83277021;116716;
01.02.2019;17:14:04;83393857;83277170;116687;
01.02.2019;17:15:08;83393949;83277326;116623;
01.02.2019;17:16:05;83394029;83277453;116576;
01.02.2019;17:17:05;83394123;83277616;116507;
01.02.2019;17:18:04;83394222;83277786;116436;
01.02.2019;17:19:05;83394313;83277921;116392;
01.02.2019;17:20:08;83394409;83278109;116300;
01.02.2019;17:21:05;83394474;83278273;116201;
01.02.2019;17:22:05;83394572;83278432;116140;
01.02.2019;17:23:05;83394676;83278582;116094;
01.02.2019;17:24:04;83394775;83278731;116044;
01.02.2019;17:25:07;83394872;83278876;115996;
01.02.2019;17:26:05;83394952;83279010;115942;
01.02.2019;17:27:05;83395052;83279184;115868;
01.02.2019;17:28:05;83395152;83279304;115848;
01.02.2019;17:29:04;83395228;83279446;115782;
01.02.2019;17:30:07;83395331;83279595;115736;
01.02.2019;17:31:04;83395427;83279755;115672;
01.02.2019;17:32:05;83395525;83279891;115634;
01.02.2019;17:33:04;83395606;83280051;115555;
01.02.2019;17:34:04;83395699;83280206;115493;
01.02.2019;17:35:07;83395796;83280360;115436;
01.02.2019;17:36:04;83395878;83280504;115374;
01.02.2019;17:37:05;83395956;83280686;115270;
01.02.2019;17:38:04;83396051;83280817;115234;
01.02.2019;17:39:06;83396158;83280984;115174;
01.02.2019;17:40:08;83396270;83281118;115152;
01.02.2019;17:41:05;83396362;83281273;115089;
01.02.2019;17:42:04;83396433;83281401;115032;
01.02.2019;17:43:04;83396527;83281554;114973;
01.02.2019;17:44:20;83396641;83281752;114889;
01.02.2019;17:45:07;83396721;83281842;114879;
01.02.2019;17:46:04;83396792;83281957;114835;
01.02.2019;17:47:04;83396882;83282097;114785;
01.02.2019;17:48:05;83396960;83282261;114699;
01.02.2019;17:49:04;83397064;83282411;114653;
01.02.2019;17:50:08;83397177;83282558;114619;
01.02.2019;17:51:04;83397271;83282692;114579;
01.02.2019;17:52:05;83397368;83282832;114536;
01.02.2019;17:53:05;83397443;83282936;114507;
01.02.2019;17:54:05;83397535;83283128;114407;
01.02.2019;17:55:07;83397600;83283289;114311;
01.02.2019;17:56:04;83397728;83283434;114294;
01.02.2019;17:57:05;83397805;83283569;114236;
01.02.2019;17:58:04;83397898;83283717;114181;
01.02.2019;17:59:04;83397979;83283851;114128;
01.02.2019;18:00:08;83398060;83284001;114059;
01.02.2019;18:01:05;83398144;83284151;113993;
01.02.2019;18:02:09;83398228;83284260;113968;
01.02.2019;18:03:04;83398315;83284380;113935;
01.02.2019;18:04:05;83398400;83284524;113876;
01.02.2019;18:05:08;83398490;83284650;113840;
01.02.2019;18:06:05;83398584;83284777;113807;
01.02.2019;18:07:04;83398687;83284903;113784;
01.02.2019;18:08:05;83398774;83285051;113723;
01.02.2019;18:09:06;83398869;83285202;113667;
01.02.2019;18:10:08;83398946;83285309;113637;
01.02.2019;18:11:05;83399059;83285440;113619;
01.02.2019;18:12:04;83399155;83285576;113579;
01.02.2019;18:13:05;83399249;83285706;113543;
01.02.2019;18:14:05;83399326;83285854;113472;
01.02.2019;18:15:07;83399428;83285986;113442;
01.02.2019;18:16:04;83399506;83286107;113399;
01.02.2019;18:17:05;83399590;83286254;113336;
01.02.2019;18:18:05;83399684;83286377;113307;
01.02.2019;18:19:05;83399793;83286545;113248;
01.02.2019;18:20:07;83399900;83286712;113188;
01.02.2019;18:21:04;83399991;83286824;113167;
01.02.2019;18:22:05;83400095;83286951;113144;
01.02.2019;18:23:05;83400169;83287067;113102;
01.02.2019;18:24:05;83400270;83287231;113039;
01.02.2019;18:25:07;83400367;83287370;112997;
01.02.2019;18:26:04;83400442;83287508;112934;
01.02.2019;18:27:04;83400523;83287631;112892;
01.02.2019;18:28:05;83400585;83287740;112845;
01.02.2019;18:29:05;83400669;83287857;112812;
01.02.2019;18:30:07;83400751;83287971;112780;
01.02.2019;18:31:04;83400817;83288050;112767;
01.02.2019;18:32:05;83400907;83288171;112736;
01.02.2019;18:33:05;83400989;83288287;112702;
01.02.2019;18:34:04;83401086;83288387;112699;
01.02.2019;18:35:07;83401197;83288506;112691;
01.02.2019;18:36:04;83401253;83288612;112641;
01.02.2019;18:37:05;83401269;83288675;112594;
01.02.2019;18:38:04;83401372;83288795;112577;
01.02.2019;18:39:06;83401457;83288914;112543;
01.02.2019;18:40:08;83401542;83289047;112495;
01.02.2019;18:41:05;83401614;83289146;112468;
01.02.2019;18:42:04;83401706;83289276;112430;
01.02.2019;18:43:04;83401801;83289412;112389;
01.02.2019;18:44:05;83401861;83289536;112325;
01.02.2019;18:45:07;83401938;83289654;112284;
01.02.2019;18:46:04;83402016;83289758;112258;
01.02.2019;18:47:04;83402103;83289884;112219;
01.02.2019;18:48:05;83402190;83290023;112167;
01.02.2019;18:49:05;83402255;83290140;112115;
01.02.2019;18:50:08;83402328;83290275;112053;
01.02.2019;18:51:05;83402452;83290379;112073;
01.02.2019;18:52:05;83402536;83290499;112037;
01.02.2019;18:53:04;83402599;83290609;111990;
01.02.2019;18:54:05;83402699;83290707;111992;
01.02.2019;18:55:07;83402779;83290834;111945;
01.02.2019;18:56:04;83402861;83290946;111915;
01.02.2019;18:57:05;83402942;83291049;111893;
01.02.2019;18:58:04;83403032;83291142;111890;
01.02.2019;18:59:04;83403097;83291234;111863;
01.02.2019;19:00:08;83403179;83291350;111829;
01.02.2019;19:01:04;83403251;83291460;111791;
01.02.2019;19:02:05;83403329;83291545;111784;
01.02.2019;19:03:04;83403407;83291630;111777;
01.02.2019;19:04:05;83403483;83291727;111756;
01.02.2019;19:05:06;83403587;83291830;111757;
01.02.2019;19:06:05;83403667;83291933;111734;
01.02.2019;19:07:05;83403741;83292041;111700;
01.02.2019;19:08:05;83403837;83292139;111698;
01.02.2019;19:09:06;83403903;83292241;111662;
01.02.2019;19:10:04;83403995;83292357;111638;
01.02.2019;19:11:06;83404067;83292467;111600;
01.02.2019;19:12:05;83404148;83292564;111584;
01.02.2019;19:13:05;83404229;83292661;111568;
01.02.2019;19:14:04;83404314;83292750;111564;
01.02.2019;19:15:04;83404423;83292861;111562;
01.02.2019;19:16:08;83404501;83292966;111535;
01.02.2019;19:17:07;83404584;83293066;111518;
01.02.2019;19:18:05;83404685;83293169;111516;
01.02.2019;19:19:05;83404763;83293263;111500;
01.02.2019;19:20:05;83404845;83293339;111506;
01.02.2019;19:21:08;83404934;83293460;111474;
01.02.2019;19:22:05;83405003;83293546;111457;
01.02.2019;19:23:05;83405076;83293629;111447;
01.02.2019;19:24:04;83405146;83293692;111454;
01.02.2019;19:25:04;83405240;83293790;111450;
01.02.2019;19:26:08;83405333;83293887;111446;
01.02.2019;19:27:05;83405391;83293989;111402;
01.02.2019;19:28:05;83405481;83294075;111406;
01.02.2019;19:29:05;83405576;83294191;111385;
01.02.2019;19:30:08;83405649;83294295;111354;
01.02.2019;19:31:05;83405722;83294363;111359;
01.02.2019;19:32:07;83405825;83294450;111375;
01.02.2019;19:33:05;83405910;83294552;111358;
01.02.2019;19:34:05;83405978;83294623;111355;
01.02.2019;19:35:05;83406063;83294695;111368;
01.02.2019;19:36:04;83406158;83294783;111375;
01.02.2019;19:37:04;83406250;83294873;111377;
01.02.2019;19:38:05;83406349;83294965;111384;
01.02.2019;19:39:07;83406424;83295048;111376;
01.02.2019;19:40:07;83406499;83295143;111356;
01.02.2019;19:41:07;83406584;83295213;111371;
01.02.2019;19:42:04;83406664;83295284;111380;
01.02.2019;19:43:04;83406752;83295381;111371;
01.02.2019;19:44:07;83406836;83295471;111365;
01.02.2019;19:45:05;83406937;83295559;111378;
01.02.2019;19:46:05;83407042;83295636;111406;
01.02.2019;19:47:05;83407132;83295725;111407;
01.02.2019;19:48:05;83407233;83295821;111412;
01.02.2019;19:49:05;83407331;83295888;111443;
01.02.2019;19:50:05;83407412;83295958;111454;
01.02.2019;19:51:05;83407483;83296024;111459;
01.02.2019;19:52:05;83407576;83296111;111465;
01.02.2019;19:53:05;83407650;83296187;111463;
01.02.2019;19:54:05;83407754;83296270;111484;
01.02.2019;19:55:05;83407844;83296347;111497;
01.02.2019;19:56:05;83407946;83296415;111531;
01.02.2019;19:57:05;83408021;83296492;111529;
01.02.2019;19:58:04;83408109;83296561;111548;
01.02.2019;19:59:04;83408189;83296617;111572;
01.02.2019;20:00:05;83408291;83296700;111591;
01.02.2019;20:01:05;83408387;83296775;111612;
01.02.2019;20:02:05;83408462;83296836;111626;
01.02.2019;20:03:05;83408556;83296913;111643;
01.02.2019;20:04:05;83408646;83296982;111664;
01.02.2019;20:05:05;83408741;83297068;111673;
01.02.2019;20:06:04;83408853;83297129;111724;
01.02.2019;20:07:05;83408956;83297195;111761;
01.02.2019;20:08:05;83409042;83297257;111785;
01.02.2019;20:09:07;83409134;83297360;111774;
01.02.2019;20:10:05;83409233;83297426;111807;
01.02.2019;20:11:04;83409337;83297513;111824;
01.02.2019;20:12:04;83409425;83297557;111868;
01.02.2019;20:13:05;83409521;83297629;111892;
01.02.2019;20:14:05;83409620;83297702;111918;
01.02.2019;20:15:05;83409692;83297772;111920;
01.02.2019;20:16:04;83409782;83297837;111945;
01.02.2019;20:17:04;83409869;83297903;111966;
01.02.2019;20:18:04;83409965;83297953;112012;
01.02.2019;20:19:05;83410055;83298029;112026;
01.02.2019;20:20:06;83410140;83298068;112072;
01.02.2019;20:21:04;83410229;83298134;112095;
01.02.2019;20:22:04;83410308;83298188;112120;
01.02.2019;20:23:05;83410360;83298251;112109;
01.02.2019;20:24:05;83410449;83298308;112141;
01.02.2019;20:26:05;83410582;83298365;112217;
01.02.2019;20:27:05;83410645;83298437;112208;
01.02.2019;20:28:04;83410728;83298492;112236;
01.02.2019;20:29:04;83410813;83298546;112267;
01.02.2019;20:30:05;83410882;83298608;112274;
01.02.2019;20:31:05;83410942;83298661;112281;
01.02.2019;20:32:05;83411028;83298668;112360;
01.02.2019;20:33:05;83411108;83298735;112373;
01.02.2019;20:34:05;83411173;83298775;112398;
01.02.2019;20:35:05;83411252;83298879;112373;
01.02.2019;20:36:04;83411330;83298934;112396;
01.02.2019;20:37:05;83411398;83298985;112413;
01.02.2019;20:38:05;83411500;83299033;112467;
01.02.2019;20:39:07;83411589;83299060;112529;
01.02.2019;20:40:05;83411672;83299120;112552;
01.02.2019;20:41:05;83411713;83299190;112523;
01.02.2019;20:42:05;83411745;83299254;112491;
01.02.2019;20:43:04;83411787;83299302;112485;
01.02.2019;20:44:04;83411829;83299360;112469;
01.02.2019;20:45:05;83411909;83299411;112498;
01.02.2019;20:46:05;83411967;83299463;112504;
01.02.2019;20:47:05;83412030;83299518;112512;
01.02.2019;20:48:04;83412096;83299570;112526;
01.02.2019;20:49:04;83412150;83299636;112514;
01.02.2019;20:50:05;83412235;83299694;112541;
01.02.2019;20:51:04;83412313;83299735;112578;
01.02.2019;20:52:04;83412396;83299808;112588;
01.02.2019;20:53:04;83412433;83299860;112573;
01.02.2019;20:54:05;83412506;83299919;112587;
01.02.2019;20:55:05;83412579;83299958;112621;
01.02.2019;20:56:05;83412635;83299996;112639;
01.02.2019;20:57:05;83412699;83300034;112665;
01.02.2019;20:58:05;83412778;83300091;112687;
01.02.2019;20:59:05;83412866;83300135;112731;
01.02.2019;21:00:04;83412921;83300189;112732;
01.02.2019;21:01:04;83412990;83300261;112729;
01.02.2019;21:02:04;83411931;83305942;105989;
01.02.2019;21:03:05;83412007;83306003;106004;
01.02.2019;21:04:05;83412076;83306055;106021;
01.02.2019;21:05:04;83412169;83306108;106061;
01.02.2019;21:06:05;83412230;83306162;106068;
01.02.2019;21:07:04;83412301;83306207;106094;
01.02.2019;21:08:04;83412378;83306246;106132;
01.02.2019;21:09:05;83412476;83306298;106178;
01.02.2019;21:10:05;83412549;83306351;106198;
01.02.2019;21:11:05;83412633;83306392;106241;
01.02.2019;21:12:05;83412698;83306436;106262;
01.02.2019;21:13:05;83412791;83306484;106307;
01.02.2019;21:14:04;83412868;83306532;106336;
01.02.2019;21:15:05;83412921;83306565;106356;
01.02.2019;21:16:04;83413026;83306615;106411;
01.02.2019;21:17:04;83413101;83306648;106453;
01.02.2019;21:18:04;83413198;83306698;106500;
01.02.2019;21:19:05;83413295;83306739;106556;
01.02.2019;21:20:05;83413363;83306777;106586;
01.02.2019;21:21:05;83413441;83306820;106621;
01.02.2019;21:22:04;83413516;83306868;106648;
01.02.2019;21:23:09;83413610;83306930;106680;
01.02.2019;21:24:04;83413688;83306968;106720;
01.02.2019;21:25:05;83413767;83307034;106733;
01.02.2019;21:26:05;83413829;83307078;106751;
01.02.2019;21:27:04;83413891;83307120;106771;
01.02.2019;21:28:04;83413966;83307169;106797;
01.02.2019;21:29:05;83414036;83307197;106839;
01.02.2019;21:30:06;83414117;83307251;106866;
01.02.2019;21:31:05;83414225;83307291;106934;
01.02.2019;21:32:17;83414317;83307332;106985;
01.02.2019;21:33:26;83414405;83307393;107012;
01.02.2019;21:34:04;83414477;83307404;107073;
01.02.2019;21:35:05;83414545;83307455;107090;
01.02.2019;21:36:04;83414602;83307490;107112;
01.02.2019;21:37:04;83414698;83307542;107156;
01.02.2019;21:38:05;83414769;83307590;107179;
01.02.2019;21:39:06;83414856;83307625;107231;
01.02.2019;21:40:05;83414942;83307658;107284;
01.02.2019;21:41:05;83415015;83307696;107319;
01.02.2019;21:42:05;83415105;83307738;107367;
01.02.2019;21:43:04;83415172;83307782;107390;
01.02.2019;21:44:04;83415263;83307835;107428;
01.02.2019;21:45:05;83415334;83307869;107465;
01.02.2019;21:46:20;83415389;83307868;107521;
01.02.2019;21:47:05;83415452;83307898;107554;
01.02.2019;21:48:05;83415550;83307943;107607;
01.02.2019;21:49:04;83415612;83307987;107625;
01.02.2019;21:50:04;83415701;83308031;107670;
01.02.2019;21:51:05;83415772;83308072;107700;
01.02.2019;21:52:05;83415862;83308095;107767;
01.02.2019;21:53:05;83415937;83308130;107807;
01.02.2019;21:54:05;83416015;83308163;107852;
01.02.2019;21:55:04;83416073;83308193;107880;
01.02.2019;21:56:04;83416147;83308219;107928;
01.02.2019;21:57:04;83416218;83308266;107952;
01.02.2019;21:58:05;83416270;83308297;107973;
01.02.2019;21:59:04;83416349;83308315;108034;
01.02.2019;22:00:05;83416423;83308353;108070;
01.02.2019;22:01:09;83416486;83308387;108099;
01.02.2019;22:02:04;83416562;83308414;108148;
01.02.2019;22:03:05;83416631;83308456;108175;
01.02.2019;22:04:05;83416723;83308488;108235;
01.02.2019;22:05:05;83416801;83308525;108276;
01.02.2019;22:06:04;83416869;83308570;108299;
01.02.2019;22:07:04;83416938;83308606;108332;
01.02.2019;22:08:05;83417019;83308637;108382;
01.02.2019;22:09:06;83417116;83308694;108422;
01.02.2019;22:10:04;83417152;83308732;108420;
01.02.2019;22:11:04;83417271;83308788;108483;
01.02.2019;22:12:05;83417362;83308823;108539;
01.02.2019;22:13:05;83417431;83308842;108589;
01.02.2019;22:14:04;83417513;83308872;108641;
01.02.2019;22:15:04;83417573;83308919;108654;
01.02.2019;22:16:10;83417668;83308947;108721;
01.02.2019;22:17:04;83417732;83308974;108758;
01.02.2019;22:18:04;83417797;83309005;108792;
01.02.2019;22:19:05;83417895;83309038;108857;
01.02.2019;22:20:05;83417975;83309058;108917;
01.02.2019;22:21:04;83418039;83309106;108933;
01.02.2019;22:22:04;83418116;83309118;108998;
01.02.2019;22:23:05;83418173;83309149;109024;
01.02.2019;22:24:10;83418243;83309175;109068;
01.02.2019;22:25:04;83418305;83309185;109120;
01.02.2019;22:26:04;83418372;83309217;109155;
01.02.2019;22:27:05;83418445;83309231;109214;
01.02.2019;22:28:05;83418517;83309243;109274;
01.02.2019;22:29:04;83418595;83309285;109310;
01.02.2019;22:30:04;83418650;83309320;109330;
01.02.2019;22:31:05;83418719;83309340;109379;
01.02.2019;22:32:05;83418790;83309373;109417;
01.02.2019;22:33:04;83418860;83309392;109468;
01.02.2019;22:34:04;83418932;83309414;109518;
01.02.2019;22:35:04;83418970;83309443;109527;
01.02.2019;22:36:05;83419036;83309474;109562;
01.02.2019;22:37:05;83419073;83309504;109569;
01.02.2019;22:38:04;83419183;83309524;109659;
01.02.2019;22:39:04;83419262;83309542;109720;
01.02.2019;22:40:05;83419335;83309576;109759;
01.02.2019;22:41:04;83419392;83309600;109792;
01.02.2019;22:42:04;83419461;83309623;109838;
01.02.2019;22:43:05;83419543;83309641;109902;
01.02.2019;22:44:05;83419600;83309662;109938;
01.02.2019;22:45:04;83419686;83309696;109990;
01.02.2019;22:46:10;83419776;83309732;110044;
01.02.2019;22:47:05;83419830;83309746;110084;
01.02.2019;22:48:05;83419902;83309772;110130;
01.02.2019;22:49:04;83419953;83309793;110160;
01.02.2019;22:50:10;83420059;83309810;110249;
01.02.2019;22:51:05;83420135;83309837;110298;
01.02.2019;22:52:05;83420204;83309862;110342;
01.02.2019;22:53:04;83420286;83309892;110394;
01.02.2019;22:54:04;83420374;83309913;110461;
01.02.2019;22:55:05;83420474;83309953;110521;
01.02.2019;22:56:04;83420553;83309980;110573;
01.02.2019;22:57:04;83420619;83310004;110615;
01.02.2019;22:58:05;83420701;83310043;110658;
01.02.2019;22:59:05;83420780;83310071;110709;
01.02.2019;23:00:04;83420847;83310096;110751;
01.02.2019;23:01:05;83420931;83310123;110808;
01.02.2019;23:02:05;83421013;83310150;110863;
01.02.2019;23:03:04;83421070;83310164;110906;
01.02.2019;23:04:04;83421133;83310200;110933;
01.02.2019;23:05:05;83421207;83310228;110979;
01.02.2019;23:06:04;83421283;83310258;111025;
01.02.2019;23:07:05;83421346;83310287;111059;
01.02.2019;23:08:20;83421424;83310323;111101;
01.02.2019;23:09:04;83421481;83310352;111129;
01.02.2019;23:10:04;83421550;83310377;111173;
01.02.2019;23:11:05;83421627;83310416;111211;
01.02.2019;23:12:04;83421683;83310448;111235;
01.02.2019;23:13:04;83421732;83310471;111261;
01.02.2019;23:14:05;83421834;83310494;111340;
01.02.2019;23:15:04;83421886;83310514;111372;
01.02.2019;23:16:05;83421955;83310528;111427;
01.02.2019;23:17:05;83422035;83310551;111484;
01.02.2019;23:18:06;83422117;83310571;111546;
01.02.2019;23:19:05;83422195;83310595;111600;
01.02.2019;23:20:04;83422282;83310624;111658;
01.02.2019;23:21:04;83422353;83310641;111712;
01.02.2019;23:22:06;83422443;83310662;111781;
01.02.2019;23:23:04;83422503;83310671;111832;
01.02.2019;23:24:04;83422569;83310691;111878;
01.02.2019;23:25:05;83422642;83310717;111925;
01.02.2019;23:26:04;83422714;83310740;111974;
01.02.2019;23:27:04;83422785;83310759;112026;
01.02.2019;23:28:06;83422842;83310774;112068;
01.02.2019;23:29:05;83422924;83310798;112126;
01.02.2019;23:30:10;83423014;83310824;112190;
01.02.2019;23:31:04;83423080;83310850;112230;
01.02.2019;23:32:05;83423156;83310880;112276;
01.02.2019;23:33:05;83423247;83310899;112348;
01.02.2019;23:34:04;83423341;83310917;112424;
01.02.2019;23:35:05;83423403;83310938;112465;
01.02.2019;23:36:04;83423472;83310969;112503;
01.02.2019;23:37:04;83423547;83310996;112551;
01.02.2019;23:38:05;83423625;83311015;112610;
01.02.2019;23:39:06;83423703;83311048;112655;
01.02.2019;23:40:04;83423755;83311061;112694;
01.02.2019;23:41:06;83423827;83311077;112750;
01.02.2019;23:42:05;83423899;83311119;112780;
01.02.2019;23:43:04;83423988;83311139;112849;
01.02.2019;23:44:05;83424066;83311177;112889;
01.02.2019;23:45:05;83424134;83311199;112935;
01.02.2019;23:46:04;83424206;83311207;112999;
01.02.2019;23:47:04;83424285;83311233;113052;
01.02.2019;23:48:05;83424349;83311260;113089;
01.02.2019;23:49:04;83424435;83311280;113155;
01.02.2019;23:50:04;83424545;83311311;113234;
01.02.2019;23:51:05;83424625;83311331;113294;
01.02.2019;23:52:05;83424686;83311351;113335;
01.02.2019;23:53:07;83424755;83311369;113386;
01.02.2019;23:54:09;83424822;83311386;113436;
01.02.2019;23:55:04;83424892;83311410;113482;
01.02.2019;23:56:12;83424989;83311441;113548;
01.02.2019;23:57:04;83425058;83311468;113590;
01.02.2019;23:58:04;83425125;83311494;113631;
01.02.2019;23:59:05;83425220;83311517;113703;
02.02.2019;00:00:13;83425293;83311536;113757;
02.02.2019;00:01:07;83425386;83311554;113832;
02.02.2019;00:02:13;83425445;83311580;113865;
02.02.2019;00:03:07;83425507;83311602;113905;
02.02.2019;00:04:08;83425557;83311630;113927;
02.02.2019;00:05:08;83425614;83311660;113954;
02.02.2019;00:06:07;83425702;83311676;114026;
02.02.2019;00:07:08;83425772;83311705;114067;
02.02.2019;00:08:08;83425832;83311732;114100;
02.02.2019;00:09:08;83425900;83311755;114145;
02.02.2019;00:10:08;83425983;83311779;114204;
02.02.2019;00:11:08;83426049;83311800;114249;
02.02.2019;00:12:08;83426111;83311833;114278;
02.02.2019;00:13:07;83426175;83311850;114325;
02.02.2019;00:14:08;83426241;83311866;114375;
02.02.2019;00:15:08;83426296;83311888;114408;
02.02.2019;00:16:08;83426383;83311910;114473;
02.02.2019;00:17:08;83426442;83311940;114502;
02.02.2019;00:18:08;83426509;83311952;114557;
02.02.2019;00:19:06;83426560;83311974;114586;
02.02.2019;00:20:08;83426614;83311984;114630;
02.02.2019;00:21:08;83426648;83311998;114650;
02.02.2019;00:22:07;83426699;83312012;114687;
02.02.2019;00:23:09;83426748;83312032;114716;
02.02.2019;00:24:07;83426777;83312047;114730;
02.02.2019;00:25:07;83426821;83312072;114749;
02.02.2019;00:26:07;83426879;83312097;114782;
02.02.2019;00:27:07;83426948;83312123;114825;
02.02.2019;00:28:08;83427009;83312139;114870;
02.02.2019;00:29:07;83427069;83312151;114918;
02.02.2019;00:30:08;83427131;83312173;114958;
02.02.2019;00:31:07;83427192;83312190;115002;
02.02.2019;00:32:08;83427249;83312205;115044;
02.02.2019;00:33:08;83427290;83312226;115064;
02.02.2019;00:34:08;83427344;83312229;115115;
02.02.2019;00:35:07;83427397;83312260;115137;
02.02.2019;00:36:08;83427437;83312280;115157;
02.02.2019;00:37:07;83427511;83312301;115210;
02.02.2019;00:38:07;83427555;83312321;115234;
02.02.2019;00:39:07;83427614;83312343;115271;
02.02.2019;00:40:06;83427673;83312359;115314;
02.02.2019;00:41:08;83427738;83312377;115361;
02.02.2019;00:42:07;83427802;83312396;115406;
02.02.2019;00:43:07;83427848;83312416;115432;
02.02.2019;00:44:07;83427912;83312449;115463;
02.02.2019;00:45:07;83427994;83312465;115529;
02.02.2019;00:46:07;83428058;83312487;115571;
02.02.2019;00:47:07;83428128;83312517;115611;
02.02.2019;00:48:07;83428178;83312540;115638;
02.02.2019;00:49:08;83428259;83312563;115696;
02.02.2019;00:50:06;83428332;83312593;115739;
02.02.2019;00:51:07;83428397;83312617;115780;
02.02.2019;00:52:08;83428471;83312634;115837;
02.02.2019;00:53:08;83428534;83312652;115882;
02.02.2019;00:54:08;83428615;83312668;115947;
02.02.2019;00:55:07;83428668;83312703;115965;
02.02.2019;00:56:08;83428737;83312721;116016;
02.02.2019;00:57:07;83428809;83312751;116058;
02.02.2019;00:58:07;83428867;83312794;116073;
02.02.2019;00:59:08;83428938;83312820;116118;
02.02.2019;01:00:05;83429007;83312845;116162;
02.02.2019;01:01:04;83429062;83312880;116182;
02.02.2019;01:02:04;83429133;83312897;116236;
02.02.2019;01:03:05;83429210;83312931;116279;
02.02.2019;01:04:05;83429275;83312956;116319;
02.02.2019;01:05:04;83429344;83312973;116371;
02.02.2019;01:06:04;83429420;83312995;116425;
02.02.2019;01:07:05;83429467;83313020;116447;
02.02.2019;01:08:04;83429532;83313048;116484;
02.02.2019;01:09:06;83429604;83313066;116538;
02.02.2019;01:10:04;83429666;83313108;116558;
02.02.2019;01:11:04;83429718;83313125;116593;
02.02.2019;01:12:05;83429789;83313159;116630;
02.02.2019;01:13:04;83429845;83313192;116653;
02.02.2019;01:14:04;83429900;83313202;116698;
02.02.2019;01:15:05;83429980;83313252;116728;
02.02.2019;01:16:04;83430036;83313263;116773;
02.02.2019;01:17:05;83430125;83313301;116824;
02.02.2019;01:18:05;83430192;83313313;116879;
02.02.2019;01:19:04;83430252;83313336;116916;
02.02.2019;01:20:05;83430321;83313360;116961;
02.02.2019;01:21:05;83430393;83313392;117001;
02.02.2019;01:22:04;83430459;83313407;117052;
02.02.2019;01:23:05;83430539;83313434;117105;
02.02.2019;01:24:04;83430622;83313471;117151;
02.02.2019;01:25:04;83430705;83313507;117198;
02.02.2019;01:26:05;83430775;83313541;117234;
02.02.2019;01:27:04;83430843;83313576;117267;
02.02.2019;01:28:05;83430914;83313605;117309;
02.02.2019;01:29:04;83430976;83313642;117334;
02.02.2019;01:30:04;83431058;83313676;117382;
02.02.2019;01:31:05;83431115;83313716;117399;
02.02.2019;01:32:04;83431194;83313751;117443;
02.02.2019;01:33:05;83431256;83313785;117471;
02.02.2019;01:34:05;83431317;83313817;117500;
02.02.2019;01:35:05;83431402;83313841;117561;
02.02.2019;01:36:04;83431465;83313870;117595;
02.02.2019;01:37:05;83431537;83313900;117637;
02.02.2019;01:38:04;83431587;83313946;117641;
02.02.2019;01:39:05;83431652;83313993;117659;
02.02.2019;01:40:04;83431712;83314027;117685;
02.02.2019;01:41:04;83431769;83314055;117714;
02.02.2019;01:42:04;83431841;83314096;117745;
02.02.2019;01:43:05;83431920;83314131;117789;
02.02.2019;01:44:04;83431987;83314178;117809;
02.02.2019;01:45:04;83432059;83314207;117852;
02.02.2019;01:46:05;83432132;83314244;117888;
02.02.2019;01:47:04;83432209;83314292;117917;
02.02.2019;01:48:05;83432288;83314323;117965;
02.02.2019;01:49:04;83432357;83314363;117994;
02.02.2019;01:50:04;83432418;83314388;118030;
02.02.2019;01:51:05;83432491;83314434;118057;
02.02.2019;01:52:04;83432548;83314490;118058;
02.02.2019;01:53:05;83432638;83314532;118106;
02.02.2019;01:54:04;83432707;83314579;118128;
02.02.2019;01:55:05;83432779;83314608;118171;
02.02.2019;01:56:04;83432838;83314654;118184;
02.02.2019;01:57:04;83432910;83314695;118215;
02.02.2019;01:58:05;83432993;83314738;118255;
02.02.2019;01:59:04;83433077;83314777;118300;
02.02.2019;02:00:05;83433135;83314815;118320;
02.02.2019;02:01:04;83433143;83314807;118336;
02.02.2019;02:02:05;83433212;83314848;118364;
02.02.2019;02:03:04;83433288;83314898;118390;
02.02.2019;02:04:04;83433352;83314954;118398;
02.02.2019;02:05:04;83433430;83314995;118435;
02.02.2019;02:06:04;83433498;83315037;118461;
02.02.2019;02:07:05;83433575;83315085;118490;
02.02.2019;02:08:04;83433650;83315126;118524;
02.02.2019;02:09:05;83433718;83315170;118548;
02.02.2019;02:10:04;83433791;83315220;118571;
02.02.2019;02:11:04;83433850;83315262;118588;
02.02.2019;02:12:05;83433915;83315319;118596;
02.02.2019;02:13:04;83433987;83315363;118624;
02.02.2019;02:14:05;83434059;83315420;118639;
02.02.2019;02:15:04;83434135;83315479;118656;
02.02.2019;02:16:04;83434187;83315526;118661;
02.02.2019;02:17:05;83434207;83315572;118635;
02.02.2019;02:18:04;83434257;83315634;118623;
02.02.2019;02:19:04;83434301;83315690;118611;
02.02.2019;02:20:05;83434383;83315737;118646;
02.02.2019;02:21:04;83434426;83315782;118644;
02.02.2019;02:22:05;83434480;83315847;118633;
02.02.2019;02:23:04;83434553;83315907;118646;
02.02.2019;02:24:05;83434597;83315954;118643;
02.02.2019;02:25:04;83434656;83316025;118631;
02.02.2019;02:26:04;83434731;83316075;118656;
02.02.2019;02:27:05;83434787;83316137;118650;
02.02.2019;02:28:04;83434854;83316213;118641;
02.02.2019;02:29:05;83434927;83316258;118669;
02.02.2019;02:30:04;83435004;83316322;118682;
02.02.2019;02:31:04;83435068;83316382;118686;
02.02.2019;02:32:05;83435125;83316449;118676;
02.02.2019;02:33:04;83435186;83316501;118685;
02.02.2019;02:34:05;83435248;83316569;118679;
02.02.2019;02:35:05;83435280;83316641;118639;
02.02.2019;02:36:04;83435365;83316709;118656;
02.02.2019;02:37:04;83435424;83316776;118648;
02.02.2019;02:38:05;83435516;83316844;118672;
02.02.2019;02:39:06;83435583;83316915;118668;
02.02.2019;02:40:05;83435649;83316973;118676;
02.02.2019;02:41:04;83435704;83317041;118663;
02.02.2019;02:42:05;83435771;83317089;118682;
02.02.2019;02:43:04;83435848;83317156;118692;
02.02.2019;02:44:05;83435930;83317234;118696;
02.02.2019;02:45:04;83435990;83317320;118670;
02.02.2019;02:46:04;83436064;83317400;118664;
02.02.2019;02:47:04;83436144;83317468;118676;
02.02.2019;02:48:04;83436222;83317549;118673;
02.02.2019;02:49:04;83436305;83317608;118697;
02.02.2019;02:50:04;83436396;83317675;118721;
02.02.2019;02:51:05;83436463;83317740;118723;
02.02.2019;02:52:04;83436535;83317835;118700;
02.02.2019;02:53:05;83436610;83317924;118686;
02.02.2019;02:54:04;83436695;83318002;118693;
02.02.2019;02:55:04;83436769;83318092;118677;
02.02.2019;02:56:05;83436825;83318168;118657;
02.02.2019;02:57:04;83436880;83318255;118625;
02.02.2019;02:58:04;83436954;83318325;118629;
02.02.2019;02:59:05;83437035;83318412;118623;
02.02.2019;03:00:04;83437101;83318480;118621;
02.02.2019;03:01:05;83437160;83318550;118610;
02.02.2019;03:02:04;83437226;83318641;118585;
02.02.2019;03:03:04;83437297;83318704;118593;
02.02.2019;03:04:04;83437365;83318787;118578;
02.02.2019;03:05:04;83437430;83318876;118554;
02.02.2019;03:06:05;83437496;83318962;118534;
02.02.2019;03:07:05;83437562;83319027;118535;
02.02.2019;03:08:04;83437632;83319123;118509;
02.02.2019;03:09:07;83437711;83319207;118504;
02.02.2019;03:10:05;83437800;83319295;118505;
02.02.2019;03:11:05;83437872;83319398;118474;
02.02.2019;03:12:04;83437930;83319491;118439;
02.02.2019;03:13:04;83438010;83319599;118411;
02.02.2019;03:14:05;83438098;83319690;118408;
02.02.2019;03:15:04;83438177;83319791;118386;
02.02.2019;03:16:05;83438262;83319882;118380;
02.02.2019;03:17:05;83438322;83319978;118344;
02.02.2019;03:18:04;83438396;83320064;118332;
02.02.2019;03:19:04;83438470;83320146;118324;
02.02.2019;03:20:04;83438554;83320258;118296;
02.02.2019;03:21:04;83438632;83320380;118252;
02.02.2019;03:22:05;83438731;83320493;118238;
02.02.2019;03:23:04;83438799;83320589;118210;
02.02.2019;03:24:04;83438871;83320685;118186;
02.02.2019;03:25:05;83438956;83320761;118195;
02.02.2019;03:26:04;83439054;83320879;118175;
02.02.2019;03:27:05;83439135;83320991;118144;
02.02.2019;03:28:05;83439201;83321088;118113;
02.02.2019;03:29:04;83439275;83321189;118086;
02.02.2019;03:30:05;83439357;83321294;118063;
02.02.2019;03:31:04;83439434;83321398;118036;
02.02.2019;03:32:04;83439501;83321502;117999;
02.02.2019;03:33:05;83439581;83321609;117972;
02.02.2019;03:34:04;83439640;83321718;117922;
02.02.2019;03:35:05;83439706;83321818;117888;
02.02.2019;03:36:04;83439778;83321919;117859;
02.02.2019;03:37:05;83439858;83322005;117853;
02.02.2019;03:38:04;83439948;83322083;117865;
02.02.2019;03:39:04;83440007;83322191;117816;
02.02.2019;03:40:05;83440091;83322306;117785;
02.02.2019;03:41:04;83440163;83322419;117744;
02.02.2019;03:42:04;83440251;83322511;117740;
02.02.2019;03:43:05;83440329;83322613;117716;
02.02.2019;03:44:04;83440395;83322694;117701;
02.02.2019;03:45:05;83440489;83322791;117698;
02.02.2019;03:46:04;83440585;83322901;117684;
02.02.2019;03:47:04;83440666;83323003;117663;
02.02.2019;03:48:04;83440755;83323092;117663;
02.02.2019;03:49:04;83440831;83323206;117625;
02.02.2019;03:50:04;83440917;83323296;117621;
02.02.2019;03:51:05;83440993;83323431;117562;
02.02.2019;03:52:04;83441056;83323541;117515;
02.02.2019;03:53:04;83441105;83323619;117486;
02.02.2019;03:54:04;83441186;83323723;117463;
02.02.2019;03:55:04;83441268;83323819;117449;
02.02.2019;03:56:05;83441358;83323953;117405;
02.02.2019;03:57:04;83441432;83324043;117389;
02.02.2019;03:58:04;83441508;83324149;117359;
02.02.2019;03:59:04;83441592;83324273;117319;
02.02.2019;04:00:04;83441644;83324363;117281;
02.02.2019;04:01:05;83441741;83324487;117254;
02.02.2019;04:02:05;83441799;83324590;117209;
02.02.2019;04:03:04;83441884;83324716;117168;
02.02.2019;04:04:04;83441977;83324830;117147;
02.02.2019;04:05:05;83442061;83324923;117138;
02.02.2019;04:06:04;83442138;83325034;117104;
02.02.2019;04:07:05;83442254;83325149;117105;
02.02.2019;04:08:04;83442322;83325262;117060;
02.02.2019;04:09:06;83442407;83325370;117037;
02.02.2019;04:10:05;83442478;83325477;117001;
02.02.2019;04:11:04;83442558;83325577;116981;
02.02.2019;04:12:04;83442634;83325692;116942;
02.02.2019;04:13:04;83442714;83325800;116914;
02.02.2019;04:14:04;83442794;83325912;116882;
02.02.2019;04:15:04;83442864;83326008;116856;
02.02.2019;04:16:05;83442939;83326137;116802;
02.02.2019;04:17:04;83442992;83326246;116746;
02.02.2019;04:18:04;83443059;83326349;116710;
02.02.2019;04:19:05;83443115;83326441;116674;
02.02.2019;04:20:04;83443176;83326568;116608;
02.02.2019;04:21:05;83443244;83326676;116568;
02.02.2019;04:22:04;83443304;83326778;116526;
02.02.2019;04:23:04;83443376;83326895;116481;
02.02.2019;04:24:04;83443458;83327016;116442;
02.02.2019;04:25:04;83443537;83327115;116422;
02.02.2019;04:26:05;83443605;83327218;116387;
02.02.2019;04:27:04;83443674;83327323;116351;
02.02.2019;04:28:05;83443745;83327433;116312;
02.02.2019;04:29:04;83443824;83327540;116284;
02.02.2019;04:30:04;83443909;83327656;116253;
02.02.2019;04:31:04;83443990;83327775;116215;
02.02.2019;04:32:04;83444078;83327901;116177;
02.02.2019;04:33:04;83444144;83328021;116123;
02.02.2019;04:34:04;83444220;83328143;116077;
02.02.2019;04:35:04;83444310;83328259;116051;
02.02.2019;04:36:05;83444390;83328370;116020;
02.02.2019;04:37:04;83444458;83328477;115981;
02.02.2019;04:38:05;83444543;83328602;115941;
02.02.2019;04:39:06;83444640;83328711;115929;
02.02.2019;04:40:05;83444729;83328830;115899;
02.02.2019;04:41:04;83444811;83328963;115848;
02.02.2019;04:42:04;83444900;83329069;115831;
02.02.2019;04:43:05;83444975;83329210;115765;
02.02.2019;04:44:04;83445032;83329319;115713;
02.02.2019;04:45:05;83445106;83329437;115669;
02.02.2019;04:46:04;83445189;83329538;115651;
02.02.2019;04:47:04;83445263;83329666;115597;
02.02.2019;04:48:04;83445339;83329809;115530;
02.02.2019;04:49:04;83445432;83329918;115514;
02.02.2019;04:50:04;83445522;83330043;115479;
02.02.2019;04:51:04;83445603;83330147;115456;
02.02.2019;04:52:05;83445691;83330242;115449;
02.02.2019;04:53:04;83445775;83330369;115406;
02.02.2019;04:54:04;83445865;83330508;115357;
02.02.2019;04:55:04;83445951;83330626;115325;
02.02.2019;04:56:04;83446036;83330747;115289;
02.02.2019;04:57:05;83446115;83330854;115261;
02.02.2019;04:58:04;83446219;83330959;115260;
02.02.2019;04:59:05;83446300;83331086;115214;
02.02.2019;05:00:04;83446378;83331200;115178;
02.02.2019;05:01:04;83446444;83331297;115147;
02.02.2019;05:02:04;83446515;83331408;115107;
02.02.2019;05:03:04;83446601;83331535;115066;
02.02.2019;05:04:05;83446687;83331634;115053;
02.02.2019;05:05:04;83446759;83331746;115013;
02.02.2019;05:06:04;83446839;83331872;114967;
02.02.2019;05:07:04;83446904;83331987;114917;
02.02.2019;05:08:04;83446972;83332098;114874;
02.02.2019;05:09:05;83447048;83332221;114827;
02.02.2019;05:10:04;83447124;83332335;114789;
02.02.2019;05:11:04;83447227;83332465;114762;
02.02.2019;05:12:05;83447308;83332583;114725;
02.02.2019;05:13:04;83447407;83332707;114700;
02.02.2019;05:14:05;83447477;83332805;114672;
02.02.2019;05:15:04;83447558;83332919;114639;
02.02.2019;05:16:04;83447624;83333038;114586;
02.02.2019;05:17:05;83447710;83333167;114543;
02.02.2019;05:18:04;83447813;83333298;114515;
02.02.2019;05:19:04;83447907;83333411;114496;
02.02.2019;05:20:05;83447992;83333537;114455;
02.02.2019;05:21:04;83448072;83333647;114425;
02.02.2019;05:22:05;83448165;83333786;114379;
02.02.2019;05:23:04;83448258;83333894;114364;
02.02.2019;05:24:05;83448346;83334029;114317;
02.02.2019;05:25:04;83448416;83334146;114270;
02.02.2019;05:26:04;83448473;83334273;114200;
02.02.2019;05:27:04;83448552;83334386;114166;
02.02.2019;05:28:04;83448630;83334506;114124;
02.02.2019;05:29:05;83448715;83334626;114089;
02.02.2019;05:30:04;83448785;83334758;114027;
02.02.2019;05:31:05;83448847;83334888;113959;
02.02.2019;05:32:04;83448937;83335018;113919;
02.02.2019;05:33:04;83449011;83335137;113874;
02.02.2019;05:34:05;83449091;83335260;113831;
02.02.2019;05:35:04;83449169;83335381;113788;
02.02.2019;05:36:05;83449253;83335524;113729;
02.02.2019;05:37:04;83449321;83335652;113669;
02.02.2019;05:38:05;83449418;83335765;113653;
02.02.2019;05:39:05;83449501;83335900;113601;
02.02.2019;05:40:04;83449579;83336024;113555;
02.02.2019;05:41:05;83449635;83336156;113479;
02.02.2019;05:42:04;83449700;83336294;113406;
02.02.2019;05:43:04;83449760;83336429;113331;
02.02.2019;05:44:04;83449849;83336566;113283;
02.02.2019;05:45:04;83449914;83336688;113226;
02.02.2019;05:46:05;83449979;83336823;113156;
02.02.2019;05:47:04;83450039;83336951;113088;
02.02.2019;05:48:05;83450121;83337063;113058;
02.02.2019;05:49:04;83450209;83337184;113025;
02.02.2019;05:50:05;83450286;83337325;112961;
02.02.2019;05:51:04;83450362;83337441;112921;
02.02.2019;05:52:05;83450435;83337592;112843;
02.02.2019;05:53:04;83450486;83337722;112764;
02.02.2019;05:54:04;83450562;83337863;112699;
02.02.2019;05:55:05;83450632;83337984;112648;
02.02.2019;05:56:04;83450713;83338117;112596;
02.02.2019;05:57:04;83450808;83338243;112565;
02.02.2019;05:58:05;83450872;83338368;112504;
02.02.2019;05:59:04;83450953;83338487;112466;
02.02.2019;06:00:05;83451012;83338623;112389;
02.02.2019;06:01:04;83451073;83338753;112320;
02.02.2019;06:02:05;83451140;83338879;112261;
02.02.2019;06:03:04;83451215;83339006;112209;
02.02.2019;06:04:04;83451308;83339145;112163;
02.02.2019;06:05:04;83451402;83339283;112119;
02.02.2019;06:06:04;83451476;83339405;112071;
02.02.2019;06:07:05;83451539;83339542;111997;
02.02.2019;06:08:04;83451624;83339664;111960;
02.02.2019;06:09:05;83451691;83339784;111907;
02.02.2019;06:10:04;83451763;83339911;111852;
02.02.2019;06:11:04;83451811;83340028;111783;
02.02.2019;06:12:04;83451882;83340168;111714;
02.02.2019;06:13:04;83451948;83340290;111658;
02.02.2019;06:14:04;83452023;83340380;111643;
02.02.2019;06:15:05;83452106;83340480;111626;
02.02.2019;06:16:04;83452152;83340604;111548;
02.02.2019;06:17:04;83452233;83340748;111485;
02.02.2019;06:18:04;83452298;83340848;111450;
02.02.2019;06:19:04;83452364;83340959;111405;
02.02.2019;06:20:04;83452393;83341103;111290;
02.02.2019;06:21:04;83452449;83341228;111221;
02.02.2019;06:22:04;83452498;83341347;111151;
02.02.2019;06:23:05;83452552;83341438;111114;
02.02.2019;06:24:04;83452614;83341527;111087;
02.02.2019;06:25:08;83452635;83341663;110972;
02.02.2019;06:26:10;83452699;83341778;110921;
02.02.2019;06:27:04;83452745;83341868;110877;
02.02.2019;06:28:04;83452802;83341997;110805;
02.02.2019;06:29:04;83452858;83342108;110750;
02.02.2019;06:30:05;83452889;83342221;110668;
02.02.2019;06:31:04;83452971;83342347;110624;
02.02.2019;06:32:05;83453031;83342462;110569;
02.02.2019;06:33:04;83453100;83342582;110518;
02.02.2019;06:34:05;83453152;83342699;110453;
02.02.2019;06:35:04;83453210;83342807;110403;
02.02.2019;06:36:04;83453282;83342944;110338;
02.02.2019;06:37:05;83453355;83343078;110277;
02.02.2019;06:38:05;83453413;83343217;110196;
02.02.2019;06:39:04;83453478;83343355;110123;
02.02.2019;06:40:04;83453552;83343468;110084;
02.02.2019;06:41:04;83453611;83343615;109996;
02.02.2019;06:42:04;83453694;83343705;109989;
02.02.2019;06:43:05;83453762;83343849;109913;
02.02.2019;06:44:04;83453815;83343993;109822;
02.02.2019;06:45:08;83453894;83344105;109789;
02.02.2019;06:46:05;83453964;83344238;109726;
02.02.2019;06:47:04;83454034;83344352;109682;
02.02.2019;06:48:04;83454082;83344476;109606;
02.02.2019;06:49:04;83454151;83344595;109556;
02.02.2019;06:50:04;83454191;83344710;109481;
02.02.2019;06:51:05;83454275;83344863;109412;
02.02.2019;06:52:04;83454323;83344993;109330;
02.02.2019;06:53:05;83454353;83345130;109223;
02.02.2019;06:54:04;83454395;83345239;109156;
02.02.2019;06:55:04;83454465;83345350;109115;
02.02.2019;06:56:05;83454532;83345476;109056;
02.02.2019;06:57:04;83454598;83345596;109002;
02.02.2019;06:58:05;83454661;83345718;108943;
02.02.2019;06:59:05;83454726;83345845;108881;
02.02.2019;07:00:04;83454788;83345950;108838;
02.02.2019;07:01:05;83454859;83346063;108796;
02.02.2019;07:02:04;83454928;83346175;108753;
02.02.2019;07:03:05;83454983;83346339;108644;
02.02.2019;07:04:04;83455050;83346477;108573;
02.02.2019;07:05:04;83455122;83346616;108506;
02.02.2019;07:06:05;83455191;83346732;108459;
02.02.2019;07:07:04;83455254;83346859;108395;
02.02.2019;07:08:05;83455340;83347001;108339;
02.02.2019;07:09:05;83455406;83347107;108299;
02.02.2019;07:10:04;83455478;83347241;108237;
02.02.2019;07:11:04;83455553;83347378;108175;
02.02.2019;07:12:05;83455634;83347506;108128;
02.02.2019;07:13:04;83455680;83347602;108078;
02.02.2019;07:14:05;83455739;83347709;108030;
02.02.2019;07:15:04;83455804;83347845;107959;
02.02.2019;07:16:04;83455854;83347963;107891;
02.02.2019;07:17:05;83455952;83348099;107853;
02.02.2019;07:18:04;83456033;83348228;107805;
02.02.2019;07:19:04;83456104;83348347;107757;
02.02.2019;07:20:05;83456167;83348476;107691;
02.02.2019;07:21:05;83456246;83348603;107643;
02.02.2019;07:22:04;83456285;83348735;107550;
02.02.2019;07:23:04;83456336;83348889;107447;
02.02.2019;07:24:05;83456388;83349037;107351;
02.02.2019;07:25:05;83456459;83349164;107295;
02.02.2019;07:26:04;83456506;83349282;107224;
02.02.2019;07:27:05;83456561;83349407;107154;
02.02.2019;07:28:05;83456623;83349544;107079;
02.02.2019;07:29:04;83456700;83349678;107022;
02.02.2019;07:30:04;83456749;83349803;106946;
02.02.2019;07:31:05;83456802;83349943;106859;
02.02.2019;07:32:04;83456864;83350065;106799;
02.02.2019;07:33:05;83456931;83350176;106755;
02.02.2019;07:34:04;83457002;83350293;106709;
02.02.2019;07:35:04;83457054;83350428;106626;
02.02.2019;07:36:05;83457108;83350548;106560;
02.02.2019;07:37:04;83457159;83350660;106499;
02.02.2019;07:38:05;83457220;83350805;106415;
02.02.2019;07:39:04;83457297;83350931;106366;
02.02.2019;07:40:04;83457369;83351086;106283;
02.02.2019;07:41:05;83457454;83351209;106245;
02.02.2019;07:42:04;83457515;83351321;106194;
02.02.2019;07:43:05;83457589;83351462;106127;
02.02.2019;07:44:04;83457675;83351600;106075;
02.02.2019;07:45:04;83457743;83351724;106019;
02.02.2019;07:46:04;83457811;83351863;105948;
02.02.2019;07:47:04;83457870;83352002;105868;
02.02.2019;07:48:05;83457921;83352126;105795;
02.02.2019;07:49:05;83457991;83352263;105728;
02.02.2019;07:50:04;83458040;83352375;105665;
02.02.2019;07:51:05;83458099;83352503;105596;
02.02.2019;07:52:04;83458166;83352630;105536;
02.02.2019;07:53:04;83458243;83352768;105475;
02.02.2019;07:54:05;83458308;83352896;105412;
02.02.2019;07:55:05;83458369;83353022;105347;
02.02.2019;07:56:04;83458438;83353153;105285;
02.02.2019;07:57:04;83458516;83353261;105255;
02.02.2019;07:58:05;83458584;83353399;105185;
02.02.2019;07:59:04;83458636;83353517;105119;
02.02.2019;08:00:05;83458694;83353621;105073;
02.02.2019;08:01:05;83458758;83353732;105026;
02.02.2019;08:02:04;83458825;83353848;104977;
02.02.2019;08:03:04;83458880;83353984;104896;
02.02.2019;08:04:05;83458947;83354102;104845;
02.02.2019;08:05:04;83458990;83354230;104760;
02.02.2019;08:06:05;83459046;83354355;104691;
02.02.2019;08:07:04;83459114;83354484;104630;
02.02.2019;08:08:05;83459191;83354608;104583;
02.02.2019;08:09:05;83459252;83354740;104512;
02.02.2019;08:10:04;83459304;83354855;104449;
02.02.2019;08:11:05;83459367;83354984;104383;
02.02.2019;08:12:04;83459427;83355140;104287;
02.02.2019;08:13:04;83459478;83355263;104215;
02.02.2019;08:14:05;83459524;83355393;104131;
02.02.2019;08:15:04;83459579;83355503;104076;
02.02.2019;08:16:04;83459627;83355618;104009;
02.02.2019;08:17:05;83459670;83355730;103940;
02.02.2019;08:18:05;83459721;83355877;103844;
02.02.2019;08:19:04;83459762;83355983;103779;
02.02.2019;08:20:05;83459803;83356085;103718;
02.02.2019;08:21:04;83459843;83356172;103671;
02.02.2019;08:22:04;83459870;83356284;103586;
02.02.2019;08:23:05;83459902;83356419;103483;
02.02.2019;08:24:04;83459942;83356541;103401;
02.02.2019;08:25:04;83459974;83356637;103337;
02.02.2019;08:26:05;83460033;83356760;103273;
02.02.2019;08:27:04;83460081;83356897;103184;
02.02.2019;08:28:05;83460138;83357047;103091;
02.02.2019;08:29:04;83460198;83357194;103004;
02.02.2019;08:30:04;83460241;83357327;102914;
02.02.2019;08:31:05;83460306;83357424;102882;
02.02.2019;08:32:04;83460343;83357545;102798;
02.02.2019;08:33:05;83460394;83357648;102746;
02.02.2019;08:34:05;83460451;83357777;102674;
02.02.2019;08:35:04;83460509;83357919;102590;
02.02.2019;08:36:04;83460562;83358048;102514;
02.02.2019;08:37:05;83460619;83358187;102432;
02.02.2019;08:38:04;83460674;83358332;102342;
02.02.2019;08:39:07;83460738;83358460;102278;
02.02.2019;08:40:04;83460773;83358595;102178;
02.02.2019;08:41:04;83460809;83358721;102088;
02.02.2019;08:42:05;83460860;83358865;101995;
02.02.2019;08:43:05;83460925;83358985;101940;
02.02.2019;08:44:04;83460983;83359113;101870;
02.02.2019;08:45:04;83461045;83359253;101792;
02.02.2019;08:46:05;83461114;83359383;101731;
02.02.2019;08:47:04;83461166;83359504;101662;
02.02.2019;08:48:05;83461233;83359622;101611;
02.02.2019;08:49:04;83461278;83359749;101529;
02.02.2019;08:50:05;83461345;83359865;101480;
02.02.2019;08:51:04;83461395;83360001;101394;
02.02.2019;08:52:05;83461439;83360138;101301;
02.02.2019;08:53:04;83461510;83360276;101234;
02.02.2019;08:54:04;83461587;83360407;101180;
02.02.2019;08:55:04;83461651;83360522;101129;
02.02.2019;08:56:05;83461726;83360655;101071;
02.02.2019;08:57:05;83461784;83360785;100999;
02.02.2019;08:58:04;83461828;83360931;100897;
02.02.2019;08:59:05;83461877;83361037;100840;
02.02.2019;09:00:05;83461921;83361160;100761;
02.02.2019;09:01:05;83462007;83361296;100711;
02.02.2019;09:02:04;83462065;83361402;100663;
02.02.2019;09:03:04;83462113;83361526;100587;
02.02.2019;09:04:05;83462190;83361661;100529;
02.02.2019;09:05:04;83462245;83361781;100464;
02.02.2019;09:06:05;83462313;83361923;100390;
02.02.2019;09:07:04;83462352;83362037;100315;
02.02.2019;09:08:05;83462407;83362172;100235;
02.02.2019;09:09:05;83462466;83362303;100163;
02.02.2019;09:10:04;83462514;83362432;100082;
02.02.2019;09:11:05;83462561;83362570;99991;
02.02.2019;09:12:04;83462613;83362702;99911;
02.02.2019;09:13:04;83462676;83362825;99851;
02.02.2019;09:14:05;83462748;83362934;99814;
02.02.2019;09:15:05;83462805;83363061;99744;
02.02.2019;09:16:05;83462857;83363171;99686;
02.02.2019;09:17:04;83462906;83363320;99586;
02.02.2019;09:18:04;83462977;83363439;99538;
02.02.2019;09:19:04;83463024;83363569;99455;
02.02.2019;09:20:11;83463105;83363717;99388;
02.02.2019;09:21:10;83463156;83363856;99300;
02.02.2019;09:22:04;83463205;83363980;99225;
02.02.2019;09:23:04;83463286;83364113;99173;
02.02.2019;09:24:05;83463363;83364238;99125;
02.02.2019;09:25:04;83463409;83364389;99020;
02.02.2019;09:26:04;83463490;83364525;98965;
02.02.2019;09:27:05;83463559;83364670;98889;
02.02.2019;09:28:05;83463641;83364816;98825;
02.02.2019;09:29:04;83463696;83364950;98746;
02.02.2019;09:30:04;83463769;83365068;98701;
02.02.2019;09:31:05;83463827;83365177;98650;
02.02.2019;09:32:04;83463890;83365315;98575;
02.02.2019;09:33:04;83463944;83365450;98494;
02.02.2019;09:34:05;83464009;83365575;98434;
02.02.2019;09:35:05;83464063;83365701;98362;
02.02.2019;09:36:04;83464138;83365831;98307;
02.02.2019;09:37:05;83464212;83365992;98220;
02.02.2019;09:38:05;83464281;83366133;98148;
02.02.2019;09:39:06;83464349;83366254;98095;
02.02.2019;09:40:10;83464426;83366380;98046;
02.02.2019;09:41:05;83464492;83366514;97978;
02.02.2019;09:42:05;83464560;83366639;97921;
02.02.2019;09:43:04;83464629;83366770;97859;
02.02.2019;09:44:04;83464708;83366909;97799;
02.02.2019;09:45:04;83464768;83367017;97751;
02.02.2019;09:46:04;83464848;83367164;97684;
02.02.2019;09:47:04;83464909;83367283;97626;
02.02.2019;09:48:05;83464932;83367343;97589;
02.02.2019;09:49:04;83464993;83367485;97508;
02.02.2019;09:50:05;83465054;83367642;97412;
02.02.2019;09:51:05;83465115;83367772;97343;
02.02.2019;09:52:05;83465170;83367885;97285;
02.02.2019;09:53:04;83465232;83368013;97219;
02.02.2019;09:54:04;83465294;83368141;97153;
02.02.2019;09:55:05;83465358;83368276;97082;
02.02.2019;09:56:04;83465430;83368407;97023;
02.02.2019;09:57:04;83465488;83368552;96936;
02.02.2019;09:58:05;83465567;83368690;96877;
02.02.2019;09:59:04;83465627;83368819;96808;
02.02.2019;10:00:05;83465676;83368947;96729;
02.02.2019;10:01:04;83465744;83369092;96652;
02.02.2019;10:02:04;83465805;83369248;96557;
02.02.2019;10:03:05;83465837;83369386;96451;
02.02.2019;10:04:05;83465894;83369528;96366;
02.02.2019;10:05:04;83465966;83369669;96297;
02.02.2019;10:06:04;83466029;83369807;96222;
02.02.2019;10:07:05;83466090;83369944;96146;
02.02.2019;10:08:05;83466138;83370085;96053;
02.02.2019;10:09:05;83466213;83370227;95986;
02.02.2019;10:10:05;83466272;83370380;95892;
02.02.2019;10:11:04;83466320;83370520;95800;
02.02.2019;10:13:04;83466393;83370799;95594;
02.02.2019;10:14:05;83466447;83370914;95533;
02.02.2019;10:15:05;83466484;83371058;95426;
02.02.2019;10:16:04;83466527;83371181;95346;
02.02.2019;10:17:05;83466572;83371319;95253;
02.02.2019;10:18:05;83466626;83371454;95172;
02.02.2019;10:19:04;83466669;83371548;95121;
02.02.2019;10:20:09;83466716;83371672;95044;
02.02.2019;10:21:05;83466753;83371813;94940;
02.02.2019;10:22:04;83466797;83371917;94880;
02.02.2019;10:23:04;83466833;83372039;94794;
02.02.2019;10:24:04;83466898;83372163;94735;
02.02.2019;10:25:05;83466919;83372282;94637;
02.02.2019;10:26:05;83466974;83372407;94567;
02.02.2019;10:27:05;83467036;83372564;94472;
02.02.2019;10:28:04;83467096;83372704;94392;
02.02.2019;10:29:04;83467157;83372832;94325;
02.02.2019;10:30:05;83467213;83372976;94237;
02.02.2019;10:31:05;83467276;83373098;94178;
02.02.2019;10:32:04;83467343;83373231;94112;
02.02.2019;10:33:05;83467394;83373341;94053;
02.02.2019;10:34:04;83467475;83373499;93976;
02.02.2019;10:35:04;83467560;83373625;93935;
02.02.2019;10:36:04;83467613;83373773;93840;
02.02.2019;10:37:05;83467691;83373898;93793;
02.02.2019;10:38:04;83467764;83374045;93719;
02.02.2019;10:39:05;83467830;83374170;93660;
02.02.2019;10:40:04;83467895;83374293;93602;
02.02.2019;10:41:05;83467963;83374437;93526;
02.02.2019;10:42:04;83468019;83374579;93440;
02.02.2019;10:43:04;83468078;83374752;93326;
02.02.2019;10:44:04;83468147;83374896;93251;
02.02.2019;10:45:05;83468220;83375027;93193;
02.02.2019;10:46:05;83468296;83375180;93116;
02.02.2019;10:47:05;83468360;83375326;93034;
02.02.2019;10:48:04;83468418;83375457;92961;
02.02.2019;10:49:04;83468484;83375562;92922;
02.02.2019;10:50:05;83468545;83375686;92859;
02.02.2019;10:51:05;83468603;83375823;92780;
02.02.2019;10:52:04;83468674;83375935;92739;
02.02.2019;10:53:04;83468739;83376078;92661;
02.02.2019;10:54:05;83468809;83376221;92588;
02.02.2019;10:55:05;83468870;83376365;92505;
02.02.2019;10:56:04;83468942;83376532;92410;
02.02.2019;10:57:04;83469010;83376678;92332;
02.02.2019;10:58:05;83469070;83376826;92244;
02.02.2019;10:59:04;83469140;83376971;92169;
02.02.2019;11:00:04;83469199;83377095;92104;
02.02.2019;11:01:05;83469262;83377238;92024;
02.02.2019;11:02:05;83469335;83377379;91956;
02.02.2019;11:03:05;83469408;83377521;91887;
02.02.2019;11:04:05;83469485;83377674;91811;
02.02.2019;11:05:04;83469547;83377820;91727;
02.02.2019;11:06:05;83469618;83377958;91660;
02.02.2019;11:07:05;83469683;83378069;91614;
02.02.2019;11:08:04;83469769;83378225;91544;
02.02.2019;11:09:06;83469846;83378364;91482;
02.02.2019;11:10:05;83469905;83378514;91391;
02.02.2019;11:11:05;83469979;83378646;91333;
02.02.2019;11:12:04;83470023;83378801;91222;
02.02.2019;11:13:04;83470099;83378919;91180;
02.02.2019;11:14:04;83470141;83379068;91073;
02.02.2019;11:15:05;83470190;83379205;90985;
02.02.2019;11:16:05;83470242;83379337;90905;
02.02.2019;11:17:04;83470314;83379472;90842;
02.02.2019;11:18:04;83470368;83379614;90754;
02.02.2019;11:19:05;83470459;83379756;90703;
02.02.2019;11:20:04;83470532;83379881;90651;
02.02.2019;11:21:04;83470621;83380018;90603;
02.02.2019;11:22:05;83470683;83380144;90539;
02.02.2019;11:23:05;83470759;83380269;90490;
02.02.2019;11:24:04;83470820;83380421;90399;
02.02.2019;11:25:04;83470877;83380568;90309;
02.02.2019;11:26:05;83470931;83380703;90228;
02.02.2019;11:27:05;83471008;83380833;90175;
02.02.2019;11:28:05;83471097;83380977;90120;
02.02.2019;11:29:04;83471152;83381143;90009;
02.02.2019;11:30:04;83471228;83381306;89922;
02.02.2019;11:31:05;83471299;83381454;89845;
02.02.2019;11:32:05;83471371;83381585;89786;
02.02.2019;11:33:05;83471447;83381734;89713;
02.02.2019;11:34:04;83471516;83381870;89646;
02.02.2019;11:35:20;83471579;83382062;89517;
02.02.2019;11:36:05;83471637;83382164;89473;
02.02.2019;11:37:04;83471701;83382323;89378;
02.02.2019;11:38:04;83471764;83382461;89303;
02.02.2019;11:39:07;83471825;83382606;89219;
02.02.2019;11:40:05;83471910;83382737;89173;
02.02.2019;11:41:04;83471976;83382881;89095;
02.02.2019;11:42:04;83472036;83383032;89004;
02.02.2019;11:43:09;83472100;83383177;88923;
02.02.2019;11:44:04;83472161;83383300;88861;
02.02.2019;11:45:04;83472226;83383423;88803;
02.02.2019;11:46:05;83472297;83383584;88713;
02.02.2019;11:47:04;83472367;83383710;88657;
02.02.2019;11:48:04;83472444;83383863;88581;
02.02.2019;11:49:04;83472503;83383993;88510;
02.02.2019;11:50:04;83472553;83384127;88426;
02.02.2019;11:51:05;83472638;83384237;88401;
02.02.2019;11:52:04;83472721;83384360;88361;
02.02.2019;11:53:05;83472802;83384506;88296;
02.02.2019;11:54:05;83472873;83384657;88216;
02.02.2019;11:55:04;83472944;83384811;88133;
02.02.2019;11:56:05;83473016;83384948;88068;
02.02.2019;11:57:05;83473078;83385096;87982;
02.02.2019;11:58:04;83473122;83385231;87891;
02.02.2019;11:59:04;83473193;83385380;87813;
02.02.2019;12:00:05;83473252;83385521;87731;
02.02.2019;12:01:05;83473327;83385667;87660;
02.02.2019;12:02:05;83473404;83385780;87624;
02.02.2019;12:03:05;83473474;83385926;87548;
02.02.2019;12:04:05;83473539;83386088;87451;
02.02.2019;12:05:04;83473613;83386232;87381;
02.02.2019;12:06:04;83473697;83386352;87345;
02.02.2019;12:07:04;83473774;83386492;87282;
02.02.2019;12:08:04;83473849;83386639;87210;
02.02.2019;12:09:05;83473933;83386784;87149;
02.02.2019;12:10:05;83473993;83386916;87077;
02.02.2019;12:11:06;83474024;83387012;87012;
02.02.2019;12:12:04;83474072;83387067;87005;
02.02.2019;12:13:04;83474087;83387129;86958;
02.02.2019;12:14:05;83474103;83387214;86889;
02.02.2019;12:15:05;83474144;83387305;86839;
02.02.2019;12:16:04;83474187;83387373;86814;
02.02.2019;12:17:05;83474227;83387490;86737;
02.02.2019;12:18:05;83474262;83387588;86674;
02.02.2019;12:19:04;83474317;83387693;86624;
02.02.2019;12:20:04;83474365;83387803;86562;
02.02.2019;12:21:05;83474405;83387927;86478;
02.02.2019;12:22:04;83474476;83388040;86436;
02.02.2019;12:23:04;83474549;83388125;86424;
02.02.2019;12:24:06;83474621;83388279;86342;
02.02.2019;12:25:04;83474683;83388401;86282;
02.02.2019;12:26:05;83474755;83388533;86222;
02.02.2019;12:27:04;83474821;83388651;86170;
02.02.2019;12:28:04;83474882;83388780;86102;
02.02.2019;12:29:05;83474955;83388870;86085;
02.02.2019;12:30:05;83475027;83389026;86001;
02.02.2019;12:31:04;83475085;83389144;85941;
02.02.2019;12:32:04;83475158;83389269;85889;
02.02.2019;12:33:05;83475219;83389393;85826;
02.02.2019;12:34:05;83475267;83389527;85740;
02.02.2019;12:35:04;83475339;83389666;85673;
02.02.2019;12:36:04;83475409;83389784;85625;
02.02.2019;12:37:05;83475479;83389888;85591;
02.02.2019;12:38:05;83475544;83390021;85523;
02.02.2019;12:39:06;83475598;83390161;85437;
02.02.2019;12:40:04;83475660;83390271;85389;
02.02.2019;12:41:04;83475709;83390398;85311;
02.02.2019;12:42:04;83475787;83390549;85238;
02.02.2019;12:43:05;83475876;83390669;85207;
02.02.2019;12:44:05;83475950;83390812;85138;
02.02.2019;12:45:05;83476024;83390931;85093;
02.02.2019;12:46:04;83476082;83391038;85044;
02.02.2019;12:47:04;83476166;83391156;85010;
02.02.2019;12:48:04;83476233;83391299;84934;
02.02.2019;12:49:05;83476307;83391417;84890;
02.02.2019;12:50:04;83476376;83391558;84818;
02.02.2019;12:51:04;83476467;83391677;84790;
02.02.2019;12:52:05;83476532;83391815;84717;
02.02.2019;12:53:04;83476616;83391945;84671;
02.02.2019;12:54:04;83476701;83392090;84611;
02.02.2019;12:55:05;83476786;83392213;84573;
02.02.2019;12:56:05;83476860;83392346;84514;
02.02.2019;12:57:04;83476924;83392471;84453;
02.02.2019;12:58:05;83477003;83392596;84407;
02.02.2019;12:59:06;83477087;83392736;84351;
02.02.2019;13:00:07;83477153;83392879;84274;
02.02.2019;13:01:08;83477216;83393018;84198;
02.02.2019;13:02:05;83477296;83393125;84171;
02.02.2019;13:03:04;83477352;83393262;84090;
02.02.2019;13:04:04;83477430;83393419;84011;
02.02.2019;13:05:05;83477508;83393559;83949;
02.02.2019;13:06:04;83477576;83393681;83895;
02.02.2019;13:07:04;83477665;83393793;83872;
02.02.2019;13:08:05;83477757;83393905;83852;
02.02.2019;13:09:05;83477841;83394023;83818;
02.02.2019;13:10:04;83477914;83394164;83750;
02.02.2019;13:11:05;83477993;83394301;83692;
02.02.2019;13:12:05;83478080;83394454;83626;
02.02.2019;13:13:04;83478171;83394573;83598;
02.02.2019;13:14:05;83478251;83394713;83538;
02.02.2019;13:15:05;83478316;83394839;83477;
02.02.2019;13:16:04;83478374;83394996;83378;
02.02.2019;13:17:04;83478444;83395139;83305;
02.02.2019;13:18:04;83478503;83395282;83221;
02.02.2019;13:19:05;83478573;83395422;83151;
02.02.2019;13:20:04;83478604;83395557;83047;
02.02.2019;13:21:04;83478702;83395683;83019;
02.02.2019;13:22:05;83478786;83395841;82945;
02.02.2019;13:23:04;83478857;83395985;82872;
02.02.2019;13:24:04;83478931;83396117;82814;
02.02.2019;13:25:05;83478994;83396265;82729;
02.02.2019;13:26:04;83479059;83396427;82632;
02.02.2019;13:27:04;83479136;83396582;82554;
02.02.2019;13:28:04;83479210;83396738;82472;
02.02.2019;13:29:05;83479298;83396890;82408;
02.02.2019;13:30:04;83479350;83397031;82319;
02.02.2019;13:31:04;83479434;83397180;82254;
02.02.2019;13:32:05;83479516;83397333;82183;
02.02.2019;13:33:04;83479578;83397449;82129;
02.02.2019;13:34:04;83479651;83397612;82039;
02.02.2019;13:35:05;83479720;83397735;81985;
02.02.2019;13:36:05;83479788;83397864;81924;
02.02.2019;13:37:04;83479872;83397975;81897;
02.02.2019;13:38:05;83479958;83398120;81838;
02.02.2019;13:39:06;83480032;83398246;81786;
02.02.2019;13:40:04;83480102;83398358;81744;
02.02.2019;13:41:05;83480168;83398511;81657;
02.02.2019;13:42:05;83480231;83398619;81612;
02.02.2019;13:43:04;83480309;83398704;81605;
02.02.2019;13:44:04;83480396;83398861;81535;
02.02.2019;13:45:04;83480469;83398994;81475;
02.02.2019;13:46:04;83480539;83399137;81402;
02.02.2019;13:47:05;83480644;83399278;81366;
02.02.2019;13:48:05;83480725;83399396;81329;
02.02.2019;13:49:05;83480800;83399527;81273;
02.02.2019;13:50:04;83480868;83399658;81210;
02.02.2019;13:51:04;83480941;83399810;81131;
02.02.2019;13:52:04;83481014;83399935;81079;
02.02.2019;13:53:05;83481093;83400051;81042;
02.02.2019;13:54:04;83481166;83400191;80975;
02.02.2019;13:55:04;83481258;83400321;80937;
02.02.2019;13:56:04;83481347;83400442;80905;
02.02.2019;13:57:05;83481448;83400592;80856;
02.02.2019;13:59:05;83481632;83400843;80789;
02.02.2019;14:00:05;83481707;83400970;80737;
02.02.2019;14:01:05;83481774;83401109;80665;
02.02.2019;14:02:05;83481828;83401231;80597;
02.02.2019;14:03:05;83481895;83401358;80537;
02.02.2019;14:04:05;83481963;83401477;80486;
02.02.2019;14:05:05;83482054;83401593;80461;
02.02.2019;14:06:05;83482133;83401735;80398;
02.02.2019;14:07:04;83482214;83401900;80314;
02.02.2019;14:08:04;83482291;83402066;80225;
02.02.2019;14:09:06;83482377;83402221;80156;
02.02.2019;14:10:04;83482444;83402358;80086;
02.02.2019;14:11:05;83482537;83402498;80039;
02.02.2019;14:12:04;83482619;83402627;79992;
02.02.2019;14:13:05;83482711;83402795;79916;
02.02.2019;14:14:05;83482800;83402935;79865;
02.02.2019;14:15:04;83482859;83403070;79789;
02.02.2019;14:16:04;83482950;83403204;79746;
02.02.2019;14:17:05;83483034;83403326;79708;
02.02.2019;14:18:05;83483077;83403420;79657;
02.02.2019;14:19:04;83483149;83403521;79628;
02.02.2019;14:20:04;83483197;83403638;79559;
02.02.2019;14:21:05;83483269;83403756;79513;
02.02.2019;14:22:05;83483330;83403866;79464;
02.02.2019;14:23:04;83483393;83403971;79422;
02.02.2019;14:24:04;83483470;83404098;79372;
02.02.2019;14:25:04;83483534;83404256;79278;
02.02.2019;14:26:05;83483581;83404374;79207;
02.02.2019;14:27:05;83483630;83404507;79123;
02.02.2019;14:28:04;83483682;83404663;79019;
02.02.2019;14:29:05;83483749;83404819;78930;
02.02.2019;14:30:04;83483809;83404927;78882;
02.02.2019;14:31:05;83483870;83405060;78810;
02.02.2019;14:32:04;83483945;83405204;78741;
02.02.2019;14:33:04;83484018;83405354;78664;
02.02.2019;14:34:05;83484100;83405480;78620;
02.02.2019;14:35:05;83484184;83405623;78561;
02.02.2019;14:36:05;83484279;83405784;78495;
02.02.2019;14:37:06;83484367;83405915;78452;
02.02.2019;14:38:05;83484443;83406028;78415;
02.02.2019;14:39:06;83484516;83406187;78329;
02.02.2019;14:40:05;83484588;83406320;78268;
02.02.2019;14:41:05;83484689;83406464;78225;
02.02.2019;14:42:05;83484787;83406594;78193;
02.02.2019;14:43:05;83484896;83406733;78163;
02.02.2019;14:44:06;83484977;83406865;78112;
02.02.2019;14:45:04;83485090;83407010;78080;
02.02.2019;14:46:05;83485192;83407179;78013;
02.02.2019;14:47:04;83485282;83407332;77950;
02.02.2019;14:48:04;83485394;83407411;77983;
02.02.2019;14:49:04;83485476;83407547;77929;
02.02.2019;14:50:04;83485559;83407686;77873;
02.02.2019;14:51:05;83485653;83407771;77882;
02.02.2019;14:52:04;83485751;83407952;77799;
02.02.2019;14:53:04;83485842;83408089;77753;
02.02.2019;14:54:09;83485939;83408248;77691;
02.02.2019;14:55:04;83486032;83408378;77654;
02.02.2019;14:56:04;83486123;83408516;77607;
02.02.2019;14:57:05;83486196;83408661;77535;
02.02.2019;14:58:04;83486286;83408801;77485;
02.02.2019;14:59:04;83486370;83408933;77437;
02.02.2019;15:00:08;83486477;83409083;77394;
02.02.2019;15:01:09;83486563;83409245;77318;
02.02.2019;15:02:07;83486648;83409375;77273;
02.02.2019;15:03:08;83486727;83409534;77193;
02.02.2019;15:04:06;83486818;83409658;77160;
02.02.2019;15:05:07;83486905;83409822;77083;
02.02.2019;15:06:07;83486997;83409947;77050;
02.02.2019;15:07:09;83487089;83410075;77014;
02.02.2019;15:08:10;83487179;83410217;76962;
02.02.2019;15:09:08;83487272;83410355;76917;
02.02.2019;15:10:07;83487386;83410485;76901;
02.02.2019;15:11:13;83487528;83410669;76859;
02.02.2019;15:12:06;83487618;83410801;76817;
02.02.2019;15:13:07;83487722;83410943;76779;
02.02.2019;15:14:10;83487810;83411111;76699;
02.02.2019;15:15:10;83487928;83411244;76684;
02.02.2019;15:16:14;83488038;83411381;76657;
02.02.2019;15:17:14;83488140;83411530;76610;
02.02.2019;15:18:09;83488227;83411646;76581;
02.02.2019;15:19:08;83488309;83411792;76517;
02.02.2019;15:20:09;83488444;83411925;76519;
02.02.2019;15:21:07;83488543;83412087;76456;
02.02.2019;15:22:08;83488652;83412264;76388;
02.02.2019;15:23:08;83488754;83412445;76309;
02.02.2019;15:24:10;83488864;83412630;76234;
02.02.2019;15:25:14;83488948;83412780;76168;
02.02.2019;15:26:07;83489042;83412920;76122;
02.02.2019;15:27:08;83489155;83413069;76086;
02.02.2019;15:28:10;83489271;83413216;76055;
02.02.2019;15:29:08;83489367;83413366;76001;
02.02.2019;15:30:08;83489486;83413502;75984;
02.02.2019;15:31:09;83489598;83413668;75930;
02.02.2019;15:32:10;83489695;83413833;75862;
02.02.2019;15:33:09;83489782;83413991;75791;
02.02.2019;15:34:08;83489854;83414124;75730;
02.02.2019;15:35:07;83489962;83414262;75700;
02.02.2019;15:36:08;83490073;83414403;75670;
02.02.2019;15:37:07;83490189;83414556;75633;
02.02.2019;15:38:10;83490283;83414724;75559;
02.02.2019;15:39:08;83490379;83414861;75518;
02.02.2019;15:40:07;83490489;83415028;75461;
02.02.2019;15:41:14;83490602;83415208;75394;
02.02.2019;15:42:08;83490671;83415358;75313;
02.02.2019;15:43:08;83490755;83415508;75247;
02.02.2019;15:44:07;83490849;83415657;75192;
02.02.2019;15:45:07;83490898;83415752;75146;
02.02.2019;15:46:08;83490569;83415592;74977;
02.02.2019;15:47:08;83490641;83415723;74918;
02.02.2019;15:48:11;83490748;83415869;74879;
02.02.2019;15:49:07;83490841;83416017;74824;
02.02.2019;15:50:07;83490953;83416164;74789;
02.02.2019;15:51:09;83491079;83416317;74762;
02.02.2019;15:52:07;83491174;83416468;74706;
02.02.2019;15:53:08;83491267;83416643;74624;
02.02.2019;15:54:13;83491397;83416818;74579;
02.02.2019;15:55:13;83491519;83416955;74564;
02.02.2019;15:56:07;83491623;83417068;74555;
02.02.2019;15:57:07;83491739;83417239;74500;
02.02.2019;15:58:09;83491858;83417373;74485;
02.02.2019;15:59:10;83491942;83417556;74386;
02.02.2019;16:00:05;83492031;83417682;74349;
02.02.2019;16:01:05;83492135;83417842;74293;
02.02.2019;16:02:05;83492230;83418017;74213;
02.02.2019;16:03:05;83492342;83418188;74154;
02.02.2019;16:04:05;83492419;83418305;74114;
02.02.2019;16:05:06;83492529;83418463;74066;
02.02.2019;16:06:05;83492610;83418605;74005;
02.02.2019;16:07:05;83492667;83418790;73877;
02.02.2019;16:08:10;83492818;83418946;73872;
02.02.2019;16:09:07;83492928;83419091;73837;
02.02.2019;16:10:05;83493052;83419256;73796;
02.02.2019;16:11:05;83493165;83419407;73758;
02.02.2019;16:12:06;83493265;83419571;73694;
02.02.2019;16:13:10;83493380;83419738;73642;
02.02.2019;16:14:05;83493480;83419873;73607;
02.02.2019;16:15:10;83493568;83420050;73518;
02.02.2019;16:16:04;83493629;83420184;73445;
02.02.2019;16:17:11;83493731;83420347;73384;
02.02.2019;16:18:06;83493793;83420485;73308;
02.02.2019;16:19:05;83493858;83420629;73229;
02.02.2019;16:20:05;83493949;83420758;73191;
02.02.2019;16:21:06;83494048;83420890;73158;
02.02.2019;16:22:05;83494134;83421015;73119;
02.02.2019;16:23:06;83494233;83421166;73067;
02.02.2019;16:24:06;83494305;83421318;72987;
02.02.2019;16:25:05;83494404;83421485;72919;
02.02.2019;16:26:10;83494496;83421649;72847;
02.02.2019;16:27:04;83494579;83421775;72804;
02.02.2019;16:28:05;83494669;83421920;72749;
02.02.2019;16:29:05;83494760;83422081;72679;
02.02.2019;16:30:04;83494872;83422262;72610;
02.02.2019;16:31:04;83494971;83422416;72555;
02.02.2019;16:32:04;83495049;83422559;72490;
02.02.2019;16:33:04;83495144;83422711;72433;
02.02.2019;16:34:05;83495241;83422887;72354;
02.02.2019;16:35:05;83495339;83423068;72271;
02.02.2019;16:36:04;83495445;83423213;72232;
02.02.2019;16:37:04;83495573;83423338;72235;
02.02.2019;16:38:05;83495675;83423510;72165;
02.02.2019;16:39:06;83495790;83423686;72104;
02.02.2019;16:40:05;83495890;83423857;72033;
02.02.2019;16:41:05;83496003;83424001;72002;
02.02.2019;16:42:04;83496117;83424168;71949;
02.02.2019;16:43:04;83496197;83424314;71883;
02.02.2019;16:44:05;83496307;83424490;71817;
02.02.2019;16:45:04;83496434;83424657;71777;
02.02.2019;16:46:04;83496545;83424813;71732;
02.02.2019;16:47:05;83496655;83424960;71695;
02.02.2019;16:48:04;83496764;83425112;71652;
02.02.2019;16:49:04;83496853;83425261;71592;
02.02.2019;16:50:05;83496958;83425415;71543;
02.02.2019;16:51:15;83497105;83425581;71524;
02.02.2019;16:52:04;83497210;83425743;71467;
02.02.2019;16:53:04;83497324;83425925;71399;
02.02.2019;16:54:05;83497437;83426091;71346;
02.02.2019;16:55:05;83497521;83426250;71271;
02.02.2019;16:56:04;83497678;83426421;71257;
02.02.2019;16:57:04;83497778;83426587;71191;
02.02.2019;16:58:05;83497918;83426727;71191;
02.02.2019;16:59:05;83498032;83426906;71126;
02.02.2019;17:00:05;83498142;83427090;71052;
02.02.2019;17:01:04;83498248;83427250;70998;
02.02.2019;17:02:04;83498360;83427421;70939;
02.02.2019;17:03:05;83498484;83427592;70892;
02.02.2019;17:04:05;83498591;83427748;70843;
02.02.2019;17:05:06;83498693;83427912;70781;
02.02.2019;17:06:05;83498787;83428057;70730;
02.02.2019;17:07:04;83498902;83428217;70685;
02.02.2019;17:08:04;83499022;83428402;70620;
02.02.2019;17:09:07;83499162;83428595;70567;
02.02.2019;17:11:05;83499429;83428923;70506;
02.02.2019;17:12:05;83499580;83429099;70481;
02.02.2019;17:13:05;83499713;83429281;70432;
02.02.2019;17:14:11;83499856;83429448;70408;
02.02.2019;17:15:05;83499954;83429604;70350;
02.02.2019;17:16:08;83500091;83429764;70327;
02.02.2019;17:17:05;83500185;83429905;70280;
02.02.2019;17:18:05;83500287;83430046;70241;
02.02.2019;17:19:06;83500421;83430193;70228;
02.02.2019;17:20:06;83500553;83430359;70194;
02.02.2019;17:21:05;83500675;83430493;70182;
02.02.2019;17:22:04;83500776;83430667;70109;
02.02.2019;17:23:04;83500910;83430834;70076;
02.02.2019;17:24:05;83501027;83430996;70031;
02.02.2019;17:25:06;83501144;83431149;69995;
02.02.2019;17:26:04;83501274;83431282;69992;
02.02.2019;17:27:05;83501399;83431457;69942;
02.02.2019;17:28:05;83501528;83431625;69903;
02.02.2019;17:29:05;83501628;83431770;69858;
02.02.2019;17:30:05;83501745;83431948;69797;
02.02.2019;17:31:04;83501868;83432102;69766;
02.02.2019;17:32:04;83502006;83432284;69722;
02.02.2019;17:33:05;83502108;83432464;69644;
02.02.2019;17:34:04;83502240;83432622;69618;
02.02.2019;17:35:04;83502352;83432776;69576;
02.02.2019;17:36:05;83502474;83432944;69530;
02.02.2019;17:37:05;83502607;83433097;69510;
02.02.2019;17:38:04;83502719;83433235;69484;
02.02.2019;17:39:04;83502846;83433392;69454;
02.02.2019;17:40:05;83502974;83433574;69400;
02.02.2019;17:41:04;83503106;83433713;69393;
02.02.2019;17:42:05;83503249;83433862;69387;
02.02.2019;17:43:04;83503353;83434005;69348;
02.02.2019;17:44:04;83503500;83434168;69332;
02.02.2019;17:45:05;83503622;83434313;69309;
02.02.2019;17:46:05;83503744;83434457;69287;
02.02.2019;17:47:04;83503864;83434598;69266;
02.02.2019;17:48:04;83503990;83434744;69246;
02.02.2019;17:49:05;83504102;83434890;69212;
02.02.2019;17:50:04;83504221;83435039;69182;
02.02.2019;17:51:04;83504333;83435185;69148;
02.02.2019;17:52:07;83504490;83435334;69156;
02.02.2019;17:53:05;83504618;83435478;69140;
02.02.2019;17:54:05;83504735;83435659;69076;
02.02.2019;17:55:04;83504878;83435816;69062;
02.02.2019;17:56:04;83504982;83435994;68988;
02.02.2019;17:57:05;83505094;83436151;68943;
02.02.2019;17:58:05;83505203;83436287;68916;
02.02.2019;17:59:05;83505320;83436420;68900;
02.02.2019;18:00:05;83505452;83436594;68858;
02.02.2019;18:01:04;83505573;83436758;68815;
02.02.2019;18:02:04;83505698;83436916;68782;
02.02.2019;18:03:09;83505815;83437084;68731;
02.02.2019;18:04:05;83505948;83437226;68722;
02.02.2019;18:05:04;83506089;83437377;68712;
02.02.2019;18:06:04;83506230;83437500;68730;
02.02.2019;18:07:05;83506363;83437639;68724;
02.02.2019;18:08:04;83506492;83437796;68696;
02.02.2019;18:09:07;83506608;83437944;68664;
02.02.2019;18:10:04;83506739;83438112;68627;
02.02.2019;18:11:04;83506862;83438263;68599;
02.02.2019;18:12:05;83506976;83438391;68585;
02.02.2019;18:13:04;83507096;83438534;68562;
02.02.2019;18:14:04;83507238;83438709;68529;
02.02.2019;18:15:05;83507388;83438852;68536;
02.02.2019;18:16:05;83507512;83439015;68497;
02.02.2019;18:17:05;83507638;83439157;68481;
02.02.2019;18:18:05;83507735;83439295;68440;
02.02.2019;18:19:05;83507844;83439419;68425;
02.02.2019;18:20:07;83507945;83439548;68397;
02.02.2019;18:21:04;83508053;83439675;68378;
02.02.2019;18:22:05;83508118;83439783;68335;
02.02.2019;18:23:05;83508225;83439924;68301;
02.02.2019;18:24:04;83508315;83440036;68279;
02.02.2019;18:25:05;83508423;83440177;68246;
02.02.2019;18:26:05;83508513;83440293;68220;
02.02.2019;18:27:05;83508626;83440428;68198;
02.02.2019;18:28:08;83508742;83440584;68158;
02.02.2019;18:29:05;83508851;83440696;68155;
02.02.2019;18:30:04;83508963;83440823;68140;
02.02.2019;18:31:04;83509082;83440947;68135;
02.02.2019;18:32:04;83509199;83441071;68128;
02.02.2019;18:33:05;83509304;83441208;68096;
02.02.2019;18:34:05;83509420;83441343;68077;
02.02.2019;18:35:05;83509542;83441463;68079;
02.02.2019;18:36:05;83509655;83441592;68063;
02.02.2019;18:37:05;83509785;83441722;68063;
02.02.2019;18:38:09;83509923;83441820;68103;
02.02.2019;18:39:04;83510025;83441939;68086;
02.02.2019;18:40:05;83510147;83442047;68100;
02.02.2019;18:41:05;83510265;83442187;68078;
02.02.2019;18:42:04;83510389;83442310;68079;
02.02.2019;18:43:07;83510488;83442429;68059;
02.02.2019;18:44:04;83510554;83442518;68036;
02.02.2019;18:45:05;83510636;83442614;68022;
02.02.2019;18:46:05;83510773;83442742;68031;
02.02.2019;18:47:04;83510883;83442882;68001;
02.02.2019;18:48:05;83511024;83442996;68028;
02.02.2019;18:49:04;83511181;83443132;68049;
02.02.2019;18:50:05;83511320;83443261;68059;
02.02.2019;18:51:05;83511453;83443407;68046;
02.02.2019;18:52:05;83511609;83443554;68055;
02.02.2019;18:53:04;83511733;83443676;68057;
02.02.2019;18:54:06;83511840;83443833;68007;
02.02.2019;18:55:05;83511971;83443965;68006;
02.02.2019;18:56:05;83512098;83444096;68002;
02.02.2019;18:57:05;83512226;83444218;68008;
02.02.2019;18:58:05;83512363;83444348;68015;
02.02.2019;18:59:04;83512510;83444476;68034;
02.02.2019;19:00:04;83512657;83444596;68061;
02.02.2019;19:01:06;83512762;83444749;68013;
02.02.2019;19:02:05;83512881;83444886;67995;
02.02.2019;19:03:06;83513005;83445016;67989;
02.02.2019;19:04:05;83513166;83445164;68002;
02.02.2019;19:05:05;83513304;83445300;68004;
02.02.2019;19:06:05;83513449;83445442;68007;
02.02.2019;19:07:05;83513580;83445614;67966;
02.02.2019;19:08:04;83513746;83445780;67966;
02.02.2019;19:09:07;83513890;83445922;67968;
02.02.2019;19:10:05;83514034;83446050;67984;
02.02.2019;19:11:06;83514158;83446205;67953;
02.02.2019;19:12:05;83514286;83446361;67925;
02.02.2019;19:13:04;83514410;83446506;67904;
02.02.2019;19:14:04;83514551;83446660;67891;
02.02.2019;19:15:05;83514671;83446802;67869;
02.02.2019;19:16:05;83514790;83446936;67854;
02.02.2019;19:17:05;83514789;83447070;67719;
02.02.2019;19:18:05;83514867;83447179;67688;
02.02.2019;19:19:04;83514940;83447296;67644;
02.02.2019;19:20:04;83515048;83447407;67641;
02.02.2019;19:21:05;83515142;83447520;67622;
02.02.2019;19:22:05;83515224;83447646;67578;
02.02.2019;19:23:05;83515284;83447793;67491;
02.02.2019;19:24:05;83515374;83447904;67470;
02.02.2019;19:25:04;83515459;83448018;67441;
02.02.2019;19:26:04;83515517;83448142;67375;
02.02.2019;19:27:05;83515603;83448261;67342;
02.02.2019;19:28:05;83515685;83448400;67285;
02.02.2019;19:29:05;83515771;83448527;67244;
02.02.2019;19:30:05;83515883;83448658;67225;
02.02.2019;19:31:05;83516031;83448753;67278;
02.02.2019;19:32:05;83516139;83448866;67273;
02.02.2019;19:33:05;83516235;83448957;67278;
02.02.2019;19:34:04;83516364;83449064;67300;
02.02.2019;19:35:05;83516459;83449163;67296;
02.02.2019;19:36:06;83516596;83449280;67316;
02.02.2019;19:37:05;83516686;83449410;67276;
02.02.2019;19:38:06;83516800;83449511;67289;
02.02.2019;19:39:08;83516888;83449637;67251;
02.02.2019;19:40:04;83516989;83449761;67228;
02.02.2019;19:41:04;83517139;83449874;67265;
02.02.2019;19:42:06;83517265;83449970;67295;
02.02.2019;19:43:08;83517372;83450062;67310;
02.02.2019;19:44:06;83517490;83450142;67348;
02.02.2019;19:45:06;83517586;83450248;67338;
02.02.2019;19:46:07;83517664;83450338;67326;
02.02.2019;19:47:07;83517756;83450439;67317;
02.02.2019;19:48:06;83517841;83450534;67307;
02.02.2019;19:49:10;83517967;83450635;67332;
02.02.2019;19:50:08;83518099;83450710;67389;
02.02.2019;19:51:07;83518188;83450804;67384;
02.02.2019;19:52:05;83518324;83450894;67430;
02.02.2019;19:53:05;83518410;83450982;67428;
02.02.2019;19:54:06;83518510;83451074;67436;
02.02.2019;19:55:05;83518591;83451158;67433;
02.02.2019;19:56:05;83518695;83451238;67457;
02.02.2019;19:57:05;83518799;83451317;67482;
02.02.2019;19:58:06;83518915;83451424;67491;
02.02.2019;19:59:11;83519037;83451512;67525;
02.02.2019;20:00:04;83519122;83451610;67512;
02.02.2019;20:01:10;83519191;83451711;67480;
02.02.2019;20:02:07;83519291;83451795;67496;
02.02.2019;20:03:04;83519386;83451879;67507;
02.02.2019;20:04:06;83519491;83451933;67558;
02.02.2019;20:05:10;83519604;83452045;67559;
02.02.2019;20:06:04;83519690;83452123;67567;
02.02.2019;20:07:10;83519776;83452223;67553;
02.02.2019;20:08:06;83519874;83452289;67585;
02.02.2019;20:09:07;83519974;83452363;67611;
02.02.2019;20:10:07;83520071;83452441;67630;
02.02.2019;20:11:06;83520171;83452536;67635;
02.02.2019;20:12:06;83520299;83452634;67665;
02.02.2019;20:13:05;83520385;83452710;67675;
02.02.2019;20:14:04;83520490;83452797;67693;
02.02.2019;20:15:05;83520575;83452879;67696;
02.02.2019;20:16:05;83520639;83452960;67679;
02.02.2019;20:17:07;83520717;83453051;67666;
02.02.2019;20:18:05;83520802;83453109;67693;
02.02.2019;20:19:05;83520868;83453167;67701;
02.02.2019;20:20:07;83520947;83453227;67720;
02.02.2019;20:22:13;83521064;83453386;67678;
02.02.2019;20:23:05;83521136;83453436;67700;
02.02.2019;20:24:05;83521229;83453507;67722;
02.02.2019;20:25:06;83521323;83453560;67763;
02.02.2019;20:26:05;83521384;83453607;67777;
02.02.2019;20:27:07;83521456;83453690;67766;
02.02.2019;20:28:07;83521525;83453756;67769;
02.02.2019;20:29:10;83521620;83453829;67791;
02.02.2019;20:30:04;83521681;83453899;67782;
02.02.2019;20:31:04;83521757;83453958;67799;
02.02.2019;20:32:06;83521818;83454036;67782;
02.02.2019;20:33:04;83521909;83454115;67794;
02.02.2019;20:34:05;83521974;83454197;67777;
02.02.2019;20:35:05;83522042;83454250;67792;
02.02.2019;20:36:04;83522142;83454318;67824;
02.02.2019;20:37:04;83522251;83454389;67862;
02.02.2019;20:38:05;83522340;83454462;67878;
02.02.2019;20:39:05;83522435;83454531;67904;
02.02.2019;20:40:04;83522542;83454565;67977;
02.02.2019;20:41:04;83522629;83454660;67969;
02.02.2019;20:42:05;83522740;83454724;68016;
02.02.2019;20:43:05;83522855;83454784;68071;
02.02.2019;20:44:05;83522968;83454848;68120;
02.02.2019;20:45:05;83523065;83454922;68143;
02.02.2019;20:46:05;83523173;83454990;68183;
02.02.2019;20:47:05;83523296;83455068;68228;
02.02.2019;20:48:05;83523394;83455136;68258;
02.02.2019;20:49:04;83523487;83455167;68320;
02.02.2019;20:50:09;83523631;83460681;62950;
02.02.2019;20:51:10;83523729;83460766;62963;
02.02.2019;20:52:05;83523833;83460797;63036;
02.02.2019;20:53:04;83521093;83460847;60246;
02.02.2019;20:54:05;83521212;83460906;60306;
02.02.2019;20:55:05;83521316;83460987;60329;
02.02.2019;20:56:05;83521427;83461043;60384;
02.02.2019;20:57:04;83521529;83461120;60409;
02.02.2019;20:58:04;83521640;83461183;60457;
02.02.2019;20:59:05;83521771;83461256;60515;
02.02.2019;21:00:05;83521883;83461320;60563;
02.02.2019;21:01:05;83521989;83461375;60614;
02.02.2019;21:02:04;83522092;83461453;60639;
02.02.2019;21:03:04;83522195;83461526;60669;
02.02.2019;21:04:04;83522322;83461579;60743;
02.02.2019;21:05:04;83522438;83461648;60790;
02.02.2019;21:06:05;83522572;83461708;60864;
02.02.2019;21:07:04;83522686;83461768;60918;
02.02.2019;21:08:05;83522793;83461829;60964;
02.02.2019;21:09:07;83522866;83461888;60978;
02.02.2019;21:10:04;83523012;83461951;61061;
02.02.2019;21:11:04;83523130;83462027;61103;
02.02.2019;21:12:12;83523252;83462096;61156;
02.02.2019;21:13:05;83523362;83462169;61193;
02.02.2019;21:14:04;83523460;83462231;61229;
02.02.2019;21:15:04;83523574;83462293;61281;
02.02.2019;21:16:04;83523694;83462360;61334;
02.02.2019;21:17:05;83523808;83462416;61392;
02.02.2019;21:18:05;83523922;83462487;61435;
02.02.2019;21:19:04;83524042;83462558;61484;
02.02.2019;21:20:05;83524154;83462617;61537;
02.02.2019;21:21:05;83524303;83462672;61631;
02.02.2019;21:22:05;83524401;83462726;61675;
02.02.2019;21:23:04;83524505;83462776;61729;
02.02.2019;21:24:04;83524623;83462830;61793;
02.02.2019;21:25:05;83524728;83462890;61838;
02.02.2019;21:26:05;83524845;83462937;61908;
02.02.2019;21:27:04;83524969;83463002;61967;
02.02.2019;21:28:04;83525106;83463052;62054;
02.02.2019;21:29:05;83525241;83463101;62140;
02.02.2019;21:30:04;83525369;83463159;62210;
02.02.2019;21:31:04;83525486;83463206;62280;
02.02.2019;21:32:05;83525601;83463262;62339;
02.02.2019;21:33:05;83525713;83463310;62403;
02.02.2019;21:34:04;83525822;83463362;62460;
02.02.2019;21:35:04;83525921;83463419;62502;
02.02.2019;21:36:05;83526035;83463468;62567;
02.02.2019;21:37:05;83526169;83463526;62643;
02.02.2019;21:38:05;83526267;83463603;62664;
02.02.2019;21:39:04;83526416;83463653;62763;
02.02.2019;21:40:06;83526559;83463710;62849;
02.02.2019;21:41:05;83526667;83463770;62897;
02.02.2019;21:42:05;83526792;83463828;62964;
02.02.2019;21:44:05;83526963;83463889;63074;
02.02.2019;21:45:05;83527097;83463944;63153;
02.02.2019;21:46:04;83527244;83464007;63237;
02.02.2019;21:47:05;83527385;83464063;63322;
02.02.2019;21:48:05;83527514;83464101;63413;
02.02.2019;21:49:04;83527649;83464141;63508;
02.02.2019;21:50:04;83527776;83464193;63583;
02.02.2019;21:51:05;83527884;83464234;63650;
02.02.2019;21:52:04;83528006;83464276;63730;
02.02.2019;21:53:04;83528103;83464312;63791;
02.02.2019;21:54:04;83528225;83464345;63880;
02.02.2019;21:55:05;83528350;83464384;63966;
02.02.2019;21:56:05;83528467;83464421;64046;
02.02.2019;21:57:04;83528568;83464481;64087;
02.02.2019;21:58:04;83528699;83464509;64190;
02.02.2019;21:59:05;83528826;83464558;64268;
02.02.2019;22:00:05;83528974;83464604;64370;
02.02.2019;22:01:04;83529083;83464646;64437;
02.02.2019;22:02:05;83529217;83464701;64516;
02.02.2019;22:03:05;83529350;83464747;64603;
02.02.2019;22:04:04;83529460;83464796;64664;
02.02.2019;22:05:04;83529585;83464830;64755;
02.02.2019;22:06:05;83529713;83464873;64840;
02.02.2019;22:07:05;83529816;83464913;64903;
02.02.2019;22:08:04;83529931;83464957;64974;
02.02.2019;22:09:04;83530054;83465014;65040;
02.02.2019;22:10:05;83530194;83465048;65146;
02.02.2019;22:11:05;83530297;83465083;65214;
02.02.2019;22:12:04;83530384;83465142;65242;
02.02.2019;22:13:05;83530536;83465187;65349;
02.02.2019;22:14:05;83530620;83465241;65379;
02.02.2019;22:15:04;83530798;83465277;65521;
02.02.2019;22:16:05;83530871;83465310;65561;
02.02.2019;22:17:05;83530973;83465355;65618;
02.02.2019;22:18:05;83531039;83465376;65663;
02.02.2019;22:19:04;83531102;83465407;65695;
02.02.2019;22:20:05;83531185;83465422;65763;
02.02.2019;22:21:05;83531259;83465436;65823;
02.02.2019;22:22:05;83531333;83465468;65865;
02.02.2019;22:23:05;83531421;83465486;65935;
02.02.2019;22:24:04;83531522;83465505;66017;
02.02.2019;22:25:05;83531597;83465532;66065;
02.02.2019;22:26:05;83531713;83465562;66151;
02.02.2019;22:27:04;83531802;83465589;66213;
02.02.2019;22:28:04;83531887;83465620;66267;
02.02.2019;22:29:05;83531993;83465655;66338;
02.02.2019;22:30:04;83532088;83465680;66408;
02.02.2019;22:31:04;83532175;83465717;66458;
02.02.2019;22:32:05;83532261;83465752;66509;
02.02.2019;22:33:05;83532351;83465773;66578;
02.02.2019;22:34:04;83532467;83465813;66654;
02.02.2019;22:35:04;83532543;83465836;66707;
02.02.2019;22:36:04;83532640;83465872;66768;
02.02.2019;22:37:05;83532734;83465900;66834;
02.02.2019;22:38:04;83532851;83465922;66929;
02.02.2019;22:39:06;83532955;83465961;66994;
02.02.2019;22:40:04;83533053;83465985;67068;
02.02.2019;22:41:09;83533145;83466031;67114;
02.02.2019;22:42:05;83533250;83466070;67180;
02.02.2019;22:43:05;83533383;83466099;67284;
02.02.2019;22:44:05;83533488;83466147;67341;
02.02.2019;22:45:04;83533628;83466188;67440;
02.02.2019;22:46:04;83533759;83466241;67518;
02.02.2019;22:47:05;83533848;83466284;67564;
02.02.2019;22:48:04;83533965;83466316;67649;
02.02.2019;22:49:04;83534091;83466351;67740;
02.02.2019;22:50:05;83534204;83466391;67813;
02.02.2019;22:51:04;83534332;83466434;67898;
02.02.2019;22:52:04;83534424;83466471;67953;
02.02.2019;22:53:05;83534556;83466516;68040;
02.02.2019;22:54:04;83534665;83466550;68115;
02.02.2019;22:55:05;83534792;83466584;68208;
02.02.2019;22:56:05;83534918;83466626;68292;
02.02.2019;22:57:04;83535041;83466668;68373;
02.02.2019;22:58:04;83535193;83466699;68494;
02.02.2019;22:59:04;83535302;83466735;68567;
02.02.2019;23:00:15;83535458;83466793;68665;
02.02.2019;23:01:07;83535562;83466830;68732;
02.02.2019;23:02:04;83535679;83466864;68815;
02.02.2019;23:03:04;83535796;83466891;68905;
02.02.2019;23:04:04;83535916;83466944;68972;
02.02.2019;23:05:04;83536030;83466996;69034;
02.02.2019;23:06:05;83536158;83467025;69133;
02.02.2019;23:07:04;83536285;83467047;69238;
02.02.2019;23:08:04;83536404;83467077;69327;
02.02.2019;23:09:07;83536532;83467125;69407;
02.02.2019;23:10:04;83536652;83467161;69491;
02.02.2019;23:11:05;83536785;83467207;69578;
02.02.2019;23:12:05;83536882;83467259;69623;
02.02.2019;23:13:04;83537005;83467288;69717;
02.02.2019;23:14:04;83537118;83467326;69792;
02.02.2019;23:15:04;83537247;83467355;69892;
02.02.2019;23:16:04;83537335;83467373;69962;
02.02.2019;23:17:05;83537427;83467401;70026;
02.02.2019;23:18:05;83537553;83467456;70097;
02.02.2019;23:19:05;83537655;83467488;70167;
02.02.2019;23:20:04;83537756;83467515;70241;
02.02.2019;23:21:04;83537890;83467534;70356;
02.02.2019;23:22:05;83537984;83467554;70430;
02.02.2019;23:23:04;83538087;83467590;70497;
02.02.2019;23:24:04;83538183;83467634;70549;
02.02.2019;23:25:05;83538289;83467652;70637;
02.02.2019;23:26:04;83538382;83467691;70691;
02.02.2019;23:27:05;83538492;83467721;70771;
02.02.2019;23:28:05;83538600;83467751;70849;
02.02.2019;23:29:04;83538749;83467784;70965;
02.02.2019;23:30:05;83538879;83467822;71057;
02.02.2019;23:31:04;83539000;83467859;71141;
02.02.2019;23:32:05;83539107;83467895;71212;
02.02.2019;23:33:05;83539247;83467920;71327;
02.02.2019;23:34:05;83539367;83467950;71417;
02.02.2019;23:35:05;83539484;83468001;71483;
02.02.2019;23:36:04;83539623;83468037;71586;
02.02.2019;23:37:05;83539747;83468082;71665;
02.02.2019;23:38:05;83539871;83468110;71761;
02.02.2019;23:39:06;83539962;83468115;71847;
02.02.2019;23:40:05;83540061;83468138;71923;
02.02.2019;23:41:05;83540182;83468151;72031;
02.02.2019;23:42:04;83540310;83468172;72138;
02.02.2019;23:43:04;83540436;83468206;72230;
02.02.2019;23:44:05;83540563;83468244;72319;
02.02.2019;23:45:05;83540712;83468269;72443;
02.02.2019;23:46:04;83540825;83468302;72523;
02.02.2019;23:47:04;83540933;83468331;72602;
02.02.2019;23:48:05;83541080;83468366;72714;
02.02.2019;23:49:04;83541200;83468388;72812;
02.02.2019;23:50:04;83541340;83468431;72909;
02.02.2019;23:51:05;83541446;83468457;72989;
02.02.2019;23:52:04;83541552;83468484;73068;
02.02.2019;23:53:04;83541662;83468513;73149;
02.02.2019;23:54:04;83541750;83468555;73195;
02.02.2019;23:55:05;83541890;83468579;73311;
02.02.2019;23:56:04;83542000;83468608;73392;
02.02.2019;23:57:04;83542113;83468637;73476;
02.02.2019;23:58:05;83542223;83468670;73553;
02.02.2019;23:59:04;83542342;83468713;73629;
03.02.2019;00:00:07;83542442;83468741;73701;
03.02.2019;00:01:08;83542551;83468772;73779;
03.02.2019;00:02:07;83542652;83468806;73846;
03.02.2019;00:03:08;83542757;83468828;73929;
03.02.2019;00:04:07;83542863;83468854;74009;
03.02.2019;00:05:07;83542979;83468868;74111;
03.02.2019;00:06:07;83543084;83468880;74204;
03.02.2019;00:07:08;83543177;83468913;74264;
03.02.2019;00:08:08;83543292;83468956;74336;
03.02.2019;00:09:09;83543412;83468987;74425;
03.02.2019;00:10:07;83543494;83469006;74488;
03.02.2019;00:11:08;83543572;83469032;74540;
03.02.2019;00:12:07;83543663;83469058;74605;
03.02.2019;00:13:10;83543730;83469085;74645;
03.02.2019;00:14:07;83543776;83469115;74661;
03.02.2019;00:15:07;83543838;83469128;74710;
03.02.2019;00:16:08;83543887;83469165;74722;
03.02.2019;00:17:08;83543930;83469185;74745;
03.02.2019;00:18:07;83543960;83469202;74758;
03.02.2019;00:19:07;83544028;83469217;74811;
03.02.2019;00:20:14;83544119;83469242;74877;
03.02.2019;00:21:08;83544214;83469259;74955;
03.02.2019;00:22:07;83544305;83469296;75009;
03.02.2019;00:23:09;83544386;83469321;75065;
03.02.2019;00:24:08;83544472;83469351;75121;
03.02.2019;00:25:08;83544526;83469365;75161;
03.02.2019;00:26:07;83544635;83469391;75244;
03.02.2019;00:27:08;83544715;83469397;75318;
03.02.2019;00:28:11;83544819;83469419;75400;
03.02.2019;00:29:11;83544912;83469452;75460;
03.02.2019;00:30:08;83545005;83469480;75525;
03.02.2019;00:31:09;83545130;83469500;75630;
03.02.2019;00:32:08;83545230;83469524;75706;
03.02.2019;00:33:08;83545333;83469555;75778;
03.02.2019;00:34:08;83545444;83469570;75874;
03.02.2019;00:35:09;83545547;83469598;75949;
03.02.2019;00:36:09;83545651;83469624;76027;
03.02.2019;00:37:09;83545747;83469646;76101;
03.02.2019;00:38:08;83545862;83469678;76184;
03.02.2019;00:39:14;83545982;83469719;76263;
03.02.2019;00:40:09;83546101;83469749;76352;
03.02.2019;00:41:09;83546215;83469793;76422;
03.02.2019;00:42:10;83546264;83469775;76489;
03.02.2019;00:43:08;83546365;83469798;76567;
03.02.2019;00:44:08;83546497;83469818;76679;
03.02.2019;00:45:09;83546606;83469854;76752;
03.02.2019;00:46:07;83546703;83469885;76818;
03.02.2019;00:47:07;83546847;83469917;76930;
03.02.2019;00:48:09;83546972;83469933;77039;
03.02.2019;00:49:07;83547075;83469959;77116;
03.02.2019;00:50:09;83547189;83469995;77194;
03.02.2019;00:51:08;83547283;83470038;77245;
03.02.2019;00:52:08;83547386;83470079;77307;
03.02.2019;00:53:10;83547495;83470111;77384;
03.02.2019;00:54:07;83547575;83470143;77432;
03.02.2019;00:55:08;83547685;83470169;77516;
03.02.2019;00:56:08;83547788;83470215;77573;
03.02.2019;00:57:07;83547888;83470247;77641;
03.02.2019;00:58:10;83547995;83470288;77707;
03.02.2019;00:59:07;83548102;83470325;77777;
03.02.2019;01:00:04;83548196;83470341;77855;
03.02.2019;01:01:06;83548306;83470374;77932;
03.02.2019;01:02:05;83548415;83470411;78004;
03.02.2019;01:03:07;83548515;83470449;78066;
03.02.2019;01:04:06;83548613;83470479;78134;
03.02.2019;01:05:05;83548718;83470510;78208;
03.02.2019;01:06:08;83548803;83470546;78257;
03.02.2019;01:07:12;83548943;83470582;78361;
03.02.2019;01:08:04;83549039;83470612;78427;
03.02.2019;01:09:07;83549132;83470644;78488;
03.02.2019;01:10:11;83549261;83470679;78582;
03.02.2019;01:11:04;83549384;83470698;78686;
03.02.2019;01:12:05;83549493;83470742;78751;
03.02.2019;01:13:07;83549595;83470761;78834;
03.02.2019;01:14:04;83549692;83470794;78898;
03.02.2019;01:15:06;83549797;83470830;78967;
03.02.2019;01:16:06;83549916;83470853;79063;
03.02.2019;01:17:08;83550043;83470894;79149;
03.02.2019;01:18:04;83550143;83470935;79208;
03.02.2019;01:19:04;83550222;83470967;79255;
03.02.2019;01:20:07;83550335;83470990;79345;
03.02.2019;01:21:04;83550442;83471015;79427;
03.02.2019;01:22:09;83550554;83471055;79499;
03.02.2019;01:23:04;83550651;83471085;79566;
03.02.2019;01:24:05;83550772;83471133;79639;
03.02.2019;01:25:12;83550891;83471167;79724;
03.02.2019;01:26:05;83550983;83471202;79781;
03.02.2019;01:27:06;83551070;83471230;79840;
03.02.2019;01:28:05;83551190;83471279;79911;
03.02.2019;01:29:04;83551292;83471322;79970;
03.02.2019;01:30:05;83551402;83471365;80037;
03.02.2019;01:31:07;83551523;83471411;80112;
03.02.2019;01:32:16;83551652;83471466;80186;
03.02.2019;01:33:06;83551733;83471511;80222;
03.02.2019;01:34:08;83551883;83471555;80328;
03.02.2019;01:35:06;83551990;83471583;80407;
03.02.2019;01:36:07;83552114;83471625;80489;
03.02.2019;01:37:07;83552233;83471668;80565;
03.02.2019;01:38:10;83552353;83471714;80639;
03.02.2019;01:39:09;83552446;83471765;80681;
03.02.2019;01:40:06;83552565;83471798;80767;
03.02.2019;01:41:07;83552676;83471844;80832;
03.02.2019;01:42:06;83552766;83471871;80895;
03.02.2019;01:43:05;83552881;83471921;80960;
03.02.2019;01:44:04;83552979;83471955;81024;
03.02.2019;01:45:06;83553078;83471999;81079;
03.02.2019;01:46:06;83553181;83472047;81134;
03.02.2019;01:47:07;83553310;83472097;81213;
03.02.2019;01:48:04;83553423;83472151;81272;
03.02.2019;01:49:12;83553539;83472197;81342;
03.02.2019;01:50:05;83553632;83472241;81391;
03.02.2019;01:51:04;83553748;83472294;81454;
03.02.2019;01:52:06;83553849;83472341;81508;
03.02.2019;01:53:06;83553939;83472396;81543;
03.02.2019;01:54:05;83554030;83472449;81581;
03.02.2019;01:55:05;83554146;83472489;81657;
03.02.2019;01:56:06;83554238;83472535;81703;
03.02.2019;01:57:17;83554367;83472606;81761;
03.02.2019;01:58:04;83554474;83472651;81823;
03.02.2019;01:59:05;83554582;83472694;81888;
03.02.2019;02:00:05;83554706;83472743;81963;
03.02.2019;02:01:05;83554826;83472807;82019;
03.02.2019;02:02:07;83554929;83472859;82070;
03.02.2019;02:03:04;83555005;83472909;82096;
03.02.2019;02:04:04;83555110;83472971;82139;
03.02.2019;02:05:08;83555233;83473034;82199;
03.02.2019;02:06:10;83555319;83473086;82233;
03.02.2019;02:07:11;83555438;83473152;82286;
03.02.2019;02:08:06;83555535;83473205;82330;
03.02.2019;02:09:07;83555620;83473255;82365;
03.02.2019;02:10:06;83555704;83473311;82393;
03.02.2019;02:11:12;83555786;83473369;82417;
03.02.2019;02:12:06;83555885;83473422;82463;
03.02.2019;02:13:06;83555972;83473475;82497;
03.02.2019;02:14:06;83556067;83473525;82542;
03.02.2019;02:15:11;83556164;83473587;82577;
03.02.2019;02:16:06;83556236;83473641;82595;
03.02.2019;02:17:08;83556284;83473713;82571;
03.02.2019;02:18:10;83556404;83473780;82624;
03.02.2019;02:19:05;83556467;83473838;82629;
03.02.2019;02:20:12;83556521;83473917;82604;
03.02.2019;02:21:06;83556559;83473979;82580;
03.02.2019;02:22:06;83556598;83474030;82568;
03.02.2019;02:23:07;83556679;83474078;82601;
03.02.2019;02:24:06;83556744;83474139;82605;
03.02.2019;02:25:06;83556816;83474235;82581;
03.02.2019;02:26:21;83556920;83474310;82610;
03.02.2019;02:27:07;83556986;83474350;82636;
03.02.2019;02:28:06;83557067;83474418;82649;
03.02.2019;02:29:08;83557128;83474469;82659;
03.02.2019;02:30:06;83557201;83474532;82669;
03.02.2019;02:31:07;83557296;83474607;82689;
03.02.2019;02:32:06;83557410;83474679;82731;
03.02.2019;02:33:05;83557505;83474751;82754;
03.02.2019;02:34:06;83557602;83474836;82766;
03.02.2019;02:35:06;83557687;83474911;82776;
03.02.2019;02:36:04;83557774;83474974;82800;
03.02.2019;02:37:05;83557878;83475051;82827;
03.02.2019;02:38:05;83557974;83475112;82862;
03.02.2019;02:39:09;83558097;83475219;82878;
03.02.2019;02:40:04;83558196;83475289;82907;
03.02.2019;02:41:06;83558332;83475372;82960;
03.02.2019;02:42:05;83558445;83475446;82999;
03.02.2019;02:43:09;83558544;83475517;83027;
03.02.2019;02:44:05;83558653;83475595;83058;
03.02.2019;02:45:06;83558768;83475667;83101;
03.02.2019;02:46:12;83558882;83475755;83127;
03.02.2019;02:47:05;83559014;83475829;83185;
03.02.2019;02:48:04;83559137;83475917;83220;
03.02.2019;02:49:04;83559242;83475988;83254;
03.02.2019;02:50:05;83559357;83476082;83275;
03.02.2019;02:51:11;83559464;83476189;83275;
03.02.2019;02:52:05;83559568;83476266;83302;
03.02.2019;02:53:04;83559688;83476302;83386;
03.02.2019;02:54:05;83559820;83476430;83390;
03.02.2019;02:55:05;83559941;83476511;83430;
03.02.2019;02:56:05;83560052;83476609;83443;
03.02.2019;02:57:04;83560178;83476704;83474;
03.02.2019;02:58:05;83560287;83476800;83487;
03.02.2019;02:59:06;83560385;83476890;83495;
03.02.2019;03:00:06;83560500;83476994;83506;
03.02.2019;03:01:05;83560609;83477111;83498;
03.02.2019;03:02:05;83560728;83477198;83530;
03.02.2019;03:03:12;83560851;83477289;83562;
03.02.2019;03:04:04;83560932;83477390;83542;
03.02.2019;03:05:05;83561063;83477485;83578;
03.02.2019;03:06:05;83561178;83477574;83604;
03.02.2019;03:07:13;83561309;83477708;83601;
03.02.2019;03:08:07;83561427;83477778;83649;
03.02.2019;03:10:06;83561651;83477997;83654;
03.02.2019;03:11:08;83561791;83478107;83684;
03.02.2019;03:12:06;83561921;83478221;83700;
03.02.2019;03:13:07;83562016;83478320;83696;
03.02.2019;03:14:13;83562147;83478424;83723;
03.02.2019;03:15:05;83562274;83478532;83742;
03.02.2019;03:16:07;83562388;83478638;83750;
03.02.2019;03:17:07;83562489;83478744;83745;
03.02.2019;03:18:10;83562594;83478854;83740;
03.02.2019;03:19:06;83562701;83478957;83744;
03.02.2019;03:20:07;83562800;83479065;83735;
03.02.2019;03:21:11;83562925;83479175;83750;
03.02.2019;03:22:06;83563040;83479289;83751;
03.02.2019;03:23:05;83563146;83479387;83759;
03.02.2019;03:24:07;83563261;83479523;83738;
03.02.2019;03:25:05;83563365;83479653;83712;
03.02.2019;03:26:09;83563460;83479741;83719;
03.02.2019;03:27:05;83563578;83479850;83728;
03.02.2019;03:28:05;83563694;83480002;83692;
03.02.2019;03:29:06;83563792;83480118;83674;
03.02.2019;03:30:10;83563918;83480237;83681;
03.02.2019;03:31:05;83564048;83480328;83720;
03.02.2019;03:32:09;83564150;83480455;83695;
03.02.2019;03:33:07;83564274;83480583;83691;
03.02.2019;03:34:07;83564394;83480705;83689;
03.02.2019;03:35:09;83564503;83480836;83667;
03.02.2019;03:36:06;83564616;83480950;83666;
03.02.2019;03:37:13;83564756;83481087;83669;
03.02.2019;03:38:07;83564857;83481193;83664;
03.02.2019;03:39:05;83564993;83481331;83662;
03.02.2019;03:40:05;83565108;83481470;83638;
03.02.2019;03:41:06;83565222;83481582;83640;
03.02.2019;03:42:04;83565350;83481720;83630;
03.02.2019;03:43:06;83565471;83481835;83636;
03.02.2019;03:44:08;83565573;83481946;83627;
03.02.2019;03:45:04;83565692;83482045;83647;
03.02.2019;03:46:05;83565775;83482125;83650;
03.02.2019;03:47:04;83565897;83482225;83672;
03.02.2019;03:48:11;83566039;83482355;83684;
03.02.2019;03:49:06;83566168;83482479;83689;
03.02.2019;03:50:05;83566278;83482608;83670;
03.02.2019;03:51:05;83566398;83482741;83657;
03.02.2019;03:52:05;83566515;83482860;83655;
03.02.2019;03:53:05;83566625;83483006;83619;
03.02.2019;03:54:14;83566750;83483183;83567;
03.02.2019;03:55:04;83566872;83483284;83588;
03.02.2019;03:56:07;83566988;83483405;83583;
03.02.2019;03:57:06;83567104;83483553;83551;
03.02.2019;03:58:04;83567234;83483682;83552;
03.02.2019;03:59:05;83567365;83483827;83538;
03.02.2019;04:00:05;83567499;83483959;83540;
03.02.2019;04:01:10;83567622;83484116;83506;
03.02.2019;04:02:06;83567729;83484256;83473;
03.02.2019;04:03:06;83567833;83484389;83444;
03.02.2019;04:04:06;83567938;83484522;83416;
03.02.2019;04:05:07;83568048;83484662;83386;
03.02.2019;04:06:06;83568144;83484813;83331;
03.02.2019;04:07:10;83568208;83484968;83240;
03.02.2019;04:08:05;83568287;83485080;83207;
03.02.2019;04:09:12;83568387;83485249;83138;
03.02.2019;04:10:05;83568445;83485371;83074;
03.02.2019;04:11:07;83568550;83485519;83031;
03.02.2019;04:12:06;83568606;83485632;82974;
03.02.2019;04:13:05;83568685;83485781;82904;
03.02.2019;04:14:04;83568756;83485876;82880;
03.02.2019;04:15:07;83568842;83486034;82808;
03.02.2019;04:16:05;83568910;83486144;82766;
03.02.2019;04:17:07;83568966;83486257;82709;
03.02.2019;04:18:12;83569047;83486419;82628;
03.02.2019;04:19:09;83569136;83486567;82569;
03.02.2019;04:20:11;83569238;83486693;82545;
03.02.2019;04:21:06;83569341;83486819;82522;
03.02.2019;04:22:06;83569432;83486956;82476;
03.02.2019;04:23:06;83569545;83487082;82463;
03.02.2019;04:24:04;83569637;83487207;82430;
03.02.2019;04:25:06;83569770;83487347;82423;
03.02.2019;04:26:05;83569886;83487484;82402;
03.02.2019;04:27:10;83570002;83487667;82335;
03.02.2019;04:28:10;83570128;83487802;82326;
03.02.2019;04:29:08;83570223;83487937;82286;
03.02.2019;04:30:07;83570352;83488079;82273;
03.02.2019;04:31:08;83570478;83488222;82256;
03.02.2019;04:32:06;83570585;83488344;82241;
03.02.2019;04:33:07;83570687;83488487;82200;
03.02.2019;04:34:10;83570804;83488649;82155;
03.02.2019;04:35:07;83570915;83488775;82140;
03.02.2019;04:36:05;83571058;83488893;82165;
03.02.2019;04:37:12;83571176;83489039;82137;
03.02.2019;04:38:08;83571304;83489176;82128;
03.02.2019;04:39:08;83571414;83489325;82089;
03.02.2019;04:40:06;83571543;83489475;82068;
03.02.2019;04:41:05;83571658;83489655;82003;
03.02.2019;04:42:13;83571761;83489840;81921;
03.02.2019;04:43:06;83571873;83489948;81925;
03.02.2019;04:44:12;83572005;83490107;81898;
03.02.2019;04:45:05;83572113;83490230;81883;
03.02.2019;04:46:06;83572211;83490357;81854;
03.02.2019;04:47:07;83572304;83490525;81779;
03.02.2019;04:48:06;83572421;83490660;81761;
03.02.2019;04:49:04;83572548;83490784;81764;
03.02.2019;04:50:05;83572652;83490933;81719;
03.02.2019;04:51:04;83572744;83491082;81662;
03.02.2019;04:52:05;83572856;83491248;81608;
03.02.2019;04:53:05;83572951;83491391;81560;
03.02.2019;04:54:06;83573061;83491553;81508;
03.02.2019;04:55:04;83573170;83491699;81471;
03.02.2019;04:56:04;83573304;83491861;81443;
03.02.2019;04:57:06;83573423;83492004;81419;
03.02.2019;04:58:04;83573542;83492169;81373;
03.02.2019;04:59:07;83573662;83492346;81316;
03.02.2019;05:00:05;83573799;83492497;81302;
03.02.2019;05:01:04;83573913;83492653;81260;
03.02.2019;05:02:04;83574019;83492803;81216;
03.02.2019;05:03:05;83574134;83492940;81194;
03.02.2019;05:04:10;83574229;83493096;81133;
03.02.2019;05:05:05;83574332;83493228;81104;
03.02.2019;05:06:06;83574457;83493365;81092;
03.02.2019;05:07:04;83574576;83493500;81076;
03.02.2019;05:08:06;83574692;83493658;81034;
03.02.2019;05:09:08;83574783;83493835;80948;
03.02.2019;05:10:12;83574882;83494012;80870;
03.02.2019;05:11:06;83574971;83494163;80808;
03.02.2019;05:12:04;83575077;83494302;80775;
03.02.2019;05:13:06;83575195;83494476;80719;
03.02.2019;05:14:06;83575317;83494616;80701;
03.02.2019;05:15:08;83575425;83494772;80653;
03.02.2019;05:16:04;83575521;83494897;80624;
03.02.2019;05:17:05;83575643;83495049;80594;
03.02.2019;05:18:06;83575741;83495211;80530;
03.02.2019;05:19:04;83575856;83495374;80482;
03.02.2019;05:20:06;83575953;83495540;80413;
03.02.2019;05:21:04;83576044;83495701;80343;
03.02.2019;05:22:05;83576159;83495846;80313;
03.02.2019;05:23:05;83576250;83496000;80250;
03.02.2019;05:24:05;83576360;83496169;80191;
03.02.2019;05:25:05;83576486;83496318;80168;
03.02.2019;05:26:05;83576620;83496466;80154;
03.02.2019;05:27:06;83576737;83496613;80124;
03.02.2019;05:28:06;83576876;83496757;80119;
03.02.2019;05:29:05;83576976;83496905;80071;
03.02.2019;05:30:04;83577071;83497058;80013;
03.02.2019;05:31:05;83577190;83497218;79972;
03.02.2019;05:32:11;83577313;83497400;79913;
03.02.2019;05:33:06;83577424;83497583;79841;
03.02.2019;05:34:12;83577558;83497767;79791;
03.02.2019;05:35:06;83577647;83497892;79755;
03.02.2019;05:36:04;83577774;83498053;79721;
03.02.2019;05:37:05;83577852;83498186;79666;
03.02.2019;05:38:07;83577988;83498343;79645;
03.02.2019;05:39:05;83578094;83498493;79601;
03.02.2019;05:40:04;83578207;83498666;79541;
03.02.2019;05:41:06;83578331;83498807;79524;
03.02.2019;05:42:05;83578458;83498945;79513;
03.02.2019;05:43:05;83578592;83499092;79500;
03.02.2019;05:44:07;83578710;83499248;79462;
03.02.2019;05:45:06;83578817;83499423;79394;
03.02.2019;05:46:05;83578910;83499555;79355;
03.02.2019;05:47:05;83579045;83499731;79314;
03.02.2019;05:48:04;83579160;83499911;79249;
03.02.2019;05:49:05;83579273;83500079;79194;
03.02.2019;05:50:05;83579396;83500252;79144;
03.02.2019;05:51:05;83579504;83500415;79089;
03.02.2019;05:52:05;83579620;83500570;79050;
03.02.2019;05:53:09;83579740;83500754;78986;
03.02.2019;05:54:04;83579849;83500898;78951;
03.02.2019;05:55:04;83579959;83501062;78897;
03.02.2019;05:56:05;83580079;83501220;78859;
03.02.2019;05:57:05;83580201;83501396;78805;
03.02.2019;05:58:06;83580328;83501547;78781;
03.02.2019;05:59:05;83580449;83501701;78748;
03.02.2019;06:00:05;83580539;83501879;78660;
03.02.2019;06:01:05;83580653;83502059;78594;
03.02.2019;06:02:04;83580776;83502225;78551;
03.02.2019;06:03:05;83580914;83502372;78542;
03.02.2019;06:04:05;83581020;83502547;78473;
03.02.2019;06:05:04;83581103;83502690;78413;
03.02.2019;06:06:11;83581206;83502895;78311;
03.02.2019;06:07:04;83581307;83503042;78265;
03.02.2019;06:08:09;83581428;83503225;78203;
03.02.2019;06:09:05;83581541;83503385;78156;
03.02.2019;06:10:04;83581654;83503518;78136;
03.02.2019;06:11:04;83581743;83503683;78060;
03.02.2019;06:12:05;83581828;83503856;77972;
03.02.2019;06:13:05;83581902;83503982;77920;
03.02.2019;06:14:06;83581995;83504134;77861;
03.02.2019;06:15:05;83582100;83504263;77837;
03.02.2019;06:16:04;83582186;83504407;77779;
03.02.2019;06:17:08;83582304;83504565;77739;
03.02.2019;06:18:04;83582377;83504682;77695;
03.02.2019;06:19:05;83582465;83504812;77653;
03.02.2019;06:20:06;83582533;83504982;77551;
03.02.2019;06:21:05;83582622;83505118;77504;
03.02.2019;06:22:05;83582683;83505256;77427;
03.02.2019;06:23:11;83582736;83505393;77343;
03.02.2019;06:24:04;83582777;83505507;77270;
03.02.2019;06:25:07;83582844;83505642;77202;
03.02.2019;06:26:05;83582930;83505809;77121;
03.02.2019;06:27:05;83583018;83505929;77089;
03.02.2019;06:28:05;83583095;83506115;76980;
03.02.2019;06:29:05;83583163;83506295;76868;
03.02.2019;06:30:05;83583242;83506453;76789;
03.02.2019;06:31:06;83583334;83506632;76702;
03.02.2019;06:32:04;83583436;83506779;76657;
03.02.2019;06:33:04;83583557;83506938;76619;
03.02.2019;06:34:05;83583648;83507108;76540;
03.02.2019;06:35:05;83583765;83507256;76509;
03.02.2019;06:36:04;83583870;83507410;76460;
03.02.2019;06:37:05;83583987;83507590;76397;
03.02.2019;06:38:05;83584079;83507722;76357;
03.02.2019;06:39:07;83584157;83507878;76279;
03.02.2019;06:40:05;83584259;83508058;76201;
03.02.2019;06:41:05;83584371;83508211;76160;
03.02.2019;06:42:04;83584421;83508350;76071;
03.02.2019;06:43:04;83584443;83508457;75986;
03.02.2019;06:44:04;83584529;83508620;75909;
03.02.2019;06:45:04;83584640;83508779;75861;
03.02.2019;06:46:05;83584732;83508962;75770;
03.02.2019;06:47:09;83584850;83509113;75737;
03.02.2019;06:48:05;83584946;83509236;75710;
03.02.2019;06:49:05;83585036;83509402;75634;
03.02.2019;06:50:04;83585135;83509577;75558;
03.02.2019;06:51:06;83585241;83509746;75495;
03.02.2019;06:52:05;83585376;83509897;75479;
03.02.2019;06:53:04;83585479;83510076;75403;
03.02.2019;06:54:04;83585566;83510251;75315;
03.02.2019;06:55:04;83585659;83510423;75236;
03.02.2019;06:56:05;83585756;83510577;75179;
03.02.2019;06:57:05;83585865;83510744;75121;
03.02.2019;06:58:05;83585959;83510901;75058;
03.02.2019;06:59:05;83586074;83511061;75013;
03.02.2019;07:00:04;83586169;83511235;74934;
03.02.2019;07:01:04;83586249;83511406;74843;
03.02.2019;07:02:04;83586342;83511591;74751;
03.02.2019;07:03:05;83586426;83511770;74656;
03.02.2019;07:04:05;83586516;83511930;74586;
03.02.2019;07:05:04;83586622;83512092;74530;
03.02.2019;07:06:04;83586718;83512293;74425;
03.02.2019;07:07:05;83586821;83512469;74352;
03.02.2019;07:08:05;83586915;83512632;74283;
03.02.2019;07:09:07;83587004;83512812;74192;
03.02.2019;07:10:05;83587093;83512970;74123;
03.02.2019;07:11:10;83587174;83513151;74023;
03.02.2019;07:12:05;83587263;83513320;73943;
03.02.2019;07:13:05;83587368;83513503;73865;
03.02.2019;07:14:05;83587453;83513681;73772;
03.02.2019;07:15:04;83587574;83513843;73731;
03.02.2019;07:16:06;83587679;83514021;73658;
03.02.2019;07:17:05;83587767;83514159;73608;
03.02.2019;07:18:05;83587860;83514335;73525;
03.02.2019;07:19:05;83587959;83514522;73437;
03.02.2019;07:20:05;83588051;83514698;73353;
03.02.2019;07:21:05;83588144;83514891;73253;
03.02.2019;07:22:05;83588242;83515062;73180;
03.02.2019;07:23:05;83588329;83515240;73089;
03.02.2019;07:24:05;83588409;83515404;73005;
03.02.2019;07:25:05;83588512;83515573;72939;
03.02.2019;07:26:05;83588604;83515707;72897;
03.02.2019;07:27:05;83588679;83515894;72785;
03.02.2019;07:28:05;83588761;83516051;72710;
03.02.2019;07:29:05;83588860;83516207;72653;
03.02.2019;07:30:04;83588947;83516374;72573;
03.02.2019;07:31:05;83589029;83516536;72493;
03.02.2019;07:32:05;83589138;83516710;72428;
03.02.2019;07:33:05;83589221;83516880;72341;
03.02.2019;07:34:05;83589290;83517053;72237;
03.02.2019;07:35:05;83589387;83517216;72171;
03.02.2019;07:36:05;83589473;83517359;72114;
03.02.2019;07:37:04;83589549;83517493;72056;
03.02.2019;07:38:04;83589636;83517666;71970;
03.02.2019;07:39:04;83589734;83517830;71904;
03.02.2019;07:40:05;83589834;83517996;71838;
03.02.2019;07:41:05;83589918;83518156;71762;
03.02.2019;07:42:06;83590001;83518324;71677;
03.02.2019;07:43:05;83590103;83518513;71590;
03.02.2019;07:44:05;83590184;83518673;71511;
03.02.2019;07:45:05;83590268;83518814;71454;
03.02.2019;07:46:04;83590364;83518980;71384;
03.02.2019;07:47:05;83590449;83519162;71287;
03.02.2019;07:48:05;83590535;83519335;71200;
03.02.2019;07:49:05;83590633;83519477;71156;
03.02.2019;07:50:05;83590718;83519626;71092;
03.02.2019;07:51:05;83590814;83519764;71050;
03.02.2019;07:52:05;83590904;83519908;70996;
03.02.2019;07:53:05;83591022;83520103;70919;
03.02.2019;07:54:05;83591112;83520288;70824;
03.02.2019;07:55:05;83591210;83520471;70739;
03.02.2019;07:56:05;83591286;83520607;70679;
03.02.2019;07:57:05;83591392;83520789;70603;
03.02.2019;07:58:04;83591487;83520945;70542;
03.02.2019;07:59:04;83591602;83521097;70505;
03.02.2019;08:00:04;83591691;83521228;70463;
03.02.2019;08:01:04;83591782;83521408;70374;
03.02.2019;08:02:04;83591857;83521555;70302;
03.02.2019;08:03:04;83591939;83521701;70238;
03.02.2019;08:04:05;83592028;83521861;70167;
03.02.2019;08:05:05;83592105;83522039;70066;
03.02.2019;08:06:05;83592156;83522209;69947;
03.02.2019;08:07:05;83592252;83522359;69893;
03.02.2019;08:08:05;83592291;83522492;69799;
03.02.2019;08:09:06;83592377;83522681;69696;
03.02.2019;08:10:05;83592456;83522815;69641;
03.02.2019;08:11:05;83592494;83522979;69515;
03.02.2019;08:12:05;83592567;83523162;69405;
03.02.2019;08:13:04;83592601;83523312;69289;
03.02.2019;08:14:05;83592683;83523456;69227;
03.02.2019;08:15:05;83592732;83523574;69158;
03.02.2019;08:16:05;83592785;83523737;69048;
03.02.2019;08:17:05;83592835;83523901;68934;
03.02.2019;08:18:04;83592862;83524041;68821;
03.02.2019;08:19:05;83592898;83524163;68735;
03.02.2019;08:20:05;83592953;83524306;68647;
03.02.2019;08:21:05;83593009;83524431;68578;
03.02.2019;08:22:05;83593057;83524579;68478;
03.02.2019;08:23:05;83593117;83524719;68398;
03.02.2019;08:24:05;83593168;83524878;68290;
03.02.2019;08:25:05;83593236;83525029;68207;
03.02.2019;08:26:06;83593293;83525184;68109;
03.02.2019;08:27:05;83593365;83525352;68013;
03.02.2019;08:28:05;83593432;83525519;67913;
03.02.2019;08:29:06;83593480;83525695;67785;
03.02.2019;08:30:05;83593556;83525883;67673;
03.02.2019;08:31:05;83593635;83526064;67571;
03.02.2019;08:32:06;83593705;83526242;67463;
03.02.2019;08:33:05;83593741;83526381;67360;
03.02.2019;08:34:05;83593836;83526538;67298;
03.02.2019;08:35:05;83593914;83526709;67205;
03.02.2019;08:36:05;83594003;83526847;67156;
03.02.2019;08:37:05;83594085;83527010;67075;
03.02.2019;08:38:05;83594161;83527183;66978;
03.02.2019;08:39:06;83594226;83527323;66903;
03.02.2019;08:40:05;83594307;83527480;66827;
03.02.2019;08:41:06;83594379;83527668;66711;
03.02.2019;08:42:06;83594442;83527829;66613;
03.02.2019;08:43:05;83594545;83527955;66590;
03.02.2019;08:44:05;83594637;83528098;66539;
03.02.2019;08:45:05;83594714;83528293;66421;
03.02.2019;08:46:05;83594793;83528457;66336;
03.02.2019;08:47:05;83594881;83528629;66252;
03.02.2019;08:48:07;83594959;83528793;66166;
03.02.2019;08:49:05;83595035;83528960;66075;
03.02.2019;08:50:05;83595100;83529122;65978;
03.02.2019;08:51:05;83595197;83529300;65897;
03.02.2019;08:52:05;83595274;83529480;65794;
03.02.2019;08:53:06;83595370;83529658;65712;
03.02.2019;08:54:05;83595450;83529815;65635;
03.02.2019;08:55:08;83595543;83529950;65593;
03.02.2019;08:56:10;83595632;83530141;65491;
03.02.2019;08:57:05;83595715;83530314;65401;
03.02.2019;08:58:06;83595794;83530471;65323;
03.02.2019;08:59:11;83595898;83530631;65267;
03.02.2019;09:00:05;83595978;83530796;65182;
03.02.2019;09:01:05;83596076;83530946;65130;
03.02.2019;09:02:05;83596159;83531113;65046;
03.02.2019;09:03:05;83596249;83531272;64977;
03.02.2019;09:04:05;83596327;83531432;64895;
03.02.2019;09:05:05;83596384;83531615;64769;
03.02.2019;09:06:05;83596470;83531812;64658;
03.02.2019;09:07:05;83596546;83531957;64589;
03.02.2019;09:08:05;83596619;83532138;64481;
03.02.2019;09:09:07;83596715;83532323;64392;
03.02.2019;09:10:05;83596800;83532515;64285;
03.02.2019;09:11:05;83596890;83532687;64203;
03.02.2019;09:12:06;83596981;83532874;64107;
03.02.2019;09:13:05;83597071;83533048;64023;
03.02.2019;09:14:05;83597157;83533218;63939;
03.02.2019;09:15:05;83597247;83533411;63836;
03.02.2019;09:16:05;83597327;83533578;63749;
03.02.2019;09:17:05;83597420;83533755;63665;
03.02.2019;09:18:05;83597497;83533936;63561;
03.02.2019;09:19:05;83597580;83534101;63479;
03.02.2019;09:20:05;83597679;83534275;63404;
03.02.2019;09:21:05;83597763;83534452;63311;
03.02.2019;09:22:05;83597842;83534635;63207;
03.02.2019;09:23:05;83597919;83534814;63105;
03.02.2019;09:24:05;83598017;83534973;63044;
03.02.2019;09:25:05;83598105;83535126;62979;
03.02.2019;09:26:05;83598195;83535317;62878;
03.02.2019;09:27:05;83598287;83535504;62783;
03.02.2019;09:28:05;83598370;83535713;62657;
03.02.2019;09:29:05;83598437;83535892;62545;
03.02.2019;09:30:05;83598498;83536075;62423;
03.02.2019;09:31:05;83598584;83536243;62341;
03.02.2019;09:32:05;83598671;83536423;62248;
03.02.2019;09:33:05;83598756;83536609;62147;
03.02.2019;09:34:05;83598855;83536768;62087;
03.02.2019;09:35:06;83598942;83536943;61999;
03.02.2019;09:36:05;83599028;83537098;61930;
03.02.2019;09:37:07;83599124;83537298;61826;
03.02.2019;09:38:05;83599224;83537477;61747;
03.02.2019;09:39:07;83599325;83537635;61690;
03.02.2019;09:40:05;83599392;83537800;61592;
03.02.2019;09:41:05;83599415;83537918;61497;
03.02.2019;09:42:05;83599503;83538094;61409;
03.02.2019;09:43:05;83599604;83538255;61349;
03.02.2019;09:44:05;83599669;83538446;61223;
03.02.2019;09:45:05;83599766;83538627;61139;
03.02.2019;09:46:05;83599841;83538811;61030;
03.02.2019;09:47:06;83599914;83538951;60963;
03.02.2019;09:48:05;83599994;83539096;60898;
03.02.2019;09:49:05;83600081;83539270;60811;
03.02.2019;09:50:05;83600140;83539442;60698;
03.02.2019;09:51:05;83600248;83539623;60625;
03.02.2019;09:52:05;83600339;83539788;60551;
03.02.2019;09:53:05;83600425;83539944;60481;
03.02.2019;09:54:05;83600525;83540095;60430;
03.02.2019;09:55:05;83600631;83540251;60380;
03.02.2019;09:56:05;83600711;83540411;60300;
03.02.2019;09:57:11;83600835;83540609;60226;
03.02.2019;09:58:05;83600919;83540775;60144;
03.02.2019;09:59:07;83601010;83540945;60065;
03.02.2019;10:00:05;83601092;83541118;59974;
03.02.2019;10:01:05;83601173;83541287;59886;
03.02.2019;10:02:05;83601256;83541435;59821;
03.02.2019;10:03:05;83601321;83541595;59726;
03.02.2019;10:04:05;83601391;83541740;59651;
03.02.2019;10:05:05;83601468;83541902;59566;
03.02.2019;10:06:04;83601551;83542047;59504;
03.02.2019;10:07:04;83601612;83542203;59409;
03.02.2019;10:08:05;83601692;83542365;59327;
03.02.2019;10:09:07;83601785;83542543;59242;
03.02.2019;10:10:06;83601890;83542701;59189;
03.02.2019;10:11:05;83601969;83542847;59122;
03.02.2019;10:12:05;83602066;83543016;59050;
03.02.2019;10:13:06;83602139;83543192;58947;
03.02.2019;10:14:05;83602225;83543372;58853;
03.02.2019;10:15:06;83602292;83543530;58762;
03.02.2019;10:16:05;83602366;83543666;58700;
03.02.2019;10:17:10;83602421;83543823;58598;
03.02.2019;10:18:07;83602494;83543961;58533;
03.02.2019;10:19:04;83602531;83544095;58436;
03.02.2019;10:20:04;83602592;83544227;58365;
03.02.2019;10:21:04;83602636;83544368;58268;
03.02.2019;10:22:05;83602645;83544497;58148;
03.02.2019;10:23:05;83602686;83544647;58039;
03.02.2019;10:24:07;83602727;83544796;57931;
03.02.2019;10:25:05;83602765;83544978;57787;
03.02.2019;10:26:05;83602838;83545128;57710;
03.02.2019;10:27:05;83602914;83545283;57631;
03.02.2019;10:28:05;83602992;83545428;57564;
03.02.2019;10:29:04;83603077;83545572;57505;
03.02.2019;10:30:05;83603157;83545731;57426;
03.02.2019;10:31:05;83603245;83545897;57348;
03.02.2019;10:32:05;83603322;83546053;57269;
03.02.2019;10:33:06;83603401;83546207;57194;
03.02.2019;10:34:05;83603485;83546388;57097;
03.02.2019;10:35:06;83603577;83546573;57004;
03.02.2019;10:36:05;83603660;83546704;56956;
03.02.2019;10:37:06;83603734;83546879;56855;
03.02.2019;10:38:05;83603834;83547017;56817;
03.02.2019;10:39:07;83603919;83547198;56721;
03.02.2019;10:40:05;83604008;83547370;56638;
03.02.2019;10:41:05;83604091;83547551;56540;
03.02.2019;10:42:06;83604183;83547719;56464;
03.02.2019;10:43:05;83604280;83547888;56392;
03.02.2019;10:44:05;83604371;83548036;56335;
03.02.2019;10:45:05;83604456;83548204;56252;
03.02.2019;10:46:05;83604550;83548356;56194;
03.02.2019;10:47:05;83604638;83548509;56129;
03.02.2019;10:48:05;83604732;83548686;56046;
03.02.2019;10:49:05;83604818;83548863;55955;
03.02.2019;10:50:06;83604909;83549048;55861;
03.02.2019;10:51:05;83604976;83549229;55747;
03.02.2019;10:52:05;83605033;83549376;55657;
03.02.2019;10:53:08;83605128;83549530;55598;
03.02.2019;10:54:05;83605225;83549665;55560;
03.02.2019;10:55:05;83605307;83549841;55466;
03.02.2019;10:56:05;83605392;83550003;55389;
03.02.2019;10:57:05;83605474;83550179;55295;
03.02.2019;10:58:05;83605553;83550323;55230;
03.02.2019;10:59:11;83605658;83550491;55167;
03.02.2019;11:00:04;83605719;83550650;55069;
03.02.2019;11:01:05;83605807;83550792;55015;
03.02.2019;11:02:05;83605901;83550954;54947;
03.02.2019;11:03:05;83605962;83551130;54832;
03.02.2019;11:04:05;83606042;83551309;54733;
03.02.2019;11:05:06;83606112;83551488;54624;
03.02.2019;11:06:06;83606204;83551654;54550;
03.02.2019;11:07:05;83606300;83551810;54490;
03.02.2019;11:08:05;83606392;83551963;54429;
03.02.2019;11:09:06;83606483;83552150;54333;
03.02.2019;11:10:05;83606557;83552319;54238;
03.02.2019;11:11:06;83606641;83552504;54137;
03.02.2019;11:12:10;83606743;83552662;54081;
03.02.2019;11:13:05;83606836;83552816;54020;
03.02.2019;11:14:05;83606928;83552954;53974;
03.02.2019;11:15:05;83607008;83553132;53876;
03.02.2019;11:16:05;83607097;83553284;53813;
03.02.2019;11:17:05;83607188;83553442;53746;
03.02.2019;11:18:05;83607289;83553634;53655;
03.02.2019;11:19:05;83607375;83553801;53574;
03.02.2019;11:20:05;83607474;83553969;53505;
03.02.2019;11:21:06;83607555;83554122;53433;
03.02.2019;11:22:05;83607632;83554276;53356;
03.02.2019;11:23:05;83607716;83554434;53282;
03.02.2019;11:24:06;83607804;83554603;53201;
03.02.2019;11:25:04;83607875;83554790;53085;
03.02.2019;11:26:05;83607959;83554963;52996;
03.02.2019;11:27:05;83608051;83555126;52925;
03.02.2019;11:28:04;83608142;83555306;52836;
03.02.2019;11:29:05;83608214;83555474;52740;
03.02.2019;11:30:05;83608315;83555650;52665;
03.02.2019;11:31:05;83608407;83555814;52593;
03.02.2019;11:32:05;83608483;83556003;52480;
03.02.2019;11:33:05;83608559;83556184;52375;
03.02.2019;11:34:05;83608660;83556348;52312;
03.02.2019;11:35:05;83608746;83556506;52240;
03.02.2019;11:36:05;83608849;83556668;52181;
03.02.2019;11:37:05;83608924;83556871;52053;
03.02.2019;11:38:04;83609002;83557028;51974;
03.02.2019;11:39:07;83609086;83557205;51881;
03.02.2019;11:40:06;83609160;83557378;51782;
03.02.2019;11:41:05;83609240;83557529;51711;
03.02.2019;11:42:05;83609337;83557690;51647;
03.02.2019;11:43:05;83609409;83557859;51550;
03.02.2019;11:44:05;83609504;83558007;51497;
03.02.2019;11:45:05;83609580;83558170;51410;
03.02.2019;11:46:05;83609660;83558310;51350;
03.02.2019;11:47:05;83609766;83558461;51305;
03.02.2019;11:48:06;83609857;83558633;51224;
03.02.2019;11:49:05;83609951;83558801;51150;
03.02.2019;11:50:06;83610042;83558980;51062;
03.02.2019;11:51:05;83610135;83559168;50967;
03.02.2019;11:52:05;83610207;83559345;50862;
03.02.2019;11:53:05;83610299;83559536;50763;
03.02.2019;11:54:05;83610384;83559734;50650;
03.02.2019;11:55:05;83610457;83559905;50552;
03.02.2019;11:56:05;83610539;83560065;50474;
03.02.2019;11:57:05;83610622;83560253;50369;
03.02.2019;11:58:05;83610710;83560417;50293;
03.02.2019;11:59:10;83610796;83560585;50211;
03.02.2019;12:00:05;83610883;83560724;50159;
03.02.2019;12:01:37;83610957;83561010;49947;
03.02.2019;12:02:06;83611053;83561097;49956;
03.02.2019;12:03:05;83611121;83561273;49848;
03.02.2019;12:04:05;83611229;83561443;49786;
03.02.2019;12:05:05;83611301;83561604;49697;
03.02.2019;12:06:04;83611369;83561730;49639;
03.02.2019;12:07:05;83611407;83561868;49539;
03.02.2019;12:08:05;83611462;83561997;49465;
03.02.2019;12:09:06;83611517;83562115;49402;
03.02.2019;12:10:05;83611531;83562222;49309;
03.02.2019;12:11:17;83611584;83562419;49165;
03.02.2019;12:12:18;83611598;83562557;49041;
03.02.2019;12:13:05;83611660;83562673;48987;
03.02.2019;12:14:05;83611720;83562843;48877;
03.02.2019;12:15:05;83611777;83563015;48762;
03.02.2019;12:16:05;83611862;83563168;48694;
03.02.2019;12:17:05;83611943;83563334;48609;
03.02.2019;12:18:05;83612034;83563511;48523;
03.02.2019;12:19:05;83612161;83563687;48474;
03.02.2019;12:20:04;83612221;83563849;48372;
03.02.2019;12:21:05;83612319;83564043;48276;
03.02.2019;12:22:06;83612400;83564227;48173;
03.02.2019;12:23:05;83612477;83564421;48056;
03.02.2019;12:24:05;83612567;83564618;47949;
03.02.2019;12:25:05;83612665;83564806;47859;
03.02.2019;12:26:05;83612755;83564957;47798;
03.02.2019;12:27:04;83612846;83565115;47731;
03.02.2019;12:28:04;83612946;83565321;47625;
03.02.2019;12:29:05;83613031;83565504;47527;
03.02.2019;12:30:05;83613120;83565698;47422;
03.02.2019;12:31:05;83613218;83565892;47326;
03.02.2019;12:32:04;83613302;83566064;47238;
03.02.2019;12:33:05;83613398;83566255;47143;
03.02.2019;12:34:05;83613507;83566429;47078;
03.02.2019;12:35:05;83613626;83566622;47004;
03.02.2019;12:36:05;83613713;83566807;46906;
03.02.2019;12:37:05;83613808;83566997;46811;
03.02.2019;12:38:05;83613912;83567167;46745;
03.02.2019;12:39:06;83614007;83567332;46675;
03.02.2019;12:40:05;83614091;83567566;46525;
03.02.2019;12:41:06;83614056;83567636;46420;
03.02.2019;12:42:05;83613955;83567653;46302;
03.02.2019;12:43:05;83614037;83567832;46205;
03.02.2019;12:44:06;83614152;83567982;46170;
03.02.2019;12:45:05;83614245;83568142;46103;
03.02.2019;12:46:05;83614341;83568348;45993;
03.02.2019;12:47:05;83614426;83568546;45880;
03.02.2019;12:48:10;83614533;83568719;45814;
03.02.2019;12:49:05;83614622;83568865;45757;
03.02.2019;12:50:05;83614737;83569034;45703;
03.02.2019;12:51:05;83614842;83569204;45638;
03.02.2019;12:52:04;83614937;83569392;45545;
03.02.2019;12:53:05;83615040;83569603;45437;
03.02.2019;12:54:05;83615151;83569775;45376;
03.02.2019;12:55:05;83615258;83569961;45297;
03.02.2019;12:56:05;83615372;83570126;45246;
03.02.2019;12:57:05;83615490;83570299;45191;
03.02.2019;12:58:06;83615608;83570460;45148;
03.02.2019;12:59:05;83615700;83570637;45063;
03.02.2019;13:00:05;83615801;83570810;44991;
03.02.2019;13:01:05;83615923;83570986;44937;
03.02.2019;13:02:05;83616020;83571172;44848;
03.02.2019;13:03:05;83616117;83571340;44777;
03.02.2019;13:04:05;83616233;83571522;44711;
03.02.2019;13:05:05;83616340;83571683;44657;
03.02.2019;13:06:05;83616445;83571839;44606;
03.02.2019;13:07:08;83616541;83572032;44509;
03.02.2019;13:08:05;83616636;83572208;44428;
03.02.2019;13:09:09;83616736;83572396;44340;
03.02.2019;13:10:05;83616825;83572585;44240;
03.02.2019;13:11:07;83616924;83572770;44154;
03.02.2019;13:12:06;83617011;83572914;44097;
03.02.2019;13:13:05;83617115;83573096;44019;
03.02.2019;13:14:05;83617205;83573298;43907;
03.02.2019;13:15:05;83617302;83573490;43812;
03.02.2019;13:16:05;83617415;83573698;43717;
03.02.2019;13:17:05;83617534;83573891;43643;
03.02.2019;13:18:05;83617656;83574066;43590;
03.02.2019;13:19:05;83617747;83574257;43490;
03.02.2019;13:20:05;83617850;83574430;43420;
03.02.2019;13:21:05;83617972;83574627;43345;
03.02.2019;13:22:05;83618059;83574799;43260;
03.02.2019;13:23:06;83618155;83575005;43150;
03.02.2019;13:24:05;83618251;83575209;43042;
03.02.2019;13:25:10;83618347;83575375;42972;
03.02.2019;13:26:05;83618445;83575531;42914;
03.02.2019;13:27:05;83618559;83575734;42825;
03.02.2019;13:28:05;83618678;83575886;42792;
03.02.2019;13:29:05;83618783;83576060;42723;
03.02.2019;13:30:05;83618889;83576238;42651;
03.02.2019;13:31:05;83619000;83576403;42597;
03.02.2019;13:32:05;83619112;83576578;42534;
03.02.2019;13:33:05;83619227;83576764;42463;
03.02.2019;13:34:06;83619339;83576933;42406;
03.02.2019;13:35:05;83619438;83577124;42314;
03.02.2019;13:36:05;83619540;83577310;42230;
03.02.2019;13:37:05;83619647;83577486;42161;
03.02.2019;13:38:05;83619742;83577679;42063;
03.02.2019;13:39:07;83619848;83577866;41982;
03.02.2019;13:40:05;83619950;83578069;41881;
03.02.2019;13:41:05;83620065;83578223;41842;
03.02.2019;13:42:05;83620186;83578406;41780;
03.02.2019;13:43:05;83620290;83578573;41717;
03.02.2019;13:44:10;83620416;83578781;41635;
03.02.2019;13:45:04;83620501;83578931;41570;
03.02.2019;13:46:05;83620625;83579095;41530;
03.02.2019;13:47:05;83620722;83579279;41443;
03.02.2019;13:48:06;83620826;83579474;41352;
03.02.2019;13:49:05;83620932;83579670;41262;
03.02.2019;13:50:05;83621047;83579847;41200;
03.02.2019;13:51:06;83621150;83580031;41119;
03.02.2019;13:52:05;83621259;83580240;41019;
03.02.2019;13:53:05;83621356;83580437;40919;
03.02.2019;13:54:05;83621472;83580630;40842;
03.02.2019;13:55:05;83621589;83580817;40772;
03.02.2019;13:56:05;83621706;83581012;40694;
03.02.2019;13:57:05;83621834;83581249;40585;
03.02.2019;13:58:05;83621950;83581442;40508;
03.02.2019;13:59:05;83622016;83581642;40374;
03.02.2019;14:00:04;83622177;83581807;40370;
03.02.2019;14:01:05;83622301;83581990;40311;
03.02.2019;14:02:05;83622421;83582189;40232;
03.02.2019;14:03:05;83622499;83582367;40132;
03.02.2019;14:04:05;83622626;83582548;40078;
03.02.2019;14:05:10;83622725;83582775;39950;
03.02.2019;14:06:05;83622837;83582962;39875;
03.02.2019;14:07:05;83622955;83583161;39794;
03.02.2019;14:08:06;83623095;83583352;39743;
03.02.2019;14:09:07;83623202;83583543;39659;
03.02.2019;14:10:05;83623307;83583748;39559;
03.02.2019;14:11:05;83623432;83583965;39467;
03.02.2019;14:12:04;83623510;83584135;39375;
03.02.2019;14:13:05;83623593;83584309;39284;
03.02.2019;14:14:05;83623684;83584470;39214;
03.02.2019;14:15:05;83623765;83584620;39145;
03.02.2019;14:16:05;83623833;83584766;39067;
03.02.2019;14:17:06;83623909;83584928;38981;
03.02.2019;14:18:05;83623986;83585070;38916;
03.02.2019;14:19:05;83624084;83585215;38869;
03.02.2019;14:20:05;83624149;83585409;38740;
03.02.2019;14:21:05;83624235;83585573;38662;
03.02.2019;14:22:05;83624343;83585730;38613;
03.02.2019;14:23:06;83624428;83585922;38506;
03.02.2019;14:24:05;83624526;83586083;38443;
03.02.2019;14:25:05;83624643;83586264;38379;
03.02.2019;14:26:05;83624730;83586462;38268;
03.02.2019;14:27:06;83624850;83586631;38219;
03.02.2019;14:28:05;83624949;83586790;38159;
03.02.2019;14:29:05;83625054;83586992;38062;
03.02.2019;14:30:06;83625179;83587177;38002;
03.02.2019;14:31:05;83625332;83587348;37984;
03.02.2019;14:32:05;83625436;83587528;37908;
03.02.2019;14:33:05;83625564;83587738;37826;
03.02.2019;14:34:05;83625675;83587935;37740;
03.02.2019;14:35:05;83625788;83588119;37669;
03.02.2019;14:36:05;83625907;83588324;37583;
03.02.2019;14:37:06;83626037;83588531;37506;
03.02.2019;14:38:05;83626148;83588713;37435;
03.02.2019;14:39:07;83626307;83588886;37421;
03.02.2019;14:40:05;83626426;83589065;37361;
03.02.2019;14:41:05;83626558;83589264;37294;
03.02.2019;14:42:05;83626701;83589466;37235;
03.02.2019;14:43:05;83626803;83589641;37162;
03.02.2019;14:44:04;83626916;83589853;37063;
03.02.2019;14:45:05;83627018;83590023;36995;
03.02.2019;14:46:10;83627143;83590222;36921;
03.02.2019;14:47:05;83627280;83590396;36884;
03.02.2019;14:48:05;83627402;83590597;36805;
03.02.2019;14:49:05;83627545;83590822;36723;
03.02.2019;14:50:06;83627689;83591014;36675;
03.02.2019;14:51:05;83627815;83591209;36606;
03.02.2019;14:52:06;83627953;83591423;36530;
03.02.2019;14:53:05;83628069;83591612;36457;
03.02.2019;14:54:05;83628201;83591822;36379;
03.02.2019;14:55:05;83628358;83592014;36344;
03.02.2019;14:56:05;83628482;83592198;36284;
03.02.2019;14:57:05;83628648;83592392;36256;
03.02.2019;14:58:05;83628796;83592562;36234;
03.02.2019;14:59:05;83628943;83592767;36176;
03.02.2019;15:00:08;83629083;83592969;36114;
03.02.2019;15:01:12;83629227;83593188;36039;
03.02.2019;15:02:12;83629374;83593380;35994;
03.02.2019;15:03:11;83629501;83593581;35920;
03.02.2019;15:04:11;83629638;83593812;35826;
03.02.2019;15:05:11;83629747;83593984;35763;
03.02.2019;15:06:11;83629881;83594178;35703;
03.02.2019;15:07:11;83630028;83594384;35644;
03.02.2019;15:08:11;83630188;83594593;35595;
03.02.2019;15:09:16;83630339;83594857;35482;
03.02.2019;15:10:15;83630470;83595084;35386;
03.02.2019;15:11:14;83630598;83595302;35296;
03.02.2019;15:12:15;83630736;83595549;35187;
03.02.2019;15:13:15;83630887;83595790;35097;
03.02.2019;15:14:15;83631037;83596003;35034;
03.02.2019;15:15:15;83631190;83596226;34964;
03.02.2019;15:16:17;83631328;83596464;34864;
03.02.2019;15:17:17;83631449;83596663;34786;
03.02.2019;15:18:18;83631567;83596899;34668;
03.02.2019;15:19:18;83631708;83597116;34592;
03.02.2019;15:20:18;83631855;83597322;34533;
03.02.2019;15:21:18;83632005;83597549;34456;
03.02.2019;15:22:18;83632166;83597756;34410;
03.02.2019;15:23:18;83632298;83597966;34332;
03.02.2019;15:24:20;83632437;83598181;34256;
03.02.2019;15:25:17;83632575;83598396;34179;
03.02.2019;15:26:21;83632724;83598629;34095;
03.02.2019;15:27:19;83632889;83598843;34046;
03.02.2019;15:28:18;83633044;83599060;33984;
03.02.2019;15:29:19;83633189;83599305;33884;
03.02.2019;15:30:20;83633356;83599512;33844;
03.02.2019;15:31:21;83633514;83599699;33815;
03.02.2019;15:32:21;83633661;83599935;33726;
03.02.2019;15:33:18;83633803;83600160;33643;
03.02.2019;15:34:21;83633950;83600396;33554;
03.02.2019;15:35:21;83634108;83600585;33523;
03.02.2019;15:36:21;83634232;83600788;33444;
03.02.2019;15:37:21;83634405;83601004;33401;
03.02.2019;15:38:21;83634544;83601218;33326;
03.02.2019;15:39:23;83634580;83601355;33225;
03.02.2019;15:40:21;83634567;83601398;33169;
03.02.2019;15:41:21;83634722;83601610;33112;
03.02.2019;15:42:22;83634884;83601811;33073;
03.02.2019;15:43:21;83635024;83602054;32970;
03.02.2019;15:44:21;83635206;83602260;32946;
03.02.2019;15:45:20;83635332;83602452;32880;
03.02.2019;15:46:20;83635460;83602680;32780;
03.02.2019;15:47:20;83635550;83602876;32674;
03.02.2019;15:48:21;83635616;83603135;32481;
03.02.2019;15:49:21;83635698;83603348;32350;
03.02.2019;15:50:21;83635807;83603594;32213;
03.02.2019;15:51:20;83635925;83603821;32104;
03.02.2019;15:52:20;83635989;83604075;31914;
03.02.2019;15:53:26;83636060;83604351;31709;
03.02.2019;15:54:21;83636113;83604569;31544;
03.02.2019;15:55:22;83636215;83604832;31383;
03.02.2019;15:56:21;83636358;83605097;31261;
03.02.2019;15:57:20;83636522;83605359;31163;
03.02.2019;15:58:21;83636707;83605581;31126;
03.02.2019;15:59:24;83636864;83605837;31027;
03.02.2019;16:00:17;83636969;83606027;30942;
03.02.2019;16:01:14;83637100;83606294;30806;
03.02.2019;16:02:09;83637265;83606534;30731;
03.02.2019;16:03:05;83637410;83606769;30641;
03.02.2019;16:04:05;83637561;83607045;30516;
03.02.2019;16:05:05;83637727;83607327;30400;
03.02.2019;16:06:05;83637901;83607592;30309;
03.02.2019;16:07:05;83638081;83607829;30252;
03.02.2019;16:08:06;83638250;83608113;30137;
03.02.2019;16:09:05;83638424;83608387;30037;
03.02.2019;16:10:05;83638584;83608629;29955;
03.02.2019;16:11:06;83638756;83608868;29888;
03.02.2019;16:12:05;83638952;83609091;29861;
03.02.2019;16:13:05;83638961;83609328;29633;
03.02.2019;16:14:05;83638917;83609617;29300;
03.02.2019;16:15:05;83639493;83609875;29618;
03.02.2019;16:16:05;83639804;83610088;29716;
03.02.2019;16:17:05;83640122;83610345;29777;
03.02.2019;16:18:05;83640397;83610508;29889;
03.02.2019;16:19:04;83640708;83610749;29959;
03.02.2019;16:20:05;83640993;83611027;29966;
03.02.2019;16:21:05;83641223;83611242;29981;
03.02.2019;16:22:05;83641505;83611481;30024;
03.02.2019;16:23:05;83641782;83611740;30042;
03.02.2019;16:24:05;83642034;83612015;30019;
03.02.2019;16:25:05;83642240;83612319;29921;
03.02.2019;16:26:05;83642431;83612572;29859;
03.02.2019;16:27:05;83642647;83612838;29809;
03.02.2019;16:28:05;83642898;83613078;29820;
03.02.2019;16:29:04;83643157;83613342;29815;
03.02.2019;16:30:05;83643397;83613606;29791;
03.02.2019;16:31:05;83643626;83613883;29743;
03.02.2019;16:32:06;83643853;83614096;29757;
03.02.2019;16:33:05;83644069;83614408;29661;
03.02.2019;16:34:05;83644290;83614640;29650;
03.02.2019;16:35:10;83644539;83614884;29655;
03.02.2019;16:36:05;83644780;83615133;29647;
03.02.2019;16:37:05;83645019;83615402;29617;
03.02.2019;16:38:05;83645198;83615660;29538;
03.02.2019;16:39:06;83645402;83615955;29447;
03.02.2019;16:40:05;83645650;83616218;29432;
03.02.2019;16:41:06;83645907;83616492;29415;
03.02.2019;16:42:04;83646130;83616747;29383;
03.02.2019;16:43:05;83646370;83617011;29359;
03.02.2019;16:44:06;83646604;83617311;29293;
03.02.2019;16:45:06;83646836;83617524;29312;
03.02.2019;16:46:05;83647036;83617776;29260;
03.02.2019;16:47:05;83647270;83618036;29234;
03.02.2019;16:48:05;83647519;83618291;29228;
03.02.2019;16:49:05;83647773;83618534;29239;
03.02.2019;16:50:05;83648034;83618809;29225;
03.02.2019;16:51:05;83648267;83619068;29199;
03.02.2019;16:52:05;83648546;83619268;29278;
03.02.2019;16:53:04;83648801;83619519;29282;
03.02.2019;16:54:04;83649033;83619774;29259;
03.02.2019;16:55:05;83649314;83620031;29283;
03.02.2019;16:56:05;83649567;83620298;29269;
03.02.2019;16:57:05;83649810;83620526;29284;
03.02.2019;16:58:04;83650068;83620749;29319;
03.02.2019;16:59:04;83650318;83620982;29336;
03.02.2019;17:00:05;83650570;83621249;29321;
03.02.2019;17:01:05;83650777;83621499;29278;
03.02.2019;17:02:05;83651071;83621753;29318;
03.02.2019;17:03:05;83651314;83622018;29296;
03.02.2019;17:04:06;83651549;83622282;29267;
03.02.2019;17:05:05;83651808;83622549;29259;
03.02.2019;17:06:05;83652072;83622820;29252;
03.02.2019;17:07:05;83652339;83623088;29251;
03.02.2019;17:08:05;83652623;83623339;29284;
03.02.2019;17:09:07;83652918;83623600;29318;
03.02.2019;17:10:05;83653143;83623840;29303;
03.02.2019;17:11:04;83653396;83624069;29327;
03.02.2019;17:12:05;83653685;83624310;29375;
03.02.2019;17:13:05;83653942;83624510;29432;
03.02.2019;17:14:10;83654267;83624803;29464;
03.02.2019;17:15:04;83654503;83625052;29451;
03.02.2019;17:16:04;83654785;83625305;29480;
03.02.2019;17:17:05;83655055;83625542;29513;
03.02.2019;17:18:04;83655312;83625805;29507;
03.02.2019;17:19:05;83655561;83626070;29491;
03.02.2019;17:20:05;83655788;83626351;29437;
03.02.2019;17:21:05;83656057;83626635;29422;
03.02.2019;17:22:05;83656297;83626893;29404;
03.02.2019;17:23:05;83656529;83627131;29398;
03.02.2019;17:24:05;83656816;83627389;29427;
03.02.2019;17:25:05;83657062;83627658;29404;
03.02.2019;17:26:05;83657351;83627881;29470;
03.02.2019;17:27:05;83657588;83628111;29477;
03.02.2019;17:28:04;83657845;83628357;29488;
03.02.2019;17:29:05;83658117;83628608;29509;
03.02.2019;17:30:04;83658370;83628811;29559;
03.02.2019;17:31:05;83658623;83629073;29550;
03.02.2019;17:32:05;83658895;83629324;29571;
03.02.2019;17:33:04;83659148;83629555;29593;
03.02.2019;17:34:05;83659397;83629805;29592;
03.02.2019;17:35:05;83659609;83630063;29546;
03.02.2019;17:36:06;83659875;83630294;29581;
03.02.2019;17:37:05;83660116;83630531;29585;
03.02.2019;17:38:05;83660414;83630773;29641;
03.02.2019;17:39:06;83660658;83631013;29645;
03.02.2019;17:40:05;83660943;83631258;29685;
03.02.2019;17:41:09;83661246;83631501;29745;
03.02.2019;17:42:05;83661486;83631708;29778;
03.02.2019;17:43:08;83661759;83631951;29808;
03.02.2019;17:44:04;83662005;83632184;29821;
03.02.2019;17:45:05;83662294;83632410;29884;
03.02.2019;17:46:09;83662571;83632655;29916;
03.02.2019;17:47:04;83662837;83632844;29993;
03.02.2019;17:48:05;83663137;83633078;30059;
03.02.2019;17:49:05;83663422;83633351;30071;
03.02.2019;17:50:21;83664165;83633660;30505;
03.02.2019;17:51:05;83665504;83633894;31610;
03.02.2019;17:52:05;83667058;83634124;32934;
03.02.2019;17:53:05;83668376;83634360;34016;
03.02.2019;17:54:10;83669592;83634626;34966;
03.02.2019;17:55:05;83670454;83634854;35600;
03.02.2019;17:56:05;83671331;83635111;36220;
03.02.2019;17:57:05;83672107;83635368;36739;
03.02.2019;17:58:05;83672950;83635603;37347;
03.02.2019;17:59:05;83673836;83635809;38027;
03.02.2019;18:00:05;83674807;83636083;38724;
03.02.2019;18:01:05;83675692;83636324;39368;
03.02.2019;18:02:05;83676515;83636557;39958;
03.02.2019;18:03:05;83677270;83636777;40493;
03.02.2019;18:04:05;83677974;83637018;40956;
03.02.2019;18:05:05;83678536;83637250;41286;
03.02.2019;18:06:04;83679187;83637499;41688;
03.02.2019;18:07:05;83679787;83637735;42052;
03.02.2019;18:08:05;83680274;83637958;42316;
03.02.2019;18:09:12;83680727;83638230;42497;
03.02.2019;18:10:05;83681139;83638442;42697;
03.02.2019;18:11:05;83681711;83638692;43019;
03.02.2019;18:12:05;83682460;83638940;43520;
03.02.2019;18:13:05;83683154;83639209;43945;
03.02.2019;18:14:05;83683889;83639437;44452;
03.02.2019;18:15:05;83684505;83639614;44891;
03.02.2019;18:16:05;83685064;83639822;45242;
03.02.2019;18:17:05;83685715;83640024;45691;
03.02.2019;18:18:05;83686248;83640175;46073;
03.02.2019;18:19:05;83686898;83640378;46520;
03.02.2019;18:20:06;83687522;83640562;46960;
03.02.2019;18:21:04;83688318;83640725;47593;
03.02.2019;18:22:05;83689003;83640927;48076;
03.02.2019;18:23:05;83689699;83641142;48557;
03.02.2019;18:24:06;83690634;83641310;49324;
03.02.2019;18:25:05;83691566;83641490;50076;
03.02.2019;18:26:05;83692325;83641676;50649;
03.02.2019;18:27:05;83693078;83641867;51211;
03.02.2019;18:28:05;83693800;83642012;51788;
03.02.2019;18:29:05;83694568;83642184;52384;
03.02.2019;18:30:06;83695445;83642397;53048;
03.02.2019;18:31:05;83696296;83642605;53691;
03.02.2019;18:32:05;83697162;83642803;54359;
03.02.2019;18:33:05;83697876;83643004;54872;
03.02.2019;18:34:04;83698537;83643237;55300;
03.02.2019;18:35:10;83699285;83643434;55851;
03.02.2019;18:36:05;83699950;83643578;56372;
03.02.2019;18:37:05;83700630;83643792;56838;
03.02.2019;18:38:05;83701278;83643988;57290;
03.02.2019;18:39:06;83702028;83644204;57824;
03.02.2019;18:40:06;83702659;83644437;58222;
03.02.2019;18:41:06;83703449;83644671;58778;
03.02.2019;18:42:05;83704234;83644902;59332;
03.02.2019;18:43:05;83705144;83645122;60022;
03.02.2019;18:44:06;83705767;83645345;60422;
03.02.2019;18:45:06;83706422;83645567;60855;
03.02.2019;18:46:05;83707104;83645819;61285;
03.02.2019;18:47:04;83707625;83646012;61613;
03.02.2019;18:48:05;83708259;83646213;62046;
03.02.2019;18:49:05;83708858;83646411;62447;
03.02.2019;18:50:05;83709487;83646604;62883;
03.02.2019;18:51:05;83710088;83646839;63249;
03.02.2019;18:52:05;83710738;83647038;63700;
03.02.2019;18:53:06;83711385;83647289;64096;
03.02.2019;18:54:06;83712029;83647487;64542;
03.02.2019;18:55:05;83712622;83647702;64920;
03.02.2019;18:56:06;83713215;83647892;65323;
03.02.2019;18:57:06;83713801;83648099;65702;
03.02.2019;18:58:05;83714375;83648333;66042;
03.02.2019;18:59:05;83714918;83648546;66372;
03.02.2019;19:00:05;83715438;83648735;66703;
03.02.2019;19:01:05;83715966;83648913;67053;
03.02.2019;19:02:04;83716520;83649039;67481;
03.02.2019;19:03:05;83717087;83649293;67794;
03.02.2019;19:04:05;83717607;83649495;68112;
03.02.2019;19:05:06;83718141;83649657;68484;
03.02.2019;19:06:07;83718724;83649834;68890;
03.02.2019;19:07:05;83719246;83650004;69242;
03.02.2019;19:08:05;83719723;83650203;69520;
03.02.2019;19:09:06;83720442;83650386;70056;
03.02.2019;19:10:09;83721206;83650575;70631;
03.02.2019;19:11:05;83721873;83650735;71138;
03.02.2019;19:12:05;83723858;83650903;72955;
03.02.2019;19:13:04;83725334;83651054;74280;
03.02.2019;19:14:05;83726387;83651231;75156;
03.02.2019;19:15:06;83727211;83651436;75775;
03.02.2019;19:16:06;83727948;83651618;76330;
03.02.2019;19:17:06;83728654;83651793;76861;
03.02.2019;19:18:05;83729328;83651916;77412;
03.02.2019;19:19:05;83729950;83652069;77881;
03.02.2019;19:20:05;83730583;83652231;78352;
03.02.2019;19:21:06;83731220;83652381;78839;
03.02.2019;19:22:05;83731818;83652551;79267;
03.02.2019;19:23:05;83732379;83652768;79611;
03.02.2019;19:24:05;83732980;83652940;80040;
03.02.2019;19:25:05;83733603;83653090;80513;
03.02.2019;19:26:05;83734250;83653238;81012;
03.02.2019;19:27:06;83734901;83653382;81519;
03.02.2019;19:28:05;83735460;83653529;81931;
03.02.2019;19:29:05;83736117;83653739;82378;
03.02.2019;19:30:05;83737014;83653916;83098;
03.02.2019;19:31:10;83737706;83654084;83622;
03.02.2019;19:32:05;83738454;83654221;84233;
03.02.2019;19:33:04;83739283;83654364;84919;
03.02.2019;19:34:05;83739920;83654507;85413;
03.02.2019;19:35:04;83740512;83654662;85850;
03.02.2019;19:36:06;83741084;83654813;86271;
03.02.2019;19:37:10;83741650;83655003;86647;
03.02.2019;19:38:05;83742073;83655166;86907;
03.02.2019;19:39:05;83742579;83655312;87267;
03.02.2019;19:40:05;83743119;83655452;87667;
03.02.2019;19:41:04;83743639;83655621;88018;
03.02.2019;19:42:06;83744208;83655757;88451;
03.02.2019;19:43:08;83744565;83655896;88669;
03.02.2019;19:44:05;83745170;83656022;89148;
03.02.2019;19:45:05;83745579;83656164;89415;
03.02.2019;19:46:05;83746066;83656269;89797;
03.02.2019;19:47:06;83746427;83656361;90066;
03.02.2019;19:48:05;83746735;83656501;90234;
03.02.2019;19:49:05;83747193;83656649;90544;
03.02.2019;19:50:04;83747594;83656771;90823;
03.02.2019;19:51:05;83748044;83656889;91155;
03.02.2019;19:52:05;83748465;83657022;91443;
03.02.2019;19:53:04;83748835;83657141;91694;
03.02.2019;19:54:04;83749203;83657278;91925;
03.02.2019;19:55:05;83749557;83657380;92177;
03.02.2019;19:56:05;83749913;83657509;92404;
03.02.2019;19:57:04;83750245;83657610;92635;
03.02.2019;19:58:05;83750560;83657732;92828;
03.02.2019;19:59:05;83750853;83657831;93022;
03.02.2019;20:00:05;83751214;83657916;93298;
03.02.2019;20:01:05;83751480;83658029;93451;
03.02.2019;20:02:05;83751793;83658179;93614;
03.02.2019;20:03:04;83752138;83658302;93836;
03.02.2019;20:04:05;83752489;83658420;94069;
03.02.2019;20:05:05;83752816;83658533;94283;
03.02.2019;20:06:05;83753208;83658645;94563;
03.02.2019;20:07:05;83753506;83658755;94751;
03.02.2019;20:08:05;83753861;83658874;94987;
03.02.2019;20:09:05;83754206;83659017;95189;
03.02.2019;20:10:05;83754544;83659113;95431;
03.02.2019;20:11:05;83754904;83659245;95659;
03.02.2019;20:12:05;83755284;83659358;95926;
03.02.2019;20:13:05;83755625;83659481;96144;
03.02.2019;20:14:05;83755951;83659605;96346;
03.02.2019;20:15:05;83755921;83659684;96237;
03.02.2019;20:16:05;83756171;83659738;96433;
03.02.2019;20:17:04;83756210;83659764;96446;
03.02.2019;20:18:04;83756265;83659828;96437;
03.02.2019;20:19:05;83756303;83659880;96423;
03.02.2019;20:20:05;83756301;83659952;96349;
03.02.2019;20:21:05;83756347;83659995;96352;
03.02.2019;20:22:05;83756369;83660060;96309;
03.02.2019;20:23:05;83756428;83660119;96309;
03.02.2019;20:24:04;83756493;83660186;96307;
03.02.2019;20:25:04;83756551;83660267;96284;
03.02.2019;20:26:04;83756651;83660308;96343;
03.02.2019;20:27:05;83756751;83660415;96336;
03.02.2019;20:28:04;83756898;83660492;96406;
03.02.2019;20:29:04;83757005;83660549;96456;
03.02.2019;20:30:04;83757107;83660625;96482;
03.02.2019;20:31:05;83757257;83660700;96557;
03.02.2019;20:32:05;83757401;83660777;96624;
03.02.2019;20:33:04;83757511;83660815;96696;
03.02.2019;20:34:05;83757717;83660904;96813;
03.02.2019;20:35:05;83757884;83660961;96923;
03.02.2019;20:36:05;83758091;83661031;97060;
03.02.2019;20:37:05;83758299;83661116;97183;
03.02.2019;20:38:05;83758549;83661200;97349;
03.02.2019;20:39:05;83758774;83661262;97512;
03.02.2019;20:40:05;83759036;83661344;97692;
03.02.2019;20:41:05;83759267;83661413;97854;
03.02.2019;20:42:05;83759510;83661497;98013;
03.02.2019;20:43:04;83759781;83661580;98201;
03.02.2019;20:44:04;83760034;83661676;98358;
03.02.2019;20:45:04;83760265;83661771;98494;
03.02.2019;20:46:05;83760479;83661853;98626;
03.02.2019;20:47:05;83760727;83661930;98797;
03.02.2019;20:48:05;83760977;83662009;98968;
03.02.2019;20:49:05;83761266;83662086;99180;
03.02.2019;20:50:05;83761539;83662160;99379;
03.02.2019;20:51:05;83761876;83662241;99635;
03.02.2019;20:52:05;83762197;83662318;99879;
03.02.2019;20:53:05;83762501;83662408;100093;
03.02.2019;20:54:06;83762834;83662492;100342;
03.02.2019;20:55:05;83763148;83662581;100567;
03.02.2019;20:56:10;83763476;83662655;100821;
03.02.2019;20:57:04;83763789;83662726;101063;
03.02.2019;20:58:04;83764091;83662797;101294;
03.02.2019;20:59:05;83764415;83662852;101563;
03.02.2019;21:00:04;83764648;83662950;101698;
03.02.2019;21:01:04;83765058;83663023;102035;
03.02.2019;21:02:06;83765390;83663074;102316;
03.02.2019;21:03:05;83765715;83663131;102584;
03.02.2019;21:04:05;83766004;83663193;102811;
03.02.2019;21:05:05;83766295;83663269;103026;
03.02.2019;21:06:05;83766617;83663323;103294;
03.02.2019;21:07:05;83766943;83663401;103542;
03.02.2019;21:08:05;83767225;83663488;103737;
03.02.2019;21:09:05;83767523;83663576;103947;
03.02.2019;21:10:05;83767832;83663670;104162;
03.02.2019;21:11:05;83768138;83663748;104390;
03.02.2019;21:12:05;83768433;83663810;104623;
03.02.2019;21:13:05;83768706;83663892;104814;
03.02.2019;21:14:05;83768965;83663965;105000;
03.02.2019;21:15:05;83769236;83664054;105182;
03.02.2019;21:16:05;83769498;83664130;105368;
03.02.2019;21:17:05;83769775;83664190;105585;
03.02.2019;21:18:05;83770043;83664273;105770;
03.02.2019;21:19:05;83770284;83664322;105962;
03.02.2019;21:20:05;83770593;83664387;106206;
03.02.2019;21:21:05;83770899;83664458;106441;
03.02.2019;21:22:05;83771174;83664522;106652;
03.02.2019;21:23:05;83771403;83664582;106821;
03.02.2019;21:24:10;83771691;83664658;107033;
03.02.2019;21:25:05;83771980;83664704;107276;
03.02.2019;21:26:05;83772241;83664765;107476;
03.02.2019;21:27:05;83772533;83664828;107705;
03.02.2019;21:28:05;83772846;83664901;107945;
03.02.2019;21:29:05;83773116;83664965;108151;
03.02.2019;21:30:05;83771455;83665011;106444;
03.02.2019;21:31:05;83771759;83665071;106688;
03.02.2019;21:32:05;83772019;83674416;97603;
03.02.2019;21:33:05;83772330;83674488;97842;
03.02.2019;21:34:04;83772646;83674555;98091;
03.02.2019;21:35:04;83772905;83674617;98288;
03.02.2019;21:36:05;83773194;83674680;98514;
03.02.2019;21:37:04;83773441;83674733;98708;
03.02.2019;21:38:06;83773745;83674793;98952;
03.02.2019;21:39:08;83774007;83674860;99147;
03.02.2019;21:40:09;83774309;83674925;99384;
03.02.2019;21:41:04;83774513;83674956;99557;
03.02.2019;21:42:04;83774709;83674974;99735;
03.02.2019;21:43:06;83775043;83675024;100019;
03.02.2019;21:44:05;83775324;83675090;100234;
03.02.2019;21:45:05;83775591;83675142;100449;
03.02.2019;21:46:04;83775851;83675190;100661;
03.02.2019;21:47:04;83776145;83675246;100899;
03.02.2019;21:48:05;83776387;83675307;101080;
03.02.2019;21:49:05;83776673;83675361;101312;
03.02.2019;21:50:05;83776966;83675412;101554;
03.02.2019;21:51:05;83777236;83675467;101769;
03.02.2019;21:52:05;83777547;83675532;102015;
03.02.2019;21:53:06;83777814;83675586;102228;
03.02.2019;21:54:05;83778072;83675636;102436;
03.02.2019;21:55:04;83778338;83675683;102655;
03.02.2019;21:56:04;83778623;83675745;102878;
03.02.2019;21:57:05;83778881;83675800;103081;
03.02.2019;21:58:04;83779151;83675856;103295;
03.02.2019;21:59:05;83779406;83675909;103497;
03.02.2019;22:00:05;83779697;83675948;103749;
03.02.2019;22:01:05;83779961;83676020;103941;
03.02.2019;22:02:05;83780225;83676068;104157;
03.02.2019;22:03:06;83780495;83676119;104376;
03.02.2019;22:04:05;83780765;83676175;104590;
03.02.2019;22:05:10;83781042;83676234;104808;
03.02.2019;22:06:05;83781286;83676274;105012;
03.02.2019;22:07:04;83781507;83676314;105193;
03.02.2019;22:08:04;83781786;83676359;105427;
03.02.2019;22:09:06;83782060;83676411;105649;
03.02.2019;22:10:05;83782324;83676450;105874;
03.02.2019;22:11:05;83782546;83676502;106044;
03.02.2019;22:12:05;83782673;83676549;106124;
03.02.2019;22:13:05;83782784;83676574;106210;
03.02.2019;22:14:05;83782897;83676617;106280;
03.02.2019;22:15:05;83782844;83676625;106219;
03.02.2019;22:16:05;83782842;83676651;106191;
03.02.2019;22:17:05;83782856;83676679;106177;
03.02.2019;22:18:05;83782874;83676682;106192;
03.02.2019;22:19:05;83782863;83676712;106151;
03.02.2019;22:20:04;83782855;83676738;106117;
03.02.2019;22:21:05;83782909;83676759;106150;
03.02.2019;22:22:05;83782971;83676764;106207;
03.02.2019;22:23:05;83782983;83676804;106179;
03.02.2019;22:24:05;83782992;83676816;106176;
03.02.2019;22:25:05;83783032;83676829;106203;
03.02.2019;22:26:05;83783073;83676870;106203;
03.02.2019;22:27:05;83783120;83676901;106219;
03.02.2019;22:28:05;83783233;83676941;106292;
03.02.2019;22:29:04;83783348;83676993;106355;
03.02.2019;22:30:05;83783473;83677037;106436;
03.02.2019;22:31:06;83783576;83677048;106528;
03.02.2019;22:32:10;83783735;83677084;106651;
03.02.2019;22:33:06;83783861;83677099;106762;
03.02.2019;22:34:09;83784021;83677127;106894;
03.02.2019;22:35:05;83784149;83677157;106992;
03.02.2019;22:36:05;83784260;83677198;107062;
03.02.2019;22:37:04;83784394;83677231;107163;
03.02.2019;22:38:04;83784597;83677256;107341;
03.02.2019;22:39:05;83784759;83677288;107471;
03.02.2019;22:40:06;83784925;83677311;107614;
03.02.2019;22:42:05;83785312;83677393;107919;
03.02.2019;22:43:05;83785559;83677433;108126;
03.02.2019;22:44:05;83785808;83677461;108347;
03.02.2019;22:45:05;83786008;83677496;108512;
03.02.2019;22:46:05;83786265;83677523;108742;
03.02.2019;22:47:05;83786499;83677563;108936;
03.02.2019;22:48:05;83786711;83677609;109102;
03.02.2019;22:49:05;83786958;83677643;109315;
03.02.2019;22:50:05;83787169;83677668;109501;
03.02.2019;22:51:05;83787364;83677713;109651;
03.02.2019;22:52:05;83787623;83677757;109866;
03.02.2019;22:53:05;83787847;83677800;110047;
03.02.2019;22:54:04;83788046;83677839;110207;
03.02.2019;22:55:05;83788247;83677867;110380;
03.02.2019;22:56:06;83788438;83677905;110533;
03.02.2019;22:57:05;83788673;83677938;110735;
03.02.2019;22:58:05;83788885;83677974;110911;
03.02.2019;22:59:05;83789095;83678012;111083;
03.02.2019;23:00:05;83789333;83678051;111282;
03.02.2019;23:01:05;83789550;83678090;111460;
03.02.2019;23:02:04;83789775;83678128;111647;
03.02.2019;23:03:05;83789973;83678162;111811;
03.02.2019;23:04:04;83790199;83678204;111995;
03.02.2019;23:05:04;83790417;83678244;112173;
03.02.2019;23:06:05;83790638;83678284;112354;
03.02.2019;23:07:05;83790865;83678303;112562;
03.02.2019;23:08:06;83791087;83678357;112730;
03.02.2019;23:09:05;83791215;83678393;112822;
03.02.2019;23:10:05;83791492;83678414;113078;
03.02.2019;23:11:04;83791687;83678437;113250;
03.02.2019;23:12:05;83791869;83678467;113402;
03.02.2019;23:13:07;83792065;83678501;113564;
03.02.2019;23:14:10;83792285;83678532;113753;
03.02.2019;23:15:05;83792465;83678567;113898;
03.02.2019;23:16:05;83792654;83678603;114051;
03.02.2019;23:17:05;83792848;83678634;114214;
03.02.2019;23:18:04;83793047;83678681;114366;
03.02.2019;23:19:04;83793245;83678712;114533;
03.02.2019;23:20:05;83793464;83678739;114725;
03.02.2019;23:21:05;83793652;83678773;114879;
03.02.2019;23:22:05;83793830;83678803;115027;
03.02.2019;23:23:06;83794012;83678853;115159;
03.02.2019;23:24:10;83794218;83678872;115346;
03.02.2019;23:25:05;83794415;83678913;115502;
03.02.2019;23:26:05;83794627;83678957;115670;
03.02.2019;23:27:05;83794808;83679007;115801;
03.02.2019;23:28:05;83795057;83679042;116015;
03.02.2019;23:29:04;83795251;83679083;116168;
03.02.2019;23:30:08;83795453;83679117;116336;
03.02.2019;23:31:04;83795636;83679147;116489;
03.02.2019;23:32:05;83795810;83679177;116633;
03.02.2019;23:33:05;83795989;83679219;116770;
03.02.2019;23:34:05;83796162;83679241;116921;
03.02.2019;23:35:05;83796337;83679273;117064;
03.02.2019;23:36:04;83796506;83679308;117198;
03.02.2019;23:37:04;83796709;83679354;117355;
03.02.2019;23:38:05;83796891;83679370;117521;
03.02.2019;23:39:06;83797078;83679419;117659;
03.02.2019;23:40:04;83797253;83679444;117809;
03.02.2019;23:41:04;83797426;83679490;117936;
03.02.2019;23:42:04;83797611;83679524;118087;
03.02.2019;23:43:05;83797803;83679572;118231;
03.02.2019;23:44:04;83797943;83679600;118343;
03.02.2019;23:45:04;83798122;83679640;118482;
03.02.2019;23:46:05;83798330;83679665;118665;
03.02.2019;23:47:05;83798533;83679686;118847;
03.02.2019;23:48:05;83798725;83679717;119008;
03.02.2019;23:49:05;83798905;83679737;119168;
03.02.2019;23:50:05;83799096;83679770;119326;
03.02.2019;23:51:06;83799256;83679808;119448;
03.02.2019;23:52:05;83799480;83679831;119649;
03.02.2019;23:53:05;83799639;83679862;119777;
03.02.2019;23:54:04;83799799;83679889;119910;
03.02.2019;23:55:05;83799991;83679920;120071;
03.02.2019;23:56:04;83800191;83679959;120232;
03.02.2019;23:57:04;83800385;83679991;120394;
03.02.2019;23:58:05;83800562;83680029;120533;
03.02.2019;23:59:05;83800754;83680058;120696;
04.02.2019;00:00:07;83800969;83680094;120875;
04.02.2019;00:01:08;83801169;83680133;121036;
04.02.2019;00:02:08;83801360;83680174;121186;
04.02.2019;00:03:07;83801524;83680209;121315;
04.02.2019;00:04:06;83801732;83680235;121497;
04.02.2019;00:05:08;83801922;83680257;121665;
04.02.2019;00:06:07;83802111;83680297;121814;
04.02.2019;00:07:10;83802283;83680332;121951;
04.02.2019;00:08:08;83802489;83680350;122139;
04.02.2019;00:09:08;83802692;83680387;122305;
04.02.2019;00:10:07;83802863;83680404;122459;
04.02.2019;00:11:07;83803029;83680439;122590;
04.02.2019;00:12:07;83803206;83680475;122731;
04.02.2019;00:13:08;83803312;83680502;122810;
04.02.2019;00:14:07;83803332;83680522;122810;
04.02.2019;00:15:08;83803380;83680541;122839;
04.02.2019;00:16:08;83803425;83680554;122871;
04.02.2019;00:17:07;83803499;83680554;122945;
04.02.2019;00:18:08;83803587;83680574;123013;
04.02.2019;00:19:07;83803703;83680592;123111;
04.02.2019;00:20:08;83803757;83680631;123126;
04.02.2019;00:21:07;83803839;83680649;123190;
04.02.2019;00:22:09;83803933;83680674;123259;
04.02.2019;00:23:07;83803990;83680701;123289;
04.02.2019;00:24:08;83804062;83680730;123332;
04.02.2019;00:25:08;83804129;83680757;123372;
04.02.2019;00:26:07;83804254;83680779;123475;
04.02.2019;00:27:08;83804351;83680805;123546;
04.02.2019;00:28:09;83804474;83680830;123644;
04.02.2019;00:29:08;83804561;83680862;123699;
04.02.2019;00:30:08;83804662;83680882;123780;
04.02.2019;00:31:07;83804751;83680904;123847;
04.02.2019;00:32:07;83804872;83680935;123937;
04.02.2019;00:33:07;83805000;83680962;124038;
04.02.2019;00:34:08;83805136;83680987;124149;
04.02.2019;00:35:08;83805248;83681019;124229;
04.02.2019;00:36:08;83805376;83681053;124323;
04.02.2019;00:37:08;83805492;83681088;124404;
04.02.2019;00:38:08;83805610;83681107;124503;
04.02.2019;00:39:09;83805754;83681143;124611;
04.02.2019;00:40:08;83805895;83681173;124722;
04.02.2019;00:41:08;83806009;83681147;124862;
04.02.2019;00:42:08;83806170;83681170;125000;
04.02.2019;00:43:07;83806336;83681215;125121;
04.02.2019;00:44:08;83806500;83681249;125251;
04.02.2019;00:45:07;83806653;83681276;125377;
04.02.2019;00:46:07;83806818;83681300;125518;
04.02.2019;00:47:08;83806973;83681335;125638;
04.02.2019;00:48:08;83807115;83681374;125741;
04.02.2019;00:49:07;83807251;83681410;125841;
04.02.2019;00:50:06;83807436;83681444;125992;
04.02.2019;00:51:08;83807635;83681487;126148;
04.02.2019;00:52:07;83807814;83681511;126303;
04.02.2019;00:53:07;83807953;83681535;126418;
04.02.2019;00:54:07;83808117;83681564;126553;
04.02.2019;00:55:08;83808288;83681580;126708;
04.02.2019;00:56:13;83808444;83681615;126829;
04.02.2019;00:57:09;83808659;83681644;127015;
04.02.2019;00:58:08;83808812;83681682;127130;
04.02.2019;00:59:07;83808996;83681696;127300;
04.02.2019;01:00:04;83809190;83681736;127454;
04.02.2019;01:01:05;83809342;83681777;127565;
04.02.2019;01:02:05;83809515;83681796;127719;
04.02.2019;01:03:04;83809685;83681830;127855;
04.02.2019;01:04:05;83809885;83681866;128019;
04.02.2019;01:05:05;83810047;83681909;128138;
04.02.2019;01:06:04;83810219;83681945;128274;
04.02.2019;01:07:05;83810430;83681981;128449;
04.02.2019;01:08:04;83810602;83682030;128572;
04.02.2019;01:09:05;83810790;83682070;128720;
04.02.2019;01:10:04;83810980;83682110;128870;
04.02.2019;01:11:04;83811184;83682164;129020;
04.02.2019;01:12:05;83811354;83682210;129144;
04.02.2019;01:13:05;83811527;83682244;129283;
04.02.2019;01:14:05;83811730;83682281;129449;
04.02.2019;01:15:05;83811929;83682303;129626;
04.02.2019;01:16:04;83812127;83682326;129801;
04.02.2019;01:17:04;83812294;83682370;129924;
04.02.2019;01:18:05;83812467;83682408;130059;
04.02.2019;01:19:05;83812646;83682442;130204;
04.02.2019;01:20:05;83812837;83682483;130354;
04.02.2019;01:21:04;83813042;83682521;130521;
04.02.2019;01:22:05;83813234;83682555;130679;
04.02.2019;01:23:04;83813421;83682605;130816;
04.02.2019;01:24:05;83813609;83682643;130966;
04.02.2019;01:25:05;83813803;83682691;131112;
04.02.2019;01:26:05;83813978;83682727;131251;
04.02.2019;01:27:04;83814164;83682787;131377;
04.02.2019;01:28:04;83814397;83682820;131577;
04.02.2019;01:29:05;83814613;83682867;131746;
04.02.2019;01:30:04;83814794;83682909;131885;
04.02.2019;01:31:05;83814957;83682948;132009;
04.02.2019;01:32:04;83815134;83682983;132151;
04.02.2019;01:33:05;83815299;83683030;132269;
04.02.2019;01:34:05;83815502;83683088;132414;
04.02.2019;01:35:05;83815675;83683144;132531;
04.02.2019;01:36:05;83815874;83683189;132685;
04.02.2019;01:37:04;83816063;83683246;132817;
04.02.2019;01:38:04;83816269;83683284;132985;
04.02.2019;01:39:05;83816474;83683339;133135;
04.02.2019;01:40:04;83816676;83683382;133294;
04.02.2019;01:41:05;83816886;83683434;133452;
04.02.2019;01:42:05;83817073;83683487;133586;
04.02.2019;01:43:05;83817277;83683529;133748;
04.02.2019;01:44:05;83817483;83683561;133922;
04.02.2019;01:45:05;83817696;83683592;134104;
04.02.2019;01:46:05;83817892;83683646;134246;
04.02.2019;01:47:04;83818093;83683693;134400;
04.02.2019;01:48:04;83818314;83683746;134568;
04.02.2019;01:49:04;83818501;83683806;134695;
04.02.2019;01:50:05;83818706;83683843;134863;
04.02.2019;01:51:06;83818899;83683893;135006;
04.02.2019;01:52:05;83819100;83683939;135161;
04.02.2019;01:53:04;83819315;83683987;135328;
04.02.2019;01:54:05;83819488;83684055;135433;
04.02.2019;01:55:05;83819661;83684103;135558;
04.02.2019;01:56:05;83819860;83684160;135700;
04.02.2019;01:57:05;83820048;83684217;135831;
04.02.2019;01:58:04;83820245;83684271;135974;
04.02.2019;01:59:04;83820438;83684323;136115;
04.02.2019;02:00:05;83820628;83684382;136246;
04.02.2019;02:01:12;83820850;83684458;136392;
04.02.2019;02:02:04;83821062;83684504;136558;
04.02.2019;02:03:05;83821281;83684569;136712;
04.02.2019;02:04:04;83821504;83684632;136872;
04.02.2019;02:05:05;83821742;83684704;137038;
04.02.2019;02:06:04;83821940;83684772;137168;
04.02.2019;02:07:04;83822094;83684856;137238;
04.02.2019;02:08:05;83822294;83684923;137371;
04.02.2019;02:09:06;83822502;83684955;137547;
04.02.2019;02:10:05;83822655;83685016;137639;
04.02.2019;02:11:05;83822815;83685070;137745;
04.02.2019;02:12:04;83822899;83685121;137778;
04.02.2019;02:13:04;83823020;83685198;137822;
04.02.2019;02:14:05;83823040;83685222;137818;
04.02.2019;02:15:04;83823120;83685317;137803;
04.02.2019;02:16:05;83823205;83685368;137837;
04.02.2019;02:17:05;83823231;83685434;137797;
04.02.2019;02:18:04;83823329;83685483;137846;
04.02.2019;02:19:05;83823410;83685555;137855;
04.02.2019;02:20:04;83823525;83685621;137904;
04.02.2019;02:21:05;83823660;83685687;137973;
04.02.2019;02:22:04;83823793;83685758;138035;
04.02.2019;02:23:04;83823900;83685832;138068;
04.02.2019;02:24:05;83824055;83685909;138146;
04.02.2019;02:25:04;83824230;83685973;138257;
04.02.2019;02:26:04;83824398;83686060;138338;
04.02.2019;02:27:05;83824607;83686140;138467;
04.02.2019;02:28:05;83824834;83686218;138616;
04.02.2019;02:29:05;83825058;83686298;138760;
04.02.2019;02:30:05;83825256;83686368;138888;
04.02.2019;02:31:04;83825466;83686442;139024;
04.02.2019;02:32:04;83825676;83686527;139149;
04.02.2019;02:33:05;83825904;83686589;139315;
04.02.2019;02:34:05;83826117;83686685;139432;
04.02.2019;02:35:05;83826337;83686772;139565;
04.02.2019;02:36:05;83826523;83686879;139644;
04.02.2019;02:37:04;83826705;83686957;139748;
04.02.2019;02:38:04;83826914;83687044;139870;
04.02.2019;02:39:06;83827095;83687131;139964;
04.02.2019;02:40:05;83827279;83687236;140043;
04.02.2019;02:41:05;83827461;83687314;140147;
04.02.2019;02:42:05;83827654;83687395;140259;
04.02.2019;02:43:05;83827846;83687465;140381;
04.02.2019;02:44:05;83828051;83687555;140496;
04.02.2019;02:45:04;83828279;83687658;140621;
04.02.2019;02:46:04;83828473;83687745;140728;
04.02.2019;02:47:05;83828688;83687864;140824;
04.02.2019;02:48:05;83828900;83687938;140962;
04.02.2019;02:49:05;83829076;83688028;141048;
04.02.2019;02:50:04;83829277;83688106;141171;
04.02.2019;02:51:05;83829503;83688191;141312;
04.02.2019;02:52:05;83829727;83688284;141443;
04.02.2019;02:53:04;83829944;83688364;141580;
04.02.2019;02:54:04;83830152;83688444;141708;
04.02.2019;02:55:05;83830378;83688550;141828;
04.02.2019;02:56:05;83830590;83688649;141941;
04.02.2019;02:57:04;83830804;83688752;142052;
04.02.2019;02:58:04;83831019;83688850;142169;
04.02.2019;02:59:05;83831218;83688946;142272;
04.02.2019;03:00:05;83831393;83689071;142322;
04.02.2019;03:01:05;83831618;83689170;142448;
04.02.2019;03:02:04;83831825;83689269;142556;
04.02.2019;03:03:05;83832017;83689364;142653;
04.02.2019;03:04:04;83832184;83689476;142708;
04.02.2019;03:05:04;83832337;83689572;142765;
04.02.2019;03:06:05;83832547;83689686;142861;
04.02.2019;03:07:05;83832744;83689783;142961;
04.02.2019;03:08:05;83832919;83689886;143033;
04.02.2019;03:09:06;83833110;83689971;143139;
04.02.2019;03:10:05;83833306;83690047;143259;
04.02.2019;03:11:04;83833478;83690161;143317;
04.02.2019;03:12:04;83833681;83690254;143427;
04.02.2019;03:13:05;83833908;83690375;143533;
04.02.2019;03:14:04;83834093;83690486;143607;
04.02.2019;03:15:05;83834294;83690598;143696;
04.02.2019;03:16:04;83834477;83690711;143766;
04.02.2019;03:17:05;83834661;83690814;143847;
04.02.2019;03:18:05;83834847;83690922;143925;
04.02.2019;03:19:05;83835053;83691038;144015;
04.02.2019;03:20:05;83835221;83691131;144090;
04.02.2019;03:21:04;83835396;83691234;144162;
04.02.2019;03:22:04;83835586;83691332;144254;
04.02.2019;03:23:05;83835779;83691449;144330;
04.02.2019;03:24:04;83835950;83691567;144383;
04.02.2019;03:25:05;83836103;83691662;144441;
04.02.2019;03:26:05;83836252;83691796;144456;
04.02.2019;03:27:05;83836402;83691892;144510;
04.02.2019;03:28:04;83836571;83692017;144554;
04.02.2019;03:29:04;83836731;83692105;144626;
04.02.2019;03:30:05;83836919;83692221;144698;
04.02.2019;03:31:04;83837133;83692333;144800;
04.02.2019;03:32:04;83837322;83692450;144872;
04.02.2019;03:33:04;83837499;83692554;144945;
04.02.2019;03:34:05;83837671;83692656;145015;
04.02.2019;03:35:04;83837835;83692778;145057;
04.02.2019;03:36:04;83837974;83692875;145099;
04.02.2019;03:37:04;83838166;83692982;145184;
04.02.2019;03:38:04;83838336;83693090;145246;
04.02.2019;03:39:06;83838499;83693225;145274;
04.02.2019;03:40:05;83838695;83693331;145364;
04.02.2019;03:41:05;83838855;83693449;145406;
04.02.2019;03:42:04;83838999;83693532;145467;
04.02.2019;03:43:05;83839166;83693646;145520;
04.02.2019;03:44:04;83839334;83693773;145561;
04.02.2019;03:45:05;83839526;83693885;145641;
04.02.2019;03:46:04;83839702;83693990;145712;
04.02.2019;03:47:04;83839900;83694145;145755;
04.02.2019;03:48:05;83840099;83694263;145836;
04.02.2019;03:49:04;83840245;83694407;145838;
04.02.2019;03:50:04;83840447;83694541;145906;
04.02.2019;03:51:04;83840613;83694645;145968;
04.02.2019;03:52:05;83840800;83694773;146027;
04.02.2019;03:53:05;83840968;83694882;146086;
04.02.2019;03:54:04;83841136;83695004;146132;
04.02.2019;03:55:04;83841291;83695111;146180;
04.02.2019;03:56:05;83841467;83695241;146226;
04.02.2019;03:57:04;83841673;83695364;146309;
04.02.2019;03:58:04;83841853;83695485;146368;
04.02.2019;03:59:04;83842001;83695610;146391;
04.02.2019;04:00:05;83842134;83695769;146365;
04.02.2019;04:01:05;83842284;83695906;146378;
04.02.2019;04:02:04;83842458;83696051;146407;
04.02.2019;04:03:04;83842594;83696164;146430;
04.02.2019;04:04:05;83842732;83696291;146441;
04.02.2019;04:05:04;83842922;83696415;146507;
04.02.2019;04:06:05;83843104;83696523;146581;
04.02.2019;04:07:04;83843193;83696632;146561;
04.02.2019;04:08:04;83843309;83696748;146561;
04.02.2019;04:09:05;83843464;83696845;146619;
04.02.2019;04:10:05;83843579;83696969;146610;
04.02.2019;04:11:04;83843689;83697082;146607;
04.02.2019;04:12:04;83843789;83697200;146589;
04.02.2019;04:13:05;83843913;83697341;146572;
04.02.2019;04:14:04;83844033;83697471;146562;
04.02.2019;04:15:04;83844144;83697583;146561;
04.02.2019;04:16:05;83844269;83697702;146567;
04.02.2019;04:17:05;83844358;83697795;146563;
04.02.2019;04:18:05;83844459;83697941;146518;
04.02.2019;04:19:04;83844558;83698077;146481;
04.02.2019;04:20:05;83844692;83698203;146489;
04.02.2019;04:21:04;83844832;83698343;146489;
04.02.2019;04:22:04;83844976;83698451;146525;
04.02.2019;04:23:05;83845119;83698559;146560;
04.02.2019;04:24:05;83845292;83698682;146610;
04.02.2019;04:25:05;83845423;83698824;146599;
04.02.2019;04:26:04;83845587;83698943;146644;
04.02.2019;04:27:04;83845727;83699075;146652;
04.02.2019;04:28:05;83845875;83699207;146668;
04.02.2019;04:29:05;83846048;83699341;146707;
04.02.2019;04:30:05;83846205;83699486;146719;
04.02.2019;04:31:04;83846349;83699626;146723;
04.02.2019;04:32:04;83846489;83699752;146737;
04.02.2019;04:33:05;83846630;83699883;146747;
04.02.2019;04:34:04;83846800;83700031;146769;
04.02.2019;04:35:05;83846975;83700159;146816;
04.02.2019;04:36:04;83847148;83700280;146868;
04.02.2019;04:37:04;83847311;83700414;146897;
04.02.2019;04:38:05;83847477;83700538;146939;
04.02.2019;04:39:04;83847637;83700645;146992;
04.02.2019;04:40:05;83847814;83700762;147052;
04.02.2019;04:41:05;83847964;83700900;147064;
04.02.2019;04:42:04;83848124;83701012;147112;
04.02.2019;04:43:05;83848288;83701154;147134;
04.02.2019;04:44:05;83848465;83701282;147183;
04.02.2019;04:45:04;83848636;83701408;147228;
04.02.2019;04:46:05;83848777;83701550;147227;
04.02.2019;04:47:05;83848918;83701682;147236;
04.02.2019;04:48:04;83849067;83701799;147268;
04.02.2019;04:49:04;83849220;83701917;147303;
04.02.2019;04:50:04;83849396;83702035;147361;
04.02.2019;04:51:05;83849540;83702160;147380;
04.02.2019;04:52:05;83849696;83702275;147421;
04.02.2019;04:53:04;83849852;83702401;147451;
04.02.2019;04:54:04;83850008;83702539;147469;
04.02.2019;04:55:05;83850136;83702652;147484;
04.02.2019;04:56:04;83850291;83702797;147494;
04.02.2019;04:57:04;83850436;83702901;147535;
04.02.2019;04:58:05;83850607;83703026;147581;
04.02.2019;04:59:05;83850757;83703160;147597;
04.02.2019;05:00:04;83850894;83703287;147607;
04.02.2019;05:01:04;83851046;83703412;147634;
04.02.2019;05:02:05;83851235;83703558;147677;
04.02.2019;05:03:05;83851415;83703685;147730;
04.02.2019;05:04:04;83851573;83703801;147772;
04.02.2019;05:05:04;83851730;83703929;147801;
04.02.2019;05:06:05;83851871;83704071;147800;
04.02.2019;05:07:04;83852023;83704196;147827;
04.02.2019;05:08:04;83852143;83704319;147824;
04.02.2019;05:09:07;83852310;83704415;147895;
04.02.2019;05:10:05;83852445;83704575;147870;
04.02.2019;05:11:04;83852602;83704710;147892;
04.02.2019;05:12:05;83852747;83704853;147894;
04.02.2019;05:13:05;83852898;83704978;147920;
04.02.2019;05:14:04;83853083;83705113;147970;
04.02.2019;05:15:05;83853225;83705232;147993;
04.02.2019;05:16:05;83853389;83705332;148057;
04.02.2019;05:17:05;83853534;83705459;148075;
04.02.2019;05:18:04;83853703;83705578;148125;
04.02.2019;05:19:04;83853851;83705707;148144;
04.02.2019;05:20:05;83853988;83705837;148151;
04.02.2019;05:21:05;83854165;83705972;148193;
04.02.2019;05:22:04;83854326;83706125;148201;
04.02.2019;05:23:04;83854462;83706242;148220;
04.02.2019;05:24:05;83854609;83706385;148224;
04.02.2019;05:25:05;83854772;83706519;148253;
04.02.2019;05:26:04;83854932;83706637;148295;
04.02.2019;05:27:04;83855048;83706778;148270;
04.02.2019;05:28:04;83855235;83706904;148331;
04.02.2019;05:29:05;83855404;83707040;148364;
04.02.2019;05:30:04;83855541;83707210;148331;
04.02.2019;05:31:05;83855696;83707327;148369;
04.02.2019;05:32:05;83855866;83707444;148422;
04.02.2019;05:33:04;83856023;83707570;148453;
04.02.2019;05:34:04;83856152;83707718;148434;
04.02.2019;05:35:04;83856285;83707835;148450;
04.02.2019;05:36:05;83856434;83708006;148428;
04.02.2019;05:37:04;83856599;83708129;148470;
04.02.2019;05:38:04;83856767;83708259;148508;
04.02.2019;05:39:05;83856913;83708405;148508;
04.02.2019;05:40:04;83857069;83708540;148529;
04.02.2019;05:41:04;83857216;83708659;148557;
04.02.2019;05:42:04;83857354;83708792;148562;
04.02.2019;05:43:05;83857492;83708928;148564;
04.02.2019;05:44:05;83857643;83709035;148608;
04.02.2019;05:45:04;83857811;83709147;148664;
04.02.2019;05:46:05;83857945;83709287;148658;
04.02.2019;05:47:05;83858078;83709416;148662;
04.02.2019;05:48:04;83858227;83709561;148666;
04.02.2019;05:49:04;83858380;83709690;148690;
04.02.2019;05:50:05;83858539;83709832;148707;
04.02.2019;05:51:04;83858683;83709963;148720;
04.02.2019;05:52:04;83858814;83710089;148725;
04.02.2019;05:53:05;83858955;83710216;148739;
04.02.2019;05:54:04;83859095;83710339;148756;
04.02.2019;05:55:04;83859227;83710477;148750;
04.02.2019;05:56:05;83859366;83710608;148758;
04.02.2019;05:57:04;83859483;83710745;148738;
04.02.2019;05:58:04;83859611;83710868;148743;
04.02.2019;05:59:05;83859766;83710992;148774;
04.02.2019;06:00:04;83859896;83711112;148784;
04.02.2019;06:01:04;83860038;83711239;148799;
04.02.2019;06:02:05;83860171;83711374;148797;
04.02.2019;06:03:04;83860304;83711514;148790;
04.02.2019;06:04:04;83860462;83711654;148808;
04.02.2019;06:05:05;83860618;83711776;148842;
04.02.2019;06:06:04;83860756;83711902;148854;
04.02.2019;06:07:04;83860866;83712030;148836;
04.02.2019;06:08:05;83861008;83712169;148839;
04.02.2019;06:09:07;83861143;83712298;148845;
04.02.2019;06:10:04;83861209;83712405;148804;
04.02.2019;06:11:05;83861308;83712511;148797;
04.02.2019;06:12:05;83861382;83712631;148751;
04.02.2019;06:13:04;83861466;83712742;148724;
04.02.2019;06:14:04;83861545;83712839;148706;
04.02.2019;06:15:05;83861622;83712953;148669;
04.02.2019;06:16:05;83861700;83713077;148623;
04.02.2019;06:17:05;83861783;83713216;148567;
04.02.2019;06:18:04;83861901;83713320;148581;
04.02.2019;06:19:04;83861989;83713454;148535;
04.02.2019;06:20:05;83862071;83713557;148514;
04.02.2019;06:21:05;83862152;83713644;148508;
04.02.2019;06:22:04;83862267;83713769;148498;
04.02.2019;06:23:05;83862321;83713891;148430;
04.02.2019;06:24:05;83862394;83713999;148395;
04.02.2019;06:25:08;83862472;83714140;148332;
04.02.2019;06:26:04;83862582;83714266;148316;
04.02.2019;06:27:04;83862675;83714397;148278;
04.02.2019;06:28:05;83862783;83714550;148233;
04.02.2019;06:29:04;83862918;83714687;148231;
04.02.2019;06:30:04;83863051;83714821;148230;
04.02.2019;06:31:04;83863181;83714953;148228;
04.02.2019;06:32:05;83863305;83715065;148240;
04.02.2019;06:33:05;83863426;83715150;148276;
04.02.2019;06:34:04;83863545;83715290;148255;
04.02.2019;06:35:04;83863663;83715443;148220;
04.02.2019;06:36:05;83863764;83715571;148193;
04.02.2019;06:37:04;83863913;83715676;148237;
04.02.2019;06:38:04;83863998;83715820;148178;
04.02.2019;06:39:07;83864117;83715926;148191;
04.02.2019;06:40:05;83864239;83716038;148201;
04.02.2019;06:41:05;83864343;83716173;148170;
04.02.2019;06:42:07;83864478;83716305;148173;
04.02.2019;06:43:04;83864622;83716444;148178;
04.02.2019;06:44:04;83864694;83716536;148158;
04.02.2019;06:45:05;83864831;83716665;148166;
04.02.2019;06:46:04;83864951;83716796;148155;
04.02.2019;06:47:04;83865076;83716937;148139;
04.02.2019;06:48:05;83865219;83717051;148168;
04.02.2019;06:49:05;83865351;83717176;148175;
04.02.2019;06:50:04;83865481;83717303;148178;
04.02.2019;06:51:07;83865606;83717438;148168;
04.02.2019;06:52:05;83865726;83717551;148175;
04.02.2019;06:53:05;83865841;83717681;148160;
04.02.2019;06:54:04;83865951;83717812;148139;
04.02.2019;06:55:04;83866083;83717938;148145;
04.02.2019;06:56:04;83866198;83718068;148130;
04.02.2019;06:57:05;83866333;83718215;148118;
04.02.2019;06:58:04;83866478;83718375;148103;
04.02.2019;06:59:04;83866635;83718503;148132;
04.02.2019;07:00:05;83866772;83718631;148141;
04.02.2019;07:01:05;83866897;83718779;148118;
04.02.2019;07:02:05;83867004;83718906;148098;
04.02.2019;07:03:04;83867127;83719019;148108;
04.02.2019;07:04:04;83867229;83719166;148063;
04.02.2019;07:05:04;83867334;83719294;148040;
04.02.2019;07:06:08;83867473;83719449;148024;
04.02.2019;07:07:05;83867587;83719565;148022;
04.02.2019;07:08:05;83867722;83719704;148018;
04.02.2019;07:09:06;83867864;83719826;148038;
04.02.2019;07:10:05;83867998;83719948;148050;
04.02.2019;07:11:05;83868151;83720078;148073;
04.02.2019;07:12:05;83868277;83720212;148065;
04.02.2019;07:13:05;83868393;83720340;148053;
04.02.2019;07:14:05;83868527;83720460;148067;
04.02.2019;07:15:04;83868653;83720579;148074;
04.02.2019;07:16:05;83868778;83720711;148067;
04.02.2019;07:17:04;83868900;83720855;148045;
04.02.2019;07:18:05;83869044;83720986;148058;
04.02.2019;07:19:04;83869180;83721133;148047;
04.02.2019;07:20:04;83869314;83721267;148047;
04.02.2019;07:21:05;83869468;83721435;148033;
04.02.2019;07:22:05;83869586;83721559;148027;
04.02.2019;07:23:04;83869704;83721704;148000;
04.02.2019;07:24:05;83869831;83721844;147987;
04.02.2019;07:25:04;83869926;83721983;147943;
04.02.2019;07:26:04;83870022;83722118;147904;
04.02.2019;07:27:05;83870146;83722246;147900;
04.02.2019;07:28:05;83870247;83722366;147881;
04.02.2019;07:29:04;83870356;83722483;147873;
04.02.2019;07:30:04;83870487;83722606;147881;
04.02.2019;07:31:05;83870611;83722735;147876;
04.02.2019;07:32:05;83870738;83722887;147851;
04.02.2019;07:33:05;83870856;83723038;147818;
04.02.2019;07:34:04;83870983;83723169;147814;
04.02.2019;07:35:13;83871116;83723316;147800;
04.02.2019;07:36:05;83871228;83723380;147848;
04.02.2019;07:37:05;83871330;83723525;147805;
04.02.2019;07:38:04;83871459;83723645;147814;
04.02.2019;07:39:07;83871583;83723780;147803;
04.02.2019;07:40:05;83871675;83723894;147781;
04.02.2019;07:41:04;83871807;83724037;147770;
04.02.2019;07:42:05;83871933;83724151;147782;
04.02.2019;07:43:05;83872050;83724295;147755;
04.02.2019;07:44:04;83872150;83724400;147750;
04.02.2019;07:45:04;83872262;83724520;147742;
04.02.2019;07:46:05;83872380;83724673;147707;
04.02.2019;07:47:04;83872491;83724806;147685;
04.02.2019;07:48:04;83872579;83724968;147611;
04.02.2019;07:49:05;83872697;83725091;147606;
04.02.2019;07:50:04;83872810;83725231;147579;
04.02.2019;07:51:04;83872923;83725360;147563;
04.02.2019;07:52:05;83873031;83725502;147529;
04.02.2019;07:53:05;83873158;83725645;147513;
04.02.2019;07:54:04;83873261;83725788;147473;
04.02.2019;07:55:05;83873369;83725929;147440;
04.02.2019;07:56:04;83873510;83726076;147434;
04.02.2019;07:57:05;83873619;83726205;147414;
04.02.2019;07:58:05;83873728;83726349;147379;
04.02.2019;07:59:05;83873838;83726493;147345;
04.02.2019;08:00:04;83873945;83726654;147291;
04.02.2019;08:01:04;83874062;83726832;147230;
04.02.2019;08:02:05;83874169;83726977;147192;
04.02.2019;08:03:05;83874275;83727123;147152;
04.02.2019;08:04:04;83874388;83727266;147122;
04.02.2019;08:05:05;83874472;83727439;147033;
04.02.2019;08:06:05;83874571;83727580;146991;
04.02.2019;08:07:04;83874675;83727749;146926;
04.02.2019;08:08:04;83874780;83727876;146904;
04.02.2019;08:09:04;83874872;83728033;146839;
04.02.2019;08:10:05;83874963;83728187;146776;
04.02.2019;08:11:05;83875072;83728333;146739;
04.02.2019;08:12:05;83875131;83728473;146658;
04.02.2019;08:13:04;83875214;83728599;146615;
04.02.2019;08:14:04;83875284;83728745;146539;
04.02.2019;08:15:05;83875365;83728885;146480;
04.02.2019;08:16:05;83875421;83729014;146407;
04.02.2019;08:17:05;83875478;83729149;146329;
04.02.2019;08:18:05;83875526;83729260;146266;
04.02.2019;08:19:04;83875555;83729387;146168;
04.02.2019;08:20:04;83875616;83729525;146091;
04.02.2019;08:21:05;83875667;83729667;146000;
04.02.2019;08:22:04;83875714;83729785;145929;
04.02.2019;08:23:04;83875780;83729896;145884;
04.02.2019;08:24:05;83875851;83730097;145754;
04.02.2019;08:25:05;83875930;83730232;145698;
04.02.2019;08:26:04;83876015;83730370;145645;
04.02.2019;08:27:04;83876088;83730523;145565;
04.02.2019;08:28:05;83876192;83730693;145499;
04.02.2019;08:29:05;83876291;83730881;145410;
04.02.2019;08:30:05;83876370;83731040;145330;
04.02.2019;08:31:04;83876475;83731175;145300;
04.02.2019;08:32:04;83876582;83731337;145245;
04.02.2019;08:33:05;83876698;83731513;145185;
04.02.2019;08:34:04;83876799;83731639;145160;
04.02.2019;08:35:04;83876893;83731802;145091;
04.02.2019;08:36:05;83876984;83731962;145022;
04.02.2019;08:37:05;83877073;83732103;144970;
04.02.2019;08:38:05;83877161;83732264;144897;
04.02.2019;08:39:06;83877272;83732410;144862;
04.02.2019;08:40:05;83877371;83732585;144786;
04.02.2019;08:41:05;83877476;83732745;144731;
04.02.2019;08:42:05;83877600;83732918;144682;
04.02.2019;08:43:04;83877698;83733097;144601;
04.02.2019;08:44:04;83877783;83733284;144499;
04.02.2019;08:45:05;83877860;83733425;144435;
04.02.2019;08:46:05;83877969;83733576;144393;
04.02.2019;08:47:05;83878075;83733738;144337;
04.02.2019;08:48:05;83878187;83733907;144280;
04.02.2019;08:49:05;83878294;83734060;144234;
04.02.2019;08:50:05;83878389;83734241;144148;
04.02.2019;08:51:05;83878514;83734394;144120;
04.02.2019;08:52:05;83878608;83734550;144058;
04.02.2019;08:53:10;83878702;83734720;143982;
04.02.2019;08:54:04;83878778;83734880;143898;
04.02.2019;08:55:04;83878860;83735010;143850;
04.02.2019;08:56:05;83878957;83735173;143784;
04.02.2019;08:57:05;83879056;83735334;143722;
04.02.2019;08:58:05;83879139;83735492;143647;
04.02.2019;08:59:04;83879254;83735640;143614;
04.02.2019;09:00:04;83879353;83735801;143552;
04.02.2019;09:01:05;83879450;83735954;143496;
04.02.2019;09:02:05;83879544;83736115;143429;
04.02.2019;09:03:04;83879618;83736246;143372;
04.02.2019;09:04:04;83879715;83736396;143319;
04.02.2019;09:05:05;83879801;83736579;143222;
04.02.2019;09:06:04;83879889;83736750;143139;
04.02.2019;09:07:04;83879961;83736908;143053;
04.02.2019;09:08:05;83880051;83737028;143023;
04.02.2019;09:09:06;83880159;83737264;142895;
04.02.2019;09:10:04;83880252;83737420;142832;
04.02.2019;09:11:05;83880357;83737529;142828;
04.02.2019;09:12:05;83880445;83737709;142736;
04.02.2019;09:13:04;83880524;83737894;142630;
04.02.2019;09:14:05;83880621;83738067;142554;
04.02.2019;09:15:05;83880708;83738206;142502;
04.02.2019;09:16:04;83880792;83738362;142430;
04.02.2019;09:17:07;83880880;83738539;142341;
04.02.2019;09:18:05;83880961;83738676;142285;
04.02.2019;09:19:04;83881055;83738819;142236;
04.02.2019;09:20:04;83881133;83738981;142152;
04.02.2019;09:21:05;83881245;83739153;142092;
04.02.2019;09:22:04;83881341;83739337;142004;
04.02.2019;09:23:04;83881436;83739499;141937;
04.02.2019;09:24:05;83881507;83739646;141861;
04.02.2019;09:25:04;83881602;83739803;141799;
04.02.2019;09:26:06;83881691;83739984;141707;
04.02.2019;09:27:05;83881774;83740135;141639;
04.02.2019;09:28:05;83881862;83740290;141572;
04.02.2019;09:29:06;83881949;83740435;141514;
04.02.2019;09:30:06;83882028;83740585;141443;
04.02.2019;09:31:05;83882128;83740760;141368;
04.02.2019;09:32:06;83882216;83740899;141317;
04.02.2019;09:33:06;83882302;83741039;141263;
04.02.2019;09:34:05;83882409;83741193;141216;
04.02.2019;09:35:06;83882499;83741345;141154;
04.02.2019;09:36:10;83882582;83741544;141038;
04.02.2019;09:37:10;83882658;83741711;140947;
04.02.2019;09:38:04;83882738;83741860;140878;
04.02.2019;09:39:06;83882837;83742032;140805;
04.02.2019;09:40:05;83882898;83742191;140707;
04.02.2019;09:41:05;83882982;83742335;140647;
04.02.2019;09:42:04;83883067;83742500;140567;
04.02.2019;09:43:05;83883089;83742574;140515;
04.02.2019;09:44:05;83883183;83742647;140536;
04.02.2019;09:45:05;83883253;83742746;140507;
04.02.2019;09:46:05;83883326;83742861;140465;
04.02.2019;09:47:05;83883418;83742992;140426;
04.02.2019;09:48:05;83883510;83743128;140382;
04.02.2019;09:49:04;83883587;83743289;140298;
04.02.2019;09:50:04;83883673;83743462;140211;
04.02.2019;09:51:05;83883770;83743586;140184;
04.02.2019;09:52:05;83883851;83743724;140127;
04.02.2019;09:53:04;83883936;83743874;140062;
04.02.2019;09:54:05;83884018;83744025;139993;
04.02.2019;09:55:05;83884116;83744177;139939;
04.02.2019;09:56:04;83884199;83744294;139905;
04.02.2019;09:57:04;83884279;83744435;139844;
04.02.2019;09:58:05;83884360;83744609;139751;
04.02.2019;09:59:05;83884443;83744754;139689;
04.02.2019;10:00:04;83884525;83744861;139664;
04.02.2019;10:01:04;83884615;83744991;139624;
04.02.2019;10:02:04;83884690;83745132;139558;
04.02.2019;10:03:04;83884797;83745255;139542;
04.02.2019;10:04:05;83884891;83745431;139460;
04.02.2019;10:05:04;83884991;83745608;139383;
04.02.2019;10:06:04;83885073;83745755;139318;
04.02.2019;10:07:05;83885186;83745886;139300;
04.02.2019;10:08:05;83885277;83746051;139226;
04.02.2019;10:09:06;83885358;83746181;139177;
04.02.2019;10:10:05;83885420;83746333;139087;
04.02.2019;10:11:05;83885506;83746472;139034;
04.02.2019;10:12:04;83885558;83746599;138959;
04.02.2019;10:13:05;83885584;83746681;138903;
04.02.2019;10:14:05;83885592;83746780;138812;
04.02.2019;10:15:04;83885614;83746889;138725;
04.02.2019;10:16:05;83885660;83747028;138632;
04.02.2019;10:17:05;83885706;83747152;138554;
04.02.2019;10:18:04;83885740;83747267;138473;
04.02.2019;10:19:05;83885802;83747403;138399;
04.02.2019;10:20:04;83885876;83747546;138330;
04.02.2019;10:21:04;83885936;83747669;138267;
04.02.2019;10:22:05;83886016;83747818;138198;
04.02.2019;10:23:04;83886110;83747969;138141;
04.02.2019;10:24:04;83886206;83748111;138095;
04.02.2019;10:25:05;83886316;83748270;138046;
04.02.2019;10:26:04;83886401;83748407;137994;
04.02.2019;10:27:05;83886468;83748554;137914;
04.02.2019;10:28:05;83886544;83748711;137833;
04.02.2019;10:29:04;83886648;83748877;137771;
04.02.2019;10:30:05;83886727;83749027;137700;
04.02.2019;10:31:04;83886815;83749181;137634;
04.02.2019;10:32:05;83886902;83749324;137578;
04.02.2019;10:33:04;83886985;83749417;137568;
04.02.2019;10:34:04;83887070;83749539;137531;
04.02.2019;10:35:05;83887153;83749659;137494;
04.02.2019;10:36:04;83887251;83749783;137468;
04.02.2019;10:37:04;83887328;83749934;137394;
04.02.2019;10:38:05;83887400;83750061;137339;
04.02.2019;10:39:04;83887492;83750212;137280;
04.02.2019;10:40:04;83887560;83750348;137212;
04.02.2019;10:41:05;83887647;83750490;137157;
04.02.2019;10:42:04;83887731;83750650;137081;
04.02.2019;10:43:05;83887828;83750795;137033;
04.02.2019;10:44:05;83887917;83750940;136977;
04.02.2019;10:45:05;83888009;83751079;136930;
04.02.2019;10:46:04;83888121;83751235;136886;
04.02.2019;10:47:04;83888235;83751397;136838;
04.02.2019;10:48:04;83888339;83751541;136798;
04.02.2019;10:49:05;83888441;83751693;136748;
04.02.2019;10:50:05;83888542;83751838;136704;
04.02.2019;10:51:04;83888624;83752009;136615;
04.02.2019;10:52:04;83888725;83752168;136557;
04.02.2019;10:53:05;83888816;83752323;136493;
04.02.2019;10:54:04;83888926;83752493;136433;
04.02.2019;10:55:04;83889035;83752667;136368;
04.02.2019;10:56:04;83889124;83752813;136311;
04.02.2019;10:57:04;83889207;83752975;136232;
04.02.2019;10:58:04;83889289;83753115;136174;
04.02.2019;10:59:04;83889379;83753285;136094;
04.02.2019;11:00:05;83889480;83753451;136029;
04.02.2019;11:01:05;83889575;83753584;135991;
04.02.2019;11:02:04;83889674;83753749;135925;
04.02.2019;11:03:04;83889749;83753927;135822;
04.02.2019;11:04:05;83889844;83754081;135763;
04.02.2019;11:05:04;83889935;83754235;135700;
04.02.2019;11:06:04;83890048;83754401;135647;
04.02.2019;11:07:05;83890133;83754557;135576;
04.02.2019;11:08:04;83890217;83754733;135484;
04.02.2019;11:09:06;83890318;83754920;135398;
04.02.2019;11:10:04;83890392;83755047;135345;
04.02.2019;11:11:04;83890483;83755199;135284;
04.02.2019;11:12:04;83890574;83755369;135205;
04.02.2019;11:13:05;83890652;83755514;135138;
04.02.2019;11:14:05;83890750;83755659;135091;
04.02.2019;11:15:04;83890830;83755816;135014;
04.02.2019;11:16:04;83890902;83755970;134932;
04.02.2019;11:17:05;83890992;83756110;134882;
04.02.2019;11:18:04;83891075;83756271;134804;
04.02.2019;11:19:04;83891169;83756395;134774;
04.02.2019;11:20:05;83891254;83756530;134724;
04.02.2019;11:21:04;83891321;83756674;134647;
04.02.2019;11:22:05;83891417;83756825;134592;
04.02.2019;11:23:04;83891496;83756999;134497;
04.02.2019;11:24:04;83891597;83757136;134461;
04.02.2019;11:25:05;83891693;83757262;134431;
04.02.2019;11:26:04;83891808;83757433;134375;
04.02.2019;11:27:05;83891917;83757606;134311;
04.02.2019;11:28:04;83892006;83757745;134261;
04.02.2019;11:29:04;83892115;83757903;134212;
04.02.2019;11:30:05;83892222;83758077;134145;
04.02.2019;11:31:05;83892321;83758228;134093;
04.02.2019;11:32:04;83892440;83758398;134042;
04.02.2019;11:33:05;83892555;83758538;134017;
04.02.2019;11:34:05;83892654;83758700;133954;
04.02.2019;11:35:04;83892732;83758832;133900;
04.02.2019;11:36:05;83892825;83758969;133856;
04.02.2019;11:37:04;83892914;83759132;133782;
04.02.2019;11:38:04;83893014;83759263;133751;
04.02.2019;11:39:05;83893114;83759439;133675;
04.02.2019;11:40:05;83893192;83759579;133613;
04.02.2019;11:41:04;83893301;83759740;133561;
04.02.2019;11:42:05;83893397;83759891;133506;
04.02.2019;11:43:04;83893472;83760024;133448;
04.02.2019;11:44:05;83893551;83760177;133374;
04.02.2019;11:45:04;83893630;83760329;133301;
04.02.2019;11:46:04;83893712;83760477;133235;
04.02.2019;11:47:05;83893817;83760596;133221;
04.02.2019;11:48:04;83893903;83760732;133171;
04.02.2019;11:49:04;83893999;83760897;133102;
04.02.2019;11:50:04;83894102;83761060;133042;
04.02.2019;11:51:04;83894187;83761216;132971;
04.02.2019;11:52:05;83894263;83761345;132918;
04.02.2019;11:53:05;83894343;83761508;132835;
04.02.2019;11:54:04;83894434;83761660;132774;
04.02.2019;11:55:05;83894522;83761805;132717;
04.02.2019;11:56:04;83894604;83761978;132626;
04.02.2019;11:57:04;83894687;83762130;132557;
04.02.2019;11:58:05;83894755;83762283;132472;
04.02.2019;11:59:04;83894835;83762429;132406;
04.02.2019;12:00:05;83894895;83762581;132314;
04.02.2019;12:01:04;83895006;83762730;132276;
04.02.2019;12:02:04;83895116;83762864;132252;
04.02.2019;12:03:05;83895234;83763016;132218;
04.02.2019;12:04:04;83895330;83763170;132160;
04.02.2019;12:05:04;83895423;83763332;132091;
04.02.2019;12:06:04;83895530;83763505;132025;
04.02.2019;12:07:04;83895621;83763638;131983;
04.02.2019;12:08:05;83895712;83763773;131939;
04.02.2019;12:09:05;83895796;83763926;131870;
04.02.2019;12:10:04;83895899;83764092;131807;
04.02.2019;12:11:05;83895926;83764229;131697;
04.02.2019;12:12:05;83895897;83764317;131580;
04.02.2019;12:13:04;83895863;83764393;131470;
04.02.2019;12:14:04;83895868;83764476;131392;
04.02.2019;12:15:05;83895885;83764641;131244;
04.02.2019;12:16:04;83895949;83764778;131171;
04.02.2019;12:17:05;83896055;83764963;131092;
04.02.2019;12:18:05;83896151;83765117;131034;
04.02.2019;12:19:04;83896283;83765260;131023;
04.02.2019;12:20:05;83896396;83765418;130978;
04.02.2019;12:21:05;83896488;83765588;130900;
04.02.2019;12:22:05;83896609;83765720;130889;
04.02.2019;12:23:05;83896702;83765868;130834;
04.02.2019;12:24:04;83896804;83766005;130799;
04.02.2019;12:25:04;83896907;83766149;130758;
04.02.2019;12:26:04;83897019;83766294;130725;
04.02.2019;12:27:04;83897155;83766449;130706;
04.02.2019;12:28:05;83897248;83766600;130648;
04.02.2019;12:29:04;83897369;83766740;130629;
04.02.2019;12:30:05;83897473;83766891;130582;
04.02.2019;12:31:05;83897598;83767024;130574;
04.02.2019;12:32:04;83897708;83767181;130527;
04.02.2019;12:33:05;83897799;83767337;130462;
04.02.2019;12:34:04;83897872;83767483;130389;
04.02.2019;12:35:05;83897267;83767360;129907;
04.02.2019;12:36:04;83896899;83767295;129604;
04.02.2019;12:37:05;83896987;83767455;129532;
04.02.2019;12:38:04;83897071;83767617;129454;
04.02.2019;12:39:05;83897189;83767743;129446;
04.02.2019;12:40:04;83897314;83767896;129418;
04.02.2019;12:41:05;83897445;83768047;129398;
04.02.2019;12:42:05;83897535;83768201;129334;
04.02.2019;12:43:10;83897644;83768359;129285;
04.02.2019;12:44:05;83897736;83768508;129228;
04.02.2019;12:45:04;83897843;83768666;129177;
04.02.2019;12:46:04;83897939;83768814;129125;
04.02.2019;12:47:05;83898046;83768984;129062;
04.02.2019;12:48:04;83898143;83769156;128987;
04.02.2019;12:49:04;83898267;83769290;128977;
04.02.2019;12:50:05;83898389;83769434;128955;
04.02.2019;12:51:04;83898488;83769587;128901;
04.02.2019;12:52:04;83898597;83769745;128852;
04.02.2019;12:53:05;83898712;83769910;128802;
04.02.2019;12:54:04;83898827;83770060;128767;
04.02.2019;12:55:04;83898919;83770211;128708;
04.02.2019;12:56:05;83899020;83770372;128648;
04.02.2019;12:57:04;83899129;83770526;128603;
04.02.2019;12:58:05;83899234;83770666;128568;
04.02.2019;12:59:05;83899326;83770831;128495;
04.02.2019;13:00:05;83899443;83770981;128462;
04.02.2019;13:01:05;83899553;83771132;128421;
04.02.2019;13:02:04;83899670;83771290;128380;
04.02.2019;13:03:05;83899785;83771456;128329;
04.02.2019;13:04:04;83899866;83771618;128248;
04.02.2019;13:05:04;83899963;83771804;128159;
04.02.2019;13:06:04;83900100;83771950;128150;
04.02.2019;13:07:04;83900207;83772112;128095;
04.02.2019;13:08:05;83900350;83772256;128094;
04.02.2019;13:09:05;83900464;83772417;128047;
04.02.2019;13:10:05;83900556;83772568;127988;
04.02.2019;13:11:04;83900677;83772704;127973;
04.02.2019;13:12:04;83900800;83772838;127962;
04.02.2019;13:13:04;83900930;83772997;127933;
04.02.2019;13:14:05;83901054;83773150;127904;
04.02.2019;13:15:04;83901163;83773284;127879;
04.02.2019;13:16:05;83901278;83773445;127833;
04.02.2019;13:17:05;83901398;83773611;127787;
04.02.2019;13:18:05;83901531;83773781;127750;
04.02.2019;13:19:05;83901632;83773923;127709;
04.02.2019;13:20:05;83901766;83774115;127651;
04.02.2019;13:21:04;83901887;83774252;127635;
04.02.2019;13:22:05;83902000;83774393;127607;
04.02.2019;13:23:04;83902108;83774581;127527;
04.02.2019;13:24:04;83902239;83774752;127487;
04.02.2019;13:25:05;83902373;83774906;127467;
04.02.2019;13:26:04;83902484;83775040;127444;
04.02.2019;13:27:05;83902613;83775229;127384;
04.02.2019;13:28:04;83902742;83775370;127372;
04.02.2019;13:29:05;83902854;83775550;127304;
04.02.2019;13:30:04;83902963;83775739;127224;
04.02.2019;13:31:04;83903112;83775915;127197;
04.02.2019;13:32:04;83903240;83776064;127176;
04.02.2019;13:33:04;83903375;83776217;127158;
04.02.2019;13:34:05;83903511;83776374;127137;
04.02.2019;13:35:04;83903659;83776532;127127;
04.02.2019;13:36:04;83903792;83776694;127098;
04.02.2019;13:37:05;83903915;83776881;127034;
04.02.2019;13:38:05;83904045;83777053;126992;
04.02.2019;13:39:04;83904183;83777231;126952;
04.02.2019;13:40:04;83904297;83777401;126896;
04.02.2019;13:41:04;83904442;83777541;126901;
04.02.2019;13:42:04;83904569;83777702;126867;
04.02.2019;13:43:05;83904693;83777865;126828;
04.02.2019;13:44:05;83904815;83778040;126775;
04.02.2019;13:45:04;83904922;83778211;126711;
04.02.2019;13:46:05;83905044;83778382;126662;
04.02.2019;13:47:05;83905167;83778534;126633;
04.02.2019;13:48:04;83905286;83778686;126600;
04.02.2019;13:49:05;83905425;83778824;126601;
04.02.2019;13:50:04;83905547;83778995;126552;
04.02.2019;13:51:04;83905695;83779186;126509;
04.02.2019;13:52:05;83905828;83779327;126501;
04.02.2019;13:53:04;83905945;83779505;126440;
04.02.2019;13:54:05;83906085;83779662;126423;
04.02.2019;13:55:05;83906207;83779819;126388;
04.02.2019;13:56:04;83906337;83779995;126342;
04.02.2019;13:57:04;83906488;83780159;126329;
04.02.2019;13:58:05;83906611;83780317;126294;
04.02.2019;13:59:04;83906743;83780482;126261;
04.02.2019;14:00:05;83906879;83780658;126221;
04.02.2019;14:01:04;83907011;83780850;126161;
04.02.2019;14:02:04;83907127;83780998;126129;
04.02.2019;14:03:05;83907258;83781159;126099;
04.02.2019;14:04:05;83907380;83781338;126042;
04.02.2019;14:05:07;83907523;83781525;125998;
04.02.2019;14:06:10;83907663;83781724;125939;
04.02.2019;14:07:06;83907809;83781879;125930;
04.02.2019;14:08:07;83907961;83782080;125881;
04.02.2019;14:09:08;83908088;83782232;125856;
04.02.2019;14:10:06;83908186;83782400;125786;
04.02.2019;14:11:09;83908294;83782543;125751;
04.02.2019;14:12:09;83908388;83782691;125697;
04.02.2019;14:13:07;83908475;83782859;125616;
04.02.2019;14:14:07;83908570;83783039;125531;
04.02.2019;14:15:05;83908687;83783247;125440;
04.02.2019;14:16:06;83908773;83783404;125369;
04.02.2019;14:17:10;83908861;83783535;125326;
04.02.2019;14:18:05;83908963;83783684;125279;
04.02.2019;14:19:05;83909039;83783864;125175;
04.02.2019;14:20:05;83909114;83784006;125108;
04.02.2019;14:21:04;83909202;83784139;125063;
04.02.2019;14:22:06;83909301;83784333;124968;
04.02.2019;14:23:05;83909412;83784503;124909;
04.02.2019;14:24:06;83909515;83784671;124844;
04.02.2019;14:25:05;83909614;83784810;124804;
04.02.2019;14:26:05;83909734;83784973;124761;
04.02.2019;14:27:05;83909841;83785165;124676;
04.02.2019;14:28:05;83909978;83785336;124642;
04.02.2019;14:29:05;83910099;83785506;124593;
04.02.2019;14:30:05;83910221;83785668;124553;
04.02.2019;14:31:04;83910331;83785846;124485;
04.02.2019;14:32:04;83910475;83786001;124474;
04.02.2019;14:33:05;83910620;83786187;124433;
04.02.2019;14:34:05;83910753;83786358;124395;
04.02.2019;14:35:05;83910934;83786540;124394;
04.02.2019;14:36:04;83911039;83786726;124313;
04.02.2019;14:37:05;83911186;83786912;124274;
04.02.2019;14:38:04;83911332;83787067;124265;
04.02.2019;14:39:04;83911481;83787254;124227;
04.02.2019;14:40:05;83911610;83787427;124183;
04.02.2019;14:41:05;83911736;83787572;124164;
04.02.2019;14:42:04;83911893;83787765;124128;
04.02.2019;14:43:04;83912051;83787970;124081;
04.02.2019;14:44:05;83912192;83788157;124035;
04.02.2019;14:45:05;83912321;83788358;123963;
04.02.2019;14:46:05;83912437;83788525;123912;
04.02.2019;14:47:04;83912579;83788676;123903;
04.02.2019;14:48:04;83912717;83788879;123838;
04.02.2019;14:49:04;83912808;83789075;123733;
04.02.2019;14:50:05;83913016;83789279;123737;
04.02.2019;14:51:04;83913179;83789462;123717;
04.02.2019;14:52:05;83913317;83789634;123683;
04.02.2019;14:53:05;83913440;83789801;123639;
04.02.2019;14:54:05;83913590;83789954;123636;
04.02.2019;14:55:04;83913740;83790145;123595;
04.02.2019;14:56:04;83913878;83790351;123527;
04.02.2019;14:57:04;83914015;83790552;123463;
04.02.2019;14:58:05;83914164;83790736;123428;
04.02.2019;14:59:04;83914288;83790904;123384;
04.02.2019;15:00:07;83914448;83791126;123322;
04.02.2019;15:01:12;83914603;83791312;123291;
04.02.2019;15:02:07;83914716;83791455;123261;
04.02.2019;15:03:08;83914864;83791632;123232;
04.02.2019;15:04:10;83914999;83791809;123190;
04.02.2019;15:05:08;83915124;83792006;123118;
04.02.2019;15:06:08;83915254;83792189;123065;
04.02.2019;15:07:07;83915373;83792374;122999;
04.02.2019;15:08:08;83915554;83792559;122995;
04.02.2019;15:09:10;83915697;83792742;122955;
04.02.2019;15:10:11;83915845;83792921;122924;
04.02.2019;15:11:08;83915980;83793111;122869;
04.02.2019;15:12:08;83916124;83793282;122842;
04.02.2019;15:13:08;83916276;83793495;122781;
04.02.2019;15:14:07;83916403;83793691;122712;
04.02.2019;15:15:06;83916530;83793874;122656;
04.02.2019;15:16:08;83916671;83794058;122613;
04.02.2019;15:17:08;83916810;83794240;122570;
04.02.2019;15:18:07;83916947;83794416;122531;
04.02.2019;15:19:07;83917078;83794602;122476;
04.02.2019;15:20:08;83917223;83794804;122419;
04.02.2019;15:21:07;83917375;83794996;122379;
04.02.2019;15:22:08;83917522;83795197;122325;
04.02.2019;15:23:10;83917674;83795399;122275;
04.02.2019;15:24:06;83917806;83795574;122232;
04.02.2019;15:25:07;83917951;83795795;122156;
04.02.2019;15:26:08;83918078;83795970;122108;
04.02.2019;15:27:07;83918214;83796137;122077;
04.02.2019;15:28:07;83918364;83796342;122022;
04.02.2019;15:29:07;83918504;83796523;121981;
04.02.2019;15:30:07;83918653;83796736;121917;
04.02.2019;15:31:08;83918780;83796943;121837;
04.02.2019;15:32:07;83918925;83797129;121796;
04.02.2019;15:33:07;83919064;83797296;121768;
04.02.2019;15:34:07;83919209;83797491;121718;
04.02.2019;15:35:07;83919349;83797699;121650;
04.02.2019;15:36:06;83919485;83797931;121554;
04.02.2019;15:37:08;83919615;83798134;121481;
04.02.2019;15:38:08;83919745;83798339;121406;
04.02.2019;15:39:09;83919867;83798533;121334;
04.02.2019;15:40:08;83920002;83798726;121276;
04.02.2019;15:41:08;83920157;83798919;121238;
04.02.2019;15:42:07;83920300;83799122;121178;
04.02.2019;15:43:06;83920388;83799312;121076;
04.02.2019;15:44:07;83920505;83799505;121000;
04.02.2019;15:45:07;83920649;83799696;120953;
04.02.2019;15:46:08;83920788;83799917;120871;
04.02.2019;15:47:08;83920936;83800104;120832;
04.02.2019;15:48:08;83921103;83800302;120801;
04.02.2019;15:49:07;83921235;83800485;120750;
04.02.2019;15:50:08;83921386;83800656;120730;
04.02.2019;15:51:07;83921523;83800835;120688;
04.02.2019;15:52:07;83921662;83801024;120638;
04.02.2019;15:53:07;83921836;83801228;120608;
04.02.2019;15:54:07;83922013;83801419;120594;
04.02.2019;15:55:07;83922162;83801597;120565;
04.02.2019;15:56:08;83922309;83801804;120505;
04.02.2019;15:57:08;83922453;83802010;120443;
04.02.2019;15:58:08;83922602;83802209;120393;
04.02.2019;15:59:07;83922740;83802416;120324;
04.02.2019;16:00:04;83922888;83802579;120309;
04.02.2019;16:01:05;83923011;83802797;120214;
04.02.2019;16:02:04;83923161;83803000;120161;
04.02.2019;16:03:04;83923293;83803186;120107;
04.02.2019;16:04:05;83923427;83803392;120035;
04.02.2019;16:05:05;83923540;83803560;119980;
04.02.2019;16:06:05;83923665;83803779;119886;
04.02.2019;16:07:05;83923763;83803983;119780;
04.02.2019;16:08:04;83923882;83804189;119693;
04.02.2019;16:09:04;83924016;83804359;119657;
04.02.2019;16:10:05;83924143;83804571;119572;
04.02.2019;16:11:05;83924241;83804740;119501;
04.02.2019;16:12:04;83924378;83804910;119468;
04.02.2019;16:13:04;83924509;83805051;119458;
04.02.2019;16:14:05;83924629;83805224;119405;
04.02.2019;16:15:05;83924735;83805381;119354;
04.02.2019;16:16:05;83924824;83805580;119244;
04.02.2019;16:17:05;83924908;83805755;119153;
04.02.2019;16:18:05;83925005;83805934;119071;
04.02.2019;16:19:04;83925106;83806119;118987;
04.02.2019;16:20:05;83925215;83806314;118901;
04.02.2019;16:21:04;83925343;83806487;118856;
04.02.2019;16:22:05;83925469;83806650;118819;
04.02.2019;16:23:04;83925575;83806818;118757;
04.02.2019;16:24:04;83925675;83806996;118679;
04.02.2019;16:25:05;83925791;83807217;118574;
04.02.2019;16:26:04;83925888;83807383;118505;
04.02.2019;16:27:04;83925981;83807592;118389;
04.02.2019;16:28:05;83926103;83807786;118317;
04.02.2019;16:29:05;83926179;83807970;118209;
04.02.2019;16:30:05;83926294;83808183;118111;
04.02.2019;16:31:04;83926401;83808374;118027;
04.02.2019;16:32:04;83926508;83808583;117925;
04.02.2019;16:33:05;83926606;83808752;117854;
04.02.2019;16:34:05;83926740;83808944;117796;
04.02.2019;16:35:04;83926880;83809137;117743;
04.02.2019;16:36:04;83927037;83809305;117732;
04.02.2019;16:37:04;83927187;83809488;117699;
04.02.2019;16:38:05;83927324;83809681;117643;
04.02.2019;16:39:04;83927423;83809872;117551;
04.02.2019;16:40:05;83927593;83810079;117514;
04.02.2019;16:41:05;83927723;83810267;117456;
04.02.2019;16:42:05;83927845;83810449;117396;
04.02.2019;16:43:05;83927990;83810629;117361;
04.02.2019;16:44:05;83928132;83810856;117276;
04.02.2019;16:45:05;83928237;83811010;117227;
04.02.2019;16:46:05;83928382;83811221;117161;
04.02.2019;16:47:05;83928501;83811399;117102;
04.02.2019;16:48:04;83928635;83811608;117027;
04.02.2019;16:49:04;83928793;83811823;116970;
04.02.2019;16:50:05;83928925;83812025;116900;
04.02.2019;16:51:04;83929055;83812221;116834;
04.02.2019;16:52:04;83929201;83812408;116793;
04.02.2019;16:53:05;83929351;83812607;116744;
04.02.2019;16:54:05;83929495;83812783;116712;
04.02.2019;16:55:08;83929646;83812976;116670;
04.02.2019;16:56:05;83929765;83813122;116643;
04.02.2019;16:57:04;83929936;83813319;116617;
04.02.2019;16:58:05;83930058;83813527;116531;
04.02.2019;16:59:05;83930214;83813751;116463;
04.02.2019;17:00:07;83930366;83813948;116418;
04.02.2019;17:01:04;83930524;83814171;116353;
04.02.2019;17:02:05;83930656;83814358;116298;
04.02.2019;17:03:04;83930807;83814558;116249;
04.02.2019;17:04:05;83930948;83814776;116172;
04.02.2019;17:05:04;83931066;83814965;116101;
04.02.2019;17:06:05;83931224;83815174;116050;
04.02.2019;17:07:05;83931362;83815388;115974;
04.02.2019;17:08:04;83931500;83815609;115891;
04.02.2019;17:09:30;83931673;83815921;115752;
04.02.2019;17:10:04;83931761;83816026;115735;
04.02.2019;17:11:05;83931914;83816232;115682;
04.02.2019;17:12:05;83932053;83816438;115615;
04.02.2019;17:13:04;83932169;83816630;115539;
04.02.2019;17:14:07;83932315;83816869;115446;
04.02.2019;17:15:04;83932445;83817100;115345;
04.02.2019;17:16:05;83932600;83817309;115291;
04.02.2019;17:17:04;83932752;83817519;115233;
04.02.2019;17:18:05;83932931;83817697;115234;
04.02.2019;17:19:08;83933079;83817921;115158;
04.02.2019;17:20:05;83933218;83818087;115131;
04.02.2019;17:21:05;83933385;83818286;115099;
04.02.2019;17:22:04;83933555;83818469;115086;
04.02.2019;17:23:07;83933749;83818682;115067;
04.02.2019;17:24:05;83933890;83818860;115030;
04.02.2019;17:25:05;83934048;83819056;114992;
04.02.2019;17:26:05;83934209;83819255;114954;
04.02.2019;17:27:04;83934352;83819436;114916;
04.02.2019;17:28:07;83934502;83819635;114867;
04.02.2019;17:29:04;83934651;83819861;114790;
04.02.2019;17:30:04;83934797;83820041;114756;
04.02.2019;17:31:05;83934919;83820282;114637;
04.02.2019;17:32:05;83935107;83820488;114619;
04.02.2019;17:33:07;83935252;83820714;114538;
04.02.2019;17:34:04;83935399;83820899;114500;
04.02.2019;17:35:05;83935544;83821075;114469;
04.02.2019;17:36:05;83935696;83821258;114438;
04.02.2019;17:37:06;83935830;83821432;114398;
04.02.2019;17:38:05;83935984;83821609;114375;
04.02.2019;17:39:07;83936170;83821802;114368;
04.02.2019;17:40:04;83936290;83821997;114293;
04.02.2019;17:42:04;83936613;83822436;114177;
04.02.2019;17:43:05;83936764;83822627;114137;
04.02.2019;17:44:05;83936918;83822795;114123;
04.02.2019;17:45:04;83937052;83822996;114056;
04.02.2019;17:46:06;83937206;83823189;114017;
04.02.2019;17:47:04;83937338;83823388;113950;
04.02.2019;17:48:05;83937485;83823573;113912;
04.02.2019;17:49:05;83937652;83823754;113898;
04.02.2019;17:50:07;83937825;83823955;113870;
04.02.2019;17:51:04;83937983;83824121;113862;
04.02.2019;17:52:04;83938108;83824292;113816;
04.02.2019;17:53:04;83938272;83824472;113800;
04.02.2019;17:54:04;83938407;83824650;113757;
04.02.2019;17:55:07;83938567;83824864;113703;
04.02.2019;17:56:04;83938704;83825057;113647;
04.02.2019;17:57:05;83938844;83825250;113594;
04.02.2019;17:58:05;83938995;83825428;113567;
04.02.2019;17:59:04;83939152;83825590;113562;
04.02.2019;18:00:07;83939283;83825815;113468;
04.02.2019;18:01:04;83939393;83825969;113424;
04.02.2019;18:02:04;83939496;83826132;113364;
04.02.2019;18:03:05;83939619;83826300;113319;
04.02.2019;18:04:07;83939739;83826512;113227;
04.02.2019;18:05:04;83939878;83826672;113206;
04.02.2019;18:06:05;83940008;83826870;113138;
04.02.2019;18:07:05;83940186;83827060;113126;
04.02.2019;18:08:04;83940333;83827242;113091;
04.02.2019;18:09:07;83940471;83827397;113074;
04.02.2019;18:10:04;83940623;83827578;113045;
04.02.2019;18:11:05;83940785;83827769;113016;
04.02.2019;18:12:05;83940950;83827933;113017;
04.02.2019;18:13:08;83941097;83828145;112952;
04.02.2019;18:14:05;83941213;83828315;112898;
04.02.2019;18:15:05;83941324;83828508;112816;
04.02.2019;18:16:05;83941430;83828642;112788;
04.02.2019;18:17:05;83941548;83828805;112743;
04.02.2019;18:18:08;83941676;83828984;112692;
04.02.2019;18:19:06;83941807;83829128;112679;
04.02.2019;18:20:05;83941929;83829284;112645;
04.02.2019;18:21:05;83942031;83829469;112562;
04.02.2019;18:22:07;83942196;83829626;112570;
04.02.2019;18:23:04;83942321;83829776;112545;
04.02.2019;18:24:04;83942411;83829960;112451;
04.02.2019;18:25:05;83942554;83830123;112431;
04.02.2019;18:26:05;83942694;83830245;112449;
04.02.2019;18:27:07;83942838;83830397;112441;
04.02.2019;18:28:04;83942941;83830527;112414;
04.02.2019;18:29:04;83943040;83830673;112367;
04.02.2019;18:30:05;83943190;83830834;112356;
04.02.2019;18:31:08;83943351;83831008;112343;
04.02.2019;18:32:05;83943457;83831149;112308;
04.02.2019;18:33:05;83943563;83831293;112270;
04.02.2019;18:34:04;83943645;83831433;112212;
04.02.2019;18:35:04;83943727;83831600;112127;
04.02.2019;18:36:08;83943806;83831778;112028;
04.02.2019;18:37:05;83943893;83831910;111983;
04.02.2019;18:38:05;83943992;83832042;111950;
04.02.2019;18:39:05;83944095;83832172;111923;
04.02.2019;18:40:07;83944181;83832313;111868;
04.02.2019;18:41:05;83944284;83832453;111831;
04.02.2019;18:42:05;83944315;83832547;111768;
04.02.2019;18:43:05;83944406;83832724;111682;
04.02.2019;18:44:05;83944522;83832874;111648;
04.02.2019;18:45:08;83944634;83833024;111610;
04.02.2019;18:46:05;83944716;83833172;111544;
04.02.2019;18:47:04;83944877;83833320;111557;
04.02.2019;18:48:05;83945028;83833462;111566;
04.02.2019;18:49:06;83945176;83833615;111561;
04.02.2019;18:50:05;83945283;83833791;111492;
04.02.2019;18:51:05;83945411;83833941;111470;
04.02.2019;18:52:04;83945562;83834116;111446;
04.02.2019;18:53:05;83945713;83834277;111436;
04.02.2019;18:54:13;83945831;83834453;111378;
04.02.2019;18:55:05;83945980;83834580;111400;
04.02.2019;18:56:05;83946086;83834732;111354;
04.02.2019;18:57:05;83946245;83834894;111351;
04.02.2019;18:58:04;83946384;83835042;111342;
04.02.2019;18:59:07;83946516;83835192;111324;
04.02.2019;19:00:05;83946645;83835321;111324;
04.02.2019;19:01:05;83946737;83835474;111263;
04.02.2019;19:02:05;83946866;83835610;111256;
04.02.2019;19:03:07;83946999;83835759;111240;
04.02.2019;19:04:05;83947107;83835881;111226;
04.02.2019;19:05:05;83947237;83836055;111182;
04.02.2019;19:06:05;83947385;83836244;111141;
04.02.2019;19:07:04;83947548;83836444;111104;
04.02.2019;19:08:07;83947725;83836666;111059;
04.02.2019;19:09:04;83947862;83836837;111025;
04.02.2019;19:10:04;83948011;83837007;111004;
04.02.2019;19:11:05;83948153;83837238;110915;
04.02.2019;19:12:05;83948291;83837460;110831;
04.02.2019;19:13:07;83948439;83837668;110771;
04.02.2019;19:14:05;83948605;83837846;110759;
04.02.2019;19:15:05;83948766;83838037;110729;
04.02.2019;19:16:05;83948925;83838234;110691;
04.02.2019;19:17:08;83949087;83838434;110653;
04.02.2019;19:18:05;83949209;83838605;110604;
04.02.2019;19:19:04;83949350;83838764;110586;
04.02.2019;19:20:04;83949483;83838959;110524;
04.02.2019;19:21:04;83949676;83839136;110540;
04.02.2019;19:22:08;83949821;83839304;110517;
04.02.2019;19:23:04;83949952;83839435;110517;
04.02.2019;19:24:05;83950075;83839579;110496;
04.02.2019;19:25:05;83950236;83839706;110530;
04.02.2019;19:26:07;83950382;83839831;110551;
04.02.2019;19:27:05;83950535;83839954;110581;
04.02.2019;19:28:05;83950668;83840071;110597;
04.02.2019;19:29:06;83950820;83840219;110601;
04.02.2019;19:30:05;83950956;83840333;110623;
04.02.2019;19:31:08;83951098;83840447;110651;
04.02.2019;19:32:05;83951224;83840545;110679;
04.02.2019;19:33:05;83951352;83840670;110682;
04.02.2019;19:34:05;83951501;83840796;110705;
04.02.2019;19:35:05;83951633;83840940;110693;
04.02.2019;19:36:06;83951795;83841052;110743;
04.02.2019;19:37:05;83951918;83841196;110722;
04.02.2019;19:38:06;83952045;83841285;110760;
04.02.2019;19:39:05;83952200;83841401;110799;
04.02.2019;19:40:08;83952311;83841542;110769;
04.02.2019;19:41:05;83952428;83841668;110760;
04.02.2019;19:42:05;83952556;83841765;110791;
04.02.2019;19:43:05;83952707;83841885;110822;
04.02.2019;19:44:05;83952854;83841989;110865;
04.02.2019;19:45:08;83952992;83842086;110906;
04.02.2019;19:46:04;83953092;83842186;110906;
04.02.2019;19:47:05;83953247;83842282;110965;
04.02.2019;19:48:05;83953390;83842370;111020;
04.02.2019;19:49:08;83953499;83842470;111029;
04.02.2019;19:50:04;83953621;83842571;111050;
04.02.2019;19:51:05;83953771;83842685;111086;
04.02.2019;19:52:05;83953918;83842779;111139;
04.02.2019;19:53:06;83954058;83842879;111179;
04.02.2019;19:54:05;83954195;83842965;111230;
04.02.2019;19:55:05;83954315;83843045;111270;
04.02.2019;19:56:05;83954445;83843140;111305;
04.02.2019;19:57:05;83954570;83843239;111331;
04.02.2019;19:58:09;83954699;83843346;111353;
04.02.2019;19:59:05;83954809;83843433;111376;
04.02.2019;20:00:05;83954948;83843526;111422;
04.02.2019;20:01:05;83955123;83843625;111498;
04.02.2019;20:02:05;83955276;83843738;111538;
04.02.2019;20:03:06;83955411;83843860;111551;
04.02.2019;20:04:10;83955567;83843959;111608;
04.02.2019;20:05:05;83955704;83844030;111674;
04.02.2019;20:06:04;83955811;83844137;111674;
04.02.2019;20:07:08;83955916;83844229;111687;
04.02.2019;20:08:05;83956015;83844313;111702;
04.02.2019;20:09:05;83956116;83844406;111710;
04.02.2019;20:10:04;83956222;83844455;111767;
04.02.2019;20:11:11;83956360;83844548;111812;
04.02.2019;20:12:12;83956497;83844641;111856;
04.02.2019;20:13:09;83956611;83844719;111892;
04.02.2019;20:14:05;83956701;83844787;111914;
04.02.2019;20:15:05;83956806;83844882;111924;
04.02.2019;20:16:19;83956953;83844975;111978;
04.02.2019;20:17:05;83957052;83845046;112006;
04.02.2019;20:18:05;83957169;83845126;112043;
04.02.2019;20:19:05;83957286;83845193;112093;
04.02.2019;20:20:05;83957397;83845287;112110;
04.02.2019;20:21:05;83957510;83845362;112148;
04.02.2019;20:23:04;83957772;83845522;112250;
04.02.2019;20:23:10;83957725;83845522;112203;
04.02.2019;20:24:05;83957887;83845598;112289;
04.02.2019;20:25:05;83958013;83845669;112344;
04.02.2019;20:27:05;83958268;83845817;112451;
04.02.2019;20:28:05;83958401;83845908;112493;
04.02.2019;20:29:05;83958503;83845978;112525;
04.02.2019;20:30:04;83958616;83846054;112562;
04.02.2019;20:31:04;83958754;83846129;112625;
04.02.2019;20:32:04;83958875;83846215;112660;
04.02.2019;20:33:05;83958997;83846292;112705;
04.02.2019;20:35:05;83959211;83846429;112782;
04.02.2019;20:36:05;83959360;83846506;112854;
04.02.2019;20:37:05;83959480;83846574;112906;
04.02.2019;20:38:04;83959604;83846652;112952;
04.02.2019;20:39:05;83959750;83846710;113040;
04.02.2019;20:40:04;83959874;83846779;113095;
04.02.2019;20:41:04;83960006;83846848;113158;
04.02.2019;20:42:04;83960132;83846928;113204;
04.02.2019;20:43:04;83960247;83846994;113253;
04.02.2019;20:44:37;83960433;83847092;113341;
04.02.2019;20:45:05;83960487;83847115;113372;
04.02.2019;20:46:06;83960619;83847180;113439;
04.02.2019;20:47:52;83960849;83847318;113531;
04.02.2019;20:48:05;83960883;83847336;113547;
04.02.2019;20:49:04;83961027;83847417;113610;
04.02.2019;20:50:04;83961154;83847485;113669;
04.02.2019;20:52:04;83961383;83847608;113775;
04.02.2019;20:52:09;83961398;83847611;113787;
04.02.2019;20:53:05;83961522;83847675;113847;
04.02.2019;20:54:05;83961648;83847749;113899;
04.02.2019;20:55:26;83961790;83847841;113949;
04.02.2019;20:56:04;83961907;83847873;114034;
04.02.2019;20:57:05;83962049;83847932;114117;
04.02.2019;20:58:05;83962181;83848014;114167;
04.02.2019;20:59:05;83962323;83848076;114247;
04.02.2019;21:00:05;83962459;83848156;114303;
04.02.2019;21:01:05;83962583;83848212;114371;
04.02.2019;21:02:05;83962730;83848273;114457;
04.02.2019;21:03:05;83962847;83848347;114500;
04.02.2019;21:05:05;83963131;83848468;114663;
04.02.2019;21:06:05;83963274;83848535;114739;
04.02.2019;21:07:04;83963386;83848603;114783;
04.02.2019;21:08:04;83963530;83848669;114861;
04.02.2019;21:09:04;83963668;83848743;114925;
04.02.2019;21:10:05;83963825;83848818;115007;
04.02.2019;21:11:05;83963944;83848892;115052;
04.02.2019;21:12:05;83964066;83848967;115099;
04.02.2019;21:13:05;83964182;83849015;115167;
04.02.2019;21:14:07;83964340;83849075;115265;
04.02.2019;21:15:15;83964467;83849139;115328;
04.02.2019;21:16:14;83964624;83849196;115428;
04.02.2019;21:17:07;83964767;83849270;115497;
04.02.2019;21:18:11;83964914;83849337;115577;
04.02.2019;21:19:06;83965075;83849401;115674;
04.02.2019;21:21:08;83965338;83849545;115793;
04.02.2019;21:22:16;83965498;83849610;115888;
04.02.2019;21:23:07;83965612;83849649;115963;
04.02.2019;21:24:11;83965741;83849717;116024;
04.02.2019;21:36:05;83967353;83850325;117028;
04.02.2019;21:37:05;83967493;83850387;117106;
04.02.2019;21:38:04;83967624;83850434;117190;
04.02.2019;21:39:11;83967781;83850497;117284;
04.02.2019;21:40:15;83967943;83850543;117400;
04.02.2019;21:43:09;83968330;83850695;117635;
04.02.2019;21:44:05;83968451;83850748;117703;
04.02.2019;21:45:08;83968610;83850802;117808;
04.02.2019;21:47:05;83974964;83850889;124075;
04.02.2019;21:47:10;83974845;83850895;123950;
04.02.2019;21:48:08;83975092;83850951;124141;
04.02.2019;21:49:05;83975227;83851010;124217;
04.02.2019;21:50:05;83975369;83851060;124309;
04.02.2019;21:51:04;83975480;83851100;124380;
04.02.2019;21:52:04;83975627;83851148;124479;
04.02.2019;21:53:05;83975758;83851200;124558;
04.02.2019;21:54:04;83975883;83851251;124632;
04.02.2019;21:55:04;83975982;83851248;124734;
04.02.2019;21:56:08;83976120;83851295;124825;
04.02.2019;21:57:05;83976228;83851331;124897;
04.02.2019;21:58:04;83976341;83851361;124980;
04.02.2019;21:59:04;83976467;83851431;125036;
04.02.2019;22:00:06;83976592;83851467;125125;
04.02.2019;22:01:04;83976710;83851512;125198;
04.02.2019;22:02:05;83976845;83851541;125304;
04.02.2019;22:03:05;83976970;83851584;125386;
04.02.2019;22:04:15;83977129;83851622;125507;
04.02.2019;22:05:05;83977256;83851665;125591;
04.02.2019;22:06:04;83977392;83851715;125677;
04.02.2019;22:07:04;83977536;83851762;125774;
04.02.2019;22:08:04;83977674;83851811;125863;
04.02.2019;22:10:05;83977936;83851905;126031;
04.02.2019;22:11:04;83978048;83851939;126109;
04.02.2019;22:12:04;83978154;83851984;126170;
04.02.2019;22:13:05;83978237;83852028;126209;
04.02.2019;22:15:05;83978549;83852128;126421;
04.02.2019;22:15:09;83978564;83852133;126431;
04.02.2019;22:16:04;83978654;83852166;126488;
04.02.2019;22:17:04;83978781;83852202;126579;
04.02.2019;22:18:20;83978885;83859426;119459;
04.02.2019;22:19:04;83978973;83859428;119545;
04.02.2019;22:20:05;83979065;83859464;119601;
04.02.2019;22:21:04;83979210;83859490;119720;
04.02.2019;22:22:21;83979347;83859541;119806;
04.02.2019;22:23:04;83979428;83859569;119859;
04.02.2019;22:24:05;83979506;83859600;119906;
04.02.2019;22:25:05;83979616;83859619;119997;
04.02.2019;22:26:11;83979733;83859633;120100;
04.02.2019;22:27:37;83979875;83859660;120215;
04.02.2019;22:28:04;83979915;83859691;120224;
04.02.2019;22:29:04;83979981;83859714;120267;
04.02.2019;22:30:07;83980080;83859749;120331;
04.02.2019;22:31:24;83980178;83859786;120392;
04.02.2019;22:32:04;83980263;83859797;120466;
04.02.2019;22:33:06;83980362;83859846;120516;
04.02.2019;22:34:05;83980463;83859880;120583;
04.02.2019;22:35:06;83980563;83859920;120643;
04.02.2019;22:36:05;83980688;83859965;120723;
04.02.2019;22:37:05;83980811;83859994;120817;
04.02.2019;22:38:04;83980919;83860038;120881;
04.02.2019;22:39:07;83981042;83860065;120977;
04.02.2019;22:41:05;83981252;83860131;121121;
04.02.2019;22:42:04;83981364;83860167;121197;
04.02.2019;22:43:04;83981486;83860195;121291;
04.02.2019;22:44:05;83981592;83860226;121366;
04.02.2019;22:45:04;83981748;83860264;121484;
04.02.2019;22:46:05;83981859;83860311;121548;
04.02.2019;22:47:05;83981976;83860335;121641;
04.02.2019;22:48:05;83982081;83860372;121709;
04.02.2019;22:49:04;83982203;83860412;121791;
04.02.2019;22:51:06;83982440;83860496;121944;
04.02.2019;22:52:14;83982565;83860541;122024;
04.02.2019;22:53:05;83982676;83860566;122110;
04.02.2019;22:54:05;83982802;83860590;122212;
04.02.2019;22:55:05;83982903;83860621;122282;
04.02.2019;22:56:04;83983016;83860654;122362;
04.02.2019;22:57:06;83983155;83860698;122457;
04.02.2019;22:58:04;83983269;83860740;122529;
04.02.2019;22:59:04;83983374;83860795;122579;
04.02.2019;23:00:05;83983494;83860827;122667;
04.02.2019;23:01:37;83983677;83860883;122794;
04.02.2019;23:02:04;83983724;83860902;122822;
04.02.2019;23:03:06;83983826;83860943;122883;
04.02.2019;23:04:04;83983930;83860989;122941;
04.02.2019;23:05:05;83984084;83861015;123069;
04.02.2019;23:06:05;83984244;83861051;123193;
04.02.2019;23:07:51;83984609;83861123;123486;
04.02.2019;23:08:04;83984646;83861131;123515;
04.02.2019;23:09:07;83984852;83861180;123672;
04.02.2019;23:10:05;83985006;83861219;123787;
04.02.2019;23:11:05;83985179;83861239;123940;
04.02.2019;23:12:36;83985470;83861305;124165;
04.02.2019;23:13:04;83985561;83861323;124238;
04.02.2019;23:14:04;83985744;83861368;124376;
04.02.2019;23:15:04;83985944;83861392;124552;
04.02.2019;23:16:05;83986150;83861446;124704;
04.02.2019;23:17:05;83986368;83861473;124895;
04.02.2019;23:18:05;83986530;83861504;125026;
04.02.2019;23:19:04;83986731;83861533;125198;
04.02.2019;23:20:05;83986937;83861564;125373;
04.02.2019;23:21:05;83987115;83861599;125516;
04.02.2019;23:22:05;83987292;83861615;125677;
04.02.2019;23:23:05;83987491;83861651;125840;
04.02.2019;23:24:05;83987689;83861702;125987;
04.02.2019;23:25:05;83987854;83861737;126117;
04.02.2019;23:27:05;83988209;83861792;126417;
04.02.2019;23:28:05;83988387;83861842;126545;
04.02.2019;23:29:05;83988598;83861872;126726;
04.02.2019;23:31:05;83988936;83861933;127003;
04.02.2019;23:32:05;83989092;83861963;127129;
04.02.2019;23:33:04;83989269;83861984;127285;
04.02.2019;23:34:04;83989447;83862015;127432;
04.02.2019;23:36:04;83989769;83862082;127687;
04.02.2019;23:36:15;83989790;83862091;127699;
04.02.2019;23:37:06;83989924;83862121;127803;
04.02.2019;23:38:05;83990079;83862146;127933;
04.02.2019;23:39:07;83990259;83862176;128083;
04.02.2019;23:40:05;83990422;83862210;128212;
04.02.2019;23:41:05;83990593;83862233;128360;
04.02.2019;23:42:04;83990744;83862264;128480;
04.02.2019;23:43:36;83990980;83862314;128666;
04.02.2019;23:44:05;83991046;83862339;128707;
04.02.2019;23:45:05;83991211;83862377;128834;
04.02.2019;23:46:04;83991354;83862399;128955;
04.02.2019;23:47:04;83991525;83862435;129090;
04.02.2019;23:48:04;83991692;83862461;129231;
04.02.2019;23:49:04;83991850;83862485;129365;
04.02.2019;23:50:06;83992013;83862517;129496;
04.02.2019;23:51:05;83992192;83862538;129654;
04.02.2019;23:52:11;83992393;83862562;129831;
04.02.2019;23:53:04;83992558;83862591;129967;
04.02.2019;23:54:21;83992784;83862636;130148;
04.02.2019;23:55:05;83992896;83862661;130235;
04.02.2019;23:56:04;83993068;83862707;130361;
04.02.2019;23:57:04;83993256;83862743;130513;
04.02.2019;23:58:04;83993461;83862772;130689;
04.02.2019;23:59:04;83993678;83862807;130871;
05.02.2019;00:00:13;83993900;83862844;131056;
05.02.2019;00:01:08;83994093;83862861;131232;
05.02.2019;00:02:08;83994269;83862896;131373;
05.02.2019;00:03:07;83994432;83862913;131519;
05.02.2019;00:04:07;83994638;83862959;131679;
05.02.2019;00:05:07;83994864;83862980;131884;
05.02.2019;00:06:07;83995088;83863003;132085;
05.02.2019;00:07:08;83995295;83863025;132270;
05.02.2019;00:08:08;83995477;83863058;132419;
05.02.2019;00:09:08;83995670;83863083;132587;
05.02.2019;00:10:07;83995868;83863104;132764;
05.02.2019;00:11:08;83996085;83863137;132948;
05.02.2019;00:12:08;83996315;83863162;133153;
05.02.2019;00:13:08;83996507;83863196;133311;
05.02.2019;00:14:07;83996706;83863220;133486;
05.02.2019;00:15:07;83996889;83863244;133645;
05.02.2019;00:16:07;83997083;83863271;133812;
05.02.2019;00:17:08;83997293;83863286;134007;
05.02.2019;00:18:07;83997481;83863302;134179;
05.02.2019;00:19:07;83997684;83863318;134366;
05.02.2019;00:20:07;83997886;83863364;134522;
05.02.2019;00:21:08;83998096;83863396;134700;
05.02.2019;00:22:07;83998297;83863433;134864;
05.02.2019;00:23:08;83998557;83863435;135122;
05.02.2019;00:24:07;83998747;83863465;135282;
05.02.2019;00:25:07;83998963;83863486;135477;
05.02.2019;00:26:07;83999177;83863519;135658;
05.02.2019;00:27:07;83999423;83863547;135876;
05.02.2019;00:28:07;83999663;83863583;136080;
05.02.2019;00:29:07;83999911;83863607;136304;
05.02.2019;00:30:08;84000229;83863642;136587;
05.02.2019;00:31:08;84000473;83863662;136811;
05.02.2019;00:32:07;84000691;83863696;136995;
05.02.2019;00:33:07;84000905;83863709;137196;
05.02.2019;00:34:07;84001079;83863746;137333;
05.02.2019;00:35:08;84001345;83863780;137565;
05.02.2019;00:36:07;84001589;83863809;137780;
05.02.2019;00:37:08;84001823;83863841;137982;
05.02.2019;00:38:07;84002054;83863876;138178;
05.02.2019;00:39:08;84002270;83863908;138362;
05.02.2019;00:40:07;84002506;83863943;138563;
05.02.2019;00:41:07;84002726;83863986;138740;
05.02.2019;00:42:08;84002928;83864023;138905;
05.02.2019;00:43:07;84003135;83864045;139090;
05.02.2019;00:44:07;84003379;83864080;139299;
05.02.2019;00:45:07;84003579;83864104;139475;
05.02.2019;00:46:08;84003740;83864078;139662;
05.02.2019;00:47:08;84003969;83864111;139858;
05.02.2019;00:48:07;84004212;83864149;140063;
05.02.2019;00:49:07;84004467;83864193;140274;
05.02.2019;00:50:07;84004698;83864238;140460;
05.02.2019;00:51:07;84004912;83864273;140639;
05.02.2019;00:52:10;84005172;83864309;140863;
05.02.2019;00:53:06;84005373;83864342;141031;
05.02.2019;00:54:07;84005641;83864379;141262;
05.02.2019;00:55:07;84005867;83864404;141463;
05.02.2019;00:56:07;84006117;83864439;141678;
05.02.2019;00:57:08;84006324;83864475;141849;
05.02.2019;00:58:08;84006569;83864511;142058;
05.02.2019;00:59:07;84006751;83864532;142219;
05.02.2019;01:00:04;84006951;83864566;142385;
05.02.2019;01:01:04;84007145;83864613;142532;
05.02.2019;01:02:05;84007354;83864651;142703;
05.02.2019;01:03:05;84007569;83864686;142883;
05.02.2019;01:04:04;84007778;83864719;143059;
05.02.2019;01:05:05;84007992;83864757;143235;
05.02.2019;01:06:06;84008221;83864785;143436;
05.02.2019;01:07:05;84008431;83864816;143615;
05.02.2019;01:08:04;84008621;83864862;143759;
05.02.2019;01:09:07;84008832;83864912;143920;
05.02.2019;01:10:04;84009027;83864933;144094;
05.02.2019;01:11:04;84009224;83864967;144257;
05.02.2019;01:12:05;84009427;83865017;144410;
05.02.2019;01:13:05;84009629;83865049;144580;
05.02.2019;01:14:04;84009830;83865086;144744;
05.02.2019;01:15:05;84010031;83865126;144905;
05.02.2019;01:16:05;84010241;83865164;145077;
05.02.2019;01:17:05;84010436;83865196;145240;
05.02.2019;01:18:04;84010649;83865250;145399;
05.02.2019;01:19:04;84010858;83865292;145566;
05.02.2019;01:20:05;84011071;83865327;145744;
05.02.2019;01:21:04;84011258;83865364;145894;
05.02.2019;01:22:04;84011438;83865400;146038;
05.02.2019;01:23:05;84011641;83865443;146198;
05.02.2019;01:24:04;84011839;83865479;146360;
05.02.2019;01:25:04;84012018;83865523;146495;
05.02.2019;01:26:05;84012232;83865560;146672;
05.02.2019;01:27:05;84012437;83865621;146816;
05.02.2019;01:28:04;84012646;83865660;146986;
05.02.2019;01:29:05;84012842;83865707;147135;
05.02.2019;01:30:04;84013033;83865756;147277;
05.02.2019;01:31:04;84013229;83865790;147439;
05.02.2019;01:32:04;84013423;83865832;147591;
05.02.2019;01:33:05;84013611;83865881;147730;
05.02.2019;01:34:04;84013803;83865916;147887;
05.02.2019;01:35:04;84013992;83865958;148034;
05.02.2019;01:36:05;84014188;83866004;148184;
05.02.2019;01:37:04;84014417;83866056;148361;
05.02.2019;01:38:04;84014610;83866107;148503;
05.02.2019;01:39:07;84014834;83866153;148681;
05.02.2019;01:40:05;84014988;83866192;148796;
05.02.2019;01:41:04;84015150;83866243;148907;
05.02.2019;01:42:05;84015315;83866292;149023;
05.02.2019;01:43:04;84015507;83866366;149141;
05.02.2019;01:44:04;84015673;83866420;149253;
05.02.2019;01:45:05;84015868;83866474;149394;
05.02.2019;01:46:05;84016040;83866521;149519;
05.02.2019;01:47:05;84016237;83866578;149659;
05.02.2019;01:48:04;84016418;83866621;149797;
05.02.2019;01:49:04;84016622;83866660;149962;
05.02.2019;01:50:05;84016825;83866704;150121;
05.02.2019;01:51:05;84017033;83866751;150282;
05.02.2019;01:52:05;84017222;83866794;150428;
05.02.2019;01:53:04;84017427;83866850;150577;
05.02.2019;01:54:04;84017628;83866903;150725;
05.02.2019;01:55:09;84017813;83866965;150848;
05.02.2019;01:56:04;84018000;83867019;150981;
05.02.2019;01:57:05;84018172;83867073;151099;
05.02.2019;01:58:04;84018356;83867137;151219;
05.02.2019;01:59:04;84018549;83867202;151347;
05.02.2019;02:00:05;84018729;83867263;151466;
05.02.2019;02:01:04;84018916;83867334;151582;
05.02.2019;02:02:05;84019115;83867391;151724;
05.02.2019;02:03:04;84019289;83867460;151829;
05.02.2019;02:04:04;84019503;83867525;151978;
05.02.2019;02:05:05;84019691;83867593;152098;
05.02.2019;02:06:04;84019885;83867635;152250;
05.02.2019;02:07:05;84020075;83867707;152368;
05.02.2019;02:08:04;84020254;83867760;152494;
05.02.2019;02:09:07;84020430;83867825;152605;
05.02.2019;02:10:04;84020594;83867897;152697;
05.02.2019;02:11:04;84020798;83867960;152838;
05.02.2019;02:12:04;84020945;83868019;152926;
05.02.2019;02:13:04;84021155;83868087;153068;
05.02.2019;02:14:05;84021338;83868159;153179;
05.02.2019;02:15:04;84021483;83868254;153229;
05.02.2019;02:16:06;84021689;83868324;153365;
05.02.2019;02:17:05;84021877;83868397;153480;
05.02.2019;02:18:04;84022035;83868481;153554;
05.02.2019;02:19:05;84022230;83868549;153681;
05.02.2019;02:20:04;84022426;83868621;153805;
05.02.2019;02:21:04;84022626;83868696;153930;
05.02.2019;02:22:05;84022841;83868785;154056;
05.02.2019;02:23:04;84023004;83868843;154161;
05.02.2019;02:24:04;84023173;83868916;154257;
05.02.2019;02:25:04;84023309;83868981;154328;
05.02.2019;02:26:04;84023467;83869042;154425;
05.02.2019;02:27:05;84023587;83869127;154460;
05.02.2019;02:28:04;84023691;83869194;154497;
05.02.2019;02:29:04;84023825;83869258;154567;
05.02.2019;02:30:05;84023979;83869333;154646;
05.02.2019;02:31:04;84024139;83869433;154706;
05.02.2019;02:32:05;84024275;83869506;154769;
05.02.2019;02:33:04;84024418;83869575;154843;
05.02.2019;02:34:04;84024581;83869652;154929;
05.02.2019;02:35:05;84024731;83869747;154984;
05.02.2019;02:36:04;84024846;83869831;155015;
05.02.2019;02:37:05;84025026;83869926;155100;
05.02.2019;02:38:04;84025156;83870022;155134;
05.02.2019;02:39:04;84025316;83870100;155216;
05.02.2019;02:40:05;84025461;83870195;155266;
05.02.2019;02:41:04;84025623;83870271;155352;
05.02.2019;02:42:04;84025785;83870360;155425;
05.02.2019;02:43:05;84025921;83870466;155455;
05.02.2019;02:44:04;84026084;83870562;155522;
05.02.2019;02:45:05;84026261;83870637;155624;
05.02.2019;02:46:04;84026466;83870733;155733;
05.02.2019;02:47:04;84026659;83870834;155825;
05.02.2019;02:48:05;84026844;83870930;155914;
05.02.2019;02:49:04;84027008;83871024;155984;
05.02.2019;02:50:05;84027204;83871121;156083;
05.02.2019;02:51:05;84027389;83871210;156179;
05.02.2019;02:52:05;84027552;83871311;156241;
05.02.2019;02:53:04;84027712;83871404;156308;
05.02.2019;02:54:04;84027918;83871511;156407;
05.02.2019;02:55:05;84028098;83871645;156453;
05.02.2019;02:56:04;84028305;83871745;156560;
05.02.2019;02:57:04;84028484;83871849;156635;
05.02.2019;02:58:05;84028673;83871947;156726;
05.02.2019;02:59:04;84028845;83872064;156781;
05.02.2019;03:00:05;84029042;83872182;156860;
05.02.2019;03:01:04;84029228;83872284;156944;
05.02.2019;03:02:04;84029391;83872388;157003;
05.02.2019;03:03:05;84029564;83872496;157068;
05.02.2019;03:04:04;84029741;83872616;157125;
05.02.2019;03:05:05;84029915;83872729;157186;
05.02.2019;03:06:09;84030092;83872853;157239;
05.02.2019;03:07:04;84030263;83872960;157303;
05.02.2019;03:08:05;84030412;83873073;157339;
05.02.2019;03:09:06;84030605;83873195;157410;
05.02.2019;03:10:05;84030767;83873269;157498;
05.02.2019;03:11:04;84030941;83873374;157567;
05.02.2019;03:12:04;84031124;83873485;157639;
05.02.2019;03:13:05;84031295;83873611;157684;
05.02.2019;03:14:14;84031495;83873743;157752;
05.02.2019;03:15:05;84031639;83873846;157793;
05.02.2019;03:16:04;84031795;83873957;157838;
05.02.2019;03:17:04;84031949;83874089;157860;
05.02.2019;03:18:05;84032140;83874223;157917;
05.02.2019;03:19:04;84032316;83874332;157984;
05.02.2019;03:20:04;84032503;83874433;158070;
05.02.2019;03:21:05;84032681;83874543;158138;
05.02.2019;03:22:04;84032830;83874678;158152;
05.02.2019;03:23:05;84033019;83874792;158227;
05.02.2019;03:24:06;84033181;83874928;158253;
05.02.2019;03:25:04;84033371;83875061;158310;
05.02.2019;03:26:05;84033544;83875193;158351;
05.02.2019;03:27:04;84033727;83875331;158396;
05.02.2019;03:28:04;84033902;83875450;158452;
05.02.2019;03:29:04;84034083;83875594;158489;
05.02.2019;03:30:04;84034263;83875727;158536;
05.02.2019;03:31:05;84034436;83875857;158579;
05.02.2019;03:32:05;84034627;83875966;158661;
05.02.2019;03:33:04;84034796;83876082;158714;
05.02.2019;03:34:05;84034974;83876217;158757;
05.02.2019;03:35:04;84035151;83876343;158808;
05.02.2019;03:36:04;84035327;83876480;158847;
05.02.2019;03:37:05;84035461;83876616;158845;
05.02.2019;03:38:04;84035652;83876751;158901;
05.02.2019;03:39:07;84035852;83876879;158973;
05.02.2019;03:40:04;84036014;83876991;159023;
05.02.2019;03:41:05;84036174;83877147;159027;
05.02.2019;03:42:04;84036331;83877254;159077;
05.02.2019;03:43:04;84036495;83877396;159099;
05.02.2019;03:44:05;84036693;83877541;159152;
05.02.2019;03:45:04;84036845;83877692;159153;
05.02.2019;03:46:05;84037014;83877820;159194;
05.02.2019;03:47:05;84037185;83877942;159243;
05.02.2019;03:48:04;84037339;83878092;159247;
05.02.2019;03:49:05;84037503;83878256;159247;
05.02.2019;03:50:04;84037677;83878402;159275;
05.02.2019;03:51:05;84037850;83878541;159309;
05.02.2019;03:52:05;84038033;83878673;159360;
05.02.2019;03:53:04;84038198;83878807;159391;
05.02.2019;03:54:04;84038375;83878945;159430;
05.02.2019;03:55:05;84038570;83879063;159507;
05.02.2019;03:56:04;84038755;83879220;159535;
05.02.2019;03:57:05;84038930;83879347;159583;
05.02.2019;03:58:10;84039061;83879469;159592;
05.02.2019;03:59:05;84039236;83879592;159644;
05.02.2019;04:00:04;84039391;83879733;159658;
05.02.2019;04:01:06;84039529;83879858;159671;
05.02.2019;04:02:04;84039749;83880001;159748;
05.02.2019;04:03:04;84039906;83880149;159757;
05.02.2019;04:04:05;84040086;83880292;159794;
05.02.2019;04:05:04;84040236;83880437;159799;
05.02.2019;04:06:04;84040412;83880586;159826;
05.02.2019;04:07:05;84040579;83880704;159875;
05.02.2019;04:08:04;84040762;83880870;159892;
05.02.2019;04:09:06;84040942;83881021;159921;
05.02.2019;04:10:04;84041107;83881167;159940;
05.02.2019;04:11:04;84041279;83881282;159997;
05.02.2019;04:12:04;84041466;83881415;160051;
05.02.2019;04:13:04;84041642;83881548;160094;
05.02.2019;04:14:05;84041781;83881672;160109;
05.02.2019;04:15:05;84041954;83881765;160189;
05.02.2019;04:16:04;84042071;83881914;160157;
05.02.2019;04:17:05;84042233;83882037;160196;
05.02.2019;04:18:04;84042374;83882176;160198;
05.02.2019;04:19:04;84042537;83882300;160237;
05.02.2019;04:20:05;84042678;83882410;160268;
05.02.2019;04:21:04;84042824;83882541;160283;
05.02.2019;04:22:04;84042963;83882653;160310;
05.02.2019;04:23:04;84043089;83882791;160298;
05.02.2019;04:24:04;84043221;83882926;160295;
05.02.2019;04:25:05;84043342;83883074;160268;
05.02.2019;04:26:04;84043467;83883238;160229;
05.02.2019;04:27:05;84043591;83883386;160205;
05.02.2019;04:28:04;84043704;83883507;160197;
05.02.2019;04:29:04;84043818;83883630;160188;
05.02.2019;04:30:04;84043920;83883767;160153;
05.02.2019;04:31:04;84044036;83883885;160151;
05.02.2019;04:32:05;84044148;83884021;160127;
05.02.2019;04:33:04;84044262;83884148;160114;
05.02.2019;04:34:05;84044427;83884270;160157;
05.02.2019;04:35:04;84044588;83884391;160197;
05.02.2019;04:36:04;84044755;83884510;160245;
05.02.2019;04:37:05;84044889;83884654;160235;
05.02.2019;04:38:04;84044999;83884782;160217;
05.02.2019;04:39:05;84045157;83884919;160238;
05.02.2019;04:40:04;84045295;83885055;160240;
05.02.2019;04:41:04;84045457;83885203;160254;
05.02.2019;04:42:05;84045607;83885344;160263;
05.02.2019;04:43:04;84045762;83885481;160281;
05.02.2019;04:44:06;84045921;83885629;160292;
05.02.2019;04:45:04;84046070;83885780;160290;
05.02.2019;04:46:04;84046247;83885955;160292;
05.02.2019;04:47:05;84046408;83886085;160323;
05.02.2019;04:48:04;84046577;83886235;160342;
05.02.2019;04:49:05;84046722;83886323;160399;
05.02.2019;04:50:04;84046882;83886493;160389;
05.02.2019;04:51:04;84047037;83886631;160406;
05.02.2019;04:52:05;84047183;83886788;160395;
05.02.2019;04:53:04;84047317;83886929;160388;
05.02.2019;04:54:05;84047479;83887070;160409;
05.02.2019;04:55:04;84047624;83887197;160427;
05.02.2019;04:56:05;84047789;83887329;160460;
05.02.2019;04:57:05;84047935;83887477;160458;
05.02.2019;04:58:04;84048076;83887636;160440;
05.02.2019;04:59:04;84048223;83887777;160446;
05.02.2019;05:00:05;84048349;83887920;160429;
05.02.2019;05:01:04;84048475;83888046;160429;
05.02.2019;05:02:04;84048595;83888204;160391;
05.02.2019;05:03:05;84048766;83888333;160433;
05.02.2019;05:04:04;84048925;83888482;160443;
05.02.2019;05:05:05;84049085;83888599;160486;
05.02.2019;05:06:04;84049233;83888760;160473;
05.02.2019;05:07:04;84049390;83888900;160490;
05.02.2019;05:08:04;84049540;83889042;160498;
05.02.2019;05:09:06;84049694;83889182;160512;
05.02.2019;05:10:04;84049828;83889322;160506;
05.02.2019;05:11:04;84049978;83889448;160530;
05.02.2019;05:12:05;84050110;83889592;160518;
05.02.2019;05:13:04;84050256;83889734;160522;
05.02.2019;05:14:04;84050391;83889880;160511;
05.02.2019;05:15:05;84050540;83890019;160521;
05.02.2019;05:16:04;84050685;83890168;160517;
05.02.2019;05:17:05;84050805;83890313;160492;
05.02.2019;05:18:05;84050936;83890441;160495;
05.02.2019;05:19:05;84051062;83890566;160496;
05.02.2019;05:20:04;84051205;83890682;160523;
05.02.2019;05:21:05;84051354;83890793;160561;
05.02.2019;05:22:04;84051498;83890938;160560;
05.02.2019;05:23:04;84051631;83891068;160563;
05.02.2019;05:24:06;84051784;83891206;160578;
05.02.2019;05:25:04;84051902;83891340;160562;
05.02.2019;05:26:04;84052032;83891475;160557;
05.02.2019;05:27:05;84052164;83891634;160530;
05.02.2019;05:28:04;84052291;83891780;160511;
05.02.2019;05:29:05;84052427;83891881;160546;
05.02.2019;05:30:04;84052566;83892040;160526;
05.02.2019;05:31:04;84052715;83892188;160527;
05.02.2019;05:32:05;84052857;83892328;160529;
05.02.2019;05:33:04;84053025;83892482;160543;
05.02.2019;05:34:04;84053164;83892637;160527;
05.02.2019;05:35:04;84053304;83892784;160520;
05.02.2019;05:36:04;84053461;83892929;160532;
05.02.2019;05:37:10;84053610;83893092;160518;
05.02.2019;05:38:05;84053753;83893210;160543;
05.02.2019;05:39:12;84053871;83893363;160508;
05.02.2019;05:40:06;84054021;83893483;160538;
05.02.2019;05:41:05;84054168;83893637;160531;
05.02.2019;05:42:05;84054291;83893771;160520;
05.02.2019;05:43:05;84054435;83893898;160537;
05.02.2019;05:44:04;84054584;83894029;160555;
05.02.2019;05:45:04;84054717;83894152;160565;
05.02.2019;05:46:05;84054851;83894290;160561;
05.02.2019;05:47:04;84054987;83894414;160573;
05.02.2019;05:48:05;84055137;83894557;160580;
05.02.2019;05:49:04;84055255;83894715;160540;
05.02.2019;05:50:04;84055392;83894859;160533;
05.02.2019;05:51:05;84055536;83895005;160531;
05.02.2019;05:52:04;84055658;83895142;160516;
05.02.2019;05:53:04;84055803;83895274;160529;
05.02.2019;05:54:05;84055900;83895409;160491;
05.02.2019;05:55:05;84056010;83895540;160470;
05.02.2019;05:56:04;84056133;83895675;160458;
05.02.2019;05:57:04;84056253;83895805;160448;
05.02.2019;05:58:05;84056377;83895966;160411;
05.02.2019;05:59:04;84056528;83896090;160438;
05.02.2019;06:00:04;84056669;83896220;160449;
05.02.2019;06:01:05;84056809;83896367;160442;
05.02.2019;06:02:05;84056926;83896517;160409;
05.02.2019;06:03:05;84057046;83896655;160391;
05.02.2019;06:04:04;84057172;83896786;160386;
05.02.2019;06:05:05;84057300;83896920;160380;
05.02.2019;06:06:04;84057428;83897063;160365;
05.02.2019;06:07:04;84057549;83897205;160344;
05.02.2019;06:08:05;84057682;83897346;160336;
05.02.2019;06:09:06;84057800;83897474;160326;
05.02.2019;06:10:04;84057921;83897606;160315;
05.02.2019;06:11:05;84058053;83897754;160299;
05.02.2019;06:12:04;84058163;83897908;160255;
05.02.2019;06:13:04;84058255;83898042;160213;
05.02.2019;06:14:05;84058329;83898159;160170;
05.02.2019;06:15:04;84058405;83898282;160123;
05.02.2019;06:16:04;84058482;83898353;160129;
05.02.2019;06:17:05;84058571;83898511;160060;
05.02.2019;06:18:05;84058666;83898621;160045;
05.02.2019;06:19:04;84058757;83898754;160003;
05.02.2019;06:20:05;84058854;83898885;159969;
05.02.2019;06:21:05;84058957;83899016;159941;
05.02.2019;06:22:04;84059050;83899164;159886;
05.02.2019;06:23:05;84059151;83899308;159843;
05.02.2019;06:24:05;84059251;83899451;159800;
05.02.2019;06:25:07;84059369;83899591;159778;
05.02.2019;06:26:04;84059446;83899714;159732;
05.02.2019;06:27:05;84059551;83899847;159704;
05.02.2019;06:28:05;84059644;83899991;159653;
05.02.2019;06:29:04;84059728;83900115;159613;
05.02.2019;06:30:04;84059814;83900275;159539;
05.02.2019;06:31:05;84059914;83900382;159532;
05.02.2019;06:32:05;84059975;83900511;159464;
05.02.2019;06:33:04;84060066;83900649;159417;
05.02.2019;06:34:04;84060138;83900782;159356;
05.02.2019;06:35:05;84060242;83900921;159321;
05.02.2019;06:36:05;84060380;83901068;159312;
05.02.2019;06:37:04;84060508;83901206;159302;
05.02.2019;06:38:05;84060632;83901358;159274;
05.02.2019;06:39:07;84060758;83901462;159296;
05.02.2019;06:40:05;84060893;83901570;159323;
05.02.2019;06:41:04;84061004;83901684;159320;
05.02.2019;06:42:04;84061105;83901790;159315;
05.02.2019;06:43:05;84061209;83901931;159278;
05.02.2019;06:44:04;84061287;83902031;159256;
05.02.2019;06:45:04;84061397;83902158;159239;
05.02.2019;06:46:06;84061505;83902260;159245;
05.02.2019;06:47:05;84061588;83902343;159245;
05.02.2019;06:48:04;84061710;83902471;159239;
05.02.2019;06:49:05;84061837;83902626;159211;
05.02.2019;06:50:05;84061960;83902740;159220;
05.02.2019;06:51:05;84062081;83902877;159204;
05.02.2019;06:52:11;84062210;83903028;159182;
05.02.2019;06:53:10;84062342;83903160;159182;
05.02.2019;06:54:04;84062458;83903268;159190;
05.02.2019;06:55:05;84062582;83903400;159182;
05.02.2019;06:56:06;84062691;83903531;159160;
05.02.2019;06:57:04;84062805;83903648;159157;
05.02.2019;06:58:10;84062930;83903804;159126;
05.02.2019;06:59:09;84063042;83903909;159133;
05.02.2019;07:00:07;84063160;83904036;159124;
05.02.2019;07:01:05;84063271;83904170;159101;
05.02.2019;07:02:05;84063387;83904295;159092;
05.02.2019;07:03:05;84063511;83904420;159091;
05.02.2019;07:04:06;84063636;83904531;159105;
05.02.2019;07:05:06;84063770;83904645;159125;
05.02.2019;07:06:10;84063893;83904791;159102;
05.02.2019;07:07:05;84064011;83904900;159111;
05.02.2019;07:08:05;84064131;83905029;159102;
05.02.2019;07:09:06;84064229;83905168;159061;
05.02.2019;07:10:04;84064338;83905320;159018;
05.02.2019;07:11:05;84064465;83905451;159014;
05.02.2019;07:12:05;84064583;83905589;158994;
05.02.2019;07:13:04;84064702;83905752;158950;
05.02.2019;07:14:04;84064815;83905890;158925;
05.02.2019;07:15:06;84064941;83906031;158910;
05.02.2019;07:16:06;84065050;83906172;158878;
05.02.2019;07:17:05;84065139;83906308;158831;
05.02.2019;07:18:11;84065253;83906444;158809;
05.02.2019;07:19:04;84065337;83906571;158766;
05.02.2019;07:20:05;84065451;83906698;158753;
05.02.2019;07:21:04;84065575;83906798;158777;
05.02.2019;07:22:05;84065698;83906940;158758;
05.02.2019;07:23:05;84065813;83907101;158712;
05.02.2019;07:24:05;84065928;83907235;158693;
05.02.2019;07:25:05;84066055;83907371;158684;
05.02.2019;07:26:05;84066159;83907506;158653;
05.02.2019;07:27:04;84066274;83907641;158633;
05.02.2019;07:28:04;84066380;83907804;158576;
05.02.2019;07:29:05;84066527;83907924;158603;
05.02.2019;07:30:05;84066630;83908057;158573;
05.02.2019;07:31:04;84066735;83908195;158540;
05.02.2019;07:32:04;84066832;83908343;158489;
05.02.2019;07:33:05;84066933;83908458;158475;
05.02.2019;07:34:05;84067026;83908608;158418;
05.02.2019;07:35:05;84067128;83908744;158384;
05.02.2019;07:36:05;84067255;83908897;158358;
05.02.2019;07:37:04;84067351;83909025;158326;
05.02.2019;07:38:04;84067467;83909152;158315;
05.02.2019;07:39:07;84067581;83909305;158276;
05.02.2019;07:40:04;84067690;83909428;158262;
05.02.2019;07:41:05;84067792;83909546;158246;
05.02.2019;07:42:05;84067915;83909698;158217;
05.02.2019;07:43:05;84068023;83909837;158186;
05.02.2019;07:44:05;84068140;83909975;158165;
05.02.2019;07:45:04;84068265;83910126;158139;
05.02.2019;07:46:04;84068365;83910261;158104;
05.02.2019;07:47:05;84068485;83910407;158078;
05.02.2019;07:48:05;84068587;83910527;158060;
05.02.2019;07:49:05;84068697;83910674;158023;
05.02.2019;07:50:05;84068806;83910824;157982;
05.02.2019;07:51:04;84068914;83910959;157955;
05.02.2019;07:52:04;84069021;83911088;157933;
05.02.2019;07:53:05;84069140;83911234;157906;
05.02.2019;07:54:05;84069229;83911370;157859;
05.02.2019;07:55:05;84069330;83911480;157850;
05.02.2019;07:56:04;84069443;83911605;157838;
05.02.2019;07:57:04;84069531;83911729;157802;
05.02.2019;07:58:05;84069643;83911843;157800;
05.02.2019;07:59:05;84069735;83911978;157757;
05.02.2019;08:00:05;84069837;83912100;157737;
05.02.2019;08:01:04;84069924;83912228;157696;
05.02.2019;08:02:05;84070022;83912352;157670;
05.02.2019;08:03:05;84070116;83912477;157639;
05.02.2019;08:04:05;84070214;83912600;157614;
05.02.2019;08:05:05;84070326;83912744;157582;
05.02.2019;08:06:05;84070435;83912857;157578;
05.02.2019;08:07:05;84070532;83912987;157545;
05.02.2019;08:08:05;84070640;83913137;157503;
05.02.2019;08:09:05;84070749;83913277;157472;
05.02.2019;08:10:05;84070848;83913424;157424;
05.02.2019;08:11:05;84070933;83913523;157410;
05.02.2019;08:12:05;84071028;83913633;157395;
05.02.2019;08:13:04;84071130;83913712;157418;
05.02.2019;08:14:04;84071184;83913841;157343;
05.02.2019;08:15:05;84071252;83913973;157279;
05.02.2019;08:16:05;84071336;83914084;157252;
05.02.2019;08:17:05;84071397;83914203;157194;
05.02.2019;08:18:04;84071466;83914334;157132;
05.02.2019;08:19:05;84071534;83914466;157068;
05.02.2019;08:20:04;84071632;83914597;157035;
05.02.2019;08:21:05;84071724;83914733;156991;
05.02.2019;08:22:04;84071808;83914865;156943;
05.02.2019;08:23:06;84071889;83914977;156912;
05.02.2019;08:24:05;84071956;83915116;156840;
05.02.2019;08:25:04;84072030;83915254;156776;
05.02.2019;08:26:04;84072103;83915385;156718;
05.02.2019;08:27:05;84072190;83915487;156703;
05.02.2019;08:28:06;84072274;83915622;156652;
05.02.2019;08:29:04;84072371;83915755;156616;
05.02.2019;08:30:05;84072462;83915875;156587;
05.02.2019;08:31:04;84072556;83916006;156550;
05.02.2019;08:32:04;84072638;83916124;156514;
05.02.2019;08:33:05;84072733;83916257;156476;
05.02.2019;08:34:04;84072846;83916408;156438;
05.02.2019;08:35:05;84072939;83916546;156393;
05.02.2019;08:36:04;84073023;83916685;156338;
05.02.2019;08:37:04;84073109;83916810;156299;
05.02.2019;08:38:05;84073226;83916947;156279;
05.02.2019;08:39:06;84073328;83917092;156236;
05.02.2019;08:40:05;84073439;83917217;156222;
05.02.2019;08:41:05;84073524;83917368;156156;
05.02.2019;08:42:04;84073613;83917522;156091;
05.02.2019;08:43:04;84073715;83917648;156067;
05.02.2019;08:44:05;84073820;83917791;156029;
05.02.2019;08:45:04;84073931;83917912;156019;
05.02.2019;08:46:05;84074037;83918036;156001;
05.02.2019;08:47:04;84074151;83918176;155975;
05.02.2019;08:48:05;84074247;83918308;155939;
05.02.2019;08:49:04;84074366;83918454;155912;
05.02.2019;08:50:04;84074461;83918607;155854;
05.02.2019;08:51:05;84074590;83918753;155837;
05.02.2019;08:52:04;84074706;83918885;155821;
05.02.2019;08:53:05;84074796;83919048;155748;
05.02.2019;08:54:04;84074901;83919200;155701;
05.02.2019;08:55:04;84075024;83919365;155659;
05.02.2019;08:56:05;84075124;83919514;155610;
05.02.2019;08:57:04;84075232;83919667;155565;
05.02.2019;08:58:04;84075341;83919807;155534;
05.02.2019;08:59:05;84075446;83919958;155488;
05.02.2019;09:00:04;84075565;83920078;155487;
05.02.2019;09:01:05;84075679;83920228;155451;
05.02.2019;09:02:05;84075768;83920368;155400;
05.02.2019;09:03:04;84075851;83920510;155341;
05.02.2019;09:04:04;84075926;83920675;155251;
05.02.2019;09:05:05;84076032;83920826;155206;
05.02.2019;09:06:05;84076134;83920972;155162;
05.02.2019;09:07:05;84076215;83921105;155110;
05.02.2019;09:08:05;84076295;83921252;155043;
05.02.2019;09:09:07;84076400;83921427;154973;
05.02.2019;09:10:05;84076504;83921561;154943;
05.02.2019;09:11:05;84076600;83921707;154893;
05.02.2019;09:12:05;84076681;83921864;154817;
05.02.2019;09:13:05;84076791;83922005;154786;
05.02.2019;09:14:05;84076894;83922148;154746;
05.02.2019;09:15:05;84076986;83922284;154702;
05.02.2019;09:16:05;84077076;83922423;154653;
05.02.2019;09:17:04;84077156;83922575;154581;
05.02.2019;09:18:04;84077275;83922736;154539;
05.02.2019;09:19:05;84077386;83922897;154489;
05.02.2019;09:20:04;84077483;83923048;154435;
05.02.2019;09:21:04;84077590;83923182;154408;
05.02.2019;09:22:05;84077719;83923344;154375;
05.02.2019;09:23:04;84077818;83923484;154334;
05.02.2019;09:24:04;84077902;83923643;154259;
05.02.2019;09:25:04;84077998;83923789;154209;
05.02.2019;09:26:04;84078101;83923949;154152;
05.02.2019;09:27:04;84078191;83924078;154113;
05.02.2019;09:28:05;84078278;83924228;154050;
05.02.2019;09:29:04;84078351;83924379;153972;
05.02.2019;09:30:04;84078424;83924545;153879;
05.02.2019;09:31:05;84078526;83924694;153832;
05.02.2019;09:32:04;84078607;83924843;153764;
05.02.2019;09:33:04;84078701;83924988;153713;
05.02.2019;09:34:05;84078803;83925144;153659;
05.02.2019;09:35:04;84078888;83925307;153581;
05.02.2019;09:36:04;84078968;83925446;153522;
05.02.2019;09:37:05;84079065;83925618;153447;
05.02.2019;09:38:05;84079158;83925761;153397;
05.02.2019;09:39:06;84079247;83925924;153323;
05.02.2019;09:40:05;84079323;83926078;153245;
05.02.2019;09:41:05;84079415;83926216;153199;
05.02.2019;09:42:04;84079501;83926367;153134;
05.02.2019;09:43:05;84079591;83926493;153098;
05.02.2019;09:44:05;84079685;83926648;153037;
05.02.2019;09:45:05;84079772;83926814;152958;
05.02.2019;09:46:04;84079868;83926971;152897;
05.02.2019;09:47:04;84079951;83927082;152869;
05.02.2019;09:48:05;84080051;83927231;152820;
05.02.2019;09:49:04;84080143;83927388;152755;
05.02.2019;09:50:04;84080238;83927528;152710;
05.02.2019;09:51:05;84080303;83927649;152654;
05.02.2019;09:52:05;84080394;83927773;152621;
05.02.2019;09:53:05;84080447;83927863;152584;
05.02.2019;09:54:05;84080521;83927925;152596;
05.02.2019;09:55:05;84080600;83928059;152541;
05.02.2019;09:56:04;84080685;83928157;152528;
05.02.2019;09:57:04;84080792;83928300;152492;
05.02.2019;09:58:05;84080891;83928410;152481;
05.02.2019;09:59:05;84080978;83928550;152428;
05.02.2019;10:00:04;84081074;83928724;152350;
05.02.2019;10:01:05;84081168;83928875;152293;
05.02.2019;10:02:05;84081251;83929015;152236;
05.02.2019;10:03:04;84081355;83929149;152206;
05.02.2019;10:04:04;84081434;83929284;152150;
05.02.2019;10:05:05;84081492;83929402;152090;
05.02.2019;10:06:04;84081535;83929536;151999;
05.02.2019;10:07:05;84081573;83929666;151907;
05.02.2019;10:08:05;84081625;83929782;151843;
05.02.2019;10:09:07;84081665;83929902;151763;
05.02.2019;10:10:04;84081727;83929993;151734;
05.02.2019;10:11:04;84081787;83930104;151683;
05.02.2019;10:12:05;84081842;83930229;151613;
05.02.2019;10:13:05;84081915;83930344;151571;
05.02.2019;10:14:04;84081964;83930472;151492;
05.02.2019;10:15:04;84082044;83930615;151429;
05.02.2019;10:16:05;84082095;83930740;151355;
05.02.2019;10:17:04;84082167;83930876;151291;
05.02.2019;10:18:04;84082241;83931005;151236;
05.02.2019;10:19:05;84082315;83931142;151173;
05.02.2019;10:20:04;84082404;83931301;151103;
05.02.2019;10:21:04;84082482;83931431;151051;
05.02.2019;10:22:05;84082550;83931572;150978;
05.02.2019;10:23:04;84082633;83931716;150917;
05.02.2019;10:24:05;84082710;83931885;150825;
05.02.2019;10:25:04;84082814;83932047;150767;
05.02.2019;10:26:04;84082894;83932166;150728;
05.02.2019;10:27:05;84082965;83932321;150644;
05.02.2019;10:28:04;84083053;83932487;150566;
05.02.2019;10:29:04;84083148;83932620;150528;
05.02.2019;10:30:05;84083238;83932769;150469;
05.02.2019;10:31:04;84083320;83932942;150378;
05.02.2019;10:32:04;84083404;83933092;150312;
05.02.2019;10:33:05;84083490;83933247;150243;
05.02.2019;10:34:04;84083596;83933418;150178;
05.02.2019;10:35:04;84083683;83933585;150098;
05.02.2019;10:36:05;84083747;83933711;150036;
05.02.2019;10:37:05;84083822;83933866;149956;
05.02.2019;10:38:05;84083929;83934027;149902;
05.02.2019;10:39:06;84084016;83934188;149828;
05.02.2019;10:40:05;84084093;83934313;149780;
05.02.2019;10:41:04;84084182;83934451;149731;
05.02.2019;10:42:05;84084291;83934614;149677;
05.02.2019;10:43:04;84084371;83934730;149641;
05.02.2019;10:44:05;84084432;83934877;149555;
05.02.2019;10:45:04;84084521;83935064;149457;
05.02.2019;10:46:04;84084612;83935195;149417;
05.02.2019;10:47:05;84084710;83935354;149356;
05.02.2019;10:48:04;84084784;83935506;149278;
05.02.2019;10:49:05;84084864;83935679;149185;
05.02.2019;10:50:04;84084953;83935819;149134;
05.02.2019;10:51:04;84085036;83935966;149070;
05.02.2019;10:52:05;84085143;83936134;149009;
05.02.2019;10:53:04;84085218;83936283;148935;
05.02.2019;10:54:04;84085293;83936420;148873;
05.02.2019;10:55:05;84085373;83936593;148780;
05.02.2019;10:56:04;84085463;83936746;148717;
05.02.2019;10:57:04;84085533;83936909;148624;
05.02.2019;10:58:05;84085650;83937057;148593;
05.02.2019;10:59:04;84085736;83937203;148533;
05.02.2019;11:00:04;84085846;83937355;148491;
05.02.2019;11:01:05;84085923;83937538;148385;
05.02.2019;11:02:04;84086002;83937698;148304;
05.02.2019;11:03:05;84086073;83937847;148226;
05.02.2019;11:04:05;84086140;83938028;148112;
05.02.2019;11:05:05;84086199;83938202;147997;
05.02.2019;11:06:04;84086272;83938358;147914;
05.02.2019;11:07:05;84086353;83938511;147842;
05.02.2019;11:08:04;84086458;83938667;147791;
05.02.2019;11:09:06;84086563;83938811;147752;
05.02.2019;11:10:05;84086654;83938991;147663;
05.02.2019;11:11:04;84086739;83939145;147594;
05.02.2019;11:12:04;84086836;83939306;147530;
05.02.2019;11:13:05;84086914;83939493;147421;
05.02.2019;11:14:04;84087004;83939643;147361;
05.02.2019;11:15:04;84087120;83939789;147331;
05.02.2019;11:16:04;84087197;83939940;147257;
05.02.2019;11:17:05;84087284;83940122;147162;
05.02.2019;11:18:05;84087364;83940255;147109;
05.02.2019;11:19:05;84087445;83940416;147029;
05.02.2019;11:20:05;84087523;83940570;146953;
05.02.2019;11:21:05;84087627;83940733;146894;
05.02.2019;11:22:04;84087706;83940869;146837;
05.02.2019;11:23:04;84087786;83941007;146779;
05.02.2019;11:24:05;84087883;83941178;146705;
05.02.2019;11:25:04;84087970;83941320;146650;
05.02.2019;11:26:04;84088039;83941467;146572;
05.02.2019;11:27:05;84088122;83941621;146501;
05.02.2019;11:28:04;84088193;83941792;146401;
05.02.2019;11:29:04;84088267;83941966;146301;
05.02.2019;11:30:04;84088329;83942132;146197;
05.02.2019;11:31:04;84088406;83942287;146119;
05.02.2019;11:32:07;84088483;83942452;146031;
05.02.2019;11:33:04;84088564;83942606;145958;
05.02.2019;11:34:05;84088660;83942748;145912;
05.02.2019;11:35:05;84088740;83942912;145828;
05.02.2019;11:36:04;84088810;83943094;145716;
05.02.2019;11:37:05;84088893;83943251;145642;
05.02.2019;11:38:04;84088970;83943392;145578;
05.02.2019;11:39:06;84089054;83943555;145499;
05.02.2019;11:40:05;84089128;83943711;145417;
05.02.2019;11:41:04;84089215;83943872;145343;
05.02.2019;11:42:04;84089286;83944013;145273;
05.02.2019;11:43:06;84089376;83944189;145187;
05.02.2019;11:44:05;84089476;83944333;145143;
05.02.2019;11:45:04;84089542;83944479;145063;
05.02.2019;11:46:06;84089635;83944629;145006;
05.02.2019;11:47:04;84089720;83944801;144919;
05.02.2019;11:48:04;84089814;83944948;144866;
05.02.2019;11:49:05;84089913;83945088;144825;
05.02.2019;11:50:04;84090006;83945234;144772;
05.02.2019;11:51:04;84090092;83945377;144715;
05.02.2019;11:52:10;84090171;83945559;144612;
05.02.2019;11:53:10;84090268;83945740;144528;
05.02.2019;11:54:11;84090352;83945900;144452;
05.02.2019;11:55:05;84090430;83946036;144394;
05.02.2019;11:56:05;84090512;83946183;144329;
05.02.2019;11:57:11;84090629;83946346;144283;
05.02.2019;11:58:05;84090710;83946490;144220;
05.02.2019;11:59:06;84090814;83946678;144136;
05.02.2019;12:00:06;84090905;83946840;144065;
05.02.2019;12:01:04;84090994;83946969;144025;
05.02.2019;12:02:10;84090885;83947014;143871;
05.02.2019;12:03:06;84090757;83947032;143725;
05.02.2019;12:04:05;84090817;83947145;143672;
05.02.2019;12:05:04;84090896;83947291;143605;
05.02.2019;12:06:05;84091020;83947446;143574;
05.02.2019;12:07:04;84091110;83947584;143526;
05.02.2019;12:08:04;84091200;83947757;143443;
05.02.2019;12:09:06;84091290;83947928;143362;
05.02.2019;12:10:04;84091385;83948116;143269;
05.02.2019;12:11:06;84091468;83948282;143186;
05.02.2019;12:12:10;84091561;83948444;143117;
05.02.2019;12:13:05;84091641;83948604;143037;
05.02.2019;12:14:04;84091751;83948761;142990;
05.02.2019;12:15:05;84091833;83948914;142919;
05.02.2019;12:16:04;84091934;83949076;142858;
05.02.2019;12:17:05;84092010;83949254;142756;
05.02.2019;12:18:06;84092109;83949408;142701;
05.02.2019;12:19:04;84092221;83949592;142629;
05.02.2019;12:20:04;84092302;83949739;142563;
05.02.2019;12:21:05;84092392;83949900;142492;
05.02.2019;12:22:04;84092462;83950031;142431;
05.02.2019;12:23:04;84092585;83950168;142417;
05.02.2019;12:24:05;84092686;83950318;142368;
05.02.2019;12:25:04;84092768;83950480;142288;
05.02.2019;12:26:04;84092851;83950646;142205;
05.02.2019;12:27:05;84092938;83950800;142138;
05.02.2019;12:28:04;84093051;83950978;142073;
05.02.2019;12:29:05;84093159;83951147;142012;
05.02.2019;12:30:05;84093266;83951293;141973;
05.02.2019;12:31:04;84093355;83951465;141890;
05.02.2019;12:32:04;84093454;83951616;141838;
05.02.2019;12:33:05;84093556;83951763;141793;
05.02.2019;12:34:05;84093659;83951945;141714;
05.02.2019;12:35:04;84093767;83952103;141664;
05.02.2019;12:36:04;84093872;83952256;141616;
05.02.2019;12:37:05;84093980;83952443;141537;
05.02.2019;12:38:04;84094104;83952592;141512;
05.02.2019;12:39:06;84094200;83952763;141437;
05.02.2019;12:40:05;84094315;83952911;141404;
05.02.2019;12:41:05;84094420;83953103;141317;
05.02.2019;12:42:04;84094378;83953101;141277;
05.02.2019;12:43:04;84094000;83952550;141450;
05.02.2019;12:44:05;84094094;83952699;141395;
05.02.2019;12:45:04;84094185;83952874;141311;
05.02.2019;12:46:04;84094286;83953047;141239;
05.02.2019;12:47:05;84094386;83953211;141175;
05.02.2019;12:48:04;84094489;83953364;141125;
05.02.2019;12:49:05;84094603;83953523;141080;
05.02.2019;12:50:04;84094703;83953680;141023;
05.02.2019;12:51:04;84094804;83953851;140953;
05.02.2019;12:52:05;84094929;83953995;140934;
05.02.2019;12:53:04;84095034;83954144;140890;
05.02.2019;12:54:04;84095130;83954295;140835;
05.02.2019;12:55:08;84095235;83954441;140794;
05.02.2019;12:56:05;84095341;83954624;140717;
05.02.2019;12:57:04;84095431;83954819;140612;
05.02.2019;12:58:05;84095555;83954980;140575;
05.02.2019;12:59:05;84095631;83955094;140537;
05.02.2019;13:00:04;84095793;83955249;140544;
05.02.2019;13:01:04;84095908;83955400;140508;
05.02.2019;13:02:05;84096028;83955597;140431;
05.02.2019;13:03:04;84096130;83955754;140376;
05.02.2019;13:04:05;84096240;83955891;140349;
05.02.2019;13:05:04;84096370;83956067;140303;
05.02.2019;13:06:04;84096486;83956244;140242;
05.02.2019;13:07:05;84096581;83956400;140181;
05.02.2019;13:08:04;84096692;83956582;140110;
05.02.2019;13:09:06;84096808;83956727;140081;
05.02.2019;13:10:04;84096926;83956885;140041;
05.02.2019;13:11:04;84097052;83957036;140016;
05.02.2019;13:12:05;84097159;83957208;139951;
05.02.2019;13:13:04;84097300;83957375;139925;
05.02.2019;13:14:04;84097397;83957529;139868;
05.02.2019;13:15:05;84097540;83957718;139822;
05.02.2019;13:16:04;84097665;83957889;139776;
05.02.2019;13:17:04;84097767;83958054;139713;
05.02.2019;13:18:04;84097892;83958210;139682;
05.02.2019;13:19:05;84098016;83958393;139623;
05.02.2019;13:20:04;84098137;83958559;139578;
05.02.2019;13:21:05;84098250;83958712;139538;
05.02.2019;13:22:04;84098361;83958866;139495;
05.02.2019;13:23:04;84098498;83959003;139495;
05.02.2019;13:24:05;84098621;83959178;139443;
05.02.2019;13:25:04;84098716;83959374;139342;
05.02.2019;13:26:04;84098877;83959530;139347;
05.02.2019;13:27:05;84098991;83959703;139288;
05.02.2019;13:28:04;84099091;83959857;139234;
05.02.2019;13:29:04;84099232;83960009;139223;
05.02.2019;13:30:05;84099355;83960179;139176;
05.02.2019;13:31:04;84099466;83960335;139131;
05.02.2019;13:32:04;84099579;83960472;139107;
05.02.2019;13:33:05;84099694;83960637;139057;
05.02.2019;13:34:05;84099786;83960797;138989;
05.02.2019;13:35:05;84099903;83960945;138958;
05.02.2019;13:36:05;84100008;83961108;138900;
05.02.2019;13:37:04;84100131;83961276;138855;
05.02.2019;13:38:05;84100235;83961446;138789;
05.02.2019;13:39:07;84100381;83961616;138765;
05.02.2019;13:40:04;84100481;83961774;138707;
05.02.2019;13:41:04;84100579;83961925;138654;
05.02.2019;13:42:05;84100687;83962098;138589;
05.02.2019;13:43:05;84100860;83962281;138579;
05.02.2019;13:44:04;84101021;83962447;138574;
05.02.2019;13:45:05;84101172;83962617;138555;
05.02.2019;13:46:05;84101313;83962805;138508;
05.02.2019;13:47:04;84101463;83962970;138493;
05.02.2019;13:48:08;84101605;83963159;138446;
05.02.2019;13:49:05;84101740;83963303;138437;
05.02.2019;13:50:05;84101885;83963495;138390;
05.02.2019;13:51:08;84102020;83963695;138325;
05.02.2019;13:52:05;84102105;83963865;138240;
05.02.2019;13:53:04;84102265;83964021;138244;
05.02.2019;13:54:06;84102394;83964174;138220;
05.02.2019;13:55:05;84102528;83964351;138177;
05.02.2019;13:56:04;84102664;83964522;138142;
05.02.2019;13:57:05;84102800;83964695;138105;
05.02.2019;13:58:05;84102968;83964873;138095;
05.02.2019;13:59:05;84103096;83965085;138011;
05.02.2019;14:00:07;84103228;83965267;137961;
05.02.2019;14:01:04;84103356;83965436;137920;
05.02.2019;14:02:04;84103507;83965581;137926;
05.02.2019;14:03:05;84103636;83965745;137891;
05.02.2019;14:04:05;84103779;83965935;137844;
05.02.2019;14:05:08;84103892;83966128;137764;
05.02.2019;14:06:05;84103867;83966099;137768;
05.02.2019;14:07:04;84103790;83966175;137615;
05.02.2019;14:08:04;84103912;83966346;137566;
05.02.2019;14:09:10;84104060;83966522;137538;
05.02.2019;14:10:05;84104180;83966663;137517;
05.02.2019;14:11:05;84104309;83966848;137461;
05.02.2019;14:12:04;84104438;83967033;137405;
05.02.2019;14:13:07;84104595;83967236;137359;
05.02.2019;14:14:05;84104731;83967404;137327;
05.02.2019;14:15:05;84104871;83967589;137282;
05.02.2019;14:16:04;84105016;83967795;137221;
05.02.2019;14:17:05;84105184;83967973;137211;
05.02.2019;14:18:07;84105333;83968153;137180;
05.02.2019;14:19:04;84105461;83968337;137124;
05.02.2019;14:20:04;84105579;83968517;137062;
05.02.2019;14:21:05;84105714;83968700;137014;
05.02.2019;14:22:05;84105845;83968892;136953;
05.02.2019;14:23:06;84105979;83969093;136886;
05.02.2019;14:24:05;84106126;83969241;136885;
05.02.2019;14:25:04;84106254;83969440;136814;
05.02.2019;14:26:05;84106401;83969609;136792;
05.02.2019;14:27:07;84106544;83969796;136748;
05.02.2019;14:28:05;84106674;83969991;136683;
05.02.2019;14:29:05;84106816;83970170;136646;
05.02.2019;14:30:05;84106940;83970346;136594;
05.02.2019;14:31:04;84107085;83970529;136556;
05.02.2019;14:32:07;84107205;83970712;136493;
05.02.2019;14:33:05;84107315;83970882;136433;
05.02.2019;14:34:05;84107466;83971085;136381;
05.02.2019;14:35:05;84107604;83971246;136358;
05.02.2019;14:36:07;84107751;83971457;136294;
05.02.2019;14:37:05;84107884;83971655;136229;
05.02.2019;14:38:05;84108024;83971815;136209;
05.02.2019;14:39:08;84108161;83971997;136164;
05.02.2019;14:40:05;84108289;83972122;136167;
05.02.2019;14:41:07;84108417;83972287;136130;
05.02.2019;14:42:04;84108561;83972458;136103;
05.02.2019;14:43:05;84108699;83972633;136066;
05.02.2019;14:44:04;84108825;83972818;136007;
05.02.2019;14:45:06;84109004;83973005;135999;
05.02.2019;14:46:04;84109122;83973165;135957;
05.02.2019;14:47:04;84109261;83973350;135911;
05.02.2019;14:48:04;84109379;83973530;135849;
05.02.2019;14:49:05;84109506;83973691;135815;
05.02.2019;14:50:07;84109650;83973889;135761;
05.02.2019;14:51:04;84109789;83974055;135734;
05.02.2019;14:52:04;84109918;83974219;135699;
05.02.2019;14:53:05;84110066;83974391;135675;
05.02.2019;14:54:04;84110204;83974581;135623;
05.02.2019;14:55:07;84110347;83974751;135596;
05.02.2019;14:56:05;84110454;83974944;135510;
05.02.2019;14:57:05;84110565;83975122;135443;
05.02.2019;14:58:04;84110672;83975304;135368;
05.02.2019;14:59:07;84110805;83975486;135319;
05.02.2019;15:00:07;84110923;83975665;135258;
05.02.2019;15:01:10;84111067;83975831;135236;
05.02.2019;15:02:13;84111210;83976020;135190;
05.02.2019;15:03:10;84111302;83976204;135098;
05.02.2019;15:04:10;84111415;83976386;135029;
05.02.2019;15:05:13;84111552;83976584;134968;
05.02.2019;15:06:10;84111684;83976758;134926;
05.02.2019;15:07:16;84111780;83976957;134823;
05.02.2019;15:08:13;84111905;83977128;134777;
05.02.2019;15:09:18;84112057;83977312;134745;
05.02.2019;15:10:14;84112155;83977473;134682;
05.02.2019;15:11:16;84112274;83977684;134590;
05.02.2019;15:12:13;84112387;83977832;134555;
05.02.2019;15:13:16;84112537;83978034;134503;
05.02.2019;15:14:13;84112674;83978205;134469;
05.02.2019;15:15:16;84112816;83978375;134441;
05.02.2019;15:16:13;84112924;83978574;134350;
05.02.2019;15:17:19;84113043;83978762;134281;
05.02.2019;15:18:14;84113159;83978911;134248;
05.02.2019;15:19:20;84113273;83979084;134189;
05.02.2019;15:20:16;84113393;83979242;134151;
05.02.2019;15:21:20;84113513;83979443;134070;
05.02.2019;15:22:16;84113618;83979621;133997;
05.02.2019;15:23:19;84113731;83979790;133941;
05.02.2019;15:24:16;84113840;83979960;133880;
05.02.2019;15:25:18;84113978;83980175;133803;
05.02.2019;15:26:19;84114096;83980372;133724;
05.02.2019;15:27:16;84114206;83980556;133650;
05.02.2019;15:28:19;84114359;83980733;133626;
05.02.2019;15:29:16;84114482;83980899;133583;
05.02.2019;15:30:19;84114588;83981124;133464;
05.02.2019;15:31:16;84114719;83981299;133420;
05.02.2019;15:32:20;84114862;83981505;133357;
05.02.2019;15:33:16;84114968;83981688;133280;
05.02.2019;15:34:20;84115097;83981872;133225;
05.02.2019;15:35:19;84115215;83982061;133154;
05.02.2019;15:36:16;84115345;83982264;133081;
05.02.2019;15:37:19;84115456;83982433;133023;
05.02.2019;15:38:19;84115602;83982629;132973;
05.02.2019;15:39:19;84115728;83982821;132907;
05.02.2019;15:40:19;84115838;83983002;132836;
05.02.2019;15:41:20;84115964;83983175;132789;
05.02.2019;15:42:20;84116069;83983359;132710;
05.02.2019;15:43:21;84116220;83983537;132683;
05.02.2019;15:44:23;84116361;83983723;132638;
05.02.2019;15:45:20;84116496;83983904;132592;
05.02.2019;15:46:18;84116624;83984057;132567;
05.02.2019;15:47:14;84116749;83984211;132538;
05.02.2019;15:48:16;84116880;83984393;132487;
05.02.2019;15:49:14;84116979;83984563;132416;
05.02.2019;15:50:16;84117135;83984758;132377;
05.02.2019;15:51:15;84117258;83984941;132317;
05.02.2019;15:52:19;84117387;83985158;132229;
05.02.2019;15:53:17;84117506;83985322;132184;
05.02.2019;15:54:18;84117646;83985519;132127;
05.02.2019;15:55:16;84117781;83985716;132065;
05.02.2019;15:56:19;84117923;83985909;132014;
05.02.2019;15:57:16;84118048;83986085;131963;
05.02.2019;15:58:18;84118176;83986307;131869;
05.02.2019;15:59:18;84118295;83986490;131805;
05.02.2019;16:00:13;84118426;83986677;131749;
05.02.2019;16:01:11;84118540;83986862;131678;
05.02.2019;16:02:04;84118660;83987035;131625;
05.02.2019;16:03:04;84118773;83987224;131549;
05.02.2019;16:04:04;84118916;83987397;131519;
05.02.2019;16:05:05;84119025;83987623;131402;
05.02.2019;16:06:08;84119151;83987802;131349;
05.02.2019;16:07:04;84119225;83987940;131285;
05.02.2019;16:08:04;84119172;83988022;131150;
05.02.2019;16:09:07;84119092;83988099;130993;
05.02.2019;16:10:04;84119171;83988254;130917;
05.02.2019;16:11:07;84119319;83988465;130854;
05.02.2019;16:12:04;84119432;83988657;130775;
05.02.2019;16:13:05;84119543;83988843;130700;
05.02.2019;16:14:05;84119697;83989006;130691;
05.02.2019;16:15:07;84119836;83989204;130632;
05.02.2019;16:16:05;84119950;83989384;130566;
05.02.2019;16:17:05;84120081;83989581;130500;
05.02.2019;16:18:05;84120231;83989764;130467;
05.02.2019;16:19:04;84120364;83989928;130436;
05.02.2019;16:20:07;84120516;83990138;130378;
05.02.2019;16:21:05;84120656;83990307;130349;
05.02.2019;16:22:05;84120793;83990497;130296;
05.02.2019;16:23:05;84120941;83990687;130254;
05.02.2019;16:24:04;84121092;83990858;130234;
05.02.2019;16:25:05;84121234;83991058;130176;
05.02.2019;16:26:05;84121386;83991241;130145;
05.02.2019;16:27:07;84121524;83991445;130079;
05.02.2019;16:28:10;84121639;83991667;129972;
05.02.2019;16:29:07;84121768;83991825;129943;
05.02.2019;16:30:05;84121900;83991988;129912;
05.02.2019;16:31:05;84122048;83992185;129863;
05.02.2019;16:32:09;84122216;83992395;129821;
05.02.2019;16:33:06;84122363;83992576;129787;
05.02.2019;16:34:05;84122509;83992735;129774;
05.02.2019;16:35:04;84122645;83992941;129704;
05.02.2019;16:36:04;84122792;83993127;129665;
05.02.2019;16:37:05;84122908;83993314;129594;
05.02.2019;16:38:05;84123060;83993486;129574;
05.02.2019;16:39:06;84123219;83993703;129516;
05.02.2019;16:40:05;84123354;83993857;129497;
05.02.2019;16:41:05;84123478;83994040;129438;
05.02.2019;16:42:05;84123614;83994241;129373;
05.02.2019;16:43:04;84123769;83994429;129340;
05.02.2019;16:44:05;84123917;83994604;129313;
05.02.2019;16:45:05;84124076;83994802;129274;
05.02.2019;16:46:04;84124226;83994996;129230;
05.02.2019;16:47:04;84124395;83995185;129210;
05.02.2019;16:48:05;84124534;83995379;129155;
05.02.2019;16:49:05;84124683;83995597;129086;
05.02.2019;16:50:04;84124842;83995795;129047;
05.02.2019;16:51:05;84125012;83995985;129027;
05.02.2019;16:52:05;84125158;83996186;128972;
05.02.2019;16:53:05;84125296;83996392;128904;
05.02.2019;16:54:04;84125444;83996585;128859;
05.02.2019;16:55:05;84125609;83996764;128845;
05.02.2019;16:56:05;84125761;83996955;128806;
05.02.2019;16:57:04;84125900;83997127;128773;
05.02.2019;16:58:04;84126071;83997337;128734;
05.02.2019;16:59:05;84126228;83997577;128651;
05.02.2019;17:00:05;84126370;83997785;128585;
05.02.2019;17:01:05;84126510;83997951;128559;
05.02.2019;17:02:04;84126645;83998115;128530;
05.02.2019;17:03:04;84126805;83998299;128506;
05.02.2019;17:04:05;84126963;83998500;128463;
05.02.2019;17:05:05;84127113;83998692;128421;
05.02.2019;17:06:04;84127266;83998872;128394;
05.02.2019;17:07:04;84127418;83999060;128358;
05.02.2019;17:08:04;84127568;83999271;128297;
05.02.2019;17:09:05;84127713;83999468;128245;
05.02.2019;17:10:05;84127865;83999662;128203;
05.02.2019;17:11:05;84127994;83999882;128112;
05.02.2019;17:12:04;84128124;84000104;128020;
05.02.2019;17:13:05;84128294;84000316;127978;
05.02.2019;17:14:07;84128410;84000525;127885;
05.02.2019;17:15:04;84128606;84000711;127895;
05.02.2019;17:16:04;84128772;84000919;127853;
05.02.2019;17:17:05;84128918;84001117;127801;
05.02.2019;17:18:08;84129061;84001327;127734;
05.02.2019;17:19:05;84129217;84001526;127691;
05.02.2019;17:20:04;84129361;84001709;127652;
05.02.2019;17:21:04;84129498;84001941;127557;
05.02.2019;17:22:05;84129649;84002136;127513;
05.02.2019;17:23:08;84129802;84002341;127461;
05.02.2019;17:24:05;84129929;84002530;127399;
05.02.2019;17:25:05;84130069;84002726;127343;
05.02.2019;17:26:05;84130204;84002932;127272;
05.02.2019;17:27:06;84130355;84003152;127203;
05.02.2019;17:28:05;84130489;84003329;127160;
05.02.2019;17:29:05;84130639;84003522;127117;
05.02.2019;17:30:04;84130797;84003697;127100;
05.02.2019;17:31:04;84130948;84003870;127078;
05.02.2019;17:32:08;84131118;84004044;127074;
05.02.2019;17:33:05;84131246;84004265;126981;
05.02.2019;17:34:04;84131398;84004464;126934;
05.02.2019;17:35:04;84131543;84004661;126882;
05.02.2019;17:36:05;84131717;84004849;126868;
05.02.2019;17:37:07;84131874;84005046;126828;
05.02.2019;17:38:04;84131989;84005226;126763;
05.02.2019;17:39:07;84132115;84005399;126716;
05.02.2019;17:40:05;84132236;84005589;126647;
05.02.2019;17:41:07;84132375;84005765;126610;
05.02.2019;17:42:04;84132534;84005934;126600;
05.02.2019;17:43:04;84132661;84006131;126530;
05.02.2019;17:44:04;84132797;84006313;126484;
05.02.2019;17:45:05;84132975;84006533;126442;
05.02.2019;17:46:13;84133138;84006715;126423;
05.02.2019;17:47:05;84133278;84006884;126394;
05.02.2019;17:48:05;84133434;84007100;126334;
05.02.2019;17:49:04;84133611;84007290;126321;
05.02.2019;17:50:07;84133748;84007502;126246;
05.02.2019;17:51:04;84133900;84007659;126241;
05.02.2019;17:52:05;84134051;84007869;126182;
05.02.2019;17:53:05;84134216;84008072;126144;
05.02.2019;17:54:04;84134365;84008238;126127;
05.02.2019;17:55:07;84134507;84008438;126069;
05.02.2019;17:56:05;84134669;84008605;126064;
05.02.2019;18:06:05;84136313;84010354;125959;
05.02.2019;18:07:04;84136464;84010524;125940;
05.02.2019;18:08:05;84136628;84010683;125945;
05.02.2019;18:09:07;84136830;84010833;125997;
05.02.2019;18:10:04;84136951;84010979;125972;
05.02.2019;18:11:04;84137017;84011092;125925;
05.02.2019;18:12:04;84136994;84011082;125912;
05.02.2019;18:13:05;84137051;84011127;125924;
05.02.2019;18:14:04;84137172;84011274;125898;
05.02.2019;18:15:04;84137326;84011471;125855;
05.02.2019;18:16:05;84137449;84011641;125808;
05.02.2019;18:17:05;84137586;84011778;125808;
05.02.2019;18:18:05;84137745;84011949;125796;
05.02.2019;18:19:04;84137897;84012130;125767;
05.02.2019;18:20:04;84138067;84012336;125731;
05.02.2019;18:21:05;84138225;84012493;125732;
05.02.2019;18:22:04;84138410;84012623;125787;
05.02.2019;18:23:04;84138579;84012819;125760;
05.02.2019;18:24:04;84138734;84012983;125751;
05.02.2019;18:25:05;84138910;84013138;125772;
05.02.2019;18:26:05;84139073;84013282;125791;
05.02.2019;18:27:05;84139234;84013425;125809;
05.02.2019;18:28:04;84139386;84013606;125780;
05.02.2019;18:29:07;84139548;84013772;125776;
05.02.2019;18:30:04;84139689;84013912;125777;
05.02.2019;18:31:05;84139856;84014079;125777;
05.02.2019;18:32:05;84140017;84014223;125794;
05.02.2019;18:33:07;84140187;84014374;125813;
05.02.2019;18:34:04;84140343;84014549;125794;
05.02.2019;18:35:04;84140503;84014684;125819;
05.02.2019;18:36:05;84140650;84014827;125823;
05.02.2019;18:37:05;84140806;84014964;125842;
05.02.2019;18:38:07;84140976;84015106;125870;
05.02.2019;18:39:07;84141142;84015230;125912;
05.02.2019;18:40:05;84141255;84015380;125875;
05.02.2019;18:41:06;84141413;84015559;125854;
05.02.2019;18:42:04;84141556;84015705;125851;
05.02.2019;18:43:05;84141719;84015848;125871;
05.02.2019;18:44:04;84141871;84015978;125893;
05.02.2019;18:45:05;84142043;84016137;125906;
05.02.2019;18:46:05;84142177;84016252;125925;
05.02.2019;18:47:08;84142338;84016422;125916;
05.02.2019;18:48:06;84142465;84016529;125936;
05.02.2019;18:49:04;84142586;84016619;125967;
05.02.2019;18:50:05;84142724;84016763;125961;
05.02.2019;18:51:05;84142855;84016883;125972;
05.02.2019;18:52:07;84143025;84017035;125990;
05.02.2019;18:53:05;84143174;84017188;125986;
05.02.2019;18:54:04;84143314;84017350;125964;
05.02.2019;18:55:05;84143467;84017483;125984;
05.02.2019;18:56:08;84143624;84017654;125970;
05.02.2019;18:57:05;84143783;84017792;125991;
05.02.2019;18:58:04;84143929;84017954;125975;
05.02.2019;18:59:05;84144096;84018069;126027;
05.02.2019;19:00:05;84144263;84018221;126042;
05.02.2019;19:01:07;84144422;84018348;126074;
05.02.2019;19:02:04;84144566;84018464;126102;
05.02.2019;19:03:04;84144727;84018608;126119;
05.02.2019;19:04:05;84144843;84018735;126108;
05.02.2019;19:05:07;84144998;84018868;126130;
05.02.2019;19:06:05;84145138;84019004;126134;
05.02.2019;19:07:04;84145293;84019144;126149;
05.02.2019;19:08:10;84145433;84019300;126133;
05.02.2019;19:09:07;84145477;84019457;126020;
05.02.2019;19:10:07;84145550;84019594;125956;
05.02.2019;19:11:05;84145661;84019699;125962;
05.02.2019;19:12:06;84145780;84019849;125931;
05.02.2019;19:13:05;84145866;84019976;125890;
05.02.2019;19:14:05;84146003;84020093;125910;
05.02.2019;19:15:05;84146123;84020237;125886;
05.02.2019;19:16:05;84146239;84020372;125867;
05.02.2019;19:17:05;84146373;84020486;125887;
05.02.2019;19:18:05;84146492;84020602;125890;
05.02.2019;19:19:08;84146619;84020721;125898;
05.02.2019;19:20:04;84146745;84020845;125900;
05.02.2019;19:21:04;84146879;84020965;125914;
05.02.2019;19:22:05;84146996;84021090;125906;
05.02.2019;19:23:05;84147099;84021204;125895;
05.02.2019;19:24:07;84147252;84021329;125923;
05.02.2019;19:25:05;84147379;84021434;125945;
05.02.2019;19:26:05;84147505;84021550;125955;
05.02.2019;19:27:05;84147629;84021665;125964;
05.02.2019;19:28:08;84147771;84021790;125981;
05.02.2019;19:29:05;84147896;84021906;125990;
05.02.2019;19:30:05;84148015;84022025;125990;
05.02.2019;19:31:04;84148128;84022148;125980;
05.02.2019;19:32:04;84148258;84022229;126029;
05.02.2019;19:33:08;84148409;84022353;126056;
05.02.2019;19:34:05;84148503;84022479;126024;
05.02.2019;19:35:04;84148620;84022604;126016;
05.02.2019;19:36:05;84148750;84022684;126066;
05.02.2019;19:37:08;84148860;84022800;126060;
05.02.2019;19:38:05;84148959;84022901;126058;
05.02.2019;19:39:06;84149113;84022985;126128;
05.02.2019;19:40:05;84149239;84023088;126151;
05.02.2019;19:41:05;84149370;84023184;126186;
05.02.2019;19:42:08;84149490;84023306;126184;
05.02.2019;19:43:04;84149600;84023394;126206;
05.02.2019;19:44:04;84149713;84023508;126205;
05.02.2019;19:45:05;84149843;84023598;126245;
05.02.2019;19:46:08;84149959;84023727;126232;
05.02.2019;19:47:05;84150068;84023833;126235;
05.02.2019;19:48:04;84150242;84023917;126325;
05.02.2019;19:49:04;84150374;84023987;126387;
05.02.2019;19:50:05;84150496;84024090;126406;
05.02.2019;19:51:08;84150648;84024205;126443;
05.02.2019;19:52:05;84150807;84024307;126500;
05.02.2019;19:53:05;84150957;84024401;126556;
05.02.2019;19:54:04;84151074;84024497;126577;
05.02.2019;19:55:08;84151212;84024606;126606;
05.02.2019;19:56:05;84151349;84024694;126655;
05.02.2019;19:57:05;84151490;84024777;126713;
05.02.2019;19:58:05;84151597;84024880;126717;
05.02.2019;19:59:07;84151734;84024971;126763;
05.02.2019;20:00:06;84151878;84025068;126810;
05.02.2019;20:01:05;84152014;84025152;126862;
05.02.2019;20:02:05;84152147;84025241;126906;
05.02.2019;20:03:04;84152297;84025347;126950;
05.02.2019;20:04:08;84152436;84025441;126995;
05.02.2019;20:05:04;84152581;84025546;127035;
05.02.2019;20:06:05;84152682;84025642;127040;
05.02.2019;20:07:06;84152829;84025725;127104;
05.02.2019;20:08:07;84152972;84025801;127171;
05.02.2019;20:09:05;84153117;84025871;127246;
05.02.2019;20:10:04;84153224;84025938;127286;
05.02.2019;20:11:04;84153369;84026018;127351;
05.02.2019;20:12:05;84153505;84026099;127406;
05.02.2019;20:13:08;84153612;84026159;127453;
05.02.2019;20:14:05;84153572;84026119;127453;
05.02.2019;20:15:06;84153543;84026035;127508;
05.02.2019;20:16:05;84153605;84026117;127488;
05.02.2019;20:17:08;84153735;84026183;127552;
05.02.2019;20:18:05;84153859;84026262;127597;
05.02.2019;20:19:05;84154018;84026342;127676;
05.02.2019;20:20:04;84154158;84026435;127723;
05.02.2019;20:21:05;84154291;84026500;127791;
05.02.2019;20:22:07;84154451;84026583;127868;
05.02.2019;20:23:04;84154590;84026627;127963;
05.02.2019;20:24:05;84154722;84026696;128026;
05.02.2019;20:25:05;84154860;84026771;128089;
05.02.2019;20:26:09;84155032;84026848;128184;
05.02.2019;20:27:05;84155145;84026922;128223;
05.02.2019;20:28:05;84155266;84027000;128266;
05.02.2019;20:29:11;84155425;84027079;128346;
05.02.2019;20:30:05;84155532;84027139;128393;
05.02.2019;20:31:08;84155690;84027194;128496;
05.02.2019;20:32:05;84155799;84027245;128554;
05.02.2019;20:33:05;84155926;84027309;128617;
05.02.2019;20:34:05;84156061;84027368;128693;
05.02.2019;20:35:07;84156188;84027447;128741;
05.02.2019;20:36:06;84156299;84027515;128784;
05.02.2019;20:37:05;84156407;84027576;128831;
05.02.2019;20:38:05;84156544;84027626;128918;
05.02.2019;20:39:08;84156680;84027689;128991;
05.02.2019;20:40:09;84156825;84027762;129063;
05.02.2019;20:41:08;84156934;84027820;129114;
05.02.2019;20:42:05;84157040;84027876;129164;
05.02.2019;20:43:05;84157154;84027909;129245;
05.02.2019;20:44:07;84157281;84027962;129319;
05.02.2019;20:45:04;84157404;84028021;129383;
05.02.2019;20:46:05;84157537;84028079;129458;
05.02.2019;20:47:06;84157660;84028135;129525;
05.02.2019;20:48:05;84157779;84028195;129584;
05.02.2019;20:49:08;84157913;84028263;129650;
05.02.2019;20:50:05;84158052;84028339;129713;
05.02.2019;20:51:05;84158182;84028417;129765;
05.02.2019;20:52:05;84158310;84028495;129815;
05.02.2019;20:53:07;84158470;84028551;129919;
05.02.2019;20:54:05;84158596;84028614;129982;
05.02.2019;20:55:05;84158724;84028679;130045;
05.02.2019;20:56:05;84158858;84028745;130113;
05.02.2019;20:58:05;84159138;84028882;130256;
05.02.2019;20:59:05;84159301;84028950;130351;
05.02.2019;21:00:04;84159421;84029032;130389;
05.02.2019;21:01:04;84159575;84029102;130473;
05.02.2019;21:02:08;84159705;84029186;130519;
05.02.2019;21:03:06;84159861;84029248;130613;
05.02.2019;21:04:04;84159979;84029286;130693;
05.02.2019;21:05:04;84160093;84029324;130769;
05.02.2019;21:06:07;84160257;84029386;130871;
05.02.2019;21:07:05;84160374;84029433;130941;
05.02.2019;21:08:05;84160520;84029486;131034;
05.02.2019;21:09:07;84160650;84029562;131088;
05.02.2019;21:10:05;84160790;84029619;131171;
05.02.2019;21:11:07;84160919;84029678;131241;
05.02.2019;21:12:04;84161078;84029735;131343;
05.02.2019;21:13:04;84161210;84029786;131424;
05.02.2019;21:14:04;84161342;84029847;131495;
05.02.2019;21:15:06;84161481;84029903;131578;
05.02.2019;21:16:06;84161634;84029951;131683;
05.02.2019;21:17:04;84161796;84030006;131790;
05.02.2019;21:18:04;84161947;84030055;131892;
05.02.2019;21:19:11;84165837;84030118;135719;
05.02.2019;21:20:08;84165978;84030161;135817;
05.02.2019;21:21:11;84166094;84042164;123930;
05.02.2019;21:22:11;84166232;84042195;124037;
05.02.2019;21:23:06;84166376;84042240;124136;
05.02.2019;21:24:07;84166504;84042296;124208;
05.02.2019;21:25:13;84166645;84042354;124291;
05.02.2019;21:26:04;84166783;84042425;124358;
05.02.2019;21:27:04;84166935;84042480;124455;
05.02.2019;21:28:06;84167104;84042522;124582;
05.02.2019;21:29:13;84167224;84042576;124648;
05.02.2019;21:30:06;84167329;84042631;124698;
05.02.2019;21:31:06;84167451;84042681;124770;
05.02.2019;21:32:05;84167567;84042734;124833;
05.02.2019;21:33:05;84167699;84042786;124913;
05.02.2019;21:34:05;84167813;84042834;124979;
05.02.2019;21:35:05;84167947;84042873;125074;
05.02.2019;21:36:05;84168098;84042924;125174;
05.02.2019;21:37:05;84168260;84042971;125289;
05.02.2019;21:38:05;84168409;84043020;125389;
05.02.2019;21:39:07;84168531;84043054;125477;
05.02.2019;21:40:04;84168669;84043105;125564;
05.02.2019;21:41:05;84168799;84043151;125648;
05.02.2019;21:42:05;84168950;84043212;125738;
05.02.2019;21:43:04;84169076;84043245;125831;
05.02.2019;21:44:04;84169224;84043284;125940;
05.02.2019;21:45:09;84169351;84043356;125995;
05.02.2019;21:46:05;84169486;84043402;126084;
05.02.2019;21:47:05;84169635;84043426;126209;
05.02.2019;21:48:06;84169774;84043484;126290;
05.02.2019;21:49:04;84169898;84043529;126369;
05.02.2019;21:51:10;84170159;84043614;126545;
05.02.2019;21:52:05;84170277;84043652;126625;
05.02.2019;21:53:11;84170429;84043703;126726;
05.02.2019;21:54:04;84170538;84043737;126801;
05.02.2019;21:55:04;84170668;84043769;126899;
05.02.2019;21:56:10;84170768;84043809;126959;
05.02.2019;21:57:05;84170947;84043833;127114;
05.02.2019;21:58:05;84171087;84043882;127205;
05.02.2019;21:59:04;84171229;84043913;127316;
05.02.2019;22:00:04;84171352;84043954;127398;
05.02.2019;22:01:04;84171431;84043901;127530;
05.02.2019;22:02:05;84171599;84043933;127666;
05.02.2019;22:03:05;84171757;84043987;127770;
05.02.2019;22:04:04;84171885;84044027;127858;
05.02.2019;22:05:07;84172053;84044071;127982;
05.02.2019;22:06:04;84172175;84044105;128070;
05.02.2019;22:07:05;84172292;84044148;128144;
05.02.2019;22:08:06;84172411;84044182;128229;
05.02.2019;22:09:05;84172554;84044228;128326;
05.02.2019;22:10:05;84172654;84044241;128413;
05.02.2019;22:11:05;84172628;84044214;128414;
05.02.2019;22:12:04;84172631;84044236;128395;
05.02.2019;22:13:05;84172709;84044250;128459;
05.02.2019;22:14:04;84172805;84044268;128537;
05.02.2019;22:15:05;84172904;84044293;128611;
05.02.2019;22:16:05;84173003;84044328;128675;
05.02.2019;22:17:04;84173127;84044360;128767;
05.02.2019;22:18:04;84173267;84044390;128877;
05.02.2019;22:19:06;84173398;84044444;128954;
05.02.2019;22:20:05;84173540;84044485;129055;
05.02.2019;22:21:04;84173672;84044519;129153;
05.02.2019;22:22:04;84173801;84044542;129259;
05.02.2019;22:23:05;84173924;84044576;129348;
05.02.2019;22:24:07;84174066;84044619;129447;
05.02.2019;22:25:05;84174199;84044652;129547;
05.02.2019;22:26:05;84174317;84044701;129616;
05.02.2019;22:27:05;84174460;84044740;129720;
05.02.2019;22:28:06;84174613;84044785;129828;
05.02.2019;22:29:10;84174768;84044819;129949;
05.02.2019;22:30:04;84174887;84044832;130055;
05.02.2019;22:31:05;84175027;84044884;130143;
05.02.2019;22:32:06;84175167;84044929;130238;
05.02.2019;22:33:05;84175317;84044953;130364;
05.02.2019;22:34:04;84175441;84044988;130453;
05.02.2019;22:35:05;84175573;84045016;130557;
05.02.2019;22:36:06;84175703;84045045;130658;
05.02.2019;22:37:10;84175847;84045089;130758;
05.02.2019;22:38:06;84176015;84045108;130907;
05.02.2019;22:39:09;84176112;84045133;130979;
05.02.2019;22:40:04;84176271;84045174;131097;
05.02.2019;22:41:05;84176373;84045189;131184;
05.02.2019;22:42:05;84176512;84045215;131297;
05.02.2019;22:43:05;84176607;84045245;131362;
05.02.2019;22:44:17;84176736;84045311;131425;
05.02.2019;22:45:09;84176851;84045339;131512;
05.02.2019;22:46:04;84176971;84045372;131599;
05.02.2019;22:47:06;84177094;84045414;131680;
05.02.2019;22:48:05;84177219;84045452;131767;
05.02.2019;22:49:04;84177353;84045488;131865;
05.02.2019;22:50:10;84177504;84045514;131990;
05.02.2019;22:51:11;84177618;84045538;132080;
05.02.2019;22:52:11;84177738;84045563;132175;
05.02.2019;22:53:06;84177855;84045598;132257;
05.02.2019;22:54:06;84177989;84045633;132356;
05.02.2019;22:55:05;84178136;84045661;132475;
05.02.2019;22:56:06;84178283;84045689;132594;
05.02.2019;22:57:10;84178402;84045722;132680;
05.02.2019;22:58:05;84178526;84045756;132770;
05.02.2019;22:59:07;84178646;84045785;132861;
05.02.2019;23:00:05;84178772;84045809;132963;
05.02.2019;23:01:04;84178909;84045856;133053;
05.02.2019;23:02:11;84179047;84045890;133157;
05.02.2019;23:03:05;84179159;84045912;133247;
05.02.2019;23:04:07;84179279;84045945;133334;
05.02.2019;23:05:05;84179387;84045965;133422;
05.02.2019;23:06:06;84179537;84046001;133536;
05.02.2019;23:07:06;84179677;84046043;133634;
05.02.2019;23:08:05;84179803;84046067;133736;
05.02.2019;23:09:07;84179924;84046093;133831;
05.02.2019;23:10:04;84180062;84046127;133935;
05.02.2019;23:11:05;84180177;84046156;134021;
05.02.2019;23:12:05;84180283;84046183;134100;
05.02.2019;23:13:04;84180389;84046204;134185;
05.02.2019;23:14:05;84180511;84046235;134276;
05.02.2019;23:15:05;84180640;84046268;134372;
05.02.2019;23:16:04;84180734;84046283;134451;
05.02.2019;23:17:04;84180870;84046314;134556;
05.02.2019;23:18:05;84180983;84046338;134645;
05.02.2019;23:19:05;84181121;84046368;134753;
05.02.2019;23:20:04;84181235;84046391;134844;
05.02.2019;23:21:05;84181353;84046414;134939;
05.02.2019;23:23:04;84181593;84046473;135120;
05.02.2019;23:24:05;84181699;84046507;135192;
05.02.2019;23:25:05;84181812;84046535;135277;
05.02.2019;23:26:04;84181933;84046551;135382;
05.02.2019;23:28:04;84182194;84046618;135576;
05.02.2019;23:29:04;84182304;84046657;135647;
05.02.2019;23:30:05;84182425;84046686;135739;
05.02.2019;23:31:05;84182530;84046715;135815;
05.02.2019;23:32:04;84182672;84046752;135920;
05.02.2019;23:33:04;84182791;84046777;136014;
05.02.2019;23:34:05;84182912;84046815;136097;
05.02.2019;23:35:04;84183017;84046838;136179;
05.02.2019;23:36:04;84183132;84046862;136270;
05.02.2019;23:37:05;84183253;84046889;136364;
05.02.2019;23:38:04;84183369;84046923;136446;
05.02.2019;23:39:06;84183480;84046946;136534;
05.02.2019;23:40:06;84183613;84046970;136643;
05.02.2019;23:41:04;84183736;84047001;136735;
05.02.2019;23:42:05;84183877;84047033;136844;
05.02.2019;23:43:04;84183989;84047062;136927;
05.02.2019;23:44:04;84184107;84047089;137018;
05.02.2019;23:45:05;84184238;84047103;137135;
05.02.2019;23:46:04;84184361;84047126;137235;
05.02.2019;23:47:04;84184475;84047156;137319;
05.02.2019;23:48:05;84184604;84047186;137418;
05.02.2019;23:49:04;84184713;84047212;137501;
05.02.2019;23:50:04;84184812;84047240;137572;
05.02.2019;23:51:05;84184948;84047276;137672;
05.02.2019;23:52:09;84185041;84047307;137734;
05.02.2019;23:53:05;84185157;84047335;137822;
05.02.2019;23:54:04;84185260;84047364;137896;
05.02.2019;23:55:05;84185377;84047384;137993;
05.02.2019;23:56:05;84185471;84047414;138057;
05.02.2019;23:57:05;84185599;84047441;138158;
05.02.2019;23:58:08;84185733;84047468;138265;
05.02.2019;23:59:05;84185855;84047493;138362;
06.02.2019;00:00:07;84185970;84047525;138445;
06.02.2019;00:01:07;84186083;84047560;138523;
06.02.2019;00:02:08;84186195;84047586;138609;
06.02.2019;00:03:07;84186295;84047622;138673;
06.02.2019;00:04:08;84186407;84047647;138760;
06.02.2019;00:05:07;84186506;84047672;138834;
06.02.2019;00:06:07;84186593;84047703;138890;
06.02.2019;00:07:07;84186653;84047739;138914;
06.02.2019;00:08:07;84186812;84047762;139050;
06.02.2019;00:09:07;84186923;84047793;139130;
06.02.2019;00:10:08;84187040;84047821;139219;
06.02.2019;00:11:07;84187170;84047849;139321;
06.02.2019;00:12:07;84187277;84047878;139399;
06.02.2019;00:13:07;84187393;84047895;139498;
06.02.2019;00:14:07;84187515;84047927;139588;
06.02.2019;00:15:07;84187597;84047953;139644;
06.02.2019;00:16:07;84187568;84047947;139621;
06.02.2019;00:17:08;84187523;84047943;139580;
06.02.2019;00:18:07;84187547;84047927;139620;
06.02.2019;00:19:07;84187644;84047958;139686;
06.02.2019;00:20:07;84187738;84047985;139753;
06.02.2019;00:22:08;84187935;84048056;139879;
06.02.2019;00:23:07;84188029;84048079;139950;
06.02.2019;00:24:08;84188142;84048124;140018;
06.02.2019;00:25:07;84188220;84048165;140055;
06.02.2019;00:26:07;84188335;84048180;140155;
06.02.2019;00:27:07;84188451;84048215;140236;
06.02.2019;00:28:07;84188565;84048241;140324;
06.02.2019;00:29:07;84188668;84048269;140399;
06.02.2019;00:30:07;84188772;84048273;140499;
06.02.2019;00:31:06;84188868;84048323;140545;
06.02.2019;00:32:07;84188963;84048351;140612;
06.02.2019;00:33:07;84189061;84048371;140690;
06.02.2019;00:34:07;84189147;84048399;140748;
06.02.2019;00:35:07;84189262;84048428;140834;
06.02.2019;00:36:13;84189378;84048446;140932;
06.02.2019;00:37:13;84189479;84048491;140988;
06.02.2019;00:38:08;84189594;84048518;141076;
06.02.2019;00:39:07;84189715;84048549;141166;
06.02.2019;00:40:07;84189826;84048568;141258;
06.02.2019;00:41:08;84189925;84048596;141329;
06.02.2019;00:42:10;84190062;84048628;141434;
06.02.2019;00:43:07;84190183;84048660;141523;
06.02.2019;00:44:08;84190243;84048688;141555;
06.02.2019;00:45:08;84190387;84048720;141667;
06.02.2019;00:46:07;84190483;84048765;141718;
06.02.2019;00:47:08;84190606;84048801;141805;
06.02.2019;00:48:07;84190709;84048833;141876;
06.02.2019;00:49:07;84190813;84048855;141958;
06.02.2019;00:50:07;84190913;84048878;142035;
06.02.2019;00:51:07;84191015;84048913;142102;
06.02.2019;00:52:07;84191117;84048930;142187;
06.02.2019;00:53:07;84191219;84048958;142261;
06.02.2019;00:54:07;84191321;84048994;142327;
06.02.2019;00:55:07;84191421;84049029;142392;
06.02.2019;00:56:07;84191529;84049052;142477;
06.02.2019;00:57:08;84191643;84049072;142571;
06.02.2019;00:58:08;84191753;84049094;142659;
06.02.2019;00:59:08;84191843;84049146;142697;
06.02.2019;01:00:04;84191956;84049173;142783;
06.02.2019;01:01:05;84192056;84049206;142850;
06.02.2019;01:02:04;84192148;84049240;142908;
06.02.2019;01:03:04;84192260;84049274;142986;
06.02.2019;01:04:04;84192358;84049303;143055;
06.02.2019;01:05:04;84192456;84049333;143123;
06.02.2019;01:06:05;84192575;84049372;143203;
06.02.2019;01:07:04;84192672;84049409;143263;
06.02.2019;01:08:04;84192749;84049388;143361;
06.02.2019;01:09:06;84192852;84049420;143432;
06.02.2019;01:10:04;84192963;84049454;143509;
06.02.2019;01:11:05;84193070;84049478;143592;
06.02.2019;01:12:04;84193162;84049513;143649;
06.02.2019;01:13:05;84193261;84049541;143720;
06.02.2019;01:14:04;84193356;84049584;143772;
06.02.2019;01:15:04;84193457;84049609;143848;
06.02.2019;01:16:05;84193550;84049649;143901;
06.02.2019;01:17:05;84193622;84049672;143950;
06.02.2019;01:18:04;84193713;84049705;144008;
06.02.2019;01:19:05;84193810;84049737;144073;
06.02.2019;01:20:04;84193937;84049768;144169;
06.02.2019;01:21:04;84194046;84049813;144233;
06.02.2019;01:22:04;84194151;84049845;144306;
06.02.2019;01:23:04;84194256;84049888;144368;
06.02.2019;01:24:05;84194384;84049925;144459;
06.02.2019;01:25:04;84194483;84049960;144523;
06.02.2019;01:26:05;84194571;84049998;144573;
06.02.2019;01:27:04;84194657;84050014;144643;
06.02.2019;01:28:04;84194758;84050062;144696;
06.02.2019;01:29:04;84194856;84050094;144762;
06.02.2019;01:30:04;84194939;84050134;144805;
06.02.2019;01:31:05;84195049;84050174;144875;
06.02.2019;01:32:04;84195148;84050212;144936;
06.02.2019;01:33:05;84195235;84050261;144974;
06.02.2019;01:34:04;84195309;84050310;144999;
06.02.2019;01:35:04;84195421;84050358;145063;
06.02.2019;01:36:05;84195548;84050409;145139;
06.02.2019;01:37:04;84195639;84050449;145190;
06.02.2019;01:38:04;84195742;84050495;145247;
06.02.2019;01:39:06;84195856;84050545;145311;
06.02.2019;01:40:04;84195946;84050578;145368;
06.02.2019;01:41:05;84196039;84050602;145437;
06.02.2019;01:42:04;84196129;84050646;145483;
06.02.2019;01:43:04;84196200;84050691;145509;
06.02.2019;01:44:05;84196280;84050726;145554;
06.02.2019;01:45:04;84196378;84050777;145601;
06.02.2019;01:46:05;84196478;84050821;145657;
06.02.2019;01:47:04;84196574;84050854;145720;
06.02.2019;01:48:04;84196677;84050909;145768;
06.02.2019;01:49:05;84196765;84050964;145801;
06.02.2019;01:50:04;84196855;84050997;145858;
06.02.2019;01:51:05;84196966;84051040;145926;
06.02.2019;01:52:04;84197051;84051094;145957;
06.02.2019;01:53:05;84197142;84051144;145998;
06.02.2019;01:54:04;84197243;84051189;146054;
06.02.2019;01:55:04;84197330;84051244;146086;
06.02.2019;01:56:05;84197438;84051293;146145;
06.02.2019;01:57:04;84197538;84051350;146188;
06.02.2019;01:58:05;84197647;84051394;146253;
06.02.2019;01:59:04;84197752;84051463;146289;
06.02.2019;02:00:04;84197830;84051509;146321;
06.02.2019;02:01:04;84197893;84051561;146332;
06.02.2019;02:02:04;84198014;84051602;146412;
06.02.2019;02:03:05;84198118;84051657;146461;
06.02.2019;02:04:04;84198220;84051717;146503;
06.02.2019;02:05:05;84198304;84051759;146545;
06.02.2019;02:06:04;84198407;84051828;146579;
06.02.2019;02:07:04;84198524;84051866;146658;
06.02.2019;02:08:05;84198639;84051934;146705;
06.02.2019;02:09:06;84198742;84052002;146740;
06.02.2019;02:10:04;84198830;84052073;146757;
06.02.2019;02:11:05;84198943;84052135;146808;
06.02.2019;02:12:04;84199057;84052194;146863;
06.02.2019;02:13:04;84199141;84052256;146885;
06.02.2019;02:14:05;84199251;84052313;146938;
06.02.2019;02:15:04;84199356;84052370;146986;
06.02.2019;02:16:04;84199464;84052443;147021;
06.02.2019;02:17:05;84199555;84052518;147037;
06.02.2019;02:18:04;84199664;84052588;147076;
06.02.2019;02:19:04;84199769;84052649;147120;
06.02.2019;02:20:05;84199863;84052706;147157;
06.02.2019;02:21:04;84199968;84052771;147197;
06.02.2019;02:22:05;84200061;84052843;147218;
06.02.2019;02:23:04;84200159;84052898;147261;
06.02.2019;02:24:04;84200256;84052977;147279;
06.02.2019;02:25:05;84200336;84053044;147292;
06.02.2019;02:26:04;84200352;84053095;147257;
06.02.2019;02:27:05;84200391;84053151;147240;
06.02.2019;02:28:04;84200497;84053214;147283;
06.02.2019;02:29:04;84200541;84053269;147272;
06.02.2019;02:30:05;84200623;84053348;147275;
06.02.2019;02:31:04;84200680;84053416;147264;
06.02.2019;02:32:05;84200779;84053492;147287;
06.02.2019;02:33:04;84200864;84053575;147289;
06.02.2019;02:34:05;84200953;84053659;147294;
06.02.2019;02:35:04;84201070;84053727;147343;
06.02.2019;02:36:04;84201180;84053808;147372;
06.02.2019;02:37:05;84201265;84053879;147386;
06.02.2019;02:38:04;84201398;84053969;147429;
06.02.2019;02:39:06;84201508;84054048;147460;
06.02.2019;02:40:05;84201594;84054138;147456;
06.02.2019;02:41:04;84201716;84054235;147481;
06.02.2019;02:42:05;84201836;84054305;147531;
06.02.2019;02:43:04;84201939;84054385;147554;
06.02.2019;02:44:05;84202056;84054475;147581;
06.02.2019;02:45:04;84202145;84054568;147577;
06.02.2019;02:46:04;84202250;84054651;147599;
06.02.2019;02:47:04;84202369;84054734;147635;
06.02.2019;02:48:04;84202475;84054821;147654;
06.02.2019;02:49:05;84202571;84054897;147674;
06.02.2019;02:50:04;84202661;84054990;147671;
06.02.2019;02:51:04;84202746;84055089;147657;
06.02.2019;02:52:05;84202904;84055169;147735;
06.02.2019;02:53:04;84203019;84055235;147784;
06.02.2019;02:54:05;84203115;84055312;147803;
06.02.2019;02:55:04;84203195;84055401;147794;
06.02.2019;02:56:04;84203305;84055492;147813;
06.02.2019;02:57:05;84203420;84055578;147842;
06.02.2019;02:58:04;84203516;84055671;147845;
06.02.2019;02:59:05;84203655;84055772;147883;
06.02.2019;03:00:04;84203753;84055866;147887;
06.02.2019;03:01:04;84203844;84055954;147890;
06.02.2019;03:02:05;84203926;84056044;147882;
06.02.2019;03:03:04;84204043;84056130;147913;
06.02.2019;03:04:04;84204148;84056239;147909;
06.02.2019;03:05:05;84204259;84056323;147936;
06.02.2019;03:06:04;84204353;84056386;147967;
06.02.2019;03:07:05;84204453;84056473;147980;
06.02.2019;03:08:04;84204565;84056565;148000;
06.02.2019;03:09:06;84204676;84056683;147993;
06.02.2019;03:10:04;84204764;84056789;147975;
06.02.2019;03:11:04;84204869;84056898;147971;
06.02.2019;03:12:05;84204951;84056996;147955;
06.02.2019;03:13:04;84205068;84057079;147989;
06.02.2019;03:14:04;84205188;84057186;148002;
06.02.2019;03:15:04;84205279;84057297;147982;
06.02.2019;03:16:04;84205402;84057415;147987;
06.02.2019;03:17:05;84205505;84057527;147978;
06.02.2019;03:18:04;84205609;84057615;147994;
06.02.2019;03:19:04;84205726;84057706;148020;
06.02.2019;03:20:05;84205860;84057821;148039;
06.02.2019;03:21:04;84205943;84057926;148017;
06.02.2019;03:22:04;84206058;84058038;148020;
06.02.2019;03:23:05;84206153;84058163;147990;
06.02.2019;03:24:04;84206256;84058255;148001;
06.02.2019;03:25:05;84206355;84058348;148007;
06.02.2019;03:26:04;84206442;84058461;147981;
06.02.2019;03:27:04;84206555;84058574;147981;
06.02.2019;03:28:04;84206650;84058686;147964;
06.02.2019;03:29:04;84206750;84058802;147948;
06.02.2019;03:30:05;84206850;84058917;147933;
06.02.2019;03:31:04;84206969;84059021;147948;
06.02.2019;03:32:05;84207067;84059124;147943;
06.02.2019;03:33:04;84207159;84059230;147929;
06.02.2019;03:34:04;84207265;84059329;147936;
06.02.2019;03:35:04;84207352;84059448;147904;
06.02.2019;03:36:04;84207468;84059563;147905;
06.02.2019;03:37:05;84207563;84059675;147888;
06.02.2019;03:38:04;84207694;84059774;147920;
06.02.2019;03:39:06;84207808;84059876;147932;
06.02.2019;03:40:04;84207906;84059992;147914;
06.02.2019;03:41:04;84208015;84060099;147916;
06.02.2019;03:42:04;84208101;84060204;147897;
06.02.2019;03:43:04;84208237;84060323;147914;
06.02.2019;03:44:05;84208348;84060442;147906;
06.02.2019;03:45:04;84208472;84060570;147902;
06.02.2019;03:46:05;84208591;84060682;147909;
06.02.2019;03:47:04;84208697;84060792;147905;
06.02.2019;03:48:04;84208794;84060925;147869;
06.02.2019;03:49:04;84208901;84061044;147857;
06.02.2019;03:50:04;84209007;84061146;147861;
06.02.2019;03:51:05;84209117;84061250;147867;
06.02.2019;03:52:04;84209238;84061365;147873;
06.02.2019;03:53:04;84209333;84061474;147859;
06.02.2019;03:54:05;84209443;84061619;147824;
06.02.2019;03:55:04;84209547;84061716;147831;
06.02.2019;03:56:05;84209636;84061855;147781;
06.02.2019;03:57:04;84209738;84061961;147777;
06.02.2019;03:58:04;84209863;84062074;147789;
06.02.2019;03:59:04;84209965;84062195;147770;
06.02.2019;04:00:04;84210091;84062309;147782;
06.02.2019;04:01:05;84210219;84062425;147794;
06.02.2019;04:02:04;84210334;84062547;147787;
06.02.2019;04:03:04;84210431;84062663;147768;
06.02.2019;04:04:05;84210528;84062779;147749;
06.02.2019;04:05:05;84210640;84062905;147735;
06.02.2019;04:06:04;84210746;84063043;147703;
06.02.2019;04:07:05;84210816;84063123;147693;
06.02.2019;04:08:04;84210911;84063213;147698;
06.02.2019;04:09:06;84210976;84063344;147632;
06.02.2019;04:10:04;84211114;84063463;147651;
06.02.2019;04:11:04;84211203;84063537;147666;
06.02.2019;04:12:05;84211311;84063656;147655;
06.02.2019;04:13:04;84211425;84063778;147647;
06.02.2019;04:14:05;84211534;84063865;147669;
06.02.2019;04:15:04;84211625;84064013;147612;
06.02.2019;04:16:04;84211740;84064142;147598;
06.02.2019;04:17:05;84211831;84064259;147572;
06.02.2019;04:18:04;84211928;84064379;147549;
06.02.2019;04:19:05;84212027;84064503;147524;
06.02.2019;04:20:04;84212119;84064615;147504;
06.02.2019;04:21:04;84212201;84064727;147474;
06.02.2019;04:22:05;84212283;84064834;147449;
06.02.2019;04:23:04;84212357;84064928;147429;
06.02.2019;04:24:05;84212411;84065047;147364;
06.02.2019;04:25:04;84212470;84065143;147327;
06.02.2019;04:26:04;84212533;84065263;147270;
06.02.2019;04:27:04;84212607;84065390;147217;
06.02.2019;04:28:04;84212713;84065510;147203;
06.02.2019;04:29:05;84212806;84065611;147195;
06.02.2019;04:30:04;84212909;84065717;147192;
06.02.2019;04:31:04;84213019;84065825;147194;
06.02.2019;04:32:04;84213122;84065947;147175;
06.02.2019;04:33:04;84213219;84066059;147160;
06.02.2019;04:34:05;84213301;84066166;147135;
06.02.2019;04:35:04;84213431;84066285;147146;
06.02.2019;04:36:05;84213527;84066384;147143;
06.02.2019;04:37:04;84213660;84066502;147158;
06.02.2019;04:38:04;84213743;84066626;147117;
06.02.2019;04:39:05;84213857;84066765;147092;
06.02.2019;04:40:04;84213964;84066894;147070;
06.02.2019;04:41:04;84214052;84066989;147063;
06.02.2019;04:42:04;84214164;84067109;147055;
06.02.2019;04:43:04;84214264;84067220;147044;
06.02.2019;04:44:05;84214356;84067349;147007;
06.02.2019;04:45:04;84214420;84067471;146949;
06.02.2019;04:46:05;84214521;84067570;146951;
06.02.2019;04:47:05;84214614;84067693;146921;
06.02.2019;04:48:04;84214707;84067812;146895;
06.02.2019;04:49:05;84214792;84067946;146846;
06.02.2019;04:50:04;84214899;84068054;146845;
06.02.2019;04:51:04;84214994;84068160;146834;
06.02.2019;04:52:04;84215111;84068272;146839;
06.02.2019;04:53:04;84215213;84068417;146796;
06.02.2019;04:54:05;84215327;84068521;146806;
06.02.2019;04:55:04;84215449;84068633;146816;
06.02.2019;04:56:04;84215545;84068758;146787;
06.02.2019;04:57:05;84215652;84068890;146762;
06.02.2019;04:58:04;84215741;84069034;146707;
06.02.2019;04:59:04;84215839;84069142;146697;
06.02.2019;05:00:05;84215913;84069256;146657;
06.02.2019;05:01:05;84215999;84069380;146619;
06.02.2019;05:02:04;84216072;84069488;146584;
06.02.2019;05:03:05;84216154;84069619;146535;
06.02.2019;05:04:04;84216250;84069724;146526;
06.02.2019;05:05:05;84216354;84069830;146524;
06.02.2019;05:06:04;84216436;84069947;146489;
06.02.2019;05:07:04;84216518;84070091;146427;
06.02.2019;05:08:05;84216621;84070187;146434;
06.02.2019;05:09:06;84216698;84070315;146383;
06.02.2019;05:10:05;84216810;84070424;146386;
06.02.2019;05:11:04;84216893;84070558;146335;
06.02.2019;05:12:05;84216988;84070672;146316;
06.02.2019;05:13:04;84217068;84070787;146281;
06.02.2019;05:14:04;84217162;84070906;146256;
06.02.2019;05:15:05;84217249;84071031;146218;
06.02.2019;05:16:04;84217307;84071152;146155;
06.02.2019;05:17:05;84217390;84071271;146119;
06.02.2019;05:18:04;84217475;84071391;146084;
06.02.2019;05:19:04;84217571;84071516;146055;
06.02.2019;05:20:05;84217649;84071665;145984;
06.02.2019;05:21:04;84217752;84071788;145964;
06.02.2019;05:22:04;84217845;84071907;145938;
06.02.2019;05:23:05;84217921;84072014;145907;
06.02.2019;05:24:04;84218007;84072126;145881;
06.02.2019;05:25:05;84218129;84072260;145869;
06.02.2019;05:26:04;84218233;84072380;145853;
06.02.2019;05:27:04;84218315;84072509;145806;
06.02.2019;05:28:05;84218416;84072625;145791;
06.02.2019;05:29:04;84218496;84072747;145749;
06.02.2019;05:30:05;84218588;84072867;145721;
06.02.2019;05:31:04;84218666;84072979;145687;
06.02.2019;05:32:04;84218764;84073086;145678;
06.02.2019;05:33:04;84218839;84073227;145612;
06.02.2019;05:34:04;84218957;84073338;145619;
06.02.2019;05:35:06;84219032;84073461;145571;
06.02.2019;05:36:05;84219107;84073569;145538;
06.02.2019;05:37:04;84219196;84073696;145500;
06.02.2019;05:38:05;84219285;84073821;145464;
06.02.2019;05:39:06;84219404;84073947;145457;
06.02.2019;05:40:05;84219488;84074090;145398;
06.02.2019;05:41:05;84219576;84074212;145364;
06.02.2019;05:42:04;84219648;84074319;145329;
06.02.2019;05:43:05;84219730;84074452;145278;
06.02.2019;05:44:04;84219822;84074601;145221;
06.02.2019;05:45:04;84219900;84074700;145200;
06.02.2019;05:46:05;84219990;84074822;145168;
06.02.2019;05:47:05;84220076;84074956;145120;
06.02.2019;05:48:04;84220157;84075085;145072;
06.02.2019;05:49:05;84220241;84075220;145021;
06.02.2019;05:50:04;84220335;84075338;144997;
06.02.2019;05:51:04;84220425;84075465;144960;
06.02.2019;05:52:05;84220495;84075570;144925;
06.02.2019;05:53:04;84220587;84075685;144902;
06.02.2019;05:54:05;84220681;84075821;144860;
06.02.2019;05:55:04;84220768;84075930;144838;
06.02.2019;05:56:04;84220849;84076064;144785;
06.02.2019;05:57:05;84220919;84076186;144733;
06.02.2019;05:58:04;84220999;84076329;144670;
06.02.2019;05:59:05;84221092;84076447;144645;
06.02.2019;06:00:04;84221163;84076569;144594;
06.02.2019;06:01:04;84221240;84076696;144544;
06.02.2019;06:02:05;84221313;84076818;144495;
06.02.2019;06:03:04;84221391;84076943;144448;
06.02.2019;06:04:05;84221452;84077066;144386;
06.02.2019;06:05:04;84221542;84077172;144370;
06.02.2019;06:06:05;84221634;84077287;144347;
06.02.2019;06:07:04;84221707;84077413;144294;
06.02.2019;06:08:07;84221794;84077536;144258;
06.02.2019;06:09:07;84221858;84077643;144215;
06.02.2019;06:10:04;84221931;84077770;144161;
06.02.2019;06:11:05;84221986;84077868;144118;
06.02.2019;06:12:09;84222088;84077985;144103;
06.02.2019;06:13:04;84222142;84078086;144056;
06.02.2019;06:14:05;84222206;84078173;144033;
06.02.2019;06:15:04;84222257;84078279;143978;
06.02.2019;06:16:05;84222317;84078375;143942;
06.02.2019;06:17:05;84222386;84078482;143904;
06.02.2019;06:18:04;84222446;84078585;143861;
06.02.2019;06:19:04;84222502;84078684;143818;
06.02.2019;06:20:05;84222543;84078793;143750;
06.02.2019;06:21:04;84222596;84078899;143697;
06.02.2019;06:22:05;84222648;84079050;143598;
06.02.2019;06:23:06;84222721;84079159;143562;
06.02.2019;06:24:04;84222778;84079302;143476;
06.02.2019;06:25:07;84222831;84079409;143422;
06.02.2019;06:26:04;84222885;84079529;143356;
06.02.2019;06:27:05;84222936;84079670;143266;
06.02.2019;06:28:04;84223044;84079785;143259;
06.02.2019;06:29:05;84223115;84079931;143184;
06.02.2019;06:30:04;84223187;84080048;143139;
06.02.2019;06:31:04;84223240;84080187;143053;
06.02.2019;06:32:05;84223316;84080320;142996;
06.02.2019;06:33:04;84223397;84080426;142971;
06.02.2019;06:34:04;84223461;84080542;142919;
06.02.2019;06:35:04;84223531;84080665;142866;
06.02.2019;06:36:04;84223602;84080782;142820;
06.02.2019;06:37:05;84223676;84080908;142768;
06.02.2019;06:38:04;84223737;84081026;142711;
06.02.2019;06:39:07;84223808;84081144;142664;
06.02.2019;06:40:04;84223864;84081232;142632;
06.02.2019;06:41:05;84223927;84081358;142569;
06.02.2019;06:42:04;84224004;84081492;142512;
06.02.2019;06:43:04;84224082;84081622;142460;
06.02.2019;06:44:05;84224164;84081724;142440;
06.02.2019;06:45:04;84224243;84081836;142407;
06.02.2019;06:46:05;84224309;84081949;142360;
06.02.2019;06:47:05;84224378;84082089;142289;
06.02.2019;06:48:04;84224453;84082194;142259;
06.02.2019;06:49:05;84224516;84082326;142190;
06.02.2019;06:50:04;84224595;84082441;142154;
06.02.2019;06:51:05;84224675;84082560;142115;
06.02.2019;06:52:05;84224744;84082687;142057;
06.02.2019;06:53:04;84224816;84082821;141995;
06.02.2019;06:54:05;84224906;84082947;141959;
06.02.2019;06:55:04;84224969;84083078;141891;
06.02.2019;06:56:05;84225040;84083202;141838;
06.02.2019;07:02:09;84225480;84083916;141564;
06.02.2019;07:03:05;84225540;84084008;141532;
06.02.2019;07:06:11;84225784;84084405;141379;
06.02.2019;07:10:07;84226062;84084867;141195;
06.02.2019;07:13:05;84226260;84085249;141011;
06.02.2019;07:14:05;84226341;84085387;140954;
06.02.2019;07:15:10;84226422;84085521;140901;
06.02.2019;07:16:04;84226486;84085623;140863;
06.02.2019;07:17:05;84226545;84085731;140814;
06.02.2019;07:18:04;84226613;84085850;140763;
06.02.2019;07:19:04;84226676;84085954;140722;
06.02.2019;07:20:10;84226752;84086093;140659;
06.02.2019;07:21:05;84226827;84086222;140605;
06.02.2019;07:22:05;84226908;84086343;140565;
06.02.2019;07:23:05;84226988;84086489;140499;
06.02.2019;07:24:04;84227059;84086601;140458;
06.02.2019;07:25:04;84227130;84086712;140418;
06.02.2019;07:26:05;84227218;84086827;140391;
06.02.2019;07:27:04;84227307;84086926;140381;
06.02.2019;07:28:04;84227379;84087046;140333;
06.02.2019;07:29:05;84227450;84087180;140270;
06.02.2019;07:30:04;84227523;84087311;140212;
06.02.2019;07:31:05;84227579;84087442;140137;
06.02.2019;07:32:05;84227648;84087563;140085;
06.02.2019;07:33:05;84227710;84087649;140061;
06.02.2019;07:34:05;84227780;84087732;140048;
06.02.2019;07:35:04;84227846;84087836;140010;
06.02.2019;07:36:05;84227908;84087934;139974;
06.02.2019;07:37:05;84227973;84088044;139929;
06.02.2019;07:38:04;84228041;84088145;139896;
06.02.2019;07:39:06;84228100;84088262;139838;
06.02.2019;07:40:05;84228145;84088364;139781;
06.02.2019;07:41:04;84228204;84088487;139717;
06.02.2019;07:42:05;84228271;84088601;139670;
06.02.2019;07:43:04;84228330;84088723;139607;
06.02.2019;07:44:08;84228376;84088854;139522;
06.02.2019;07:45:04;84228420;84088948;139472;
06.02.2019;07:46:06;84228481;84089068;139413;
06.02.2019;07:47:05;84228543;84089176;139367;
06.02.2019;07:48:08;84228614;84089289;139325;
06.02.2019;07:49:04;84228672;84089382;139290;
06.02.2019;07:50:04;84228755;84089477;139278;
06.02.2019;07:51:05;84228840;84089591;139249;
06.02.2019;07:52:04;84228910;84089686;139224;
06.02.2019;07:53:04;84228974;84089766;139208;
06.02.2019;07:54:04;84229040;84089873;139167;
06.02.2019;07:55:05;84229097;84089979;139118;
06.02.2019;07:56:04;84229153;84090092;139061;
06.02.2019;07:57:04;84229218;84090203;139015;
06.02.2019;07:58:05;84229293;84090340;138953;
06.02.2019;07:59:05;84229374;84090454;138920;
06.02.2019;08:00:04;84229434;84090572;138862;
06.02.2019;08:01:05;84229509;84090695;138814;
06.02.2019;08:02:04;84229573;84090778;138795;
06.02.2019;08:03:04;84229628;84090908;138720;
06.02.2019;08:04:05;84229689;84091043;138646;
06.02.2019;08:05:04;84229755;84091136;138619;
06.02.2019;08:06:04;84229821;84091257;138564;
06.02.2019;08:07:05;84229881;84091359;138522;
06.02.2019;08:08:04;84229947;84091463;138484;
06.02.2019;08:09:06;84230002;84091573;138429;
06.02.2019;08:10:04;84230051;84091662;138389;
06.02.2019;08:11:04;84230092;84091740;138352;
06.02.2019;08:12:05;84230137;84091857;138280;
06.02.2019;08:13:04;84230192;84091944;138248;
06.02.2019;08:14:05;84230234;84092050;138184;
06.02.2019;08:15:04;84230259;84092132;138127;
06.02.2019;08:16:04;84230288;84092219;138069;
06.02.2019;08:17:05;84230303;84092305;137998;
06.02.2019;08:18:04;84230322;84092398;137924;
06.02.2019;08:19:04;84230345;84092513;137832;
06.02.2019;08:20:05;84230381;84092631;137750;
06.02.2019;08:21:04;84230428;84092741;137687;
06.02.2019;08:22:04;84230488;84092857;137631;
06.02.2019;08:23:05;84230525;84092969;137556;
06.02.2019;08:24:04;84230556;84093079;137477;
06.02.2019;08:25:05;84230617;84093207;137410;
06.02.2019;08:26:04;84230654;84093329;137325;
06.02.2019;08:27:04;84230701;84093431;137270;
06.02.2019;08:28:05;84230747;84093527;137220;
06.02.2019;08:29:05;84230811;84093649;137162;
06.02.2019;08:30:05;84230862;84093768;137094;
06.02.2019;08:31:05;84230917;84093891;137026;
06.02.2019;08:32:05;84230987;84094007;136980;
06.02.2019;08:33:05;84231046;84094111;136935;
06.02.2019;08:34:04;84231103;84094227;136876;
06.02.2019;08:35:04;84231151;84094332;136819;
06.02.2019;08:36:04;84231195;84094469;136726;
06.02.2019;08:37:05;84231260;84094590;136670;
06.02.2019;08:38:04;84231314;84094714;136600;
06.02.2019;08:39:06;84231389;84094827;136562;
06.02.2019;08:40:16;84231467;84094981;136486;
06.02.2019;08:41:04;84231505;84095057;136448;
06.02.2019;08:42:05;84231564;84095161;136403;
06.02.2019;08:43:04;84231621;84095295;136326;
06.02.2019;08:44:05;84231705;84095424;136281;
06.02.2019;08:45:04;84231777;84095538;136239;
06.02.2019;08:46:04;84231838;84095646;136192;
06.02.2019;08:47:05;84231893;84095754;136139;
06.02.2019;08:48:04;84231939;84095850;136089;
06.02.2019;08:49:04;84232003;84095950;136053;
06.02.2019;08:50:05;84232062;84096062;136000;
06.02.2019;08:51:04;84232133;84096178;135955;
06.02.2019;08:52:05;84232201;84096277;135924;
06.02.2019;08:53:04;84232276;84096398;135878;
06.02.2019;08:54:04;84232329;84096493;135836;
06.02.2019;08:55:05;84232383;84096631;135752;
06.02.2019;08:56:04;84232446;84096748;135698;
06.02.2019;08:57:05;84232505;84096857;135648;
06.02.2019;08:58:04;84232561;84096983;135578;
06.02.2019;08:59:04;84232628;84097095;135533;
06.02.2019;09:00:05;84232677;84097240;135437;
06.02.2019;09:01:04;84232761;84097371;135390;
06.02.2019;09:02:05;84232830;84097494;135336;
06.02.2019;09:03:04;84232881;84097631;135250;
06.02.2019;09:04:04;84232945;84097740;135205;
06.02.2019;09:05:05;84233006;84097857;135149;
06.02.2019;09:06:04;84233080;84097965;135115;
06.02.2019;09:07:05;84233135;84098075;135060;
06.02.2019;09:08:04;84233183;84098190;134993;
06.02.2019;09:09:06;84233240;84098300;134940;
06.02.2019;09:10:05;84233298;84098418;134880;
06.02.2019;09:11:04;84233359;84098553;134806;
06.02.2019;09:12:04;84233425;84098687;134738;
06.02.2019;09:13:05;84233486;84098792;134694;
06.02.2019;09:14:04;84233561;84098899;134662;
06.02.2019;09:15:04;84233623;84099013;134610;
06.02.2019;09:16:05;84233674;84099120;134554;
06.02.2019;09:17:04;84233725;84099244;134481;
06.02.2019;09:18:04;84233792;84099341;134451;
06.02.2019;09:19:05;84233858;84099457;134401;
06.02.2019;09:20:04;84233927;84099586;134341;
06.02.2019;09:21:05;84234000;84099703;134297;
06.02.2019;09:22:04;84234070;84099832;134238;
06.02.2019;09:23:04;84234133;84099982;134151;
06.02.2019;09:24:05;84234217;84100094;134123;
06.02.2019;09:25:04;84234280;84100218;134062;
06.02.2019;09:26:05;84234330;84100345;133985;
06.02.2019;09:27:05;84234389;84100478;133911;
06.02.2019;09:28:04;84234459;84100611;133848;
06.02.2019;09:29:05;84234519;84100733;133786;
06.02.2019;09:30:04;84234573;84100865;133708;
06.02.2019;09:31:04;84234639;84100985;133654;
06.02.2019;09:32:05;84234704;84101131;133573;
06.02.2019;09:33:04;84234754;84101267;133487;
06.02.2019;09:34:05;84234801;84101395;133406;
06.02.2019;09:35:04;84234855;84101518;133337;
06.02.2019;09:36:04;84234926;84101624;133302;
06.02.2019;09:37:05;84234997;84101733;133264;
06.02.2019;09:38:04;84235044;84101879;133165;
06.02.2019;09:39:07;84235108;84102018;133090;
06.02.2019;09:40:04;84235173;84102163;133010;
06.02.2019;09:41:04;84235237;84102297;132940;
06.02.2019;09:42:05;84235317;84102424;132893;
06.02.2019;09:43:04;84235382;84102559;132823;
06.02.2019;09:44:04;84235452;84102687;132765;
06.02.2019;09:45:04;84235507;84102812;132695;
06.02.2019;09:46:04;84235540;84102966;132574;
06.02.2019;09:47:05;84235612;84103091;132521;
06.02.2019;09:48:04;84235677;84103223;132454;
06.02.2019;09:49:05;84235745;84103361;132384;
06.02.2019;09:50:04;84235793;84103487;132306;
06.02.2019;09:51:04;84235854;84103603;132251;
06.02.2019;09:52:04;84235916;84103749;132167;
06.02.2019;09:53:04;84235979;84103877;132102;
06.02.2019;09:54:05;84236035;84104005;132030;
06.02.2019;09:55:04;84236089;84104136;131953;
06.02.2019;09:56:04;84236157;84104254;131903;
06.02.2019;09:57:05;84236226;84104395;131831;
06.02.2019;09:58:04;84236272;84104495;131777;
06.02.2019;09:59:04;84236321;84104612;131709;
06.02.2019;10:00:05;84236375;84104716;131659;
06.02.2019;10:01:04;84236407;84104770;131637;
06.02.2019;10:02:04;84236471;84104889;131582;
06.02.2019;10:03:05;84236531;84105009;131522;
06.02.2019;10:04:04;84236592;84105150;131442;
06.02.2019;10:05:05;84236665;84105267;131398;
06.02.2019;10:06:05;84236719;84105370;131349;
06.02.2019;10:07:04;84236764;84105478;131286;
06.02.2019;10:08:04;84236809;84105623;131186;
06.02.2019;10:09:06;84236875;84105759;131116;
06.02.2019;10:10:04;84236924;84105888;131036;
06.02.2019;10:11:05;84236999;84106026;130973;
06.02.2019;10:12:04;84237047;84106146;130901;
06.02.2019;10:13:05;84237074;84106261;130813;
06.02.2019;10:14:04;84237117;84106379;130738;
06.02.2019;10:15:04;84237146;84106492;130654;
06.02.2019;10:16:05;84237181;84106613;130568;
06.02.2019;10:17:05;84237223;84106739;130484;
06.02.2019;10:18:04;84237252;84106854;130398;
06.02.2019;10:19:05;84237280;84106973;130307;
06.02.2019;10:20:04;84237288;84107070;130218;
06.02.2019;10:21:04;84237328;84107170;130158;
06.02.2019;10:22:05;84237389;84107261;130128;
06.02.2019;10:23:04;84237404;84107375;130029;
06.02.2019;10:24:05;84237422;84107476;129946;
06.02.2019;10:25:06;84237483;84107621;129862;
06.02.2019;10:26:04;84237547;84107737;129810;
06.02.2019;10:27:04;84237609;84107859;129750;
06.02.2019;10:28:05;84237656;84107991;129665;
06.02.2019;10:29:05;84237708;84108115;129593;
06.02.2019;10:30:04;84237764;84108228;129536;
06.02.2019;10:31:05;84237811;84108363;129448;
06.02.2019;10:32:04;84237867;84108478;129389;
06.02.2019;10:33:04;84237937;84108629;129308;
06.02.2019;10:34:04;84237976;84108758;129218;
06.02.2019;10:35:05;84238043;84108890;129153;
06.02.2019;10:36:04;84238078;84109029;129049;
06.02.2019;10:37:04;84238150;84109157;128993;
06.02.2019;10:38:05;84238202;84109284;128918;
06.02.2019;10:39:06;84238266;84109421;128845;
06.02.2019;10:40:04;84238316;84109555;128761;
06.02.2019;10:41:05;84238359;84109683;128676;
06.02.2019;10:42:05;84238422;84109816;128606;
06.02.2019;10:43:05;84238483;84109964;128519;
06.02.2019;10:44:05;84238529;84110098;128431;
06.02.2019;10:45:04;84238591;84110208;128383;
06.02.2019;10:46:05;84238644;84110346;128298;
06.02.2019;10:47:05;84238706;84110457;128249;
06.02.2019;10:48:04;84238763;84110602;128161;
06.02.2019;10:49:05;84238821;84110739;128082;
06.02.2019;10:50:05;84238866;84110872;127994;
06.02.2019;10:51:05;84238921;84111029;127892;
06.02.2019;10:52:05;84238983;84111158;127825;
06.02.2019;10:53:04;84239038;84111313;127725;
06.02.2019;10:54:04;84239080;84111446;127634;
06.02.2019;10:55:05;84239159;84111591;127568;
06.02.2019;10:56:04;84239213;84111710;127503;
06.02.2019;10:57:04;84239267;84111838;127429;
06.02.2019;10:58:05;84239329;84111997;127332;
06.02.2019;10:59:04;84239407;84112150;127257;
06.02.2019;11:00:06;84239463;84112296;127167;
06.02.2019;11:01:04;84239516;84112420;127096;
06.02.2019;11:02:04;84239574;84112561;127013;
06.02.2019;11:03:05;84239629;84112707;126922;
06.02.2019;11:04:04;84239698;84112838;126860;
06.02.2019;11:05:04;84239765;84112977;126788;
06.02.2019;11:06:04;84239819;84113109;126710;
06.02.2019;11:07:04;84239867;84113251;126616;
06.02.2019;11:08:05;84239921;84113396;126525;
06.02.2019;11:09:06;84239985;84113526;126459;
06.02.2019;11:10:05;84240045;84113665;126380;
06.02.2019;11:11:04;84240104;84113789;126315;
06.02.2019;11:12:04;84240166;84113940;126226;
06.02.2019;11:13:04;84240213;84114094;126119;
06.02.2019;11:14:05;84240282;84114252;126030;
06.02.2019;11:15:04;84240335;84114379;125956;
06.02.2019;11:16:06;84240381;84114510;125871;
06.02.2019;11:17:05;84240443;84114640;125803;
06.02.2019;11:18:05;84240490;84114791;125699;
06.02.2019;11:19:04;84240555;84114908;125647;
06.02.2019;11:20:05;84240607;84115093;125514;
06.02.2019;11:21:04;84240672;84115239;125433;
06.02.2019;11:22:04;84240732;84115392;125340;
06.02.2019;11:23:05;84240784;84115528;125256;
06.02.2019;11:24:04;84240842;84115675;125167;
06.02.2019;11:25:04;84240890;84115834;125056;
06.02.2019;11:26:04;84240952;84115962;124990;
06.02.2019;11:27:05;84241008;84116105;124903;
06.02.2019;11:28:04;84241094;84116242;124852;
06.02.2019;11:29:05;84241160;84116372;124788;
06.02.2019;11:30:04;84241189;84116527;124662;
06.02.2019;11:31:04;84241292;84116682;124610;
06.02.2019;11:32:05;84241353;84116827;124526;
06.02.2019;11:33:05;84241417;84116958;124459;
06.02.2019;11:34:04;84241468;84117111;124357;
06.02.2019;11:35:05;84241513;84117255;124258;
06.02.2019;11:36:04;84241568;84117379;124189;
06.02.2019;11:37:04;84241620;84117534;124086;
06.02.2019;11:38:05;84241676;84117691;123985;
06.02.2019;11:39:06;84241740;84117830;123910;
06.02.2019;11:40:05;84241803;84117990;123813;
06.02.2019;11:41:04;84241862;84118136;123726;
06.02.2019;11:42:05;84241930;84118276;123654;
06.02.2019;11:43:05;84241988;84118431;123557;
06.02.2019;11:44:04;84242048;84118582;123466;
06.02.2019;11:45:05;84242106;84118714;123392;
06.02.2019;11:46:04;84242176;84118854;123322;
06.02.2019;11:47:04;84242242;84119013;123229;
06.02.2019;11:48:05;84242297;84119139;123158;
06.02.2019;11:49:04;84242374;84119271;123103;
06.02.2019;11:50:04;84242436;84119421;123015;
06.02.2019;11:51:05;84242491;84119569;122922;
06.02.2019;11:52:04;84242553;84119708;122845;
06.02.2019;11:53:05;84242603;84119850;122753;
06.02.2019;11:54:04;84242643;84119981;122662;
06.02.2019;11:55:04;84242705;84120129;122576;
06.02.2019;11:56:05;84242756;84120238;122518;
06.02.2019;11:57:04;84242810;84120384;122426;
06.02.2019;11:58:05;84242866;84120524;122342;
06.02.2019;11:59:04;84242926;84120679;122247;
06.02.2019;12:00:04;84242993;84120825;122168;
06.02.2019;12:01:05;84243065;84120958;122107;
06.02.2019;12:02:04;84243122;84121102;122020;
06.02.2019;12:03:05;84243197;84121243;121954;
06.02.2019;12:04:04;84243259;84121351;121908;
06.02.2019;12:05:04;84243333;84121491;121842;
06.02.2019;12:06:05;84243384;84121652;121732;
06.02.2019;12:07:05;84243449;84121774;121675;
06.02.2019;12:08:04;84243516;84121884;121632;
06.02.2019;12:09:06;84243574;84122043;121531;
06.02.2019;12:10:04;84243626;84122157;121469;
06.02.2019;12:11:05;84243677;84122305;121372;
06.02.2019;12:12:04;84243748;84122456;121292;
06.02.2019;12:13:04;84243792;84122583;121209;
06.02.2019;12:14:05;84243832;84122672;121160;
06.02.2019;12:15:04;84243870;84122753;121117;
06.02.2019;12:16:04;84243910;84122876;121034;
06.02.2019;12:17:05;84243957;84122986;120971;
06.02.2019;12:18:04;84244008;84123110;120898;
06.02.2019;12:19:04;84244051;84123219;120832;
06.02.2019;12:20:05;84244073;84123345;120728;
06.02.2019;12:21:04;84244107;84123434;120673;
06.02.2019;12:22:04;84244146;84123555;120591;
06.02.2019;12:23:05;84244206;84123669;120537;
06.02.2019;12:24:04;84244249;84123793;120456;
06.02.2019;12:25:05;84244300;84123919;120381;
06.02.2019;12:26:04;84244361;84124040;120321;
06.02.2019;12:27:04;84244447;84124190;120257;
06.02.2019;12:28:05;84244513;84124324;120189;
06.02.2019;12:29:04;84244567;84124443;120124;
06.02.2019;12:30:04;84244642;84124585;120057;
06.02.2019;12:31:05;84244693;84124741;119952;
06.02.2019;12:32:04;84244766;84124859;119907;
06.02.2019;12:33:04;84244821;84125005;119816;
06.02.2019;12:34:05;84244884;84125141;119743;
06.02.2019;12:35:05;84244954;84125286;119668;
06.02.2019;12:36:04;84245006;84125444;119562;
06.02.2019;12:37:04;84245072;84125587;119485;
06.02.2019;12:38:05;84245128;84125728;119400;
06.02.2019;12:39:06;84245196;84125897;119299;
06.02.2019;12:40:04;84245266;84126023;119243;
06.02.2019;12:41:04;84245336;84126155;119181;
06.02.2019;12:42:05;84245407;84126294;119113;
06.02.2019;12:43:04;84245465;84126447;119018;
06.02.2019;12:44:04;84245530;84126587;118943;
06.02.2019;12:45:06;84245594;84126749;118845;
06.02.2019;12:46:05;84245665;84126890;118775;
06.02.2019;12:47:05;84245737;84127020;118717;
06.02.2019;12:48:04;84245808;84127160;118648;
06.02.2019;12:49:06;84245886;84127324;118562;
06.02.2019;12:50:05;84245952;84127468;118484;
06.02.2019;12:51:04;84246025;84127628;118397;
06.02.2019;12:52:05;84246097;84127785;118312;
06.02.2019;12:53:05;84246176;84127924;118252;
06.02.2019;12:54:05;84246238;84128055;118183;
06.02.2019;12:55:05;84246316;84128179;118137;
06.02.2019;12:56:04;84246241;84127933;118308;
06.02.2019;12:57:04;84245938;84127314;118624;
06.02.2019;12:58:05;84246009;84127446;118563;
06.02.2019;12:59:04;84246072;84127586;118486;
06.02.2019;13:00:04;84246135;84127721;118414;
06.02.2019;13:01:05;84246202;84127887;118315;
06.02.2019;13:02:04;84246282;84128017;118265;
06.02.2019;13:03:05;84246356;84128185;118171;
06.02.2019;13:04:04;84246424;84128364;118060;
06.02.2019;13:05:04;84246523;84128501;118022;
06.02.2019;13:06:04;84246586;84128651;117935;
06.02.2019;13:07:05;84246649;84128807;117842;
06.02.2019;13:08:04;84246731;84128962;117769;
06.02.2019;13:09:06;84246810;84129122;117688;
06.02.2019;13:10:05;84246882;84129258;117624;
06.02.2019;13:11:04;84246947;84129394;117553;
06.02.2019;13:12:04;84247021;84129539;117482;
06.02.2019;13:13:05;84247084;84129693;117391;
06.02.2019;13:14:04;84247164;84129833;117331;
06.02.2019;13:15:05;84247243;84129983;117260;
06.02.2019;13:16:04;84247332;84130120;117212;
06.02.2019;13:17:04;84247392;84130248;117144;
06.02.2019;13:18:04;84247494;84130386;117108;
06.02.2019;13:19:04;84247593;84130540;117053;
06.02.2019;13:20:05;84247682;84130719;116963;
06.02.2019;13:21:04;84247784;84130869;116915;
06.02.2019;13:22:04;84247894;84131026;116868;
06.02.2019;13:23:04;84248004;84131203;116801;
06.02.2019;13:24:04;84248153;84131369;116784;
06.02.2019;13:25:05;84248297;84131533;116764;
06.02.2019;13:26:05;84248448;84131666;116782;
06.02.2019;13:27:04;84248585;84131802;116783;
06.02.2019;13:28:05;84248707;84131968;116739;
06.02.2019;13:29:04;84248827;84132102;116725;
06.02.2019;13:30:04;84248978;84132233;116745;
06.02.2019;13:31:05;84249106;84132370;116736;
06.02.2019;13:32:05;84249233;84132531;116702;
06.02.2019;13:33:04;84249359;84132683;116676;
06.02.2019;13:34:05;84249493;84132816;116677;
06.02.2019;13:35:04;84249631;84132970;116661;
06.02.2019;13:36:04;84249772;84133102;116670;
06.02.2019;13:37:05;84249901;84133264;116637;
06.02.2019;13:38:04;84250026;84133418;116608;
06.02.2019;13:39:06;84250162;84133545;116617;
06.02.2019;13:40:05;84250293;84133705;116588;
06.02.2019;13:41:05;84250441;84133829;116612;
06.02.2019;13:42:04;84250583;84133993;116590;
06.02.2019;13:43:04;84250718;84134133;116585;
06.02.2019;13:44:05;84250877;84134261;116616;
06.02.2019;13:45:04;84250974;84134449;116525;
06.02.2019;13:46:05;84251096;84134596;116500;
06.02.2019;13:47:05;84251222;84134740;116482;
06.02.2019;13:48:04;84251355;84134881;116474;
06.02.2019;13:49:04;84251485;84134996;116489;
06.02.2019;13:50:04;84251617;84135170;116447;
06.02.2019;13:51:04;84251733;84135301;116432;
06.02.2019;13:52:05;84251888;84135454;116434;
06.02.2019;13:53:05;84252053;84135597;116456;
06.02.2019;13:54:05;84252170;84135738;116432;
06.02.2019;13:55:04;84252325;84135902;116423;
06.02.2019;13:56:06;84252476;84136035;116441;
06.02.2019;13:57:05;84252603;84136170;116433;
06.02.2019;13:58:04;84252731;84136299;116432;
06.02.2019;13:59:04;84252884;84136480;116404;
06.02.2019;14:00:05;84253008;84136638;116370;
06.02.2019;14:01:05;84253151;84136758;116393;
06.02.2019;14:02:06;84253280;84136887;116393;
06.02.2019;14:03:04;84253415;84136986;116429;
06.02.2019;14:04:04;84253544;84137143;116401;
06.02.2019;14:05:05;84253682;84137255;116427;
06.02.2019;14:06:05;84253829;84137392;116437;
06.02.2019;14:07:05;84253969;84137529;116440;
06.02.2019;14:08:05;84254133;84137708;116425;
06.02.2019;14:09:06;84254276;84137838;116438;
06.02.2019;14:10:04;84254406;84137970;116436;
06.02.2019;14:11:05;84254539;84138114;116425;
06.02.2019;14:12:04;84254654;84138262;116392;
06.02.2019;14:13:04;84254804;84138391;116413;
06.02.2019;14:14:05;84254945;84138534;116411;
06.02.2019;14:15:05;84255095;84138680;116415;
06.02.2019;14:16:04;84255250;84138782;116468;
06.02.2019;14:17:05;84255381;84138909;116472;
06.02.2019;14:18:05;84255482;84139036;116446;
06.02.2019;14:19:05;84255613;84139149;116464;
06.02.2019;14:20:05;84255709;84139279;116430;
06.02.2019;14:21:05;84255815;84139412;116403;
06.02.2019;14:22:04;84255921;84139518;116403;
06.02.2019;14:23:04;84256041;84139644;116397;
06.02.2019;14:24:05;84256164;84139775;116389;
06.02.2019;14:25:05;84256311;84139929;116382;
06.02.2019;14:26:05;84256421;84140047;116374;
06.02.2019;14:27:04;84256544;84140188;116356;
06.02.2019;14:28:04;84256673;84140355;116318;
06.02.2019;14:29:05;84256799;84140473;116326;
06.02.2019;14:30:05;84256921;84140601;116320;
06.02.2019;14:31:05;84257072;84140721;116351;
06.02.2019;14:32:04;84257194;84140851;116343;
06.02.2019;14:33:04;84257360;84141008;116352;
06.02.2019;14:34:05;84257502;84141154;116348;
06.02.2019;14:35:05;84257638;84141309;116329;
06.02.2019;14:36:05;84257762;84141466;116296;
06.02.2019;14:37:05;84257907;84141631;116276;
06.02.2019;14:38:05;84258055;84141805;116250;
06.02.2019;14:39:07;84258213;84141967;116246;
06.02.2019;14:40:04;84258356;84142133;116223;
06.02.2019;14:41:04;84258494;84142291;116203;
06.02.2019;14:42:05;84258628;84142418;116210;
06.02.2019;14:43:06;84258750;84142554;116196;
06.02.2019;14:44:04;84258861;84142717;116144;
06.02.2019;14:45:05;84258995;84142897;116098;
06.02.2019;14:46:05;84259112;84143075;116037;
06.02.2019;14:47:04;84259225;84143226;115999;
06.02.2019;14:48:04;84259333;84143393;115940;
06.02.2019;14:49:05;84259468;84143549;115919;
06.02.2019;14:50:05;84259601;84143688;115913;
06.02.2019;14:51:05;84259726;84143820;115906;
06.02.2019;14:52:04;84259860;84143970;115890;
06.02.2019;14:53:05;84259995;84144116;115879;
06.02.2019;14:54:05;84260100;84144272;115828;
06.02.2019;14:55:04;84260236;84144410;115826;
06.02.2019;14:56:07;84260371;84144579;115792;
06.02.2019;14:57:05;84260492;84144760;115732;
06.02.2019;14:58:05;84260616;84144929;115687;
06.02.2019;14:59:05;84260753;84145061;115692;
06.02.2019;15:00:10;84260908;84145231;115677;
06.02.2019;15:01:11;84261025;84145410;115615;
06.02.2019;15:02:10;84261175;84145544;115631;
06.02.2019;15:03:13;84261325;84145727;115598;
06.02.2019;15:04:14;84261446;84145880;115566;
06.02.2019;15:05:13;84261576;84146019;115557;
06.02.2019;15:06:17;84261737;84146195;115542;
06.02.2019;15:07:15;84261902;84146349;115553;
06.02.2019;15:08:18;84262050;84146485;115565;
06.02.2019;15:09:20;84262204;84146650;115554;
06.02.2019;15:10:16;84262337;84146804;115533;
06.02.2019;15:11:18;84262489;84146982;115507;
06.02.2019;15:12:16;84262624;84147162;115462;
06.02.2019;15:13:20;84262769;84147313;115456;
06.02.2019;15:14:21;84262912;84147471;115441;
06.02.2019;15:15:17;84263023;84147628;115395;
06.02.2019;15:16:20;84263140;84147825;115315;
06.02.2019;15:17:19;84263289;84148013;115276;
06.02.2019;15:18:22;84263423;84148165;115258;
06.02.2019;15:19:20;84263559;84148323;115236;
06.02.2019;15:20:20;84263686;84148492;115194;
06.02.2019;15:21:19;84263830;84148632;115198;
06.02.2019;15:22:16;84263927;84148771;115156;
06.02.2019;15:23:16;84264053;84148939;115114;
06.02.2019;15:24:17;84264200;84149114;115086;
06.02.2019;15:25:18;84264332;84149304;115028;
06.02.2019;15:26:16;84264461;84149434;115027;
06.02.2019;15:27:19;84264622;84149620;115002;
06.02.2019;15:28:17;84264738;84149783;114955;
06.02.2019;15:29:17;84264867;84149930;114937;
06.02.2019;15:30:20;84265013;84150102;114911;
06.02.2019;15:31:18;84265142;84150261;114881;
06.02.2019;15:32:20;84265293;84150425;114868;
06.02.2019;15:33:19;84265436;84150567;114869;
06.02.2019;15:34:22;84265581;84150770;114811;
06.02.2019;15:35:23;84265722;84150919;114803;
06.02.2019;15:36:19;84265858;84151094;114764;
06.02.2019;15:37:22;84266010;84151239;114771;
06.02.2019;15:38:20;84266133;84151416;114717;
06.02.2019;15:39:23;84266272;84151583;114689;
06.02.2019;15:40:23;84266408;84151759;114649;
06.02.2019;15:41:19;84266541;84151929;114612;
06.02.2019;15:42:22;84266683;84152123;114560;
06.02.2019;15:43:20;84266832;84152281;114551;
06.02.2019;15:44:22;84266984;84152430;114554;
06.02.2019;15:45:22;84267133;84152607;114526;
06.02.2019;15:46:20;84267264;84152768;114496;
06.02.2019;15:47:24;84267400;84152941;114459;
06.02.2019;15:48:22;84267526;84153107;114419;
06.02.2019;15:49:21;84267650;84153274;114376;
06.02.2019;15:50:23;84267786;84153458;114328;
06.02.2019;15:51:22;84267936;84153643;114293;
06.02.2019;15:52:22;84268072;84153828;114244;
06.02.2019;15:53:19;84268197;84153985;114212;
06.02.2019;15:54:20;84268351;84154170;114181;
06.02.2019;15:55:19;84268478;84154344;114134;
06.02.2019;15:56:18;84268610;84154537;114073;
06.02.2019;15:57:20;84268761;84154710;114051;
06.02.2019;15:58:18;84268888;84154902;113986;
06.02.2019;15:59:18;84268995;84155061;113934;
06.02.2019;16:00:13;84269120;84155207;113913;
06.02.2019;16:01:08;84269224;84155338;113886;
06.02.2019;16:02:05;84269344;84155495;113849;
06.02.2019;16:03:05;84269483;84155665;113818;
06.02.2019;16:04:04;84269609;84155827;113782;
06.02.2019;16:05:04;84269746;84156024;113722;
06.02.2019;16:06:05;84269900;84156177;113723;
06.02.2019;16:07:04;84270028;84156339;113689;
06.02.2019;16:08:04;84270163;84156510;113653;
06.02.2019;16:09:06;84270313;84156669;113644;
06.02.2019;16:10:05;84270441;84156834;113607;
06.02.2019;16:11:05;84270569;84157003;113566;
06.02.2019;16:12:04;84270703;84157178;113525;
06.02.2019;16:13:04;84270827;84157336;113491;
06.02.2019;16:14:04;84270965;84157507;113458;
06.02.2019;16:15:05;84271110;84157703;113407;
06.02.2019;16:16:05;84271225;84157873;113352;
06.02.2019;16:17:05;84271337;84158050;113287;
06.02.2019;16:18:05;84271418;84158184;113234;
06.02.2019;16:19:05;84271517;84158329;113188;
06.02.2019;16:20:10;84271636;84158500;113136;
06.02.2019;16:21:04;84271762;84158647;113115;
06.02.2019;16:22:05;84271874;84158785;113089;
06.02.2019;16:23:05;84271992;84158949;113043;
06.02.2019;16:24:05;84272105;84159102;113003;
06.02.2019;16:25:05;84272202;84159267;112935;
06.02.2019;16:26:05;84272308;84159467;112841;
06.02.2019;16:27:04;84272428;84159612;112816;
06.02.2019;16:28:04;84272539;84159742;112797;
06.02.2019;16:29:05;84272644;84159911;112733;
06.02.2019;16:30:04;84272747;84160085;112662;
06.02.2019;16:31:04;84272886;84160244;112642;
06.02.2019;16:33:06;84273135;84160569;112566;
06.02.2019;16:34:04;84273234;84160732;112502;
06.02.2019;16:35:05;84273337;84160905;112432;
06.02.2019;16:36:09;84273514;84161077;112437;
06.02.2019;16:37:04;84273633;84161225;112408;
06.02.2019;16:38:05;84273748;84161388;112360;
06.02.2019;16:39:06;84273887;84161566;112321;
06.02.2019;16:40:06;84274036;84161742;112294;
06.02.2019;16:41:04;84274158;84161899;112259;
06.02.2019;16:42:04;84274301;84162100;112201;
06.02.2019;16:43:05;84274440;84162267;112173;
06.02.2019;16:44:11;84274578;84162456;112122;
06.02.2019;16:45:06;84274698;84162616;112082;
06.02.2019;16:46:06;84274839;84162798;112041;
06.02.2019;16:47:04;84274981;84162949;112032;
06.02.2019;16:48:04;84275113;84163140;111973;
06.02.2019;16:49:05;84275259;84163290;111969;
06.02.2019;16:50:05;84275411;84163488;111923;
06.02.2019;16:51:04;84275566;84163646;111920;
06.02.2019;16:52:04;84275710;84163812;111898;
06.02.2019;16:53:05;84275852;84163996;111856;
06.02.2019;16:54:05;84275997;84164174;111823;
06.02.2019;16:55:05;84276138;84164357;111781;
06.02.2019;16:56:04;84276272;84164520;111752;
06.02.2019;16:57:04;84276415;84164717;111698;
06.02.2019;16:58:05;84276543;84164907;111636;
06.02.2019;16:59:05;84276686;84165119;111567;
06.02.2019;17:00:11;84276836;84165321;111515;
06.02.2019;17:01:05;84276964;84165479;111485;
06.02.2019;17:02:04;84277094;84165659;111435;
06.02.2019;17:03:05;84277237;84165837;111400;
06.02.2019;17:04:06;84277377;84166057;111320;
06.02.2019;17:05:05;84277502;84166244;111258;
06.02.2019;17:06:05;84277674;84166416;111258;
06.02.2019;17:07:04;84277783;84166600;111183;
06.02.2019;17:08:04;84277916;84166773;111143;
06.02.2019;17:09:05;84278061;84166937;111124;
06.02.2019;17:10:05;84278211;84167084;111127;
06.02.2019;17:11:05;84278340;84167245;111095;
06.02.2019;17:12:04;84278477;84167438;111039;
06.02.2019;17:13:06;84278612;84167609;111003;
06.02.2019;17:14:05;84278776;84167771;111005;
06.02.2019;17:15:04;84278907;84167966;110941;
06.02.2019;17:16:09;84278988;84168152;110836;
06.02.2019;17:17:05;84279189;84168346;110843;
06.02.2019;17:18:11;84279350;84168527;110823;
06.02.2019;17:19:05;84279486;84168686;110800;
06.02.2019;17:20:05;84279609;84168878;110731;
06.02.2019;17:21:04;84279758;84169051;110707;
06.02.2019;17:22:04;84279892;84169215;110677;
06.02.2019;17:23:05;84280022;84169412;110610;
06.02.2019;17:24:06;84280163;84169592;110571;
06.02.2019;17:25:05;84280302;84169747;110555;
06.02.2019;17:26:10;84280456;84169969;110487;
06.02.2019;17:27:05;84280595;84170112;110483;
06.02.2019;17:28:06;84280748;84170310;110438;
06.02.2019;17:29:05;84280881;84170467;110414;
06.02.2019;17:30:05;84281020;84170668;110352;
06.02.2019;17:31:04;84281158;84170830;110328;
06.02.2019;17:32:06;84281286;84171000;110286;
06.02.2019;17:33:05;84281421;84171156;110265;
06.02.2019;17:34:05;84281546;84171322;110224;
06.02.2019;17:35:10;84281681;84171506;110175;
06.02.2019;17:36:05;84281783;84171685;110098;
06.02.2019;17:37:05;84281904;84171851;110053;
06.02.2019;17:38:06;84282037;84172033;110004;
06.02.2019;17:39:05;84282144;84172231;109913;
06.02.2019;17:40:05;84282259;84172412;109847;
06.02.2019;17:41:05;84282383;84172560;109823;
06.02.2019;17:42:04;84282514;84172733;109781;
06.02.2019;17:43:04;84282679;84172888;109791;
06.02.2019;17:44:06;84282823;84173081;109742;
06.02.2019;17:45:05;84282941;84173237;109704;
06.02.2019;17:46:05;84283092;84173408;109684;
06.02.2019;17:47:05;84283237;84173582;109655;
06.02.2019;17:48:05;84283387;84173727;109660;
06.02.2019;17:49:05;84283507;84173893;109614;
06.02.2019;17:50:05;84283642;84174062;109580;
06.02.2019;17:51:05;84283752;84174234;109518;
06.02.2019;17:52:07;84283900;84174386;109514;
06.02.2019;17:53:10;84284057;84174558;109499;
06.02.2019;17:54:15;84284183;84174727;109456;
06.02.2019;17:55:05;84284303;84174871;109432;
06.02.2019;17:56:05;84284429;84175012;109417;
06.02.2019;17:57:04;84284575;84175168;109407;
06.02.2019;17:58:04;84284671;84175342;109329;
06.02.2019;17:59:06;84284845;84175492;109353;
06.02.2019;18:00:05;84284993;84175660;109333;
06.02.2019;18:01:05;84285103;84175810;109293;
06.02.2019;18:02:05;84285231;84175980;109251;
06.02.2019;18:03:04;84285337;84176129;109208;
06.02.2019;18:04:06;84285440;84176311;109129;
06.02.2019;18:05:05;84285565;84176458;109107;
06.02.2019;18:06:05;84285668;84176628;109040;
06.02.2019;18:07:11;84285779;84176807;108972;
06.02.2019;18:08:05;84285948;84176931;109017;
06.02.2019;18:09:04;84286063;84177094;108969;
06.02.2019;18:10:04;84286206;84177235;108971;
06.02.2019;18:11:05;84286339;84177423;108916;
06.02.2019;18:12:06;84286449;84177591;108858;
06.02.2019;18:13:05;84286540;84177736;108804;
06.02.2019;18:14:10;84286709;84177919;108790;
06.02.2019;18:15:07;84286832;84178085;108747;
06.02.2019;18:16:04;84286951;84178229;108722;
06.02.2019;18:17:05;84287085;84178378;108707;
06.02.2019;18:18:04;84287237;84178510;108727;
06.02.2019;18:19:06;84287337;84178642;108695;
06.02.2019;18:20:04;84287446;84178799;108647;
06.02.2019;18:21:05;84287566;84178975;108591;
06.02.2019;18:22:06;84287671;84179116;108555;
06.02.2019;18:23:05;84287774;84179241;108533;
06.02.2019;18:24:08;84287863;84179397;108466;
06.02.2019;18:25:05;84287969;84179515;108454;
06.02.2019;18:26:04;84288041;84179657;108384;
06.02.2019;18:27:05;84288137;84179784;108353;
06.02.2019;18:28:08;84288249;84179914;108335;
06.02.2019;18:29:05;84288334;84180033;108301;
06.02.2019;18:30:06;84288429;84180167;108262;
06.02.2019;18:31:04;84288517;84180324;108193;
06.02.2019;18:32:07;84288610;84180433;108177;
06.02.2019;18:33:09;84288661;84180559;108102;
06.02.2019;18:34:05;84288736;84180706;108030;
06.02.2019;18:35:04;84288820;84180834;107986;
06.02.2019;18:36:05;84288885;84180980;107905;
06.02.2019;18:37:07;84288980;84181123;107857;
06.02.2019;18:38:05;84289081;84181241;107840;
06.02.2019;18:39:07;84289198;84181350;107848;
06.02.2019;18:40:04;84289284;84181484;107800;
06.02.2019;18:41:07;84289368;84181626;107742;
06.02.2019;18:42:06;84289467;84181762;107705;
06.02.2019;18:43:05;84289558;84181898;107660;
06.02.2019;18:44:11;84289697;84182051;107646;
06.02.2019;18:45:07;84289783;84182166;107617;
06.02.2019;18:46:04;84289902;84182298;107604;
06.02.2019;18:47:05;84290013;84182429;107584;
06.02.2019;18:48:05;84290162;84182574;107588;
06.02.2019;18:49:05;84290318;84182693;107625;
06.02.2019;18:50:07;84290463;84182833;107630;
06.02.2019;18:51:06;84290557;84182936;107621;
06.02.2019;18:52:04;84290666;84183107;107559;
06.02.2019;18:53:04;84290790;84183239;107551;
06.02.2019;18:54:08;84290911;84183370;107541;
06.02.2019;18:55:11;84291039;84183502;107537;
06.02.2019;18:56:05;84291158;84183599;107559;
06.02.2019;18:57:09;84291275;84183724;107551;
06.02.2019;18:58:08;84291389;84183847;107542;
06.02.2019;18:59:05;84291525;84183949;107576;
06.02.2019;19:00:10;84291658;84184073;107585;
06.02.2019;19:01:04;84291764;84184198;107566;
06.02.2019;19:02:11;84291892;84184296;107596;
06.02.2019;19:03:13;84292047;84184406;107641;
06.02.2019;19:04:05;84292191;84184506;107685;
06.02.2019;19:05:05;84292311;84184626;107685;
06.02.2019;19:06:05;84292423;84184734;107689;
06.02.2019;19:07:13;84292590;84184892;107698;
06.02.2019;19:08:06;84292701;84184978;107723;
06.02.2019;19:09:05;84292849;84185107;107742;
06.02.2019;19:10:05;84292961;84185237;107724;
06.02.2019;19:11:08;84293097;84185343;107754;
06.02.2019;19:12:05;84293230;84185471;107759;
06.02.2019;19:13:05;84293378;84185577;107801;
06.02.2019;19:14:07;84293525;84185701;107824;
06.02.2019;19:15:07;84293662;84185802;107860;
06.02.2019;19:16:06;84293774;84185918;107856;
06.02.2019;19:17:12;84293908;84186044;107864;
06.02.2019;19:18:05;84294043;84186169;107874;
06.02.2019;19:19:11;84294213;84186323;107890;
06.02.2019;19:20:07;84294343;84186438;107905;
06.02.2019;19:21:04;84294479;84186556;107923;
06.02.2019;19:22:09;84294540;84186534;108006;
06.02.2019;19:23:06;84294668;84186618;108050;
06.02.2019;19:24:08;84294810;84186745;108065;
06.02.2019;19:25:05;84294941;84186833;108108;
06.02.2019;19:26:11;84295093;84186958;108135;
06.02.2019;19:28:05;84295386;84187141;108245;
06.02.2019;19:29:06;84295549;84187251;108298;
06.02.2019;19:30:11;84295706;84187345;108361;
06.02.2019;19:31:07;84295837;84187437;108400;
06.02.2019;19:32:07;84295955;84187550;108405;
06.02.2019;19:33:09;84296104;84187635;108469;
06.02.2019;19:34:04;84296225;84187724;108501;
06.02.2019;19:35:05;84296381;84187846;108535;
06.02.2019;19:36:07;84296564;84187951;108613;
06.02.2019;19:37:13;84296721;84188054;108667;
06.02.2019;19:38:07;84296840;84188137;108703;
06.02.2019;19:39:07;84296996;84188218;108778;
06.02.2019;19:40:08;84297124;84188319;108805;
06.02.2019;19:41:05;84297272;84188423;108849;
06.02.2019;19:42:10;84297415;84188516;108899;
06.02.2019;19:43:05;84297565;84188610;108955;
06.02.2019;19:44:04;84297702;84188705;108997;
06.02.2019;19:45:06;84297854;84188789;109065;
06.02.2019;19:46:10;84297998;84188875;109123;
06.02.2019;19:47:04;84298137;84188964;109173;
06.02.2019;19:48:05;84298286;84189066;109220;
06.02.2019;19:49:06;84298457;84189144;109313;
06.02.2019;19:50:09;84298618;84189248;109370;
06.02.2019;19:51:05;84298767;84189317;109450;
06.02.2019;19:52:12;84298913;84189414;109499;
06.02.2019;19:53:15;84299057;84189520;109537;
06.02.2019;19:54:04;84299224;84189579;109645;
06.02.2019;19:55:06;84299404;84189679;109725;
06.02.2019;19:56:06;84299549;84189754;109795;
06.02.2019;19:57:11;84299710;84189844;109866;
06.02.2019;19:58:16;84299871;84189937;109934;
06.02.2019;19:59:21;84300019;84190021;109998;
06.02.2019;20:00:04;84300140;84190090;110050;
06.02.2019;20:01:04;84300314;84190155;110159;
06.02.2019;20:02:05;84300462;84190231;110231;
06.02.2019;20:03:09;84300615;84190320;110295;
06.02.2019;20:04:06;84300747;84190396;110351;
06.02.2019;20:05:13;84300922;84190484;110438;
06.02.2019;20:06:07;84301048;84190561;110487;
06.02.2019;20:07:05;84301194;84190638;110556;
06.02.2019;20:08:12;84301388;84190708;110680;
06.02.2019;20:09:07;84301543;84190775;110768;
06.02.2019;20:10:06;84301714;84190839;110875;
06.02.2019;20:11:10;84301875;84190895;110980;
06.02.2019;20:12:09;84302013;84190979;111034;
06.02.2019;20:13:05;84302179;84191034;111145;
06.02.2019;20:14:07;84302334;84191107;111227;
06.02.2019;20:15:06;84302499;84191181;111318;
06.02.2019;20:16:06;84302633;84191250;111383;
06.02.2019;20:17:06;84302770;84191334;111436;
06.02.2019;20:18:04;84302923;84191414;111509;
06.02.2019;20:19:04;84303076;84191482;111594;
06.02.2019;20:20:06;84303207;84191552;111655;
06.02.2019;20:21:07;84303324;84191597;111727;
06.02.2019;20:22:11;84303430;84191647;111783;
06.02.2019;20:23:05;84303519;84191705;111814;
06.02.2019;20:24:05;84303629;84191762;111867;
06.02.2019;20:25:13;84303773;84191845;111928;
06.02.2019;20:26:05;84303865;84191885;111980;
06.02.2019;20:27:05;84303988;84191923;112065;
06.02.2019;20:28:11;84304103;84191968;112135;
06.02.2019;20:29:06;84304243;84192013;112230;
06.02.2019;20:30:05;84304391;84192056;112335;
06.02.2019;20:31:05;84304541;84192097;112444;
06.02.2019;20:32:05;84304679;84192162;112517;
06.02.2019;20:33:05;84304794;84192220;112574;
06.02.2019;20:34:07;84304969;84192298;112671;
06.02.2019;20:35:04;84305081;84192348;112733;
06.02.2019;20:36:04;84305215;84192404;112811;
06.02.2019;20:37:05;84305375;84192485;112890;
06.02.2019;20:38:08;84305466;84192553;112913;
06.02.2019;20:39:06;84305665;84192616;113049;
06.02.2019;20:40:12;84305825;84192680;113145;
06.02.2019;20:41:11;84305971;84192752;113219;
06.02.2019;20:42:06;84306103;84192821;113282;
06.02.2019;20:43:10;84306241;84192874;113367;
06.02.2019;20:44:06;84306369;84192932;113437;
06.02.2019;20:45:05;84306517;84192973;113544;
06.02.2019;20:46:06;84306671;84193034;113637;
06.02.2019;20:47:09;84306840;84193105;113735;
06.02.2019;20:48:04;84306943;84193158;113785;
06.02.2019;20:49:05;84307105;84193221;113884;
06.02.2019;20:50:06;84307247;84193280;113967;
06.02.2019;20:51:09;84307396;84193337;114059;
06.02.2019;20:52:11;84307543;84193400;114143;
06.02.2019;20:53:05;84307667;84193457;114210;
06.02.2019;20:54:05;84307798;84193537;114261;
06.02.2019;20:55:09;84307951;84193603;114348;
06.02.2019;20:56:13;84308118;84193654;114464;
06.02.2019;20:57:05;84308259;84193717;114542;
06.02.2019;20:58:07;84308419;84193770;114649;
06.02.2019;20:59:04;84308581;84193845;114736;
06.02.2019;21:00:07;84308713;84193895;114818;
06.02.2019;21:01:06;84308837;84193954;114883;
06.02.2019;21:02:05;84308979;84194012;114967;
06.02.2019;21:03:11;84309128;84194058;115070;
06.02.2019;21:04:13;84309260;84194131;115129;
06.02.2019;21:05:05;84309403;84194198;115205;
06.02.2019;21:06:10;84309563;84194254;115309;
06.02.2019;21:07:05;84309695;84194306;115389;
06.02.2019;21:08:04;84309815;84194357;115458;
06.02.2019;21:09:06;84310002;84194402;115600;
06.02.2019;21:10:06;84310144;84194456;115688;
06.02.2019;21:11:05;84310270;84194508;115762;
06.02.2019;21:12:05;84310386;84194555;115831;
06.02.2019;21:13:08;84310521;84194614;115907;
06.02.2019;21:14:10;84310657;84194668;115989;
06.02.2019;21:15:05;84310795;84194709;116086;
06.02.2019;21:16:11;84310940;84194772;116168;
06.02.2019;21:17:07;84311074;84194821;116253;
06.02.2019;21:18:10;84311214;84194867;116347;
06.02.2019;21:19:04;84311343;84194919;116424;
06.02.2019;21:20:04;84311495;84194988;116507;
06.02.2019;21:21:08;84311671;84195046;116625;
06.02.2019;21:22:10;84311802;84195104;116698;
06.02.2019;21:23:05;84311946;84195152;116794;
06.02.2019;21:24:07;84312088;84195195;116893;
06.02.2019;21:25:12;84308279;84195226;113053;
06.02.2019;21:26:07;84308412;84195267;113145;
06.02.2019;21:27:05;84308551;84195324;113227;
06.02.2019;21:28:05;84308706;84202101;106605;
06.02.2019;21:29:04;84308839;84202144;106695;
06.02.2019;21:30:08;84308988;84202194;106794;
06.02.2019;21:31:06;84309125;84202243;106882;
06.02.2019;21:32:06;84309259;84202283;106976;
06.02.2019;21:33:06;84309407;84202333;107074;
06.02.2019;21:34:13;84309542;84202391;107151;
06.02.2019;21:35:05;84309685;84202430;107255;
06.02.2019;21:36:05;84309836;84202489;107347;
06.02.2019;21:37:05;84309986;84202531;107455;
06.02.2019;21:38:06;84310142;84202583;107559;
06.02.2019;21:39:08;84310309;84202623;107686;
06.02.2019;21:40:04;84310460;84202665;107795;
06.02.2019;21:41:04;84310620;84202706;107914;
06.02.2019;21:42:09;84310766;84202768;107998;
06.02.2019;21:43:07;84310936;84202797;108139;
06.02.2019;21:44:06;84311085;84202835;108250;
06.02.2019;21:45:05;84311252;84202874;108378;
06.02.2019;21:46:04;84311401;84202905;108496;
06.02.2019;21:47:07;84311563;84202941;108622;
06.02.2019;21:48:04;84311702;84202997;108705;
06.02.2019;21:49:06;84311864;84203053;108811;
06.02.2019;21:50:11;84312035;84203095;108940;
06.02.2019;21:51:07;84312204;84203132;109072;
06.02.2019;21:52:05;84312336;84203156;109180;
06.02.2019;21:53:04;84312478;84203205;109273;
06.02.2019;21:54:09;84312663;84203262;109401;
06.02.2019;21:55:04;84312794;84203281;109513;
06.02.2019;21:56:09;84312943;84203348;109595;
06.02.2019;21:57:06;84313071;84203380;109691;
06.02.2019;21:58:05;84313201;84203425;109776;
06.02.2019;21:59:05;84313370;84203461;109909;
06.02.2019;22:00:09;84313555;84203501;110054;
06.02.2019;22:01:10;84313691;84203541;110150;
06.02.2019;22:02:10;84313829;84203584;110245;
06.02.2019;22:03:06;84313980;84203633;110347;
06.02.2019;22:04:05;84314141;84203672;110469;
06.02.2019;22:05:05;84314310;84203718;110592;
06.02.2019;22:06:04;84314435;84203750;110685;
06.02.2019;22:07:04;84314575;84203794;110781;
06.02.2019;22:08:05;84314729;84203830;110899;
06.02.2019;22:09:09;84314874;84203875;110999;
06.02.2019;22:10:05;84315020;84203913;111107;
06.02.2019;22:11:05;84315153;84203944;111209;
06.02.2019;22:12:06;84315284;84203981;111303;
06.02.2019;22:13:08;84315453;84204036;111417;
06.02.2019;22:14:05;84315590;84204063;111527;
06.02.2019;22:15:06;84315742;84204093;111649;
06.02.2019;22:16:04;84315897;84204126;111771;
06.02.2019;22:17:06;84316048;84204163;111885;
06.02.2019;22:18:04;84316172;84204209;111963;
06.02.2019;22:19:05;84316327;84204241;112086;
06.02.2019;22:20:10;84316480;84204254;112226;
06.02.2019;22:21:08;84316620;84204307;112313;
06.02.2019;22:22:07;84316733;84204330;112403;
06.02.2019;22:23:09;84316886;84204367;112519;
06.02.2019;22:24:05;84316978;84204380;112598;
06.02.2019;22:25:05;84317101;84204395;112706;
06.02.2019;22:26:12;84317224;84204435;112789;
06.02.2019;22:27:05;84317345;84204461;112884;
06.02.2019;22:28:04;84317504;84204477;113027;
06.02.2019;22:29:04;84317618;84204495;113123;
06.02.2019;22:30:05;84317759;84204510;113249;
06.02.2019;22:31:08;84317870;84204531;113339;
06.02.2019;22:32:04;84317977;84204552;113425;
06.02.2019;22:33:05;84318135;84204576;113559;
06.02.2019;22:34:05;84318265;84204609;113656;
06.02.2019;22:35:09;84318416;84204631;113785;
06.02.2019;22:36:10;84318505;84204617;113888;
06.02.2019;22:37:05;84318617;84204607;114010;
06.02.2019;22:38:04;84318743;84204635;114108;
06.02.2019;22:39:08;84318892;84204676;114216;
06.02.2019;22:40:04;84319006;84204700;114306;
06.02.2019;22:41:05;84319160;84204728;114432;
06.02.2019;22:42:05;84319280;84204752;114528;
06.02.2019;22:43:06;84319395;84204779;114616;
06.02.2019;22:44:13;84319532;84204825;114707;
06.02.2019;22:45:05;84319644;84204867;114777;
06.02.2019;22:46:05;84319772;84204887;114885;
06.02.2019;22:47:05;84319927;84204932;114995;
06.02.2019;22:48:08;84320074;84204969;115105;
06.02.2019;22:49:04;84320192;84204996;115196;
06.02.2019;22:50:05;84320373;84205025;115348;
06.02.2019;22:51:04;84320520;84205057;115463;
06.02.2019;22:52:08;84320684;84205088;115596;
06.02.2019;22:53:05;84320823;84205121;115702;
06.02.2019;22:54:06;84320999;84205160;115839;
06.02.2019;22:55:07;84321151;84205186;115965;
06.02.2019;22:56:06;84321284;84205217;116067;
06.02.2019;22:57:04;84321425;84205252;116173;
06.02.2019;22:58:05;84321593;84205284;116309;
06.02.2019;22:59:05;84321732;84205310;116422;
06.02.2019;23:00:10;84321876;84205346;116530;
06.02.2019;23:01:07;84322029;84205375;116654;
06.02.2019;23:02:12;84322146;84205400;116746;
06.02.2019;23:03:04;84322297;84205432;116865;
06.02.2019;23:04:10;84322450;84205481;116969;
06.02.2019;23:05:07;84322554;84205506;117048;
06.02.2019;23:06:06;84322701;84205534;117167;
06.02.2019;23:07:06;84322877;84205576;117301;
06.02.2019;23:08:11;84323010;84205605;117405;
06.02.2019;23:09:05;84323175;84205632;117543;
06.02.2019;23:10:06;84323332;84205661;117671;
06.02.2019;23:11:05;84323488;84205675;117813;
06.02.2019;23:12:05;84323625;84205715;117910;
06.02.2019;23:13:04;84323746;84205746;118000;
06.02.2019;23:14:08;84323887;84205762;118125;
06.02.2019;23:15:10;84324015;84205803;118212;
06.02.2019;23:16:05;84324182;84205824;118358;
06.02.2019;23:17:05;84324328;84205869;118459;
06.02.2019;23:18:08;84324481;84205909;118572;
06.02.2019;23:19:05;84324624;84205937;118687;
06.02.2019;23:20:05;84324771;84205964;118807;
06.02.2019;23:21:05;84324884;84205999;118885;
06.02.2019;23:22:06;84325014;84206024;118990;
06.02.2019;23:23:06;84325175;84206055;119120;
06.02.2019;23:24:05;84325332;84206090;119242;
06.02.2019;23:25:04;84325479;84206122;119357;
06.02.2019;23:26:05;84325611;84206160;119451;
06.02.2019;23:27:07;84325775;84206192;119583;
06.02.2019;23:28:05;84325915;84206209;119706;
06.02.2019;23:29:04;84326059;84206236;119823;
06.02.2019;23:30:10;84326222;84206261;119961;
06.02.2019;23:31:07;84326325;84206284;120041;
06.02.2019;23:32:05;84326481;84206309;120172;
06.02.2019;23:34:16;84326753;84206377;120376;
06.02.2019;23:35:05;84326886;84206383;120503;
06.02.2019;23:36:05;84327029;84206400;120629;
06.02.2019;23:37:05;84327174;84206418;120756;
06.02.2019;23:38:06;84327324;84206432;120892;
06.02.2019;23:39:04;84327463;84206451;121012;
06.02.2019;23:40:05;84327625;84206476;121149;
06.02.2019;23:41:05;84327769;84206507;121262;
06.02.2019;23:42:04;84327913;84206533;121380;
06.02.2019;23:43:04;84328061;84206556;121505;
06.02.2019;23:44:04;84328210;84206592;121618;
06.02.2019;23:45:05;84328350;84206619;121731;
06.02.2019;23:46:04;84328503;84206651;121852;
06.02.2019;23:47:05;84328634;84206690;121944;
06.02.2019;23:48:05;84328767;84206719;122048;
06.02.2019;23:49:10;84328924;84206758;122166;
06.02.2019;23:50:05;84329039;84206776;122263;
06.02.2019;23:51:04;84329171;84206804;122367;
06.02.2019;23:52:05;84329288;84206832;122456;
06.02.2019;23:53:06;84329407;84206852;122555;
06.02.2019;23:54:04;84329513;84206868;122645;
06.02.2019;23:55:05;84329659;84206890;122769;
06.02.2019;23:56:11;84329813;84206917;122896;
06.02.2019;23:57:06;84329948;84206949;122999;
06.02.2019;23:58:04;84330085;84206975;123110;
06.02.2019;23:59:04;84330174;84207003;123171;
07.02.2019;00:00:08;84330336;84207028;123308;
07.02.2019;00:01:08;84330475;84207048;123427;
07.02.2019;00:02:07;84330615;84207063;123552;
07.02.2019;00:03:07;84330744;84207095;123649;
07.02.2019;00:04:08;84330862;84207119;123743;
07.02.2019;00:05:08;84330948;84207141;123807;
07.02.2019;00:06:08;84331081;84207157;123924;
07.02.2019;00:07:09;84331194;84207186;124008;
07.02.2019;00:08:08;84331319;84207198;124121;
07.02.2019;00:09:08;84331442;84207224;124218;
07.02.2019;00:10:07;84331578;84207242;124336;
07.02.2019;00:11:07;84331695;84207281;124414;
07.02.2019;00:12:06;84331830;84207300;124530;
07.02.2019;00:13:07;84331956;84207326;124630;
07.02.2019;00:14:08;84332053;84207340;124713;
07.02.2019;00:15:07;84332166;84207365;124801;
07.02.2019;00:16:09;84332280;84207386;124894;
07.02.2019;00:17:08;84332401;84207415;124986;
07.02.2019;00:18:08;84332524;84207432;125092;
07.02.2019;00:19:08;84332631;84207451;125180;
07.02.2019;00:20:08;84332732;84207485;125247;
07.02.2019;00:21:12;84332855;84207512;125343;
07.02.2019;00:22:07;84332955;84207548;125407;
07.02.2019;00:23:07;84333069;84207567;125502;
07.02.2019;00:24:06;84333183;84207583;125600;
07.02.2019;00:25:06;84333337;84207595;125742;
07.02.2019;00:26:08;84333470;84207609;125861;
07.02.2019;00:27:07;84333603;84207638;125965;
07.02.2019;00:28:08;84333710;84207670;126040;
07.02.2019;00:29:07;84333825;84207690;126135;
07.02.2019;00:30:07;84333954;84207726;126228;
07.02.2019;00:31:08;84334069;84207739;126330;
07.02.2019;00:32:08;84334178;84207753;126425;
07.02.2019;00:33:07;84334266;84207778;126488;
07.02.2019;00:34:13;84334368;84207803;126565;
07.02.2019;00:35:08;84334466;84207816;126650;
07.02.2019;00:36:07;84334573;84207837;126736;
07.02.2019;00:37:07;84334667;84207853;126814;
07.02.2019;00:38:08;84334796;84207883;126913;
07.02.2019;00:39:08;84334881;84207903;126978;
07.02.2019;00:40:07;84334992;84207929;127063;
07.02.2019;00:41:08;84335101;84207953;127148;
07.02.2019;00:42:07;84335204;84207971;127233;
07.02.2019;00:43:08;84335301;84208001;127300;
07.02.2019;00:44:08;84335418;84208021;127397;
07.02.2019;00:45:08;84335518;84208042;127476;
07.02.2019;00:46:07;84335634;84208075;127559;
07.02.2019;00:47:08;84335760;84208105;127655;
07.02.2019;00:48:07;84335869;84208109;127760;
07.02.2019;00:49:08;84335980;84208125;127855;
07.02.2019;00:50:08;84336086;84208156;127930;
07.02.2019;00:51:13;84336184;84208168;128016;
07.02.2019;00:52:08;84336264;84208212;128052;
07.02.2019;00:53:12;84336359;84208232;128127;
07.02.2019;00:54:13;84336454;84208253;128201;
07.02.2019;00:55:09;84336558;84208285;128273;
07.02.2019;00:56:07;84336660;84208315;128345;
07.02.2019;00:57:13;84336789;84208341;128448;
07.02.2019;00:58:12;84336887;84208373;128514;
07.02.2019;00:59:07;84336988;84208396;128592;
07.02.2019;01:00:04;84337066;84208426;128640;
07.02.2019;01:01:05;84337183;84208456;128727;
07.02.2019;01:02:05;84337278;84208476;128802;
07.02.2019;01:03:04;84337363;84208513;128850;
07.02.2019;01:04:05;84337513;84208540;128973;
07.02.2019;01:05:04;84337628;84208566;129062;
07.02.2019;01:06:04;84337743;84208588;129155;
07.02.2019;01:07:06;84337867;84208609;129258;
07.02.2019;01:08:05;84337980;84208645;129335;
07.02.2019;01:09:08;84338092;84208677;129415;
07.02.2019;01:10:04;84338178;84208693;129485;
07.02.2019;01:11:05;84338276;84208716;129560;
07.02.2019;01:12:04;84338400;84208751;129649;
07.02.2019;01:13:04;84338508;84208788;129720;
07.02.2019;01:14:05;84338582;84208819;129763;
07.02.2019;01:15:05;84338729;84208849;129880;
07.02.2019;01:16:04;84338824;84208883;129941;
07.02.2019;01:17:05;84338926;84208908;130018;
07.02.2019;01:18:05;84339015;84208937;130078;
07.02.2019;01:19:04;84339122;84208967;130155;
07.02.2019;01:20:05;84339216;84208989;130227;
07.02.2019;01:21:05;84339306;84209010;130296;
07.02.2019;01:22:04;84339413;84209060;130353;
07.02.2019;01:23:04;84339535;84209091;130444;
07.02.2019;01:24:05;84339615;84209061;130554;
07.02.2019;01:25:05;84339739;84209088;130651;
07.02.2019;01:26:04;84339847;84209123;130724;
07.02.2019;01:27:04;84339956;84209168;130788;
07.02.2019;01:28:06;84340060;84209195;130865;
07.02.2019;01:29:04;84340145;84209229;130916;
07.02.2019;01:30:05;84340270;84209266;131004;
07.02.2019;01:31:04;84340390;84209304;131086;
07.02.2019;01:32:04;84340490;84209335;131155;
07.02.2019;01:33:05;84340602;84209382;131220;
07.02.2019;01:34:04;84340717;84209426;131291;
07.02.2019;01:35:04;84340834;84209464;131370;
07.02.2019;01:36:05;84340944;84209483;131461;
07.02.2019;01:37:04;84341028;84209540;131488;
07.02.2019;01:38:06;84341132;84209582;131550;
07.02.2019;01:39:06;84341233;84209621;131612;
07.02.2019;01:40:05;84341339;84209668;131671;
07.02.2019;01:41:04;84341451;84209714;131737;
07.02.2019;01:42:04;84341535;84209745;131790;
07.02.2019;01:43:05;84341649;84209786;131863;
07.02.2019;01:44:05;84341748;84209834;131914;
07.02.2019;01:45:04;84341870;84209880;131990;
07.02.2019;01:46:04;84341999;84209916;132083;
07.02.2019;01:47:05;84342116;84209979;132137;
07.02.2019;01:48:04;84342233;84210022;132211;
07.02.2019;01:49:05;84342338;84210057;132281;
07.02.2019;01:50:05;84342438;84210107;132331;
07.02.2019;01:51:05;84342541;84210162;132379;
07.02.2019;01:52:09;84342657;84210196;132461;
07.02.2019;01:53:05;84342752;84210230;132522;
07.02.2019;01:54:04;84342870;84210282;132588;
07.02.2019;01:55:04;84342960;84210322;132638;
07.02.2019;01:56:05;84343079;84210379;132700;
07.02.2019;01:57:05;84343231;84210420;132811;
07.02.2019;01:58:04;84343353;84210498;132855;
07.02.2019;01:59:04;84343480;84210546;132934;
07.02.2019;02:00:04;84343592;84210616;132976;
07.02.2019;02:01:04;84343707;84210666;133041;
07.02.2019;02:02:05;84343810;84210708;133102;
07.02.2019;02:03:05;84343919;84210762;133157;
07.02.2019;02:04:04;84344046;84210819;133227;
07.02.2019;02:05:04;84344173;84210879;133294;
07.02.2019;02:06:05;84344298;84210937;133361;
07.02.2019;02:07:04;84344392;84210981;133411;
07.02.2019;02:08:05;84344502;84211039;133463;
07.02.2019;02:09:06;84344615;84211079;133536;
07.02.2019;02:10:05;84344722;84211124;133598;
07.02.2019;02:11:04;84344828;84211178;133650;
07.02.2019;02:12:04;84344952;84211236;133716;
07.02.2019;02:13:05;84345071;84211295;133776;
07.02.2019;02:14:04;84345192;84211347;133845;
07.02.2019;02:15:04;84345301;84211414;133887;
07.02.2019;02:16:05;84345413;84211477;133936;
07.02.2019;02:17:04;84345516;84211554;133962;
07.02.2019;02:18:04;84345616;84211618;133998;
07.02.2019;02:19:05;84345691;84211687;134004;
07.02.2019;02:20:04;84345827;84211763;134064;
07.02.2019;02:21:05;84345932;84211834;134098;
07.02.2019;02:22:04;84346059;84211909;134150;
07.02.2019;02:23:05;84346150;84211962;134188;
07.02.2019;02:24:04;84346236;84212037;134199;
07.02.2019;02:25:04;84346330;84212112;134218;
07.02.2019;02:26:05;84346427;84212171;134256;
07.02.2019;02:27:04;84346493;84212245;134248;
07.02.2019;02:28:04;84346588;84212301;134287;
07.02.2019;02:29:04;84346689;84212372;134317;
07.02.2019;02:30:04;84346787;84212449;134338;
07.02.2019;02:31:04;84346872;84212509;134363;
07.02.2019;02:32:04;84346951;84212557;134394;
07.02.2019;02:33:05;84347063;84212621;134442;
07.02.2019;02:34:04;84347183;84212695;134488;
07.02.2019;02:35:04;84347281;84212747;134534;
07.02.2019;02:36:04;84347371;84212819;134552;
07.02.2019;02:37:04;84347486;84212884;134602;
07.02.2019;02:38:05;84347571;84212963;134608;
07.02.2019;02:39:06;84347688;84213027;134661;
07.02.2019;02:40:04;84347810;84213080;134730;
07.02.2019;02:41:05;84347912;84213155;134757;
07.02.2019;02:42:04;84348030;84213237;134793;
07.02.2019;02:43:05;84348131;84213337;134794;
07.02.2019;02:44:05;84348235;84213423;134812;
07.02.2019;02:45:04;84348345;84213509;134836;
07.02.2019;02:46:05;84348456;84213582;134874;
07.02.2019;02:47:04;84348574;84213659;134915;
07.02.2019;02:48:04;84348677;84213761;134916;
07.02.2019;02:49:05;84348793;84213850;134943;
07.02.2019;02:50:05;84348906;84213933;134973;
07.02.2019;02:51:04;84349013;84214026;134987;
07.02.2019;02:52:05;84349115;84214107;135008;
07.02.2019;02:53:04;84349217;84214181;135036;
07.02.2019;02:54:04;84349335;84214271;135064;
07.02.2019;02:55:05;84349455;84214371;135084;
07.02.2019;02:56:04;84349571;84214447;135124;
07.02.2019;02:57:04;84349671;84214553;135118;
07.02.2019;02:58:05;84349780;84214643;135137;
07.02.2019;02:59:04;84349899;84214725;135174;
07.02.2019;03:00:05;84350008;84214818;135190;
07.02.2019;03:01:05;84350117;84214896;135221;
07.02.2019;03:02:04;84350213;84214983;135230;
07.02.2019;03:03:04;84350323;84215071;135252;
07.02.2019;03:04:04;84350435;84215166;135269;
07.02.2019;03:05:04;84350531;84215238;135293;
07.02.2019;03:06:05;84350659;84215330;135329;
07.02.2019;03:07:04;84350733;84215418;135315;
07.02.2019;03:08:04;84350862;84215504;135358;
07.02.2019;03:09:06;84350990;84215613;135377;
07.02.2019;03:10:04;84351088;84215717;135371;
07.02.2019;03:11:05;84351192;84215800;135392;
07.02.2019;03:12:04;84351293;84215899;135394;
07.02.2019;03:13:05;84351398;84216001;135397;
07.02.2019;03:14:05;84351521;84216083;135438;
07.02.2019;03:15:05;84351622;84216192;135430;
07.02.2019;03:16:04;84351714;84216274;135440;
07.02.2019;03:17:05;84351812;84216376;135436;
07.02.2019;03:18:05;84351951;84216471;135480;
07.02.2019;03:19:05;84352058;84216564;135494;
07.02.2019;03:20:04;84352152;84216675;135477;
07.02.2019;03:21:04;84352251;84216767;135484;
07.02.2019;03:22:04;84352360;84216879;135481;
07.02.2019;03:23:04;84352483;84216985;135498;
07.02.2019;03:24:05;84352599;84217080;135519;
07.02.2019;03:25:04;84352709;84217180;135529;
07.02.2019;03:26:04;84352835;84217275;135560;
07.02.2019;03:27:04;84352944;84217384;135560;
07.02.2019;03:28:04;84353041;84217500;135541;
07.02.2019;03:29:05;84353158;84217599;135559;
07.02.2019;03:30:04;84353269;84217718;135551;
07.02.2019;03:31:04;84353378;84217843;135535;
07.02.2019;03:32:05;84353488;84217952;135536;
07.02.2019;03:33:04;84353584;84218058;135526;
07.02.2019;03:34:05;84353699;84218178;135521;
07.02.2019;03:35:04;84353818;84218278;135540;
07.02.2019;03:36:04;84353910;84218375;135535;
07.02.2019;03:37:04;84354013;84218500;135513;
07.02.2019;03:38:04;84354130;84218610;135520;
07.02.2019;03:39:04;84354237;84218724;135513;
07.02.2019;03:40:05;84354348;84218844;135504;
07.02.2019;03:41:04;84354458;84218960;135498;
07.02.2019;03:42:04;84354556;84219059;135497;
07.02.2019;03:43:04;84354667;84219155;135512;
07.02.2019;03:44:04;84354768;84219288;135480;
07.02.2019;03:45:05;84354887;84219388;135499;
07.02.2019;03:46:04;84354998;84219488;135510;
07.02.2019;03:47:05;84355109;84219591;135518;
07.02.2019;03:48:05;84355212;84219702;135510;
07.02.2019;03:49:04;84355324;84219807;135517;
07.02.2019;03:50:05;84355440;84219914;135526;
07.02.2019;03:51:04;84355542;84220014;135528;
07.02.2019;03:52:04;84355636;84220120;135516;
07.02.2019;03:53:04;84355772;84220238;135534;
07.02.2019;03:54:04;84355891;84220346;135545;
07.02.2019;03:55:04;84356012;84220460;135552;
07.02.2019;03:56:05;84356125;84220568;135557;
07.02.2019;03:57:04;84356238;84220675;135563;
07.02.2019;03:58:05;84356369;84220787;135582;
07.02.2019;03:59:04;84356479;84220900;135579;
07.02.2019;04:00:05;84356596;84220997;135599;
07.02.2019;04:01:09;84356691;84221131;135560;
07.02.2019;04:02:05;84356767;84221249;135518;
07.02.2019;04:03:04;84356852;84221377;135475;
07.02.2019;04:04:04;84356964;84221469;135495;
07.02.2019;04:05:04;84357058;84221593;135465;
07.02.2019;04:06:04;84357159;84221702;135457;
07.02.2019;04:07:05;84357266;84221812;135454;
07.02.2019;04:08:04;84357363;84221947;135416;
07.02.2019;04:09:04;84357471;84222049;135422;
07.02.2019;04:10:05;84357581;84222172;135409;
07.02.2019;04:11:04;84357673;84222289;135384;
07.02.2019;04:12:04;84357757;84222398;135359;
07.02.2019;04:13:04;84357878;84222503;135375;
07.02.2019;04:14:04;84357971;84222618;135353;
07.02.2019;04:15:05;84358065;84222727;135338;
07.02.2019;04:16:04;84358170;84222839;135331;
07.02.2019;04:17:05;84358270;84222960;135310;
07.02.2019;04:18:05;84358360;84223077;135283;
07.02.2019;04:19:04;84358443;84223191;135252;
07.02.2019;04:20:04;84358510;84223286;135224;
07.02.2019;04:21:05;84358561;84223379;135182;
07.02.2019;04:22:04;84358585;84223469;135116;
07.02.2019;04:23:05;84358650;84223581;135069;
07.02.2019;04:24:04;84358698;84223677;135021;
07.02.2019;04:25:04;84358737;84223707;135030;
07.02.2019;04:26:04;84358790;84223837;134953;
07.02.2019;04:27:05;84358878;84223952;134926;
07.02.2019;04:28:04;84358980;84224054;134926;
07.02.2019;04:29:05;84359085;84224187;134898;
07.02.2019;04:30:05;84359145;84224300;134845;
07.02.2019;04:31:04;84359218;84224413;134805;
07.02.2019;04:32:04;84359352;84224523;134829;
07.02.2019;04:33:05;84359461;84224659;134802;
07.02.2019;04:34:04;84359556;84224751;134805;
07.02.2019;04:35:05;84359663;84224866;134797;
07.02.2019;04:36:04;84359766;84224985;134781;
07.02.2019;04:37:04;84359823;84225099;134724;
07.02.2019;04:38:05;84359936;84225207;134729;
07.02.2019;04:39:04;84360025;84225322;134703;
07.02.2019;04:40:05;84360170;84225428;134742;
07.02.2019;04:41:05;84360283;84225534;134749;
07.02.2019;04:42:04;84360392;84225646;134746;
07.02.2019;04:43:05;84360478;84225752;134726;
07.02.2019;04:44:04;84360585;84225852;134733;
07.02.2019;04:45:04;84360702;84225939;134763;
07.02.2019;04:46:05;84360798;84226030;134768;
07.02.2019;04:47:04;84360912;84226142;134770;
07.02.2019;04:48:04;84361015;84226253;134762;
07.02.2019;04:49:04;84361118;84226371;134747;
07.02.2019;04:50:04;84361235;84226512;134723;
07.02.2019;04:51:05;84361324;84226614;134710;
07.02.2019;04:52:04;84361435;84226736;134699;
07.02.2019;04:53:05;84361541;84226841;134700;
07.02.2019;04:54:04;84361623;84226954;134669;
07.02.2019;04:55:04;84361731;84227048;134683;
07.02.2019;04:56:05;84361813;84227185;134628;
07.02.2019;04:57:04;84361911;84227307;134604;
07.02.2019;04:58:05;84362024;84227420;134604;
07.02.2019;04:59:04;84362124;84227513;134611;
07.02.2019;05:00:04;84362207;84227630;134577;
07.02.2019;05:01:05;84362296;84227732;134564;
07.02.2019;05:02:04;84362381;84227850;134531;
07.02.2019;05:03:04;84362474;84227981;134493;
07.02.2019;05:04:04;84362559;84228100;134459;
07.02.2019;05:05:04;84362649;84228219;134430;
07.02.2019;05:06:05;84362728;84228325;134403;
07.02.2019;05:07:04;84362840;84228438;134402;
07.02.2019;05:08:05;84362928;84228558;134370;
07.02.2019;05:09:06;84363021;84228678;134343;
07.02.2019;05:10:05;84363124;84228793;134331;
07.02.2019;05:11:04;84363225;84228922;134303;
07.02.2019;05:12:05;84363318;84229041;134277;
07.02.2019;05:13:04;84363412;84229168;134244;
07.02.2019;05:14:04;84363520;84229282;134238;
07.02.2019;05:15:04;84363608;84229420;134188;
07.02.2019;05:16:04;84363690;84229505;134185;
07.02.2019;05:17:05;84363785;84229594;134191;
07.02.2019;05:18:04;84363850;84229732;134118;
07.02.2019;05:19:04;84363947;84229845;134102;
07.02.2019;05:20:05;84364050;84229977;134073;
07.02.2019;05:21:04;84364133;84230088;134045;
07.02.2019;05:22:05;84364233;84230210;134023;
07.02.2019;05:23:04;84364337;84230340;133997;
07.02.2019;05:24:04;84364436;84230450;133986;
07.02.2019;05:25:04;84364512;84230560;133952;
07.02.2019;05:26:04;84364605;84230689;133916;
07.02.2019;05:27:05;84364684;84230820;133864;
07.02.2019;05:28:04;84364768;84230943;133825;
07.02.2019;05:29:05;84364856;84231074;133782;
07.02.2019;05:30:04;84364931;84231201;133730;
07.02.2019;05:31:04;84365012;84231313;133699;
07.02.2019;05:32:05;84365095;84231449;133646;
07.02.2019;05:33:04;84365186;84231564;133622;
07.02.2019;05:34:05;84365297;84231715;133582;
07.02.2019;05:35:04;84365383;84231847;133536;
07.02.2019;05:36:05;84365466;84231968;133498;
07.02.2019;05:37:05;84365553;84232106;133447;
07.02.2019;05:38:04;84365649;84232224;133425;
07.02.2019;05:39:05;84365711;84232352;133359;
07.02.2019;05:40:04;84365795;84232501;133294;
07.02.2019;05:41:04;84365880;84232614;133266;
07.02.2019;05:42:05;84365973;84232763;133210;
07.02.2019;05:43:04;84366069;84232888;133181;
07.02.2019;05:44:04;84366158;84233000;133158;
07.02.2019;05:45:04;84366232;84233129;133103;
07.02.2019;05:46:04;84366341;84233245;133096;
07.02.2019;05:47:05;84366412;84233376;133036;
07.02.2019;05:48:04;84366502;84233500;133002;
07.02.2019;05:49:05;84366614;84233608;133006;
07.02.2019;05:50:04;84366704;84233703;133001;
07.02.2019;05:51:04;84366774;84233807;132967;
07.02.2019;05:52:05;84366862;84233918;132944;
07.02.2019;05:53:04;84366942;84234042;132900;
07.02.2019;05:54:05;84367059;84234147;132912;
07.02.2019;05:55:04;84367150;84234247;132903;
07.02.2019;05:56:04;84367253;84234357;132896;
07.02.2019;05:57:05;84367340;84234485;132855;
07.02.2019;05:58:04;84367426;84234603;132823;
07.02.2019;05:59:04;84367507;84234704;132803;
07.02.2019;06:00:04;84367616;84234830;132786;
07.02.2019;06:01:04;84367694;84234946;132748;
07.02.2019;06:02:05;84367772;84235055;132717;
07.02.2019;06:03:04;84367852;84235198;132654;
07.02.2019;06:04:04;84367939;84235324;132615;
07.02.2019;06:05:04;84368018;84235446;132572;
07.02.2019;06:06:04;84368106;84235582;132524;
07.02.2019;06:07:05;84368193;84235691;132502;
07.02.2019;06:08:04;84368280;84235838;132442;
07.02.2019;06:09:07;84368358;84235963;132395;
07.02.2019;06:10:04;84368437;84236076;132361;
07.02.2019;06:11:05;84368506;84236215;132291;
07.02.2019;06:12:04;84368572;84236305;132267;
07.02.2019;06:13:04;84368670;84236426;132244;
07.02.2019;06:14:05;84368743;84236545;132198;
07.02.2019;06:15:04;84368798;84236660;132138;
07.02.2019;06:16:05;84368844;84236770;132074;
07.02.2019;06:17:05;84368917;84236871;132046;
07.02.2019;06:18:04;84368960;84236986;131974;
07.02.2019;06:19:04;84369027;84237110;131917;
07.02.2019;06:20:04;84369056;84237210;131846;
07.02.2019;06:21:07;84369123;84237313;131810;
07.02.2019;06:22:04;84369178;84237428;131750;
07.02.2019;06:23:05;84369222;84237544;131678;
07.02.2019;06:24:04;84369286;84237664;131622;
07.02.2019;06:25:08;84369356;84237775;131581;
07.02.2019;06:26:04;84369397;84237842;131555;
07.02.2019;06:27:04;84369453;84237953;131500;
07.02.2019;06:28:05;84369534;84238086;131448;
07.02.2019;06:29:04;84369617;84238201;131416;
07.02.2019;06:30:04;84369689;84238312;131377;
07.02.2019;06:31:04;84369758;84238421;131337;
07.02.2019;06:32:04;84369831;84238531;131300;
07.02.2019;06:33:05;84369908;84238677;131231;
07.02.2019;06:34:05;84369962;84238806;131156;
07.02.2019;06:35:04;84370051;84238908;131143;
07.02.2019;06:36:05;84370138;84238976;131162;
07.02.2019;06:37:04;84370203;84239075;131128;
07.02.2019;06:38:04;84370273;84239171;131102;
07.02.2019;06:39:07;84370357;84239274;131083;
07.02.2019;06:40:04;84370434;84239396;131038;
07.02.2019;06:41:05;84370521;84239492;131029;
07.02.2019;06:42:04;84370587;84239622;130965;
07.02.2019;06:43:04;84370662;84239712;130950;
07.02.2019;06:44:05;84370736;84239824;130912;
07.02.2019;06:45:04;84370821;84239944;130877;
07.02.2019;06:46:05;84370884;84240093;130791;
07.02.2019;06:47:05;84370987;84240204;130783;
07.02.2019;06:48:04;84371073;84240289;130784;
07.02.2019;06:49:05;84371149;84240400;130749;
07.02.2019;06:50:04;84371221;84240504;130717;
07.02.2019;06:51:04;84371306;84240622;130684;
07.02.2019;06:52:05;84371373;84240735;130638;
07.02.2019;06:53:05;84371456;84240855;130601;
07.02.2019;06:54:05;84371553;84240954;130599;
07.02.2019;06:55:04;84371637;84241050;130587;
07.02.2019;06:56:04;84371702;84241171;130531;
07.02.2019;06:57:05;84371783;84241303;130480;
07.02.2019;06:58:05;84371850;84241406;130444;
07.02.2019;06:59:05;84371927;84241499;130428;
07.02.2019;07:00:06;84372003;84241622;130381;
07.02.2019;07:01:05;84372062;84241729;130333;
07.02.2019;07:02:04;84372135;84241860;130275;
07.02.2019;07:03:05;84372218;84241987;130231;
07.02.2019;07:04:06;84372294;84242097;130197;
07.02.2019;07:05:04;84372363;84242207;130156;
07.02.2019;07:06:04;84372449;84242327;130122;
07.02.2019;07:07:05;84372528;84242472;130056;
07.02.2019;07:08:04;84372587;84242576;130011;
07.02.2019;07:09:07;84372648;84242731;129917;
07.02.2019;07:10:04;84372717;84242847;129870;
07.02.2019;07:11:05;84372801;84242987;129814;
07.02.2019;07:12:04;84372882;84243096;129786;
07.02.2019;07:13:05;84372891;84243179;129712;
07.02.2019;07:14:05;84372960;84243296;129664;
07.02.2019;07:15:04;84373036;84243417;129619;
07.02.2019;07:16:08;84373094;84243546;129548;
07.02.2019;07:17:05;84373176;84243677;129499;
07.02.2019;07:18:08;84373262;84243791;129471;
07.02.2019;07:19:05;84373329;84243893;129436;
07.02.2019;07:20:05;84373413;84244021;129392;
07.02.2019;07:21:05;84373485;84244138;129347;
07.02.2019;07:22:04;84373577;84244264;129313;
07.02.2019;07:23:04;84373625;84244388;129237;
07.02.2019;07:24:06;84373695;84244525;129170;
07.02.2019;07:25:10;84373770;84244664;129106;
07.02.2019;07:26:04;84373856;84244762;129094;
07.02.2019;07:27:04;84373920;84244894;129026;
07.02.2019;07:28:05;84373996;84245007;128989;
07.02.2019;07:29:04;84374055;84245123;128932;
07.02.2019;07:30:04;84374125;84245261;128864;
07.02.2019;07:31:05;84374200;84245385;128815;
07.02.2019;07:32:08;84374256;84245520;128736;
07.02.2019;07:33:04;84374310;84245607;128703;
07.02.2019;07:34:05;84374374;84245709;128665;
07.02.2019;07:35:04;84374448;84245826;128622;
07.02.2019;07:36:05;84374511;84245942;128569;
07.02.2019;07:37:05;84374564;84246055;128509;
07.02.2019;07:38:04;84374644;84246182;128462;
07.02.2019;07:39:05;84374709;84246310;128399;
07.02.2019;07:40:05;84374774;84246444;128330;
07.02.2019;07:41:04;84374836;84246563;128273;
07.02.2019;07:42:05;84374898;84246703;128195;
07.02.2019;07:43:04;84374978;84246824;128154;
07.02.2019;07:44:10;84375076;84246976;128100;
07.02.2019;07:45:04;84375133;84247075;128058;
07.02.2019;07:46:04;84375179;84247202;127977;
07.02.2019;07:47:04;84375248;84247330;127918;
07.02.2019;07:48:05;84375309;84247470;127839;
07.02.2019;07:49:04;84375376;84247599;127777;
07.02.2019;07:50:04;84375454;84247727;127727;
07.02.2019;07:51:04;84375523;84247843;127680;
07.02.2019;07:52:05;84375574;84247973;127601;
07.02.2019;07:53:04;84375636;84248104;127532;
07.02.2019;07:54:11;84375701;84248248;127453;
07.02.2019;07:55:04;84375767;84248365;127402;
07.02.2019;07:56:05;84375819;84248497;127322;
07.02.2019;07:57:06;84375873;84248637;127236;
07.02.2019;07:58:04;84375942;84248791;127151;
07.02.2019;07:59:05;84376003;84248925;127078;
07.02.2019;08:00:06;84376068;84249054;127014;
07.02.2019;08:01:04;84376130;84249173;126957;
07.02.2019;08:02:04;84376175;84249312;126863;
07.02.2019;08:03:04;84376250;84249405;126845;
07.02.2019;08:04:05;84376322;84249557;126765;
07.02.2019;08:05:04;84376399;84249673;126726;
07.02.2019;08:06:05;84376484;84249814;126670;
07.02.2019;08:07:05;84376545;84249956;126589;
07.02.2019;08:08:04;84376619;84250066;126553;
07.02.2019;08:09:06;84376676;84250200;126476;
07.02.2019;08:10:05;84376742;84250326;126416;
07.02.2019;08:11:05;84376807;84250441;126366;
07.02.2019;08:12:05;84376880;84250536;126344;
07.02.2019;08:13:04;84376925;84250667;126258;
07.02.2019;08:14:05;84376969;84250816;126153;
07.02.2019;08:15:05;84377023;84250893;126130;
07.02.2019;08:16:05;84377071;84251018;126053;
07.02.2019;08:17:05;84377130;84251148;125982;
07.02.2019;08:18:04;84377204;84251276;125928;
07.02.2019;08:19:04;84377264;84251391;125873;
07.02.2019;08:20:11;84377324;84251518;125806;
07.02.2019;08:21:05;84377394;84251618;125776;
07.02.2019;08:22:11;84377461;84251754;125707;
07.02.2019;08:23:05;84377507;84251881;125626;
07.02.2019;08:24:11;84377575;84252031;125544;
07.02.2019;08:25:04;84377623;84252134;125489;
07.02.2019;08:26:06;84377694;84252250;125444;
07.02.2019;08:27:04;84377773;84252379;125394;
07.02.2019;08:28:10;84377836;84252522;125314;
07.02.2019;08:29:04;84377888;84252644;125244;
07.02.2019;08:30:05;84377950;84252762;125188;
07.02.2019;08:31:10;84378009;84252921;125088;
07.02.2019;08:32:06;84378065;84253028;125037;
07.02.2019;08:33:05;84378143;84253149;124994;
07.02.2019;08:34:05;84378201;84253290;124911;
07.02.2019;08:35:05;84378268;84253399;124869;
07.02.2019;08:36:06;84378321;84253520;124801;
07.02.2019;08:37:05;84378385;84253632;124753;
07.02.2019;08:38:05;84378443;84253772;124671;
07.02.2019;08:39:07;84378492;84253911;124581;
07.02.2019;08:40:05;84378553;84254025;124528;
07.02.2019;08:41:05;84378633;84254171;124462;
07.02.2019;08:42:04;84378702;84254321;124381;
07.02.2019;08:43:04;84378768;84254424;124344;
07.02.2019;08:44:05;84378821;84254550;124271;
07.02.2019;08:45:04;84378886;84254665;124221;
07.02.2019;08:46:05;84378954;84254806;124148;
07.02.2019;08:47:05;84379016;84254953;124063;
07.02.2019;08:48:04;84379089;84255081;124008;
07.02.2019;08:49:05;84379150;84255193;123957;
07.02.2019;08:50:04;84379228;84255333;123895;
07.02.2019;08:51:04;84379299;84255467;123832;
07.02.2019;08:52:10;84379360;84255624;123736;
07.02.2019;08:53:05;84379418;84255737;123681;
07.02.2019;08:54:11;84379497;84255890;123607;
07.02.2019;08:55:05;84379567;84256024;123543;
07.02.2019;08:56:04;84379643;84256168;123475;
07.02.2019;08:57:11;84379712;84256327;123385;
07.02.2019;08:58:04;84379776;84256447;123329;
07.02.2019;08:59:04;84379842;84256586;123256;
07.02.2019;09:00:06;84379905;84256725;123180;
07.02.2019;09:01:04;84379964;84256870;123094;
07.02.2019;09:02:04;84380027;84257016;123011;
07.02.2019;09:03:05;84380097;84257144;122953;
07.02.2019;09:04:04;84380147;84257261;122886;
07.02.2019;09:05:04;84380192;84257392;122800;
07.02.2019;09:06:04;84380242;84257543;122699;
07.02.2019;09:07:05;84380318;84257683;122635;
07.02.2019;09:08:10;84380395;84257826;122569;
07.02.2019;09:09:06;84380481;84257952;122529;
07.02.2019;09:10:04;84380560;84258090;122470;
07.02.2019;09:11:04;84380625;84258224;122401;
07.02.2019;09:12:04;84380683;84258360;122323;
07.02.2019;09:13:05;84380739;84258493;122246;
07.02.2019;09:14:04;84380805;84258613;122192;
07.02.2019;09:15:05;84380869;84258791;122078;
07.02.2019;09:16:04;84380925;84258914;122011;
07.02.2019;09:17:04;84380977;84259039;121938;
07.02.2019;09:18:05;84381033;84259192;121841;
07.02.2019;09:19:10;84381094;84259337;121757;
07.02.2019;09:20:05;84381147;84259484;121663;
07.02.2019;09:21:04;84381213;84259609;121604;
07.02.2019;09:22:04;84381261;84259735;121526;
07.02.2019;09:23:05;84381310;84259877;121433;
07.02.2019;09:24:05;84381378;84259996;121382;
07.02.2019;09:25:04;84381437;84260138;121299;
07.02.2019;09:26:05;84381494;84260263;121231;
07.02.2019;09:27:04;84381566;84260392;121174;
07.02.2019;09:28:04;84381625;84260525;121100;
07.02.2019;09:29:05;84381697;84260678;121019;
07.02.2019;09:30:04;84381753;84260816;120937;
07.02.2019;09:31:05;84381823;84260950;120873;
07.02.2019;09:32:04;84381871;84261080;120791;
07.02.2019;09:33:04;84381935;84261229;120706;
07.02.2019;09:34:11;84382010;84261348;120662;
07.02.2019;09:35:05;84382061;84261466;120595;
07.02.2019;09:36:05;84382133;84261625;120508;
07.02.2019;09:37:06;84382202;84261773;120429;
07.02.2019;09:38:04;84382258;84261920;120338;
07.02.2019;09:39:06;84382337;84262025;120312;
07.02.2019;09:40:06;84382412;84262173;120239;
07.02.2019;09:41:04;84382462;84262294;120168;
07.02.2019;09:42:04;84382539;84262434;120105;
07.02.2019;09:43:04;84382597;84262577;120020;
07.02.2019;09:44:04;84382652;84262700;119952;
07.02.2019;09:45:05;84382718;84262860;119858;
07.02.2019;09:46:04;84382777;84263022;119755;
07.02.2019;09:47:05;84382851;84263176;119675;
07.02.2019;09:48:04;84382911;84263323;119588;
07.02.2019;09:49:04;84382965;84263467;119498;
07.02.2019;09:50:05;84383025;84263606;119419;
07.02.2019;09:51:04;84383082;84263758;119324;
07.02.2019;09:52:04;84383146;84263909;119237;
07.02.2019;09:53:05;84383199;84264042;119157;
07.02.2019;09:54:04;84383276;84264149;119127;
07.02.2019;09:55:04;84383347;84264286;119061;
07.02.2019;09:56:05;84383406;84264414;118992;
07.02.2019;09:57:04;84383465;84264551;118914;
07.02.2019;09:58:05;84383530;84264707;118823;
07.02.2019;09:59:04;84383590;84264817;118773;
07.02.2019;10:00:04;84383662;84264954;118708;
07.02.2019;10:01:05;84383718;84265082;118636;
07.02.2019;10:02:04;84383766;84265185;118581;
07.02.2019;10:03:05;84383838;84265316;118522;
07.02.2019;10:04:04;84383891;84265494;118397;
07.02.2019;10:05:04;84383933;84265647;118286;
07.02.2019;10:06:05;84383991;84265794;118197;
07.02.2019;10:07:05;84384041;84265925;118116;
07.02.2019;10:08:05;84384082;84266069;118013;
07.02.2019;10:09:06;84384142;84266202;117940;
07.02.2019;10:10:04;84384210;84266349;117861;
07.02.2019;10:11:04;84384267;84266459;117808;
07.02.2019;10:12:04;84384306;84266556;117750;
07.02.2019;10:13:05;84384356;84266690;117666;
07.02.2019;10:14:05;84384400;84266858;117542;
07.02.2019;10:15:04;84384446;84266970;117476;
07.02.2019;10:16:05;84384487;84267091;117396;
07.02.2019;10:17:05;84384543;84267198;117345;
07.02.2019;10:18:04;84384586;84267324;117262;
07.02.2019;10:19:05;84384640;84267445;117195;
07.02.2019;10:20:04;84384685;84267587;117098;
07.02.2019;10:21:04;84384715;84267729;116986;
07.02.2019;10:22:04;84384753;84267868;116885;
07.02.2019;10:23:04;84384779;84267963;116816;
07.02.2019;10:24:05;84384818;84268096;116722;
07.02.2019;10:25:04;84384856;84268236;116620;
07.02.2019;10:26:04;84384910;84268375;116535;
07.02.2019;10:27:04;84384946;84268520;116426;
07.02.2019;10:28:04;84384987;84268643;116344;
07.02.2019;10:29:05;84385040;84268760;116280;
07.02.2019;10:30:04;84385096;84268913;116183;
07.02.2019;10:31:05;84385150;84269058;116092;
07.02.2019;10:32:04;84385219;84269176;116043;
07.02.2019;10:33:04;84385272;84269301;115971;
07.02.2019;10:34:05;84385340;84269449;115891;
07.02.2019;10:35:05;84385393;84269604;115789;
07.02.2019;10:36:10;84385451;84269770;115681;
07.02.2019;10:37:05;84385502;84269905;115597;
07.02.2019;10:38:04;84385578;84270049;115529;
07.02.2019;10:39:12;84385647;84270195;115452;
07.02.2019;10:40:04;84385686;84270344;115342;
07.02.2019;10:41:04;84385754;84270501;115253;
07.02.2019;10:42:05;84385807;84270678;115129;
07.02.2019;10:43:04;84385857;84270841;115016;
07.02.2019;10:44:05;84385911;84270997;114914;
07.02.2019;10:45:04;84385958;84271143;114815;
07.02.2019;10:46:04;84386020;84271305;114715;
07.02.2019;10:47:05;84386061;84271446;114615;
07.02.2019;10:48:04;84386143;84271588;114555;
07.02.2019;10:49:05;84386207;84271742;114465;
07.02.2019;10:50:05;84386268;84271892;114376;
07.02.2019;10:51:04;84386338;84272040;114298;
07.02.2019;10:52:04;84386392;84272207;114185;
07.02.2019;10:53:04;84386460;84272360;114100;
07.02.2019;10:54:04;84386526;84272501;114025;
07.02.2019;10:55:05;84386593;84272635;113958;
07.02.2019;10:56:06;84386642;84272791;113851;
07.02.2019;10:57:05;84386716;84272941;113775;
07.02.2019;10:58:04;84386770;84273076;113694;
07.02.2019;10:59:05;84386843;84273228;113615;
07.02.2019;11:00:05;84386909;84273397;113512;
07.02.2019;11:01:04;84386962;84273554;113408;
07.02.2019;11:02:04;84387017;84273715;113302;
07.02.2019;11:03:05;84387078;84273836;113242;
07.02.2019;11:04:04;84387136;84273978;113158;
07.02.2019;11:05:04;84387198;84274148;113050;
07.02.2019;11:06:05;84387245;84274282;112963;
07.02.2019;11:07:04;84387315;84274438;112877;
07.02.2019;11:08:04;84387351;84274579;112772;
07.02.2019;11:09:07;84387408;84274710;112698;
07.02.2019;11:10:04;84387456;84274861;112595;
07.02.2019;11:11:05;84387533;84275022;112511;
07.02.2019;11:12:04;84387586;84275178;112408;
07.02.2019;11:13:04;84387650;84275319;112331;
07.02.2019;11:14:05;84387720;84275478;112242;
07.02.2019;11:15:05;84387784;84275638;112146;
07.02.2019;11:16:04;84387837;84275775;112062;
07.02.2019;11:17:04;84387903;84275898;112005;
07.02.2019;11:18:05;84387960;84276058;111902;
07.02.2019;11:19:05;84388029;84276211;111818;
07.02.2019;11:20:05;84388089;84276343;111746;
07.02.2019;11:21:04;84388143;84276494;111649;
07.02.2019;11:22:04;84388201;84276651;111550;
07.02.2019;11:23:05;84388267;84276789;111478;
07.02.2019;11:24:04;84388335;84276938;111397;
07.02.2019;11:25:10;84388401;84277116;111285;
07.02.2019;11:26:05;84388476;84277256;111220;
07.02.2019;11:27:05;84388533;84277376;111157;
07.02.2019;11:28:04;84388590;84277516;111074;
07.02.2019;11:29:04;84388660;84277646;111014;
07.02.2019;11:30:05;84388724;84277802;110922;
07.02.2019;11:31:05;84388777;84277961;110816;
07.02.2019;11:32:04;84388847;84278105;110742;
07.02.2019;11:33:04;84388902;84278248;110654;
07.02.2019;11:34:05;84388975;84278370;110605;
07.02.2019;11:35:05;84389030;84278503;110527;
07.02.2019;11:36:05;84389075;84278615;110460;
07.02.2019;11:37:05;84389139;84278764;110375;
07.02.2019;11:38:04;84389194;84278928;110266;
07.02.2019;11:39:05;84389256;84279077;110179;
07.02.2019;11:40:04;84389329;84279219;110110;
07.02.2019;11:41:04;84389382;84279332;110050;
07.02.2019;11:42:05;84389437;84279438;109999;
07.02.2019;11:43:04;84389506;84279552;109954;
07.02.2019;11:44:04;84389563;84279686;109877;
07.02.2019;11:45:05;84389645;84279806;109839;
07.02.2019;11:46:05;84389696;84279922;109774;
07.02.2019;11:47:05;84389753;84280061;109692;
07.02.2019;11:48:05;84389807;84280195;109612;
07.02.2019;11:49:05;84389871;84280339;109532;
07.02.2019;11:50:04;84389929;84280484;109445;
07.02.2019;11:51:04;84389971;84280623;109348;
07.02.2019;11:52:05;84390033;84280769;109264;
07.02.2019;11:53:04;84390100;84280892;109208;
07.02.2019;11:54:04;84390158;84281026;109132;
07.02.2019;11:55:05;84390214;84281177;109037;
07.02.2019;11:56:05;84390276;84281321;108955;
07.02.2019;11:57:05;84390335;84281454;108881;
07.02.2019;11:58:05;84390385;84281609;108776;
07.02.2019;11:59:05;84390443;84281748;108695;
07.02.2019;12:00:04;84390504;84281880;108624;
07.02.2019;12:01:04;84390564;84282000;108564;
07.02.2019;12:02:05;84390609;84282131;108478;
07.02.2019;12:03:04;84390688;84282280;108408;
07.02.2019;12:04:04;84390757;84282411;108346;
07.02.2019;12:05:11;84390830;84282564;108266;
07.02.2019;12:06:06;84390881;84282697;108184;
07.02.2019;12:07:05;84390935;84282844;108091;
07.02.2019;12:08:06;84390990;84282997;107993;
07.02.2019;12:09:07;84391049;84283143;107906;
07.02.2019;12:10:05;84391118;84283270;107848;
07.02.2019;12:11:04;84391203;84283392;107811;
07.02.2019;12:12:04;84391222;84283458;107764;
07.02.2019;12:13:05;84391251;84283576;107675;
07.02.2019;12:14:05;84391260;84283639;107621;
07.02.2019;12:15:04;84391285;84283726;107559;
07.02.2019;12:16:04;84391315;84283834;107481;
07.02.2019;12:17:05;84391372;84283975;107397;
07.02.2019;12:18:05;84391419;84284105;107314;
07.02.2019;12:19:05;84391483;84284251;107232;
07.02.2019;12:20:04;84391544;84284408;107136;
07.02.2019;12:21:04;84391628;84284550;107078;
07.02.2019;12:22:05;84391690;84284695;106995;
07.02.2019;12:23:05;84391748;84284828;106920;
07.02.2019;12:24:04;84391806;84284981;106825;
07.02.2019;12:25:05;84391869;84285117;106752;
07.02.2019;12:26:05;84391948;84285270;106678;
07.02.2019;12:27:05;84392027;84285395;106632;
07.02.2019;12:28:05;84392085;84285533;106552;
07.02.2019;12:29:04;84392149;84285682;106467;
07.02.2019;12:30:04;84392210;84285800;106410;
07.02.2019;12:31:05;84392277;84285956;106321;
07.02.2019;12:32:05;84392330;84286107;106223;
07.02.2019;12:33:04;84392399;84286236;106163;
07.02.2019;12:34:05;84392465;84286383;106082;
07.02.2019;12:35:05;84392535;84286534;106001;
07.02.2019;12:36:05;84392619;84286665;105954;
07.02.2019;12:37:06;84392670;84286791;105879;
07.02.2019;12:38:05;84392744;84286894;105850;
07.02.2019;12:39:06;84392828;84287038;105790;
07.02.2019;12:40:04;84392903;84287149;105754;
07.02.2019;12:41:05;84392978;84287306;105672;
07.02.2019;12:42:05;84393065;84287437;105628;
07.02.2019;12:43:05;84393138;84287570;105568;
07.02.2019;12:44:05;84393199;84287709;105490;
07.02.2019;12:45:05;84393273;84287853;105420;
07.02.2019;12:46:05;84393348;84288008;105340;
07.02.2019;12:47:04;84393419;84288125;105294;
07.02.2019;12:48:05;84393451;84288270;105181;
07.02.2019;12:49:04;84393555;84288407;105148;
07.02.2019;12:50:04;84393612;84288553;105059;
07.02.2019;12:51:04;84393671;84288691;104980;
07.02.2019;12:52:04;84393750;84288829;104921;
07.02.2019;12:53:05;84393821;84288962;104859;
07.02.2019;12:54:05;84393914;84289137;104777;
07.02.2019;12:55:05;84394002;84289265;104737;
07.02.2019;12:56:05;84394085;84289394;104691;
07.02.2019;12:57:04;84394081;84289401;104680;
07.02.2019;12:58:05;84393823;84288913;104910;
07.02.2019;12:59:04;84393524;84288365;105159;
07.02.2019;13:00:04;84393614;84288501;105113;
07.02.2019;13:01:05;84393690;84288654;105036;
07.02.2019;13:02:05;84393762;84288774;104988;
07.02.2019;13:03:05;84393830;84288941;104889;
07.02.2019;13:04:04;84393897;84289086;104811;
07.02.2019;13:05:04;84393965;84289236;104729;
07.02.2019;13:06:05;84394035;84289374;104661;
07.02.2019;13:07:05;84394123;84289511;104612;
07.02.2019;13:08:04;84394216;84289676;104540;
07.02.2019;13:09:06;84394288;84289837;104451;
07.02.2019;13:10:06;84394370;84289999;104371;
07.02.2019;13:11:05;84394461;84290139;104322;
07.02.2019;13:12:04;84394545;84290296;104249;
07.02.2019;13:13:04;84394622;84290441;104181;
07.02.2019;13:14:06;84394714;84290605;104109;
07.02.2019;13:15:05;84394772;84290727;104045;
07.02.2019;13:16:04;84394855;84290877;103978;
07.02.2019;13:17:05;84394932;84291052;103880;
07.02.2019;13:18:05;84395001;84291233;103768;
07.02.2019;13:19:05;84395098;84291389;103709;
07.02.2019;13:20:05;84395181;84291545;103636;
07.02.2019;13:21:04;84395283;84291693;103590;
07.02.2019;13:23:05;84395451;84291969;103482;
07.02.2019;13:24:04;84395537;84292148;103389;
07.02.2019;13:25:04;84395608;84292310;103298;
07.02.2019;13:26:05;84395707;84292470;103237;
07.02.2019;13:27:10;84395786;84292651;103135;
07.02.2019;13:28:05;84395861;84292784;103077;
07.02.2019;13:29:05;84395945;84292880;103065;
07.02.2019;13:30:04;84396038;84293110;102928;
07.02.2019;13:31:05;84396128;84293275;102853;
07.02.2019;13:32:05;84396201;84293463;102738;
07.02.2019;13:33:04;84396301;84293635;102666;
07.02.2019;13:34:04;84396397;84293779;102618;
07.02.2019;13:35:05;84396489;84293950;102539;
07.02.2019;13:36:04;84396593;84294088;102505;
07.02.2019;13:37:04;84396700;84294235;102465;
07.02.2019;13:38:05;84396787;84294406;102381;
07.02.2019;13:39:05;84396875;84294575;102300;
07.02.2019;13:40:06;84396943;84294734;102209;
07.02.2019;13:41:04;84397085;84294900;102185;
07.02.2019;13:42:05;84397171;84295060;102111;
07.02.2019;13:43:05;84397254;84295236;102018;
07.02.2019;13:44:05;84397357;84295378;101979;
07.02.2019;13:45:05;84397453;84295524;101929;
07.02.2019;13:46:05;84397550;84295710;101840;
07.02.2019;13:47:05;84397665;84295865;101800;
07.02.2019;13:48:05;84397735;84296024;101711;
07.02.2019;13:49:05;84397813;84296155;101658;
07.02.2019;13:50:05;84397912;84296313;101599;
07.02.2019;13:51:04;84398037;84296473;101564;
07.02.2019;13:52:04;84398145;84296614;101531;
07.02.2019;13:53:05;84398249;84296772;101477;
07.02.2019;13:54:04;84398336;84296908;101428;
07.02.2019;13:55:04;84398441;84297068;101373;
07.02.2019;13:56:05;84398543;84297178;101365;
07.02.2019;13:57:05;84398632;84297323;101309;
07.02.2019;13:58:04;84398727;84297490;101237;
07.02.2019;13:59:04;84398821;84297620;101201;
07.02.2019;14:00:05;84398918;84297760;101158;
07.02.2019;14:01:06;84399019;84297929;101090;
07.02.2019;14:02:04;84399116;84298086;101030;
07.02.2019;14:03:04;84399210;84298212;100998;
07.02.2019;14:04:05;84399322;84298357;100965;
07.02.2019;14:05:05;84399434;84298524;100910;
07.02.2019;14:06:05;84399557;84298661;100896;
07.02.2019;14:07:04;84399655;84298813;100842;
07.02.2019;14:08:05;84399748;84298959;100789;
07.02.2019;14:09:05;84399850;84299093;100757;
07.02.2019;14:10:04;84399945;84299222;100723;
07.02.2019;14:11:04;84400056;84299333;100723;
07.02.2019;14:12:04;84400136;84299463;100673;
07.02.2019;14:13:04;84400224;84299601;100623;
07.02.2019;14:14:05;84400336;84299767;100569;
07.02.2019;14:15:04;84400432;84299897;100535;
07.02.2019;14:16:04;84400501;84300055;100446;
07.02.2019;14:17:06;84400598;84300181;100417;
07.02.2019;14:18:05;84400680;84300255;100425;
07.02.2019;14:19:04;84400785;84300418;100367;
07.02.2019;14:20:04;84400847;84300530;100317;
07.02.2019;14:21:05;84400932;84300665;100267;
07.02.2019;14:22:05;84401013;84300809;100204;
07.02.2019;14:23:05;84401124;84300929;100195;
07.02.2019;14:24:05;84401205;84301062;100143;
07.02.2019;14:25:05;84401309;84301245;100064;
07.02.2019;14:26:04;84401376;84301386;99990;
07.02.2019;14:27:04;84401479;84301528;99951;
07.02.2019;14:28:05;84401545;84301690;99855;
07.02.2019;14:29:05;84401637;84301830;99807;
07.02.2019;14:30:05;84401735;84301986;99749;
07.02.2019;14:31:04;84401818;84302124;99694;
07.02.2019;14:32:04;84401908;84302298;99610;
07.02.2019;14:33:05;84402017;84302437;99580;
07.02.2019;14:34:05;84402128;84302601;99527;
07.02.2019;14:35:05;84402247;84302771;99476;
07.02.2019;14:36:05;84402343;84302951;99392;
07.02.2019;14:37:05;84402448;84303118;99330;
07.02.2019;14:38:04;84402576;84303273;99303;
07.02.2019;14:39:04;84402674;84303390;99284;
07.02.2019;14:40:04;84402797;84303534;99263;
07.02.2019;14:41:04;84402936;84303706;99230;
07.02.2019;14:42:05;84403055;84303857;99198;
07.02.2019;14:43:04;84403161;84304008;99153;
07.02.2019;14:44:04;84403274;84304151;99123;
07.02.2019;14:45:05;84403382;84304308;99074;
07.02.2019;14:46:04;84403491;84304467;99024;
07.02.2019;14:47:04;84403600;84304608;98992;
07.02.2019;14:48:05;84403719;84304761;98958;
07.02.2019;14:49:04;84403813;84304922;98891;
07.02.2019;14:50:04;84403919;84305049;98870;
07.02.2019;14:51:05;84404006;84305253;98753;
07.02.2019;14:52:05;84404125;84305406;98719;
07.02.2019;14:53:04;84404226;84305573;98653;
07.02.2019;14:54:04;84404346;84305728;98618;
07.02.2019;14:55:05;84404450;84305891;98559;
07.02.2019;14:56:04;84404571;84306084;98487;
07.02.2019;14:57:05;84404670;84306252;98418;
07.02.2019;14:58:05;84404753;84306424;98329;
07.02.2019;14:59:04;84404852;84306575;98277;
07.02.2019;15:00:07;84404978;84306757;98221;
07.02.2019;15:01:07;84405092;84306906;98186;
07.02.2019;15:02:07;84405189;84307060;98129;
07.02.2019;15:03:08;84405272;84307224;98048;
07.02.2019;15:04:08;84405413;84307394;98019;
07.02.2019;15:05:08;84405523;84307543;97980;
07.02.2019;15:06:08;84405630;84307703;97927;
07.02.2019;15:07:08;84405744;84307888;97856;
07.02.2019;15:08:08;84405854;84308061;97793;
07.02.2019;15:09:07;84405957;84308236;97721;
07.02.2019;15:10:07;84406056;84308400;97656;
07.02.2019;15:11:07;84406151;84308593;97558;
07.02.2019;15:12:08;84406243;84308760;97483;
07.02.2019;15:13:08;84406361;84308910;97451;
07.02.2019;15:14:08;84406484;84309096;97388;
07.02.2019;15:15:07;84406584;84309264;97320;
07.02.2019;15:16:08;84406674;84309421;97253;
07.02.2019;15:17:07;84406779;84309576;97203;
07.02.2019;15:18:07;84406888;84309743;97145;
07.02.2019;15:19:07;84406994;84309915;97079;
07.02.2019;15:20:08;84407077;84310047;97030;
07.02.2019;15:21:07;84407191;84310215;96976;
07.02.2019;15:22:07;84407308;84310430;96878;
07.02.2019;15:23:08;84407411;84310593;96818;
07.02.2019;15:24:08;84407488;84310761;96727;
07.02.2019;15:25:07;84407582;84310945;96637;
07.02.2019;15:26:08;84407687;84311129;96558;
07.02.2019;15:27:10;84407804;84311295;96509;
07.02.2019;15:28:09;84407903;84311437;96466;
07.02.2019;15:29:08;84408032;84311601;96431;
07.02.2019;15:30:07;84408120;84311793;96327;
07.02.2019;15:31:08;84408238;84311981;96257;
07.02.2019;15:32:08;84408337;84312160;96177;
07.02.2019;15:33:07;84408467;84312296;96171;
07.02.2019;15:34:07;84408581;84312455;96126;
07.02.2019;15:35:08;84408684;84312648;96036;
07.02.2019;15:36:08;84408781;84312797;95984;
07.02.2019;15:37:08;84408885;84312964;95921;
07.02.2019;15:38:08;84408955;84313114;95841;
07.02.2019;15:39:07;84409052;84313271;95781;
07.02.2019;15:40:07;84409209;84313477;95732;
07.02.2019;15:41:07;84409321;84313649;95672;
07.02.2019;15:42:11;84409439;84313824;95615;
07.02.2019;15:43:08;84409522;84313981;95541;
07.02.2019;15:44:07;84409614;84314124;95490;
07.02.2019;15:45:07;84409725;84314282;95443;
07.02.2019;15:46:07;84409792;84314441;95351;
07.02.2019;15:47:07;84409897;84314600;95297;
07.02.2019;15:48:08;84410006;84314799;95207;
07.02.2019;15:49:06;84410076;84314939;95137;
07.02.2019;15:50:08;84410182;84315105;95077;
07.02.2019;15:51:07;84410266;84315290;94976;
07.02.2019;15:52:08;84410380;84315454;94926;
07.02.2019;15:53:07;84410490;84315634;94856;
07.02.2019;15:54:08;84410608;84315805;94803;
07.02.2019;15:55:08;84410738;84315990;94748;
07.02.2019;15:56:10;84410854;84316166;94688;
07.02.2019;15:57:06;84410972;84316328;94644;
07.02.2019;15:58:08;84411104;84316502;94602;
07.02.2019;15:59:08;84411213;84316664;94549;
07.02.2019;16:00:05;84411322;84316854;94468;
07.02.2019;16:01:05;84411445;84317027;94418;
07.02.2019;16:02:05;84411576;84317217;94359;
07.02.2019;16:03:09;84411700;84317393;94307;
07.02.2019;16:04:04;84411799;84317526;94273;
07.02.2019;16:05:10;84411898;84317702;94196;
07.02.2019;16:06:05;84411989;84317889;94100;
07.02.2019;16:07:04;84412091;84318065;94026;
07.02.2019;16:08:04;84412196;84318278;93918;
07.02.2019;16:09:07;84412294;84318441;93853;
07.02.2019;16:10:05;84412404;84318618;93786;
07.02.2019;16:11:04;84412493;84318801;93692;
07.02.2019;16:12:04;84412611;84318976;93635;
07.02.2019;16:13:05;84412709;84319164;93545;
07.02.2019;16:14:05;84412801;84319338;93463;
07.02.2019;16:15:04;84412889;84319517;93372;
07.02.2019;16:16:05;84412976;84319694;93282;
07.02.2019;16:17:05;84413068;84319851;93217;
07.02.2019;16:18:04;84413149;84319990;93159;
07.02.2019;16:19:04;84413238;84320152;93086;
07.02.2019;16:20:04;84413344;84320312;93032;
07.02.2019;16:21:05;84413437;84320462;92975;
07.02.2019;16:22:05;84413552;84320613;92939;
07.02.2019;16:23:05;84413635;84320780;92855;
07.02.2019;16:24:05;84413726;84320929;92797;
07.02.2019;16:25:09;84413834;84321098;92736;
07.02.2019;16:26:05;84413923;84321253;92670;
07.02.2019;16:27:05;84413986;84321408;92578;
07.02.2019;16:28:05;84414077;84321558;92519;
07.02.2019;16:29:05;84414172;84321701;92471;
07.02.2019;16:30:05;84414305;84321843;92462;
07.02.2019;16:31:05;84414401;84321976;92425;
07.02.2019;16:32:04;84414516;84322111;92405;
07.02.2019;16:33:05;84414614;84322295;92319;
07.02.2019;16:34:05;84414704;84322426;92278;
07.02.2019;16:35:04;84414824;84322569;92255;
07.02.2019;16:36:04;84414949;84322746;92203;
07.02.2019;16:37:05;84415061;84322922;92139;
07.02.2019;16:38:05;84415177;84323099;92078;
07.02.2019;16:39:05;84415290;84323248;92042;
07.02.2019;16:40:04;84415404;84323435;91969;
07.02.2019;16:41:04;84415525;84323612;91913;
07.02.2019;16:42:05;84415666;84323768;91898;
07.02.2019;16:43:04;84415789;84323938;91851;
07.02.2019;16:44:04;84415902;84324090;91812;
07.02.2019;16:45:05;84416026;84324269;91757;
07.02.2019;16:46:05;84416131;84324433;91698;
07.02.2019;16:48:09;84416389;84324781;91608;
07.02.2019;16:49:05;84416444;84324959;91485;
07.02.2019;16:50:05;84416575;84325143;91432;
07.02.2019;16:52:04;84416831;84325498;91333;
07.02.2019;16:53:06;84416957;84325673;91284;
07.02.2019;16:54:05;84417052;84325829;91223;
07.02.2019;16:55:05;84417165;84325981;91184;
07.02.2019;16:56:06;84417270;84326166;91104;
07.02.2019;16:57:06;84417391;84326312;91079;
07.02.2019;16:58:05;84417493;84326500;90993;
07.02.2019;16:59:04;84417604;84326679;90925;
07.02.2019;17:00:05;84417720;84326876;90844;
07.02.2019;17:01:04;84417844;84327051;90793;
07.02.2019;17:02:05;84417982;84327194;90788;
07.02.2019;17:03:05;84418117;84327348;90769;
07.02.2019;17:04:05;84418210;84327543;90667;
07.02.2019;17:05:04;84418336;84327704;90632;
07.02.2019;17:06:06;84418458;84327893;90565;
07.02.2019;17:07:05;84418586;84328092;90494;
07.02.2019;17:08:05;84418680;84328264;90416;
07.02.2019;17:09:06;84418819;84328443;90376;
07.02.2019;17:10:06;84418928;84328606;90322;
07.02.2019;17:11:05;84419060;84328780;90280;
07.02.2019;17:12:05;84419154;84328947;90207;
07.02.2019;17:13:10;84419313;84329113;90200;
07.02.2019;17:14:04;84419417;84329301;90116;
07.02.2019;17:15:05;84419532;84329483;90049;
07.02.2019;17:16:05;84419632;84329653;89979;
07.02.2019;17:17:05;84419745;84329816;89929;
07.02.2019;17:18:05;84419868;84329995;89873;
07.02.2019;17:19:04;84419990;84330173;89817;
07.02.2019;17:20:06;84420126;84330359;89767;
07.02.2019;17:21:05;84420257;84330537;89720;
07.02.2019;17:22:05;84420373;84330715;89658;
07.02.2019;17:23:05;84420505;84330874;89631;
07.02.2019;17:24:08;84420608;84331056;89552;
07.02.2019;17:25:04;84420735;84331217;89518;
07.02.2019;17:26:04;84420854;84331409;89445;
07.02.2019;17:27:04;84420964;84331584;89380;
07.02.2019;17:28:04;84421080;84331742;89338;
07.02.2019;17:29:05;84421207;84331874;89333;
07.02.2019;17:30:05;84421320;84332083;89237;
07.02.2019;17:32:05;84421551;84332410;89141;
07.02.2019;17:33:04;84421666;84332560;89106;
07.02.2019;17:34:09;84421809;84332723;89086;
07.02.2019;17:35:05;84421914;84332888;89026;
07.02.2019;17:36:04;84422034;84333045;88989;
07.02.2019;17:37:04;84422156;84333204;88952;
07.02.2019;17:38:05;84422278;84333371;88907;
07.02.2019;17:39:07;84422407;84333531;88876;
07.02.2019;17:40:05;84422522;84333700;88822;
07.02.2019;17:41:05;84422632;84333869;88763;
07.02.2019;17:42:04;84422757;84334020;88737;
07.02.2019;17:43:04;84422889;84334180;88709;
07.02.2019;17:44:05;84423035;84334352;88683;
07.02.2019;17:45:05;84423154;84334517;88637;
07.02.2019;17:46:05;84423281;84334700;88581;
07.02.2019;17:47:04;84423398;84334871;88527;
07.02.2019;17:49:04;84423623;84335164;88459;
07.02.2019;17:50:05;84423759;84335335;88424;
07.02.2019;17:51:05;84423868;84335502;88366;
07.02.2019;17:52:04;84423973;84335653;88320;
07.02.2019;17:53:05;84424080;84335843;88237;
07.02.2019;17:54:04;84424198;84335980;88218;
07.02.2019;17:55:05;84424359;84336144;88215;
07.02.2019;17:56:05;84424474;84336291;88183;
07.02.2019;17:57:05;84424609;84336448;88161;
07.02.2019;17:58:04;84424715;84336628;88087;
07.02.2019;17:59:04;84424833;84336784;88049;
07.02.2019;18:00:05;84424972;84336945;88027;
07.02.2019;18:01:05;84425108;84337106;88002;
07.02.2019;18:02:05;84425239;84337272;87967;
07.02.2019;18:03:06;84425385;84337415;87970;
07.02.2019;18:04:04;84425491;84337559;87932;
07.02.2019;18:05:04;84425624;84337714;87910;
07.02.2019;18:06:04;84425755;84337888;87867;
07.02.2019;18:07:05;84425883;84338054;87829;
07.02.2019;18:08:05;84425994;84338197;87797;
07.02.2019;18:09:06;84426120;84338365;87755;
07.02.2019;18:10:10;84426237;84338535;87702;
07.02.2019;18:11:05;84426338;84338675;87663;
07.02.2019;18:12:07;84426446;84338806;87640;
07.02.2019;18:13:04;84426550;84338944;87606;
07.02.2019;18:14:05;84426668;84339116;87552;
07.02.2019;18:15:05;84426758;84339267;87491;
07.02.2019;18:16:08;84426867;84339413;87454;
07.02.2019;18:17:05;84426965;84339577;87388;
07.02.2019;18:18:05;84427075;84339718;87357;
07.02.2019;18:19:05;84427186;84339828;87358;
07.02.2019;18:20:07;84427311;84339992;87319;
07.02.2019;18:21:05;84427404;84340116;87288;
07.02.2019;18:22:05;84427504;84340215;87289;
07.02.2019;18:23:04;84427603;84340336;87267;
07.02.2019;18:24:04;84427655;84340483;87172;
07.02.2019;18:25:07;84427745;84340634;87111;
07.02.2019;18:26:04;84427813;84340760;87053;
07.02.2019;18:27:04;84427893;84340857;87036;
07.02.2019;18:28:05;84427993;84340956;87037;
07.02.2019;18:29:07;84428071;84341084;86987;
07.02.2019;18:30:04;84428133;84341198;86935;
07.02.2019;18:31:04;84428236;84341329;86907;
07.02.2019;18:32:04;84428327;84341462;86865;
07.02.2019;18:33:08;84428441;84341593;86848;
07.02.2019;18:34:05;84428536;84341702;86834;
07.02.2019;18:35:10;84428623;84341853;86770;
07.02.2019;18:36:05;84428700;84341971;86729;
07.02.2019;18:37:07;84428796;84342093;86703;
07.02.2019;18:38:04;84428884;84342242;86642;
07.02.2019;18:39:08;84428976;84342381;86595;
07.02.2019;18:40:04;84429086;84342493;86593;
07.02.2019;18:41:06;84429181;84342629;86552;
07.02.2019;18:42:05;84429287;84342766;86521;
07.02.2019;18:43:05;84429387;84342884;86503;
07.02.2019;18:44:04;84429501;84343031;86470;
07.02.2019;18:45:04;84429629;84343162;86467;
07.02.2019;18:46:07;84429733;84343323;86410;
07.02.2019;18:47:05;84429850;84343462;86388;
07.02.2019;18:48:10;84429961;84343619;86342;
07.02.2019;18:49:04;84430067;84343749;86318;
07.02.2019;18:50:07;84430183;84343866;86317;
07.02.2019;18:51:05;84430302;84343981;86321;
07.02.2019;18:52:05;84430428;84344116;86312;
07.02.2019;18:53:05;84430528;84344269;86259;
07.02.2019;18:54:07;84430657;84344430;86227;
07.02.2019;18:55:05;84430774;84344555;86219;
07.02.2019;18:56:05;84430870;84344683;86187;
07.02.2019;18:57:04;84431004;84344810;86194;
07.02.2019;18:58:07;84431112;84344930;86182;
07.02.2019;18:59:05;84431262;84345068;86194;
07.02.2019;19:00:04;84431378;84345192;86186;
07.02.2019;19:01:04;84431507;84345306;86201;
07.02.2019;19:02:05;84431599;84345385;86214;
07.02.2019;19:03:07;84431668;84345446;86222;
07.02.2019;19:04:05;84431771;84345542;86229;
07.02.2019;19:05:04;84431898;84345655;86243;
07.02.2019;19:06:09;84432039;84345779;86260;
07.02.2019;19:07:08;84432148;84345906;86242;
07.02.2019;19:08:05;84432260;84346022;86238;
07.02.2019;19:09:04;84432378;84346131;86247;
07.02.2019;19:10:04;84432501;84346248;86253;
07.02.2019;19:11:08;84432602;84346380;86222;
07.02.2019;19:12:05;84432695;84346501;86194;
07.02.2019;19:13:05;84432814;84346644;86170;
07.02.2019;19:14:04;84432911;84346753;86158;
07.02.2019;19:15:06;84433060;84346869;86191;
07.02.2019;19:16:05;84433188;84346964;86224;
07.02.2019;19:17:05;84433306;84347099;86207;
07.02.2019;19:18:05;84433408;84347233;86175;
07.02.2019;19:19:04;84433528;84347336;86192;
07.02.2019;19:20:08;84433654;84347447;86207;
07.02.2019;19:21:05;84433759;84347541;86218;
07.02.2019;19:22:05;84433870;84347666;86204;
07.02.2019;19:23:05;84433988;84347776;86212;
07.02.2019;19:24:07;84434108;84347896;86212;
07.02.2019;19:25:04;84434221;84347996;86225;
07.02.2019;19:26:04;84434318;84348108;86210;
07.02.2019;19:27:05;84434418;84348224;86194;
07.02.2019;19:28:07;84434537;84348369;86168;
07.02.2019;19:29:05;84434659;84348468;86191;
07.02.2019;19:30:05;84434753;84348589;86164;
07.02.2019;19:31:05;84434867;84348710;86157;
07.02.2019;19:32:04;84434982;84348813;86169;
07.02.2019;19:33:06;84435098;84348885;86213;
07.02.2019;19:34:04;84435212;84349028;86184;
07.02.2019;19:35:05;84435325;84349147;86178;
07.02.2019;19:36:10;84435436;84349292;86144;
07.02.2019;19:37:07;84435549;84349381;86168;
07.02.2019;19:38:05;84435662;84349473;86189;
07.02.2019;19:39:07;84435774;84349545;86229;
07.02.2019;19:40:05;84435892;84349643;86249;
07.02.2019;19:41:07;84436006;84349735;86271;
07.02.2019;19:42:04;84436116;84349816;86300;
07.02.2019;19:43:05;84436248;84349924;86324;
07.02.2019;19:44:07;84436379;84350026;86353;
07.02.2019;19:45:07;84436502;84350133;86369;
07.02.2019;19:46:05;84436617;84350232;86385;
07.02.2019;19:47:05;84436718;84350319;86399;
07.02.2019;19:48:05;84436829;84350420;86409;
07.02.2019;19:49:05;84436953;84350516;86437;
07.02.2019;19:50:07;84437062;84350625;86437;
07.02.2019;19:51:05;84437166;84350730;86436;
07.02.2019;19:52:05;84437279;84350842;86437;
07.02.2019;19:53:05;84437390;84350935;86455;
07.02.2019;19:54:07;84437497;84351031;86466;
07.02.2019;19:55:05;84437605;84351120;86485;
07.02.2019;19:56:05;84437742;84351209;86533;
07.02.2019;19:57:05;84437874;84351307;86567;
07.02.2019;19:58:05;84437976;84351385;86591;
07.02.2019;19:59:05;84438058;84351481;86577;
07.02.2019;20:00:04;84438183;84351586;86597;
07.02.2019;20:01:04;84438304;84351673;86631;
07.02.2019;20:02:08;84438415;84351766;86649;
07.02.2019;20:03:05;84438515;84351855;86660;
07.02.2019;20:04:04;84438645;84351940;86705;
07.02.2019;20:05:05;84438728;84352032;86696;
07.02.2019;20:06:08;84438857;84352119;86738;
07.02.2019;20:07:04;84438960;84352196;86764;
07.02.2019;20:08:04;84439067;84352282;86785;
07.02.2019;20:09:07;84439208;84352344;86864;
07.02.2019;20:10:08;84439329;84352433;86896;
07.02.2019;20:11:05;84439440;84352515;86925;
07.02.2019;20:12:05;84439566;84352587;86979;
07.02.2019;20:13:05;84439710;84352676;87034;
07.02.2019;20:14:07;84439840;84352749;87091;
07.02.2019;20:15:04;84439962;84352826;87136;
07.02.2019;20:16:05;84440075;84352896;87179;
07.02.2019;20:17:05;84440173;84352970;87203;
07.02.2019;20:18:04;84440277;84353026;87251;
07.02.2019;20:19:07;84440381;84353097;87284;
07.02.2019;20:20:05;84440475;84353154;87321;
07.02.2019;20:21:05;84440574;84353231;87343;
07.02.2019;20:22:05;84440669;84353295;87374;
07.02.2019;20:23:07;84440757;84353351;87406;
07.02.2019;20:24:04;84440833;84353401;87432;
07.02.2019;20:25:05;84440936;84353440;87496;
07.02.2019;20:26:05;84441025;84353483;87542;
07.02.2019;20:27:07;84441140;84353549;87591;
07.02.2019;20:28:05;84441243;84353605;87638;
07.02.2019;20:29:08;84441343;84353632;87711;
07.02.2019;20:30:09;84441431;84353689;87742;
07.02.2019;20:31:07;84441519;84353760;87759;
07.02.2019;20:32:04;84441565;84353833;87732;
07.02.2019;20:33:04;84441676;84353890;87786;
07.02.2019;20:34:05;84441777;84353952;87825;
07.02.2019;20:35:05;84441844;84354000;87844;
07.02.2019;20:36:08;84441944;84354067;87877;
07.02.2019;20:37:04;84442042;84354134;87908;
07.02.2019;20:38:04;84442133;84354185;87948;
07.02.2019;20:39:07;84442214;84354239;87975;
07.02.2019;20:40:07;84442302;84354299;88003;
07.02.2019;20:41:05;84442412;84354368;88044;
07.02.2019;20:42:05;84442528;84354452;88076;
07.02.2019;20:43:05;84442620;84354485;88135;
07.02.2019;20:44:07;84442720;84354546;88174;
07.02.2019;20:45:05;84442827;84354610;88217;
07.02.2019;20:46:04;84442938;84354657;88281;
07.02.2019;20:47:04;84443042;84354717;88325;
07.02.2019;20:48:08;84443132;84354783;88349;
07.02.2019;20:49:04;84443245;84354819;88426;
07.02.2019;20:50:04;84443353;84354881;88472;
07.02.2019;20:51:05;84443459;84354966;88493;
07.02.2019;20:52:04;84443584;84355018;88566;
07.02.2019;20:53:05;84443706;84355091;88615;
07.02.2019;20:54:05;84443813;84355152;88661;
07.02.2019;20:55:08;84443880;84355219;88661;
07.02.2019;20:56:04;84443919;84355286;88633;
07.02.2019;20:57:07;84443994;84355351;88643;
07.02.2019;20:58:05;84444055;84355424;88631;
07.02.2019;20:59:05;84444131;84355486;88645;
07.02.2019;21:00:04;84444212;84355546;88666;
07.02.2019;21:01:07;84444313;84355618;88695;
07.02.2019;21:02:12;84447197;84355676;91521;
07.02.2019;21:03:13;84447296;84355741;91555;
07.02.2019;21:04:05;84447370;84355781;91589;
07.02.2019;21:05:08;84447462;84355838;91624;
07.02.2019;21:06:08;84447560;84355888;91672;
07.02.2019;21:07:05;84447638;84355943;91695;
07.02.2019;21:08:08;84447747;84356005;91742;
07.02.2019;21:09:09;84447851;84356071;91780;
07.02.2019;21:10:05;84447921;84356122;91799;
07.02.2019;21:11:05;84448028;84363786;84242;
07.02.2019;21:12:15;84448121;84363844;84277;
07.02.2019;21:13:15;84448194;84363909;84285;
07.02.2019;21:14:05;84448270;84363936;84334;
07.02.2019;21:15:06;84448374;84363988;84386;
07.02.2019;21:16:08;84448492;84364046;84446;
07.02.2019;21:17:08;84448600;84364105;84495;
07.02.2019;21:18:05;84448704;84364163;84541;
07.02.2019;21:19:04;84448795;84364222;84573;
07.02.2019;21:20:07;84448864;84364267;84597;
07.02.2019;21:21:08;84448952;84364314;84638;
07.02.2019;21:22:05;84449076;84364366;84710;
07.02.2019;21:23:05;84449172;84364422;84750;
07.02.2019;21:24:07;84449277;84364466;84811;
07.02.2019;21:25:07;84449372;84364523;84849;
07.02.2019;21:26:05;84449497;84364571;84926;
07.02.2019;21:27:11;84449606;84364633;84973;
07.02.2019;21:28:08;84449717;84364694;85023;
07.02.2019;21:29:05;84449807;84364745;85062;
07.02.2019;21:30:05;84449936;84364789;85147;
07.02.2019;21:31:09;84450055;84364839;85216;
07.02.2019;21:32:07;84450167;84364860;85307;
07.02.2019;21:33:05;84450281;84364936;85345;
07.02.2019;21:34:04;84450380;84364979;85401;
07.02.2019;21:35:04;84450500;84365039;85461;
07.02.2019;21:36:08;84450637;84365089;85548;
07.02.2019;21:37:13;84450761;84365161;85600;
07.02.2019;21:38:04;84450838;84365208;85630;
07.02.2019;21:39:06;84450952;84365254;85698;
07.02.2019;21:40:07;84451056;84365300;85756;
07.02.2019;21:41:05;84451177;84365339;85838;
07.02.2019;21:42:05;84451270;84365379;85891;
07.02.2019;21:43:04;84451373;84365422;85951;
07.02.2019;21:44:16;84451492;84365477;86015;
07.02.2019;21:45:05;84451607;84365526;86081;
07.02.2019;21:46:04;84451714;84365585;86129;
07.02.2019;21:47:08;84451840;84365624;86216;
07.02.2019;21:48:08;84451955;84365663;86292;
07.02.2019;21:49:04;84452043;84365704;86339;
07.02.2019;21:50:05;84452160;84365751;86409;
07.02.2019;21:51:08;84452265;84365809;86456;
07.02.2019;21:52:04;84452397;84365858;86539;
07.02.2019;21:53:04;84452481;84365909;86572;
07.02.2019;21:54:07;84452605;84365953;86652;
07.02.2019;21:55:05;84452726;84365998;86728;
07.02.2019;21:56:05;84452833;84366034;86799;
07.02.2019;21:57:07;84452937;84366086;86851;
07.02.2019;21:58:07;84453084;84366126;86958;
07.02.2019;21:59:05;84453182;84366165;87017;
07.02.2019;22:00:04;84453315;84366222;87093;
07.02.2019;22:01:08;84453418;84366272;87146;
07.02.2019;22:02:05;84453514;84366303;87211;
07.02.2019;22:03:07;84453615;84366297;87318;
07.02.2019;22:04:04;84453696;84366297;87399;
07.02.2019;22:05:04;84453781;84366345;87436;
07.02.2019;22:06:11;84453901;84366366;87535;
07.02.2019;22:07:07;84454020;84366395;87625;
07.02.2019;22:08:04;84454114;84366429;87685;
07.02.2019;22:09:06;84454249;84366478;87771;
07.02.2019;22:10:08;84454355;84366533;87822;
07.02.2019;22:11:08;84454454;84366570;87884;
07.02.2019;22:12:04;84454575;84366605;87970;
07.02.2019;22:13:05;84454706;84366637;88069;
07.02.2019;22:14:08;84454806;84366680;88126;
07.02.2019;22:15:05;84454912;84366719;88193;
07.02.2019;22:16:06;84455041;84366754;88287;
07.02.2019;22:17:05;84455116;84366800;88316;
07.02.2019;22:18:07;84455230;84366837;88393;
07.02.2019;22:19:04;84455340;84366885;88455;
07.02.2019;22:20:07;84455453;84366915;88538;
07.02.2019;22:21:05;84455575;84366941;88634;
07.02.2019;22:22:08;84455695;84366977;88718;
07.02.2019;22:23:04;84455805;84367002;88803;
07.02.2019;22:24:07;84455904;84367041;88863;
07.02.2019;22:25:04;84455985;84367048;88937;
07.02.2019;22:26:04;84456080;84367052;89028;
07.02.2019;22:27:07;84456200;84367071;89129;
07.02.2019;22:28:04;84456280;84367093;89187;
07.02.2019;22:29:04;84456326;84367115;89211;
07.02.2019;22:30:05;84456397;84367129;89268;
07.02.2019;22:31:08;84456502;84367175;89327;
07.02.2019;22:32:04;84456540;84367186;89354;
07.02.2019;22:33:04;84456678;84367211;89467;
07.02.2019;22:34:16;84456780;84367237;89543;
07.02.2019;22:35:07;84456879;84367256;89623;
07.02.2019;22:36:04;84456986;84367290;89696;
07.02.2019;22:37:04;84457092;84367314;89778;
07.02.2019;22:38:05;84457181;84367346;89835;
07.02.2019;22:39:07;84457294;84367376;89918;
07.02.2019;22:40:04;84457389;84367418;89971;
07.02.2019;22:41:05;84457482;84367445;90037;
07.02.2019;22:42:05;84457577;84367478;90099;
07.02.2019;22:43:05;84457701;84367493;90208;
07.02.2019;22:44:07;84457788;84367516;90272;
07.02.2019;22:45:04;84457885;84367536;90349;
07.02.2019;22:46:04;84457981;84367551;90430;
07.02.2019;22:47:05;84458064;84367583;90481;
07.02.2019;22:48:07;84458200;84367618;90582;
07.02.2019;22:49:09;84458297;84367646;90651;
07.02.2019;22:50:05;84458391;84367673;90718;
07.02.2019;22:51:05;84458506;84367715;90791;
07.02.2019;22:52:07;84458617;84367735;90882;
07.02.2019;22:53:05;84458735;84367761;90974;
07.02.2019;22:54:05;84458841;84367786;91055;
07.02.2019;22:55:05;84458903;84367823;91080;
07.02.2019;22:56:07;84459029;84367869;91160;
07.02.2019;22:57:09;84459147;84367904;91243;
07.02.2019;22:58:05;84459255;84367948;91307;
07.02.2019;22:59:04;84459363;84367959;91404;
07.02.2019;23:00:05;84459482;84367979;91503;
07.02.2019;23:01:05;84459581;84368000;91581;
07.02.2019;23:02:05;84459678;84368031;91647;
07.02.2019;23:03:04;84459796;84368067;91729;
07.02.2019;23:04:05;84459872;84368086;91786;
07.02.2019;23:05:09;84459975;84368128;91847;
07.02.2019;23:06:05;84460072;84368160;91912;
07.02.2019;23:07:04;84460175;84368193;91982;
07.02.2019;23:08:05;84460280;84368227;92053;
07.02.2019;23:09:09;84460393;84368249;92144;
07.02.2019;23:10:04;84460487;84368276;92211;
07.02.2019;23:11:05;84460584;84368315;92269;
07.02.2019;23:12:05;84460692;84368349;92343;
07.02.2019;23:13:07;84460815;84368381;92434;
07.02.2019;23:14:04;84460902;84368410;92492;
07.02.2019;23:15:05;84461013;84368445;92568;
07.02.2019;23:16:05;84461108;84368489;92619;
07.02.2019;23:17:06;84461212;84368517;92695;
07.02.2019;23:18:04;84461309;84368536;92773;
07.02.2019;23:19:05;84461396;84368578;92818;
07.02.2019;23:20:04;84461505;84368602;92903;
07.02.2019;23:21:04;84461605;84368629;92976;
07.02.2019;23:22:08;84461705;84368664;93041;
07.02.2019;23:23:05;84461813;84368686;93127;
07.02.2019;23:24:04;84461924;84368716;93208;
07.02.2019;23:25:04;84461993;84368749;93244;
07.02.2019;23:26:08;84462107;84368778;93329;
07.02.2019;23:27:05;84462195;84368804;93391;
07.02.2019;23:28:05;84462279;84368836;93443;
07.02.2019;23:29:04;84462380;84368875;93505;
07.02.2019;23:30:08;84462473;84368901;93572;
07.02.2019;23:31:04;84462577;84368925;93652;
07.02.2019;23:32:04;84462667;84368963;93704;
07.02.2019;23:33:05;84462779;84368995;93784;
07.02.2019;23:34:07;84462893;84369039;93854;
07.02.2019;23:35:04;84462992;84369068;93924;
07.02.2019;23:36:04;84463100;84369093;94007;
07.02.2019;23:37:05;84463211;84369118;94093;
07.02.2019;23:38:05;84463337;84369149;94188;
07.02.2019;23:39:09;84463459;84369179;94280;
07.02.2019;23:40:04;84463574;84369204;94370;
07.02.2019;23:41:05;84463663;84369240;94423;
07.02.2019;23:42:04;84463783;84369270;94513;
07.02.2019;23:43:07;84463882;84369302;94580;
07.02.2019;23:44:04;84463973;84369328;94645;
07.02.2019;23:45:05;84464056;84369356;94700;
07.02.2019;23:46:04;84464150;84369387;94763;
07.02.2019;23:47:07;84464247;84369419;94828;
07.02.2019;23:48:05;84464344;84369446;94898;
07.02.2019;23:49:05;84464463;84369474;94989;
07.02.2019;23:50:06;84464569;84369497;95072;
07.02.2019;23:51:08;84464673;84369518;95155;
07.02.2019;23:52:05;84464769;84369536;95233;
07.02.2019;23:53:04;84464870;84369558;95312;
07.02.2019;23:54:04;84464945;84369577;95368;
07.02.2019;23:55:08;84465056;84369608;95448;
07.02.2019;23:56:04;84465157;84369639;95518;
07.02.2019;23:57:05;84465269;84369663;95606;
07.02.2019;23:58:04;84465350;84369706;95644;
07.02.2019;23:59:04;84465440;84369739;95701;
08.02.2019;00:00:09;84465554;84369759;95795;
08.02.2019;00:01:11;84465648;84369788;95860;
08.02.2019;00:02:14;84465751;84369815;95936;
08.02.2019;00:03:10;84465854;84369839;96015;
08.02.2019;00:04:11;84465949;84369871;96078;
08.02.2019;00:05:14;84466037;84369909;96128;
08.02.2019;00:06:13;84466134;84369940;96194;
08.02.2019;00:07:16;84466239;84369956;96283;
08.02.2019;00:08:13;84466327;84369992;96335;
08.02.2019;00:09:18;84466430;84370028;96402;
08.02.2019;00:10:16;84466520;84370058;96462;
08.02.2019;00:11:16;84466600;84370082;96518;
08.02.2019;00:12:20;84466702;84370111;96591;
08.02.2019;00:13:17;84466789;84370128;96661;
08.02.2019;00:14:17;84466891;84370157;96734;
08.02.2019;00:15:14;84466972;84370180;96792;
08.02.2019;00:16:13;84467077;84370195;96882;
08.02.2019;00:17:14;84467148;84370222;96926;
08.02.2019;00:18:13;84467213;84370243;96970;
08.02.2019;00:19:12;84467249;84370256;96993;
08.02.2019;00:20:13;84467327;84370273;97054;
08.02.2019;00:21:13;84467400;84370297;97103;
08.02.2019;00:22:12;84467439;84370310;97129;
08.02.2019;00:23:12;84467503;84370335;97168;
08.02.2019;00:24:12;84467575;84370359;97216;
08.02.2019;00:25:11;84467644;84370389;97255;
08.02.2019;00:26:10;84467719;84370421;97298;
08.02.2019;00:27:10;84467799;84370447;97352;
08.02.2019;00:28:10;84467863;84370464;97399;
08.02.2019;00:29:09;84467949;84370484;97465;
08.02.2019;00:30:08;84468023;84370502;97521;
08.02.2019;00:31:07;84468109;84370522;97587;
08.02.2019;00:32:08;84468192;84370541;97651;
08.02.2019;00:33:07;84468282;84370551;97731;
08.02.2019;00:34:08;84468359;84370585;97774;
08.02.2019;00:35:08;84468441;84370604;97837;
08.02.2019;00:36:08;84468539;84370634;97905;
08.02.2019;00:37:07;84468637;84370669;97968;
08.02.2019;00:38:07;84468729;84370686;98043;
08.02.2019;00:39:08;84468808;84370726;98082;
08.02.2019;00:40:08;84468876;84370744;98132;
08.02.2019;00:41:07;84468971;84370782;98189;
08.02.2019;00:42:07;84469048;84370808;98240;
08.02.2019;00:43:07;84469136;84370831;98305;
08.02.2019;00:44:08;84469228;84370858;98370;
08.02.2019;00:45:07;84469311;84370884;98427;
08.02.2019;00:46:08;84469402;84370909;98493;
08.02.2019;00:47:08;84469493;84370929;98564;
08.02.2019;00:48:07;84469596;84370963;98633;
08.02.2019;00:49:07;84469690;84370987;98703;
08.02.2019;00:50:07;84469790;84371020;98770;
08.02.2019;00:51:07;84469900;84371048;98852;
08.02.2019;00:52:08;84469984;84371083;98901;
08.02.2019;00:53:08;84470081;84371113;98968;
08.02.2019;00:54:07;84470139;84371134;99005;
08.02.2019;00:55:07;84470263;84371161;99102;
08.02.2019;00:56:07;84470358;84371181;99177;
08.02.2019;00:57:07;84470442;84371218;99224;
08.02.2019;00:58:08;84470538;84371246;99292;
08.02.2019;00:59:07;84470609;84371280;99329;
08.02.2019;01:00:04;84470686;84371317;99369;
08.02.2019;01:01:05;84470779;84371341;99438;
08.02.2019;01:02:04;84470861;84371376;99485;
08.02.2019;01:03:05;84470953;84371405;99548;
08.02.2019;01:04:04;84471032;84371438;99594;
08.02.2019;01:05:04;84471112;84371454;99658;
08.02.2019;01:06:05;84471191;84371485;99706;
08.02.2019;01:07:05;84471262;84371522;99740;
08.02.2019;01:08:04;84471343;84371561;99782;
08.02.2019;01:09:08;84471439;84371611;99828;
08.02.2019;01:10:04;84471526;84371650;99876;
08.02.2019;01:11:05;84471612;84371681;99931;
08.02.2019;01:12:04;84471690;84371709;99981;
08.02.2019;01:13:05;84471766;84371738;100028;
08.02.2019;01:14:04;84471862;84371770;100092;
08.02.2019;01:15:04;84471912;84371765;100147;
08.02.2019;01:16:04;84471997;84371790;100207;
08.02.2019;01:17:04;84472064;84371829;100235;
08.02.2019;01:18:04;84472149;84371856;100293;
08.02.2019;01:19:05;84472222;84371899;100323;
08.02.2019;01:20:05;84472308;84371929;100379;
08.02.2019;01:21:05;84472387;84371967;100420;
08.02.2019;01:22:04;84472461;84372012;100449;
08.02.2019;01:23:05;84472551;84372037;100514;
08.02.2019;01:24:04;84472641;84372076;100565;
08.02.2019;01:25:04;84472732;84372115;100617;
08.02.2019;01:26:04;84472821;84372144;100677;
08.02.2019;01:27:04;84472915;84372181;100734;
08.02.2019;01:28:04;84473009;84372215;100794;
08.02.2019;01:29:04;84473092;84372254;100838;
08.02.2019;01:30:05;84473173;84372299;100874;
08.02.2019;01:31:04;84473236;84372334;100902;
08.02.2019;01:32:05;84473319;84372361;100958;
08.02.2019;01:33:04;84473404;84372392;101012;
08.02.2019;01:34:05;84473478;84372429;101049;
08.02.2019;01:35:04;84473559;84372456;101103;
08.02.2019;01:36:04;84473640;84372492;101148;
08.02.2019;01:37:05;84473718;84372547;101171;
08.02.2019;01:38:04;84473793;84372598;101195;
08.02.2019;01:39:04;84473867;84372627;101240;
08.02.2019;01:40:04;84473927;84372655;101272;
08.02.2019;01:41:04;84474019;84372688;101331;
08.02.2019;01:42:05;84474107;84372728;101379;
08.02.2019;01:43:05;84474198;84372765;101433;
08.02.2019;01:44:04;84474285;84372814;101471;
08.02.2019;01:45:05;84474360;84372862;101498;
08.02.2019;01:46:04;84474428;84372904;101524;
08.02.2019;01:47:04;84474502;84372918;101584;
08.02.2019;01:48:04;84474594;84372995;101599;
08.02.2019;01:49:04;84474680;84373041;101639;
08.02.2019;01:50:05;84474782;84373092;101690;
08.02.2019;01:51:04;84474850;84373146;101704;
08.02.2019;01:52:04;84474945;84373191;101754;
08.02.2019;01:53:05;84475022;84373228;101794;
08.02.2019;01:54:04;84475114;84373271;101843;
08.02.2019;01:55:04;84475191;84373320;101871;
08.02.2019;01:56:04;84475265;84373372;101893;
08.02.2019;01:57:04;84475338;84373430;101908;
08.02.2019;01:58:04;84475425;84373479;101946;
08.02.2019;01:59:04;84475497;84373538;101959;
08.02.2019;02:00:05;84475574;84373586;101988;
08.02.2019;02:01:04;84475653;84373634;102019;
08.02.2019;02:02:05;84475740;84373682;102058;
08.02.2019;02:03:04;84475815;84373740;102075;
08.02.2019;02:04:04;84475890;84373788;102102;
08.02.2019;02:05:09;84475980;84373835;102145;
08.02.2019;02:06:05;84476073;84373879;102194;
08.02.2019;02:07:04;84476146;84373945;102201;
08.02.2019;02:08:04;84476233;84374019;102214;
08.02.2019;02:09:05;84476316;84374059;102257;
08.02.2019;02:10:04;84476399;84374119;102280;
08.02.2019;02:11:05;84476477;84374174;102303;
08.02.2019;02:12:04;84476567;84374237;102330;
08.02.2019;02:13:04;84476650;84374277;102373;
08.02.2019;02:14:05;84476740;84374336;102404;
08.02.2019;02:15:05;84476812;84374403;102409;
08.02.2019;02:16:05;84476888;84374450;102438;
08.02.2019;02:17:04;84476970;84374504;102466;
08.02.2019;02:18:04;84477028;84374572;102456;
08.02.2019;02:19:05;84477087;84374632;102455;
08.02.2019;02:20:04;84477162;84374703;102459;
08.02.2019;02:21:05;84477225;84374757;102468;
08.02.2019;02:22:04;84477304;84374829;102475;
08.02.2019;02:23:04;84477376;84374892;102484;
08.02.2019;02:24:05;84477455;84374935;102520;
08.02.2019;02:25:05;84477528;84374994;102534;
08.02.2019;02:26:04;84477597;84375051;102546;
08.02.2019;02:27:05;84477661;84375112;102549;
08.02.2019;02:28:04;84477732;84375197;102535;
08.02.2019;02:29:04;84477825;84375260;102565;
08.02.2019;02:30:05;84477905;84375344;102561;
08.02.2019;02:31:04;84477964;84375415;102549;
08.02.2019;02:32:05;84478039;84375470;102569;
08.02.2019;02:33:04;84478120;84375530;102590;
08.02.2019;02:34:04;84478197;84375587;102610;
08.02.2019;02:35:05;84478266;84375652;102614;
08.02.2019;02:36:04;84478352;84375693;102659;
08.02.2019;02:37:04;84478421;84375773;102648;
08.02.2019;02:38:05;84478514;84375839;102675;
08.02.2019;02:39:06;84478610;84375924;102686;
08.02.2019;02:40:05;84478692;84376010;102682;
08.02.2019;02:41:04;84478774;84376072;102702;
08.02.2019;02:42:05;84478841;84376154;102687;
08.02.2019;02:43:04;84478922;84376216;102706;
08.02.2019;02:44:05;84479034;84376282;102752;
08.02.2019;02:45:04;84479117;84376355;102762;
08.02.2019;02:46:04;84479190;84376429;102761;
08.02.2019;02:47:04;84479292;84376512;102780;
08.02.2019;02:48:05;84479377;84376592;102785;
08.02.2019;02:49:04;84479470;84376645;102825;
08.02.2019;02:50:05;84479560;84376722;102838;
08.02.2019;02:51:04;84479653;84376800;102853;
08.02.2019;02:52:05;84479725;84376871;102854;
08.02.2019;02:53:04;84479799;84376967;102832;
08.02.2019;02:54:04;84479895;84377053;102842;
08.02.2019;02:55:04;84479983;84377145;102838;
08.02.2019;02:56:04;84480072;84377232;102840;
08.02.2019;02:57:05;84480155;84377322;102833;
08.02.2019;02:58:05;84480254;84377423;102831;
08.02.2019;02:59:05;84480336;84377504;102832;
08.02.2019;03:00:04;84480418;84377601;102817;
08.02.2019;03:01:05;84480508;84377697;102811;
08.02.2019;03:02:04;84480604;84377791;102813;
08.02.2019;03:03:04;84480684;84377876;102808;
08.02.2019;03:04:05;84480758;84377960;102798;
08.02.2019;03:05:04;84480832;84378049;102783;
08.02.2019;03:06:05;84480918;84378144;102774;
08.02.2019;03:07:04;84481005;84378246;102759;
08.02.2019;03:08:04;84481084;84378331;102753;
08.02.2019;03:09:04;84481170;84378418;102752;
08.02.2019;03:10:05;84481264;84378514;102750;
08.02.2019;03:11:04;84481320;84378606;102714;
08.02.2019;03:12:04;84481392;84378713;102679;
08.02.2019;03:13:04;84481474;84378792;102682;
08.02.2019;03:14:04;84481544;84378884;102660;
08.02.2019;03:15:05;84481628;84378989;102639;
08.02.2019;03:16:04;84481702;84379078;102624;
08.02.2019;03:17:05;84481806;84379188;102618;
08.02.2019;03:18:05;84481893;84379308;102585;
08.02.2019;03:19:04;84481973;84379386;102587;
08.02.2019;03:20:04;84482061;84379482;102579;
08.02.2019;03:21:04;84482137;84379568;102569;
08.02.2019;03:22:05;84482221;84379693;102528;
08.02.2019;03:23:04;84482300;84379793;102507;
08.02.2019;03:24:05;84482405;84379885;102520;
08.02.2019;03:25:04;84482497;84379979;102518;
08.02.2019;03:26:04;84482587;84380083;102504;
08.02.2019;03:27:05;84482666;84380187;102479;
08.02.2019;03:28:05;84482764;84380300;102464;
08.02.2019;03:29:04;84482836;84380393;102443;
08.02.2019;03:30:04;84482912;84380489;102423;
08.02.2019;03:31:05;84483000;84380600;102400;
08.02.2019;03:32:04;84483081;84380719;102362;
08.02.2019;03:33:05;84483151;84380827;102324;
08.02.2019;03:34:04;84483230;84380921;102309;
08.02.2019;03:35:04;84483294;84381013;102281;
08.02.2019;03:36:05;84483371;84381095;102276;
08.02.2019;03:37:05;84483458;84381194;102264;
08.02.2019;03:38:04;84483554;84381306;102248;
08.02.2019;03:39:06;84483640;84381397;102243;
08.02.2019;03:40:04;84483713;84381474;102239;
08.02.2019;03:41:04;84483782;84381564;102218;
08.02.2019;03:42:04;84483853;84381696;102157;
08.02.2019;03:43:04;84483943;84381803;102140;
08.02.2019;03:44:05;84484026;84381916;102110;
08.02.2019;03:45:04;84484129;84382026;102103;
08.02.2019;03:46:05;84484187;84382108;102079;
08.02.2019;03:47:05;84484288;84382222;102066;
08.02.2019;03:48:05;84484365;84382334;102031;
08.02.2019;03:49:04;84484450;84382434;102016;
08.02.2019;03:50:04;84484533;84382534;101999;
08.02.2019;03:51:04;84484628;84382643;101985;
08.02.2019;03:52:04;84484759;84382737;102022;
08.02.2019;03:53:05;84484836;84382872;101964;
08.02.2019;03:54:04;84484921;84382983;101938;
08.02.2019;03:55:05;84485004;84383095;101909;
08.02.2019;03:56:04;84485067;84383206;101861;
08.02.2019;03:57:04;84485133;84383311;101822;
08.02.2019;03:58:05;84485235;84383429;101806;
08.02.2019;03:59:04;84485323;84383530;101793;
08.02.2019;04:00:04;84485424;84383633;101791;
08.02.2019;04:01:04;84485515;84383735;101780;
08.02.2019;04:02:04;84485593;84383836;101757;
08.02.2019;04:03:04;84485696;84383949;101747;
08.02.2019;04:04:04;84485762;84384056;101706;
08.02.2019;04:05:05;84485867;84384172;101695;
08.02.2019;04:06:04;84485935;84384259;101676;
08.02.2019;04:07:04;84486017;84384358;101659;
08.02.2019;04:08:05;84486092;84384499;101593;
08.02.2019;04:09:06;84486133;84384543;101590;
08.02.2019;04:10:04;84486186;84384664;101522;
08.02.2019;04:11:05;84486262;84384774;101488;
08.02.2019;04:12:04;84486346;84384887;101459;
08.02.2019;04:13:04;84486424;84384988;101436;
08.02.2019;04:14:04;84486479;84385077;101402;
08.02.2019;04:15:04;84486545;84385170;101375;
08.02.2019;04:16:10;84486597;84385255;101342;
08.02.2019;04:17:04;84486647;84385340;101307;
08.02.2019;04:18:04;84486724;84385454;101270;
08.02.2019;04:19:04;84486768;84385518;101250;
08.02.2019;04:20:05;84486861;84385644;101217;
08.02.2019;04:21:04;84486934;84385745;101189;
08.02.2019;04:22:05;84487001;84385853;101148;
08.02.2019;04:23:04;84487056;84385947;101109;
08.02.2019;04:24:04;84487113;84386058;101055;
08.02.2019;04:25:04;84487181;84386179;101002;
08.02.2019;04:26:04;84487250;84386277;100973;
08.02.2019;04:27:06;84487321;84386388;100933;
08.02.2019;04:28:04;84487395;84386506;100889;
08.02.2019;04:29:05;84487484;84386621;100863;
08.02.2019;04:30:04;84487555;84386728;100827;
08.02.2019;04:31:04;84487619;84386829;100790;
08.02.2019;04:32:04;84487691;84386965;100726;
08.02.2019;04:33:04;84487756;84387067;100689;
08.02.2019;04:34:05;84487835;84387160;100675;
08.02.2019;04:35:04;84487930;84387277;100653;
08.02.2019;04:36:05;84488013;84387390;100623;
08.02.2019;04:37:05;84488069;84387491;100578;
08.02.2019;04:38:05;84488129;84387605;100524;
08.02.2019;04:39:06;84488207;84387751;100456;
08.02.2019;04:40:05;84488275;84387839;100436;
08.02.2019;04:41:04;84488352;84387955;100397;
08.02.2019;04:42:04;84488441;84388066;100375;
08.02.2019;04:43:05;84488527;84388180;100347;
08.02.2019;04:44:04;84488593;84388306;100287;
08.02.2019;04:45:05;84488665;84388429;100236;
08.02.2019;04:46:04;84488755;84388540;100215;
08.02.2019;04:47:04;84488824;84388644;100180;
08.02.2019;04:48:05;84488896;84388775;100121;
08.02.2019;04:49:04;84488972;84388885;100087;
08.02.2019;04:50:05;84489054;84388993;100061;
08.02.2019;04:51:05;84489130;84389103;100027;
08.02.2019;04:52:05;84489206;84389224;99982;
08.02.2019;04:53:04;84489275;84389318;99957;
08.02.2019;04:54:04;84489348;84389442;99906;
08.02.2019;04:55:04;84489423;84389549;99874;
08.02.2019;04:56:04;84489498;84389678;99820;
08.02.2019;04:57:05;84489585;84389797;99788;
08.02.2019;04:58:04;84489670;84389907;99763;
08.02.2019;04:59:04;84489737;84390006;99731;
08.02.2019;05:00:04;84489814;84390157;99657;
08.02.2019;05:01:04;84489896;84390260;99636;
08.02.2019;05:02:05;84490004;84390372;99632;
08.02.2019;05:03:04;84490062;84390489;99573;
08.02.2019;05:04:05;84490131;84390601;99530;
08.02.2019;05:05:04;84490200;84390729;99471;
08.02.2019;05:06:05;84490280;84390839;99441;
08.02.2019;05:07:04;84490364;84390948;99416;
08.02.2019;05:08:04;84490449;84391069;99380;
08.02.2019;05:09:06;84490522;84391170;99352;
08.02.2019;05:10:05;84490593;84391284;99309;
08.02.2019;05:11:04;84490662;84391409;99253;
08.02.2019;05:12:04;84490746;84391501;99245;
08.02.2019;05:13:05;84490836;84391618;99218;
08.02.2019;05:14:04;84490916;84391731;99185;
08.02.2019;05:15:05;84491007;84391865;99142;
08.02.2019;05:16:04;84491084;84391985;99099;
08.02.2019;05:17:04;84491157;84392083;99074;
08.02.2019;05:18:05;84491228;84392193;99035;
08.02.2019;05:19:04;84491307;84392306;99001;
08.02.2019;05:20:04;84491398;84392421;98977;
08.02.2019;05:21:04;84491476;84392555;98921;
08.02.2019;05:22:04;84491540;84392687;98853;
08.02.2019;05:23:05;84491632;84392792;98840;
08.02.2019;05:24:04;84491700;84392891;98809;
08.02.2019;05:25:04;84491774;84393020;98754;
08.02.2019;05:26:04;84491838;84393145;98693;
08.02.2019;05:27:05;84491924;84393260;98664;
08.02.2019;05:28:04;84491994;84393384;98610;
08.02.2019;05:29:05;84492066;84393534;98532;
08.02.2019;05:30:04;84492147;84393678;98469;
08.02.2019;05:31:05;84492225;84393806;98419;
08.02.2019;05:32:04;84492303;84393953;98350;
08.02.2019;05:33:04;84492367;84394075;98292;
08.02.2019;05:34:05;84492436;84394223;98213;
08.02.2019;05:35:04;84492506;84394358;98148;
08.02.2019;05:36:05;84492601;84394475;98126;
08.02.2019;05:37:04;84492682;84394610;98072;
08.02.2019;05:38:04;84492756;84394750;98006;
08.02.2019;05:39:06;84492835;84394875;97960;
08.02.2019;05:40:04;84492903;84394993;97910;
08.02.2019;05:41:04;84492962;84395110;97852;
08.02.2019;05:42:04;84493032;84395214;97818;
08.02.2019;05:43:05;84493116;84395348;97768;
08.02.2019;05:44:04;84493179;84395477;97702;
08.02.2019;05:45:05;84493253;84395614;97639;
08.02.2019;05:46:04;84493335;84395744;97591;
08.02.2019;05:47:04;84493425;84395849;97576;
08.02.2019;05:48:04;84493510;84395990;97520;
08.02.2019;05:49:04;84493580;84396101;97479;
08.02.2019;05:50:05;84493652;84396231;97421;
08.02.2019;05:51:04;84493734;84396342;97392;
08.02.2019;05:52:05;84493796;84396491;97305;
08.02.2019;05:53:04;84493863;84396621;97242;
08.02.2019;05:54:04;84493943;84396744;97199;
08.02.2019;05:55:05;84494019;84396867;97152;
08.02.2019;05:56:04;84494087;84396987;97100;
08.02.2019;05:57:05;84494149;84397116;97033;
08.02.2019;05:58:04;84494235;84397236;96999;
08.02.2019;05:59:04;84494296;84397372;96924;
08.02.2019;06:00:04;84494351;84397487;96864;
08.02.2019;06:01:04;84494424;84397627;96797;
08.02.2019;06:02:05;84494469;84397757;96712;
08.02.2019;06:03:04;84494540;84397885;96655;
08.02.2019;06:04:04;84494589;84398011;96578;
08.02.2019;06:05:04;84494648;84398159;96489;
08.02.2019;06:06:04;84494717;84398307;96410;
08.02.2019;06:07:04;84494768;84398425;96343;
08.02.2019;06:08:04;84494850;84398550;96300;
08.02.2019;06:09:06;84494924;84398678;96246;
08.02.2019;06:10:04;84495008;84398788;96220;
08.02.2019;06:11:05;84495071;84398924;96147;
08.02.2019;06:12:04;84495142;84399066;96076;
08.02.2019;06:13:05;84495196;84399174;96022;
08.02.2019;06:14:04;84495261;84399278;95983;
08.02.2019;06:15:05;84495313;84399382;95931;
08.02.2019;06:16:04;84495348;84399498;95850;
08.02.2019;06:17:04;84495397;84399646;95751;
08.02.2019;06:18:05;84495433;84399759;95674;
08.02.2019;06:19:04;84495481;84399867;95614;
08.02.2019;06:20:04;84495548;84399982;95566;
08.02.2019;06:21:05;84495603;84400115;95488;
08.02.2019;06:22:04;84495663;84400253;95410;
08.02.2019;06:23:05;84495707;84400377;95330;
08.02.2019;06:24:04;84495752;84400511;95241;
08.02.2019;06:25:08;84495795;84400641;95154;
08.02.2019;06:26:05;84495844;84400736;95108;
08.02.2019;06:27:04;84495887;84400868;95019;
08.02.2019;06:28:05;84495939;84400994;94945;
08.02.2019;06:29:04;84495995;84401111;94884;
08.02.2019;06:30:04;84496056;84401241;94815;
08.02.2019;06:31:05;84496111;84401370;94741;
08.02.2019;06:32:04;84496178;84401482;94696;
08.02.2019;06:33:05;84496265;84401589;94676;
08.02.2019;06:34:04;84496327;84401715;94612;
08.02.2019;06:35:04;84496399;84401806;94593;
08.02.2019;06:36:04;84496472;84401965;94507;
08.02.2019;06:37:04;84496527;84402051;94476;
08.02.2019;06:38:05;84496586;84402188;94398;
08.02.2019;06:39:04;84496654;84402324;94330;
08.02.2019;06:40:04;84496722;84402429;94293;
08.02.2019;06:41:05;84496805;84402530;94275;
08.02.2019;06:42:04;84496886;84402659;94227;
08.02.2019;06:43:04;84496957;84402798;94159;
08.02.2019;06:44:04;84497014;84402935;94079;
08.02.2019;06:45:04;84497098;84403060;94038;
08.02.2019;06:46:05;84497170;84403168;94002;
08.02.2019;06:47:04;84497245;84403295;93950;
08.02.2019;06:48:04;84497312;84403428;93884;
08.02.2019;06:49:05;84497368;84403542;93826;
08.02.2019;06:50:04;84497450;84403668;93782;
08.02.2019;06:51:05;84497529;84403802;93727;
08.02.2019;06:52:04;84497594;84403914;93680;
08.02.2019;06:53:04;84497656;84404027;93629;
08.02.2019;06:54:05;84497716;84404153;93563;
08.02.2019;06:55:04;84497782;84404254;93528;
08.02.2019;06:56:04;84497843;84404383;93460;
08.02.2019;06:57:05;84497909;84404483;93426;
08.02.2019;06:58:04;84497980;84404607;93373;
08.02.2019;06:59:08;84498049;84404754;93295;
08.02.2019;07:00:05;84498114;84404869;93245;
08.02.2019;07:01:04;84498203;84404987;93216;
08.02.2019;07:02:04;84498270;84405112;93158;
08.02.2019;07:03:04;84498327;84405228;93099;
08.02.2019;07:04:04;84498372;84405337;93035;
08.02.2019;07:05:05;84498427;84405450;92977;
08.02.2019;07:06:04;84498480;84405547;92933;
08.02.2019;07:07:05;84498513;84405603;92910;
08.02.2019;07:08:05;84498583;84405710;92873;
08.02.2019;07:09:06;84498643;84405811;92832;
08.02.2019;07:10:05;84498699;84405943;92756;
08.02.2019;07:11:04;84498752;84406052;92700;
08.02.2019;07:12:05;84498817;84406133;92684;
08.02.2019;07:13:04;84498862;84406205;92657;
08.02.2019;07:14:04;84498919;84406263;92656;
08.02.2019;07:15:05;84498973;84406367;92606;
08.02.2019;07:16:04;84499046;84406463;92583;
08.02.2019;07:17:05;84499120;84406563;92557;
08.02.2019;07:18:04;84499181;84406661;92520;
08.02.2019;07:19:04;84499231;84406764;92467;
08.02.2019;07:20:05;84499277;84406855;92422;
08.02.2019;07:21:05;84499343;84406953;92390;
08.02.2019;07:22:04;84499400;84407059;92341;
08.02.2019;07:23:05;84499460;84407162;92298;
08.02.2019;07:24:04;84499531;84407269;92262;
08.02.2019;07:25:04;84499594;84407389;92205;
08.02.2019;07:26:04;84499664;84407500;92164;
08.02.2019;07:27:04;84499736;84407621;92115;
08.02.2019;07:28:05;84499811;84407718;92093;
08.02.2019;07:29:04;84499872;84407809;92063;
08.02.2019;07:30:05;84499931;84407914;92017;
08.02.2019;07:31:04;84499987;84408013;91974;
08.02.2019;07:32:04;84500073;84408105;91968;
08.02.2019;07:33:05;84500141;84408192;91949;
08.02.2019;07:34:05;84500186;84408325;91861;
08.02.2019;07:35:04;84500240;84408421;91819;
08.02.2019;07:36:04;84500304;84408543;91761;
08.02.2019;07:37:04;84500341;84408630;91711;
08.02.2019;07:38:04;84500393;84408731;91662;
08.02.2019;07:39:06;84500460;84408868;91592;
08.02.2019;07:40:04;84500516;84408982;91534;
08.02.2019;07:41:05;84500559;84409061;91498;
08.02.2019;07:42:04;84500622;84409198;91424;
08.02.2019;07:43:04;84500694;84409297;91397;
08.02.2019;07:44:04;84500752;84409428;91324;
08.02.2019;07:45:04;84500821;84409542;91279;
08.02.2019;07:46:05;84500876;84409670;91206;
08.02.2019;07:47:04;84500933;84409785;91148;
08.02.2019;07:48:04;84500990;84409904;91086;
08.02.2019;07:49:04;84501041;84410001;91040;
08.02.2019;07:50:07;84501111;84410113;90998;
08.02.2019;07:51:05;84501159;84410225;90934;
08.02.2019;07:52:07;84501210;84410324;90886;
08.02.2019;07:53:04;84501270;84410415;90855;
08.02.2019;07:54:05;84501336;84410507;90829;
08.02.2019;07:55:04;84501391;84410616;90775;
08.02.2019;07:56:05;84501433;84410725;90708;
08.02.2019;07:57:05;84501495;84410800;90695;
08.02.2019;07:58:04;84501570;84410886;90684;
08.02.2019;07:59:05;84501615;84410972;90643;
08.02.2019;08:00:04;84501670;84411087;90583;
08.02.2019;08:01:05;84501718;84411188;90530;
08.02.2019;08:02:07;84501785;84411279;90506;
08.02.2019;08:03:04;84501832;84411369;90463;
08.02.2019;08:04:05;84501893;84411458;90435;
08.02.2019;08:05:04;84501962;84411556;90406;
08.02.2019;08:06:04;84502017;84411647;90370;
08.02.2019;08:07:04;84502070;84411743;90327;
08.02.2019;08:08:05;84502130;84411822;90308;
08.02.2019;08:09:05;84502200;84411921;90279;
08.02.2019;08:10:05;84502260;84412022;90238;
08.02.2019;08:11:05;84502313;84412107;90206;
08.02.2019;08:12:05;84502335;84412222;90113;
08.02.2019;08:13:04;84502369;84412313;90056;
08.02.2019;08:14:05;84502395;84412426;89969;
08.02.2019;08:15:04;84502427;84412482;89945;
08.02.2019;08:16:04;84502452;84412584;89868;
08.02.2019;08:17:05;84502490;84412659;89831;
08.02.2019;08:18:05;84502537;84412722;89815;
08.02.2019;08:19:04;84502567;84412790;89777;
08.02.2019;08:20:05;84502583;84412896;89687;
08.02.2019;08:21:04;84502620;84412988;89632;
08.02.2019;08:22:04;84502655;84413098;89557;
08.02.2019;08:23:05;84502696;84413228;89468;
08.02.2019;08:24:04;84502733;84413324;89409;
08.02.2019;08:25:05;84502786;84413447;89339;
08.02.2019;08:26:05;84502827;84413554;89273;
08.02.2019;08:27:05;84502870;84413678;89192;
08.02.2019;08:28:04;84502920;84413792;89128;
08.02.2019;08:29:05;84502987;84413912;89075;
08.02.2019;08:30:04;84503053;84414001;89052;
08.02.2019;08:31:04;84503103;84414106;88997;
08.02.2019;08:32:05;84503153;84414199;88954;
08.02.2019;08:33:04;84503197;84414319;88878;
08.02.2019;08:34:05;84503239;84414438;88801;
08.02.2019;08:35:04;84503289;84414529;88760;
08.02.2019;08:36:04;84503338;84414624;88714;
08.02.2019;08:37:05;84503388;84414719;88669;
08.02.2019;08:38:04;84503454;84414818;88636;
08.02.2019;08:39:07;84503521;84414910;88611;
08.02.2019;08:40:04;84503591;84415011;88580;
08.02.2019;08:41:04;84503661;84415112;88549;
08.02.2019;08:42:05;84503727;84415219;88508;
08.02.2019;08:43:04;84503792;84415328;88464;
08.02.2019;08:44:04;84503854;84415453;88401;
08.02.2019;08:45:04;84503907;84415569;88338;
08.02.2019;08:46:04;84503953;84415671;88282;
08.02.2019;08:47:05;84504022;84415785;88237;
08.02.2019;08:48:04;84504043;84415882;88161;
08.02.2019;08:49:05;84504105;84415981;88124;
08.02.2019;08:50:04;84504159;84416081;88078;
08.02.2019;08:51:04;84504214;84416192;88022;
08.02.2019;08:52:05;84504269;84416286;87983;
08.02.2019;08:53:04;84504338;84416386;87952;
08.02.2019;08:54:04;84504387;84416505;87882;
08.02.2019;08:55:05;84504445;84416629;87816;
08.02.2019;08:56:04;84504496;84416741;87755;
08.02.2019;08:57:05;84504553;84416869;87684;
08.02.2019;08:58:04;84504612;84417001;87611;
08.02.2019;08:59:04;84504675;84417129;87546;
08.02.2019;09:00:05;84504722;84417245;87477;
08.02.2019;09:01:04;84504772;84417354;87418;
08.02.2019;09:02:05;84504843;84417473;87370;
08.02.2019;09:03:04;84504895;84417593;87302;
08.02.2019;09:04:04;84504963;84417721;87242;
08.02.2019;09:05:05;84505033;84417831;87202;
08.02.2019;09:06:04;84505097;84417942;87155;
08.02.2019;09:07:05;84505164;84418078;87086;
08.02.2019;09:08:04;84505227;84418186;87041;
08.02.2019;09:09:04;84505269;84418308;86961;
08.02.2019;09:10:05;84505337;84418433;86904;
08.02.2019;09:11:04;84505392;84418539;86853;
08.02.2019;09:12:04;84505439;84418665;86774;
08.02.2019;09:13:05;84505499;84418799;86700;
08.02.2019;09:14:04;84505535;84418937;86598;
08.02.2019;09:15:05;84505605;84419070;86535;
08.02.2019;09:16:04;84505650;84419194;86456;
08.02.2019;09:17:05;84505716;84419317;86399;
08.02.2019;09:18:04;84505754;84419431;86323;
08.02.2019;09:19:05;84505809;84419562;86247;
08.02.2019;09:20:04;84505857;84419686;86171;
08.02.2019;09:21:04;84505901;84419812;86089;
08.02.2019;09:22:05;84505969;84419918;86051;
08.02.2019;09:23:04;84506038;84420018;86020;
08.02.2019;09:24:06;84506090;84420123;85967;
08.02.2019;09:25:04;84506146;84420217;85929;
08.02.2019;09:26:05;84506197;84420320;85877;
08.02.2019;09:27:04;84506251;84420414;85837;
08.02.2019;09:28:04;84506311;84420535;85776;
08.02.2019;09:29:05;84506367;84420640;85727;
08.02.2019;09:30:04;84506428;84420743;85685;
08.02.2019;09:31:05;84506477;84420860;85617;
08.02.2019;09:32:04;84506525;84420976;85549;
08.02.2019;09:33:04;84506563;84421085;85478;
08.02.2019;09:34:04;84506617;84421186;85431;
08.02.2019;09:35:04;84506686;84421288;85398;
08.02.2019;09:36:04;84506748;84421393;85355;
08.02.2019;09:37:05;84506809;84421496;85313;
08.02.2019;09:38:04;84506866;84421595;85271;
08.02.2019;09:39:04;84506920;84421684;85236;
08.02.2019;09:40:05;84506979;84421790;85189;
08.02.2019;09:41:04;84507035;84421887;85148;
08.02.2019;09:42:05;84507094;84421991;85103;
08.02.2019;09:43:05;84507160;84422096;85064;
08.02.2019;09:44:05;84507215;84422200;85015;
08.02.2019;09:45:04;84507267;84422308;84959;
08.02.2019;09:46:05;84507311;84422405;84906;
08.02.2019;09:47:04;84507364;84422513;84851;
08.02.2019;09:48:04;84507412;84422630;84782;
08.02.2019;09:49:05;84507458;84422741;84717;
08.02.2019;09:50:04;84507520;84422850;84670;
08.02.2019;09:51:04;84507590;84422958;84632;
08.02.2019;09:52:05;84507650;84423072;84578;
08.02.2019;09:53:04;84507697;84423192;84505;
08.02.2019;09:54:05;84507762;84423290;84472;
08.02.2019;09:55:04;84507819;84423391;84428;
08.02.2019;09:56:04;84507876;84423497;84379;
08.02.2019;09:57:05;84507958;84423597;84361;
08.02.2019;09:58:04;84508022;84423709;84313;
08.02.2019;09:59:05;84508075;84423801;84274;
08.02.2019;10:00:04;84508128;84423908;84220;
08.02.2019;10:01:04;84508180;84424007;84173;
08.02.2019;10:02:05;84508214;84424031;84183;
08.02.2019;10:03:04;84508257;84424133;84124;
08.02.2019;10:04:05;84508304;84424263;84041;
08.02.2019;10:05:04;84508350;84424366;83984;
08.02.2019;10:06:05;84508412;84424483;83929;
08.02.2019;10:07:05;84508461;84424583;83878;
08.02.2019;10:08:04;84508521;84424689;83832;
08.02.2019;10:09:07;84508564;84424781;83783;
08.02.2019;10:10:04;84508630;84424859;83771;
08.02.2019;10:11:05;84508685;84424982;83703;
08.02.2019;10:12:04;84508721;84425088;83633;
08.02.2019;10:13:04;84508762;84425185;83577;
08.02.2019;10:14:04;84508803;84425275;83528;
08.02.2019;10:15:05;84508836;84425378;83458;
08.02.2019;10:16:04;84508862;84425481;83381;
08.02.2019;10:17:04;84508901;84425578;83323;
08.02.2019;10:18:04;84508938;84425680;83258;
08.02.2019;10:19:05;84508961;84425774;83187;
08.02.2019;10:20:04;84509005;84425879;83126;
08.02.2019;10:21:05;84509010;84425952;83058;
08.02.2019;10:22:04;84509025;84426043;82982;
08.02.2019;10:23:04;84509055;84426159;82896;
08.02.2019;10:24:05;84509115;84426287;82828;
08.02.2019;10:25:04;84509152;84426399;82753;
08.02.2019;10:26:04;84509209;84426507;82702;
08.02.2019;10:27:05;84509251;84426604;82647;
08.02.2019;10:28:04;84509298;84426697;82601;
08.02.2019;10:29:04;84509359;84426820;82539;
08.02.2019;10:30:05;84509415;84426935;82480;
08.02.2019;10:31:04;84509474;84427068;82406;
08.02.2019;10:32:04;84509541;84427181;82360;
08.02.2019;10:33:05;84509603;84427291;82312;
08.02.2019;10:34:04;84509665;84427411;82254;
08.02.2019;10:35:05;84509710;84427500;82210;
08.02.2019;10:36:04;84509747;84427625;82122;
08.02.2019;10:37:04;84509802;84427731;82071;
08.02.2019;10:38:05;84509864;84427855;82009;
08.02.2019;10:39:06;84509906;84427974;81932;
08.02.2019;10:40:05;84509953;84428094;81859;
08.02.2019;10:41:04;84510007;84428201;81806;
08.02.2019;10:42:04;84510063;84428334;81729;
08.02.2019;10:43:04;84510132;84428444;81688;
08.02.2019;10:44:04;84510171;84428553;81618;
08.02.2019;10:45:05;84510238;84428707;81531;
08.02.2019;10:46:04;84510283;84428796;81487;
08.02.2019;10:47:04;84510339;84428924;81415;
08.02.2019;10:48:05;84510395;84429049;81346;
08.02.2019;10:49:04;84510464;84429173;81291;
08.02.2019;10:50:04;84510512;84429296;81216;
08.02.2019;10:51:05;84510573;84429421;81152;
08.02.2019;10:52:04;84510616;84429562;81054;
08.02.2019;10:53:05;84510658;84429703;80955;
08.02.2019;10:54:04;84510712;84429839;80873;
08.02.2019;10:55:04;84510774;84429987;80787;
08.02.2019;10:56:05;84510823;84430105;80718;
08.02.2019;10:57:04;84510895;84430217;80678;
08.02.2019;10:58:05;84510943;84430354;80589;
08.02.2019;10:59:04;84511001;84430488;80513;
08.02.2019;11:00:04;84511064;84430601;80463;
08.02.2019;11:01:05;84511124;84430751;80373;
08.02.2019;11:02:04;84511178;84430869;80309;
08.02.2019;11:03:04;84511230;84431008;80222;
08.02.2019;11:04:05;84511279;84431147;80132;
08.02.2019;11:05:04;84511334;84431265;80069;
08.02.2019;11:06:05;84511386;84431382;80004;
08.02.2019;11:07:04;84511443;84431506;79937;
08.02.2019;11:08:04;84511497;84431638;79859;
08.02.2019;11:09:06;84511566;84431737;79829;
08.02.2019;11:10:04;84511622;84431880;79742;
08.02.2019;11:11:05;84511662;84431990;79672;
08.02.2019;11:12:04;84511706;84432107;79599;
08.02.2019;11:13:05;84511758;84432224;79534;
08.02.2019;11:14:04;84511801;84432333;79468;
08.02.2019;11:15:04;84511850;84432420;79430;
08.02.2019;11:16:04;84511907;84432547;79360;
08.02.2019;11:17:04;84511940;84432673;79267;
08.02.2019;11:18:05;84511986;84432786;79200;
08.02.2019;11:19:04;84512051;84432916;79135;
08.02.2019;11:20:04;84512102;84433048;79054;
08.02.2019;11:21:05;84512162;84433181;78981;
08.02.2019;11:22:04;84512215;84433315;78900;
08.02.2019;11:23:04;84512258;84433430;78828;
08.02.2019;11:24:05;84512314;84433538;78776;
08.02.2019;11:25:04;84512364;84433657;78707;
08.02.2019;11:26:05;84512418;84433776;78642;
08.02.2019;11:27:04;84512465;84433887;78578;
08.02.2019;11:28:04;84512520;84434024;78496;
08.02.2019;11:29:05;84512563;84434151;78412;
08.02.2019;11:30:04;84512608;84434248;78360;
08.02.2019;11:31:05;84512667;84434357;78310;
08.02.2019;11:32:04;84512726;84434460;78266;
08.02.2019;11:33:04;84512779;84434580;78199;
08.02.2019;11:34:05;84512830;84434712;78118;
08.02.2019;11:35:04;84512897;84434856;78041;
08.02.2019;11:36:04;84512948;84434976;77972;
08.02.2019;11:37:05;84513012;84435100;77912;
08.02.2019;11:38:04;84513063;84435203;77860;
08.02.2019;11:39:06;84513110;84435339;77771;
08.02.2019;11:40:04;84513158;84435457;77701;
08.02.2019;11:41:05;84513217;84435586;77631;
08.02.2019;11:42:04;84513270;84435685;77585;
08.02.2019;11:43:04;84513344;84435817;77527;
08.02.2019;11:44:04;84513425;84435940;77485;
08.02.2019;11:45:04;84513495;84436038;77457;
08.02.2019;11:46:05;84513565;84436176;77389;
08.02.2019;11:47:04;84513606;84436314;77292;
08.02.2019;11:48:05;84513656;84436445;77211;
08.02.2019;11:49:04;84513708;84436551;77157;
08.02.2019;11:50:04;84513762;84436668;77094;
08.02.2019;11:51:05;84513806;84436794;77012;
08.02.2019;11:52:04;84513870;84436885;76985;
08.02.2019;11:53:05;84513930;84436998;76932;
08.02.2019;11:54:04;84514000;84437146;76854;
08.02.2019;11:55:05;84514064;84437276;76788;
08.02.2019;11:56:04;84514130;84437429;76701;
08.02.2019;11:57:04;84514188;84437571;76617;
08.02.2019;11:58:05;84514245;84437730;76515;
08.02.2019;11:59:04;84514289;84437849;76440;
08.02.2019;12:00:05;84514353;84437964;76389;
08.02.2019;12:01:04;84514416;84438063;76353;
08.02.2019;12:02:04;84514470;84438207;76263;
08.02.2019;12:03:05;84514528;84438325;76203;
08.02.2019;12:04:04;84514589;84438461;76128;
08.02.2019;12:05:05;84514641;84438578;76063;
08.02.2019;12:06:04;84514710;84438704;76006;
08.02.2019;12:07:04;84514732;84438791;75941;
08.02.2019;12:08:05;84514778;84438900;75878;
08.02.2019;12:09:06;84514811;84439019;75792;
08.02.2019;12:10:05;84514872;84439122;75750;
08.02.2019;12:11:04;84514902;84439229;75673;
08.02.2019;12:12:04;84514890;84439266;75624;
08.02.2019;12:13:04;84514929;84439315;75614;
08.02.2019;12:14:04;84514992;84439426;75566;
08.02.2019;12:15:05;84515065;84439530;75535;
08.02.2019;12:16:04;84515121;84439645;75476;
08.02.2019;12:17:05;84515168;84439763;75405;
08.02.2019;12:18:05;84515220;84439889;75331;
08.02.2019;12:19:04;84515288;84440022;75266;
08.02.2019;12:21:04;84515421;84440271;75150;
08.02.2019;12:22:05;84515493;84440412;75081;
08.02.2019;12:23:04;84515544;84440527;75017;
08.02.2019;12:24:05;84515590;84440657;74933;
08.02.2019;12:25:05;84515632;84440799;74833;
08.02.2019;12:26:04;84515686;84440912;74774;
08.02.2019;12:27:05;84515734;84441016;74718;
08.02.2019;12:28:04;84515799;84441153;74646;
08.02.2019;12:29:04;84515864;84441283;74581;
08.02.2019;12:30:05;84515933;84441393;74540;
08.02.2019;12:31:04;84516027;84441500;74527;
08.02.2019;12:32:05;84516104;84441654;74450;
08.02.2019;12:33:04;84516168;84441780;74388;
08.02.2019;12:34:04;84516221;84441880;74341;
08.02.2019;12:35:05;84516287;84441991;74296;
08.02.2019;12:36:04;84516369;84442094;74275;
08.02.2019;12:37:04;84516436;84442208;74228;
08.02.2019;12:38:05;84516495;84442347;74148;
08.02.2019;12:39:06;84516538;84442467;74071;
08.02.2019;12:40:04;84516604;84442616;73988;
08.02.2019;12:41:04;84516658;84442752;73906;
08.02.2019;12:42:05;84516727;84442868;73859;
08.02.2019;12:43:04;84516794;84443007;73787;
08.02.2019;12:44:05;84516865;84443148;73717;
08.02.2019;12:45:05;84516942;84443252;73690;
08.02.2019;12:46:05;84517018;84443390;73628;
08.02.2019;12:47:04;84517091;84443514;73577;
08.02.2019;12:48:05;84517166;84443631;73535;
08.02.2019;12:49:04;84517252;84443738;73514;
08.02.2019;12:50:04;84517318;84443876;73442;
08.02.2019;12:51:04;84517416;84444005;73411;
08.02.2019;12:52:05;84517494;84444141;73353;
08.02.2019;12:53:04;84517566;84444268;73298;
08.02.2019;12:54:04;84517650;84444380;73270;
08.02.2019;12:55:05;84517748;84444525;73223;
08.02.2019;12:56:04;84517830;84444668;73162;
08.02.2019;12:57:04;84517920;84444803;73117;
08.02.2019;12:58:05;84518023;84444934;73089;
08.02.2019;12:59:04;84518085;84445063;73022;
08.02.2019;13:00:05;84518154;84445195;72959;
08.02.2019;13:01:04;84518242;84445327;72915;
08.02.2019;13:02:04;84518317;84445481;72836;
08.02.2019;13:03:04;84518382;84445621;72761;
08.02.2019;13:04:05;84518460;84445754;72706;
08.02.2019;13:05:04;84518535;84445907;72628;
08.02.2019;13:06:04;84518613;84446071;72542;
08.02.2019;13:07:05;84518672;84446216;72456;
08.02.2019;13:08:04;84518543;84445921;72622;
08.02.2019;13:09:07;84518280;84445180;73100;
08.02.2019;13:10:05;84518356;84445297;73059;
08.02.2019;13:11:04;84518423;84445403;73020;
08.02.2019;13:12:05;84518528;84445559;72969;
08.02.2019;13:13:05;84518622;84445692;72930;
08.02.2019;13:14:04;84518685;84445849;72836;
08.02.2019;13:15:05;84518765;84446012;72753;
08.02.2019;13:16:04;84518856;84446137;72719;
08.02.2019;13:17:04;84518932;84446277;72655;
08.02.2019;13:18:05;84519022;84446400;72622;
08.02.2019;13:19:05;84519108;84446532;72576;
08.02.2019;13:20:05;84519211;84446666;72545;
08.02.2019;13:21:04;84519279;84446809;72470;
08.02.2019;13:22:04;84519359;84446950;72409;
08.02.2019;13:23:04;84519449;84447073;72376;
08.02.2019;13:24:05;84519541;84447217;72324;
08.02.2019;13:25:04;84519626;84447334;72292;
08.02.2019;13:26:05;84519709;84447485;72224;
08.02.2019;13:27:04;84519778;84447625;72153;
08.02.2019;13:28:04;84519855;84447771;72084;
08.02.2019;13:29:05;84519953;84447918;72035;
08.02.2019;13:30:05;84520050;84448040;72010;
08.02.2019;13:31:04;84520154;84448201;71953;
08.02.2019;13:32:04;84520252;84448340;71912;
08.02.2019;13:33:05;84520327;84448467;71860;
08.02.2019;13:34:05;84520397;84448607;71790;
08.02.2019;13:35:04;84520478;84448753;71725;
08.02.2019;13:36:07;84520570;84448899;71671;
08.02.2019;13:37:04;84520673;84448997;71676;
08.02.2019;13:38:05;84520749;84449111;71638;
08.02.2019;13:39:06;84520851;84449287;71564;
08.02.2019;13:40:04;84520930;84449422;71508;
08.02.2019;13:41:04;84521030;84449571;71459;
08.02.2019;13:42:05;84521131;84449703;71428;
08.02.2019;13:43:04;84521222;84449865;71357;
08.02.2019;13:44:05;84521312;84450008;71304;
08.02.2019;13:45:04;84521395;84450150;71245;
08.02.2019;13:46:04;84521490;84450307;71183;
08.02.2019;13:47:05;84521603;84450454;71149;
08.02.2019;13:48:04;84521693;84450606;71087;
08.02.2019;13:49:05;84521804;84450707;71097;
08.02.2019;13:50:05;84521877;84450841;71036;
08.02.2019;13:51:05;84521956;84450976;70980;
08.02.2019;13:52:04;84522050;84451139;70911;
08.02.2019;13:53:04;84522135;84451277;70858;
08.02.2019;13:54:05;84522238;84451428;70810;
08.02.2019;13:55:04;84522330;84451561;70769;
08.02.2019;13:56:05;84522422;84451721;70701;
08.02.2019;13:57:06;84522510;84451856;70654;
08.02.2019;13:58:04;84522602;84451990;70612;
08.02.2019;13:59:04;84522685;84452124;70561;
08.02.2019;14:00:05;84522787;84452283;70504;
08.02.2019;14:01:04;84522898;84452415;70483;
08.02.2019;14:02:04;84522992;84452568;70424;
08.02.2019;14:03:05;84523106;84452725;70381;
08.02.2019;14:04:04;84523201;84452885;70316;
08.02.2019;14:05:05;84523279;84453047;70232;
08.02.2019;14:06:05;84523383;84453207;70176;
08.02.2019;14:07:05;84523482;84453332;70150;
08.02.2019;14:08:04;84523562;84453474;70088;
08.02.2019;14:09:06;84523622;84453613;70009;
08.02.2019;14:10:05;84523683;84453756;69927;
08.02.2019;14:11:04;84523769;84453884;69885;
08.02.2019;14:12:05;84523845;84454009;69836;
08.02.2019;14:13:05;84523917;84454141;69776;
08.02.2019;14:14:05;84523938;84454259;69679;
08.02.2019;14:15:04;84524067;84454388;69679;
08.02.2019;14:16:04;84524157;84454534;69623;
08.02.2019;14:17:04;84524209;84454667;69542;
08.02.2019;15:06:14;84528845;84462076;66769;
08.02.2019;15:07:10;84528931;84462229;66702;
08.02.2019;15:08:11;84529036;84462389;66647;
08.02.2019;15:09:16;84529160;84462575;66585;
08.02.2019;15:10:11;84529253;84462726;66527;
08.02.2019;15:11:14;84529331;84462892;66439;
08.02.2019;15:12:14;84529449;84463032;66417;
08.02.2019;15:13:15;84529550;84463201;66349;
08.02.2019;15:14:16;84529642;84463387;66255;
08.02.2019;15:15:15;84529756;84463539;66217;
08.02.2019;15:16:15;84529888;84463688;66200;
08.02.2019;15:17:17;84529984;84463868;66116;
08.02.2019;15:18:15;84530082;84464011;66071;
08.02.2019;15:19:20;84530209;84464178;66031;
08.02.2019;15:20:16;84530307;84464327;65980;
08.02.2019;15:21:19;84530433;84464482;65951;
08.02.2019;15:22:16;84530547;84464638;65909;
08.02.2019;15:23:20;84530644;84464831;65813;
08.02.2019;15:24:19;84530733;84465001;65732;
08.02.2019;15:25:18;84530858;84465168;65690;
08.02.2019;15:26:20;84530969;84465346;65623;
08.02.2019;15:27:19;84531075;84465505;65570;
08.02.2019;15:28:19;84531188;84465678;65510;
08.02.2019;15:29:22;84531294;84465867;65427;
08.02.2019;15:30:20;84531407;84466071;65336;
08.02.2019;15:31:21;84531510;84466234;65276;
08.02.2019;15:32:18;84531600;84466373;65227;
08.02.2019;15:33:22;84531730;84466584;65146;
08.02.2019;15:34:23;84531856;84466765;65091;
08.02.2019;15:35:19;84531989;84466918;65071;
08.02.2019;15:36:23;84532113;84467088;65025;
08.02.2019;15:37:21;84532228;84467252;64976;
08.02.2019;15:38:20;84532323;84467431;64892;
08.02.2019;15:39:23;84532430;84467611;64819;
08.02.2019;15:40:20;84532542;84467804;64738;
08.02.2019;15:41:25;84532649;84467970;64679;
08.02.2019;15:42:25;84532758;84468142;64616;
08.02.2019;15:43:21;84532879;84468332;64547;
08.02.2019;15:44:24;84532999;84468510;64489;
08.02.2019;15:45:25;84533107;84468681;64426;
08.02.2019;15:46:23;84533241;84468833;64408;
08.02.2019;15:47:26;84533371;84469019;64352;
08.02.2019;15:48:25;84533481;84469179;64302;
08.02.2019;15:49:22;84533555;84469321;64234;
08.02.2019;15:50:27;84533716;84469483;64233;
08.02.2019;15:52:23;84533961;84469805;64156;
08.02.2019;15:53:26;84534077;84469981;64096;
08.02.2019;15:54:25;84534218;84470159;64059;
08.02.2019;15:55:25;84534323;84470321;64002;
08.02.2019;15:56:33;84534455;84470516;63939;
08.02.2019;15:57:29;84534563;84470667;63896;
08.02.2019;15:58:34;84534684;84470857;63827;
08.02.2019;15:59:28;84534780;84471019;63761;
08.02.2019;16:00:25;84534888;84471186;63702;
08.02.2019;16:01:19;84534998;84471320;63678;
08.02.2019;16:02:17;84535101;84471473;63628;
08.02.2019;16:03:06;84535144;84471605;63539;
08.02.2019;16:04:08;84535306;84471799;63507;
08.02.2019;16:05:05;84535419;84471953;63466;
08.02.2019;16:06:06;84535525;84472175;63350;
08.02.2019;16:07:05;84535637;84472351;63286;
08.02.2019;16:08:08;84535731;84472555;63176;
08.02.2019;16:09:07;84535842;84472709;63133;
08.02.2019;16:10:04;84535915;84472877;63038;
08.02.2019;16:11:05;84536014;84472987;63027;
08.02.2019;16:12:08;84536089;84473146;62943;
08.02.2019;16:13:05;84536199;84473286;62913;
08.02.2019;16:14:05;84536293;84473435;62858;
08.02.2019;16:15:05;84536381;84473597;62784;
08.02.2019;16:16:07;84536451;84473698;62753;
08.02.2019;16:17:05;84536518;84473846;62672;
08.02.2019;16:18:05;84536594;84474030;62564;
08.02.2019;16:19:05;84536680;84474154;62526;
08.02.2019;16:20:04;84536763;84474307;62456;
08.02.2019;16:21:08;84536855;84474466;62389;
08.02.2019;16:22:05;84536921;84474603;62318;
08.02.2019;16:23:04;84537014;84474745;62269;
08.02.2019;16:24:04;84537101;84474893;62208;
08.02.2019;16:25:08;84537219;84475071;62148;
08.02.2019;16:26:05;84537310;84475240;62070;
08.02.2019;16:27:05;84537410;84475383;62027;
08.02.2019;16:28:04;84537496;84475525;61971;
08.02.2019;16:29:08;84537638;84475662;61976;
08.02.2019;16:30:04;84537716;84475825;61891;
08.02.2019;16:31:05;84537811;84475967;61844;
08.02.2019;16:32:05;84537911;84476126;61785;
08.02.2019;16:33:08;84538038;84476288;61750;
08.02.2019;16:34:05;84538133;84476440;61693;
08.02.2019;16:35:06;84538228;84476616;61612;
08.02.2019;16:36:06;84538359;84476786;61573;
08.02.2019;16:37:08;84538465;84476970;61495;
08.02.2019;16:38:05;84538581;84477143;61438;
08.02.2019;16:39:06;84538686;84477267;61419;
08.02.2019;16:40:06;84538812;84477462;61350;
08.02.2019;16:41:04;84538943;84477623;61320;
08.02.2019;16:42:07;84539050;84477823;61227;
08.02.2019;16:43:05;84539162;84478001;61161;
08.02.2019;16:44:05;84539300;84478150;61150;
08.02.2019;16:45:05;84539430;84478339;61091;
08.02.2019;16:46:08;84539565;84478517;61048;
08.02.2019;16:47:05;84539677;84478676;61001;
08.02.2019;16:48:06;84539781;84478861;60920;
08.02.2019;16:49:05;84539942;84479025;60917;
08.02.2019;16:50:08;84540068;84479242;60826;
08.02.2019;16:51:05;84540183;84479394;60789;
08.02.2019;16:52:04;84540285;84479548;60737;
08.02.2019;16:53:04;84540422;84479715;60707;
08.02.2019;16:54:10;84540535;84479918;60617;
08.02.2019;16:55:05;84540667;84480065;60602;
08.02.2019;16:56:05;84540800;84480246;60554;
08.02.2019;16:57:05;84540913;84480417;60496;
08.02.2019;16:58:09;84541042;84480590;60452;
08.02.2019;16:59:05;84541172;84480746;60426;
08.02.2019;17:00:05;84541280;84480903;60377;
08.02.2019;17:01:05;84541418;84481047;60371;
08.02.2019;17:02:08;84541538;84481211;60327;
08.02.2019;17:03:05;84541654;84481361;60293;
08.02.2019;17:04:05;84541759;84481506;60253;
08.02.2019;17:05:05;84541878;84481697;60181;
08.02.2019;17:06:05;84541998;84481898;60100;
08.02.2019;17:07:07;84542126;84482054;60072;
08.02.2019;17:08:04;84542259;84482207;60052;
08.02.2019;17:09:05;84542355;84482365;59990;
08.02.2019;17:10:05;84542470;84482565;59905;
08.02.2019;17:11:08;84542607;84482727;59880;
08.02.2019;17:12:04;84542706;84482868;59838;
08.02.2019;17:13:10;84542821;84483050;59771;
08.02.2019;17:14:05;84542925;84483219;59706;
08.02.2019;17:15:08;84543060;84483399;59661;
08.02.2019;17:16:05;84543170;84483571;59599;
08.02.2019;17:17:05;84543278;84483749;59529;
08.02.2019;17:18:05;84543382;84483947;59435;
08.02.2019;17:19:09;84543511;84484121;59390;
08.02.2019;17:20:05;84543650;84484322;59328;
08.02.2019;17:21:04;84543774;84484493;59281;
08.02.2019;17:22:04;84543887;84484696;59191;
08.02.2019;17:23:08;84544001;84484872;59129;
08.02.2019;17:24:05;84544132;84485041;59091;
08.02.2019;17:25:05;84544246;84485221;59025;
08.02.2019;17:27:08;84544435;84485618;58817;
08.02.2019;17:28:04;84544591;84485776;58815;
08.02.2019;17:29:05;84544690;84485956;58734;
08.02.2019;17:30:05;84544809;84486148;58661;
08.02.2019;17:31:07;84544933;84486300;58633;
08.02.2019;17:32:04;84545062;84486460;58602;
08.02.2019;17:33:05;84545176;84486630;58546;
08.02.2019;17:34:05;84545281;84486796;58485;
08.02.2019;17:35:05;84545386;84487000;58386;
08.02.2019;17:36:08;84545502;84487183;58319;
08.02.2019;17:37:05;84545625;84487351;58274;
08.02.2019;17:38:05;84545723;84487503;58220;
08.02.2019;17:39:05;84545833;84487694;58139;
08.02.2019;17:40:08;84545958;84487881;58077;
08.02.2019;17:41:05;84546101;84488064;58037;
08.02.2019;17:42:05;84546202;84488207;57995;
08.02.2019;17:43:05;84546373;84488379;57994;
08.02.2019;17:44:08;84546500;84488563;57937;
08.02.2019;17:45:05;84546636;84488732;57904;
08.02.2019;17:46:05;84546782;84488899;57883;
08.02.2019;17:47:04;84546851;84489069;57782;
08.02.2019;17:48:07;84547034;84489214;57820;
08.02.2019;17:49:05;84547146;84489389;57757;
08.02.2019;17:50:05;84547269;84489548;57721;
08.02.2019;17:51:05;84547387;84489715;57672;
08.02.2019;17:52:08;84547497;84489899;57598;
08.02.2019;17:53:05;84547607;84490049;57558;
08.02.2019;17:54:05;84547736;84490222;57514;
08.02.2019;17:55:04;84547842;84490398;57444;
08.02.2019;17:56:08;84547975;84490569;57406;
08.02.2019;17:57:04;84548090;84490711;57379;
08.02.2019;17:58:06;84548210;84490877;57333;
08.02.2019;17:59:06;84548317;84491045;57272;
08.02.2019;18:00:06;84548438;84491211;57227;
08.02.2019;18:01:05;84548546;84491366;57180;
08.02.2019;18:02:06;84548668;84491549;57119;
08.02.2019;18:03:06;84548811;84491701;57110;
08.02.2019;18:04:05;84548931;84491865;57066;
08.02.2019;18:05:07;84549084;84492042;57042;
08.02.2019;18:06:05;84549201;84492197;57004;
08.02.2019;18:07:05;84549329;84492370;56959;
08.02.2019;18:08:06;84549435;84492520;56915;
08.02.2019;18:09:10;84549577;84492690;56887;
08.02.2019;18:10:05;84549696;84492876;56820;
08.02.2019;18:11:05;84549797;84493037;56760;
08.02.2019;18:12:07;84549924;84493205;56719;
08.02.2019;18:13:04;84550003;84493358;56645;
08.02.2019;18:14:05;84550092;84493530;56562;
08.02.2019;18:15:05;84550208;84493676;56532;
08.02.2019;18:16:06;84550338;84493837;56501;
08.02.2019;18:17:05;84550441;84493958;56483;
08.02.2019;18:18:09;84550554;84494117;56437;
08.02.2019;18:19:04;84550658;84494242;56416;
08.02.2019;18:20:05;84550765;84494430;56335;
08.02.2019;18:21:08;84550870;84494591;56279;
08.02.2019;18:22:04;84550937;84494687;56250;
08.02.2019;18:23:05;84551033;84494826;56207;
08.02.2019;18:24:04;84551126;84494963;56163;
08.02.2019;18:25:07;84551242;84495094;56148;
08.02.2019;18:26:05;84551351;84495192;56159;
08.02.2019;18:27:04;84551459;84495371;56088;
08.02.2019;18:28:05;84551560;84495512;56048;
08.02.2019;18:29:08;84551675;84495665;56010;
08.02.2019;18:30:05;84551777;84495803;55974;
08.02.2019;18:31:04;84551883;84495939;55944;
08.02.2019;18:32:04;84551986;84496051;55935;
08.02.2019;18:33:08;84552116;84496175;55941;
08.02.2019;18:34:05;84552204;84496290;55914;
08.02.2019;18:35:05;84552296;84496412;55884;
08.02.2019;18:36:04;84552416;84496543;55873;
08.02.2019;18:37:07;84552521;84496657;55864;
08.02.2019;18:38:05;84552614;84496784;55830;
08.02.2019;18:39:05;84552710;84496949;55761;
08.02.2019;18:40:04;84552835;84497066;55769;
08.02.2019;18:41:08;84552961;84497209;55752;
08.02.2019;18:42:05;84553092;84497350;55742;
08.02.2019;18:43:05;84553211;84497466;55745;
08.02.2019;18:44:04;84553342;84497596;55746;
08.02.2019;18:45:06;84553460;84497718;55742;
08.02.2019;18:46:04;84553585;84497867;55718;
08.02.2019;18:47:04;84553714;84498014;55700;
08.02.2019;18:48:05;84553845;84498147;55698;
08.02.2019;18:49:05;84553952;84498277;55675;
08.02.2019;18:50:08;84554069;84498394;55675;
08.02.2019;18:51:05;84554195;84498533;55662;
08.02.2019;18:52:05;84554289;84498656;55633;
08.02.2019;18:53:05;84554404;84498779;55625;
08.02.2019;18:54:08;84554533;84498912;55621;
08.02.2019;18:55:05;84554622;84499049;55573;
08.02.2019;18:56:04;84554733;84499160;55573;
08.02.2019;18:57:04;84554857;84499285;55572;
08.02.2019;18:58:08;84554974;84499444;55530;
08.02.2019;18:59:05;84555059;84499565;55494;
08.02.2019;19:00:08;84555167;84499692;55475;
08.02.2019;19:01:06;84555242;84499825;55417;
08.02.2019;19:02:08;84555356;84499962;55394;
08.02.2019;19:03:06;84555465;84500092;55373;
08.02.2019;19:04:05;84555571;84500210;55361;
08.02.2019;19:05:06;84555682;84500340;55342;
08.02.2019;19:06:07;84555798;84500451;55347;
08.02.2019;19:07:04;84555887;84500578;55309;
08.02.2019;19:08:06;84556032;84500693;55339;
08.02.2019;19:09:08;84556152;84500792;55360;
08.02.2019;19:10:08;84556251;84500923;55328;
08.02.2019;19:11:06;84556336;84501032;55304;
08.02.2019;19:12:05;84556458;84501141;55317;
08.02.2019;19:13:06;84556569;84501248;55321;
08.02.2019;19:14:06;84556633;84501277;55356;
08.02.2019;19:15:06;84556731;84501404;55327;
08.02.2019;19:16:05;84556833;84501522;55311;
08.02.2019;19:17:06;84556902;84501633;55269;
08.02.2019;19:18:06;84557005;84501750;55255;
08.02.2019;19:19:08;84557100;84501872;55228;
08.02.2019;19:20:05;84557195;84501965;55230;
08.02.2019;19:21:05;84557318;84502096;55222;
08.02.2019;19:22:05;84557395;84502209;55186;
08.02.2019;19:23:07;84557501;84502328;55173;
08.02.2019;19:24:04;84557591;84502429;55162;
08.02.2019;19:25:05;84557718;84502544;55174;
08.02.2019;19:26:05;84557833;84502640;55193;
08.02.2019;19:27:08;84557970;84502751;55219;
08.02.2019;19:28:05;84558057;84502879;55178;
08.02.2019;19:29:04;84558152;84502976;55176;
08.02.2019;19:30:05;84558261;84503077;55184;
08.02.2019;19:31:09;84558389;84503181;55208;
08.02.2019;19:32:05;84558471;84503274;55197;
08.02.2019;19:33:05;84558602;84503373;55229;
08.02.2019;19:34:05;84558705;84503479;55226;
08.02.2019;19:35:08;84558809;84503591;55218;
08.02.2019;19:36:05;84558931;84503691;55240;
08.02.2019;19:37:05;84559065;84503787;55278;
08.02.2019;19:38:05;84559169;84503884;55285;
08.02.2019;19:39:07;84559289;84503991;55298;
08.02.2019;19:40:04;84559400;84504086;55314;
08.02.2019;19:41:06;84559526;84504175;55351;
08.02.2019;19:42:06;84559631;84504273;55358;
08.02.2019;19:43:07;84559746;84504384;55362;
08.02.2019;19:44:05;84559856;84504467;55389;
08.02.2019;19:45:06;84559960;84504570;55390;
08.02.2019;19:46:05;84560064;84504674;55390;
08.02.2019;19:47:05;84560142;84504754;55388;
08.02.2019;19:48:08;84560248;84504841;55407;
08.02.2019;19:49:06;84560349;84504931;55418;
08.02.2019;19:50:05;84560435;84505012;55423;
08.02.2019;19:51:05;84560540;84505102;55438;
08.02.2019;19:52:07;84560645;84505198;55447;
08.02.2019;19:53:05;84560736;84505283;55453;
08.02.2019;19:54:05;84560828;84505374;55454;
08.02.2019;19:55:05;84560954;84505475;55479;
08.02.2019;19:56:08;84561078;84505562;55516;
08.02.2019;19:57:05;84561199;84505655;55544;
08.02.2019;19:58:05;84561290;84505743;55547;
08.02.2019;19:59:05;84561407;84505822;55585;
08.02.2019;20:00:07;84561454;84505925;55529;
08.02.2019;20:01:04;84561580;84506010;55570;
08.02.2019;20:02:04;84561689;84506101;55588;
08.02.2019;20:03:05;84561776;84506192;55584;
08.02.2019;20:04:08;84561879;84506289;55590;
08.02.2019;20:05:05;84561980;84506355;55625;
08.02.2019;20:06:04;84562098;84506443;55655;
08.02.2019;20:07:04;84562223;84506518;55705;
08.02.2019;20:08:08;84562349;84506612;55737;
08.02.2019;20:09:07;84562458;84506690;55768;
08.02.2019;20:10:05;84562545;84506778;55767;
08.02.2019;20:11:05;84562652;84506842;55810;
08.02.2019;20:12:07;84562771;84506945;55826;
08.02.2019;20:13:04;84562867;84507019;55848;
08.02.2019;20:14:05;84562976;84507081;55895;
08.02.2019;20:15:05;84563075;84507149;55926;
08.02.2019;20:16:07;84563168;84507219;55949;
08.02.2019;20:17:05;84563226;84507290;55936;
08.02.2019;20:18:05;84563330;84507337;55993;
08.02.2019;20:19:04;84563404;84507390;56014;
08.02.2019;20:20:04;84563481;84507445;56036;
08.02.2019;20:21:06;84563589;84507499;56090;
08.02.2019;20:22:05;84563661;84507558;56103;
08.02.2019;20:23:06;84563737;84507619;56118;
08.02.2019;20:24:06;84563823;84507693;56130;
08.02.2019;20:25:08;84563906;84507752;56154;
08.02.2019;20:26:05;84564000;84507801;56199;
08.02.2019;20:27:05;84564100;84507871;56229;
08.02.2019;20:28:05;84564177;84507916;56261;
08.02.2019;20:29:08;84564275;84507981;56294;
08.02.2019;20:30:04;84564380;84508038;56342;
08.02.2019;20:31:05;84564458;84508091;56367;
08.02.2019;20:32:06;84564553;84508151;56402;
08.02.2019;20:33:08;84564687;84508247;56440;
08.02.2019;20:34:06;84564766;84508300;56466;
08.02.2019;20:35:05;84564877;84508353;56524;
08.02.2019;20:36:06;84564974;84508415;56559;
08.02.2019;20:37:09;84565094;84508472;56622;
08.02.2019;20:38:05;84565180;84508517;56663;
08.02.2019;20:39:05;84565293;84508582;56711;
08.02.2019;20:40:05;84565298;84516732;48566;
08.02.2019;20:41:08;84565387;84516815;48572;
08.02.2019;20:42:05;84565489;84516861;48628;
08.02.2019;20:43:06;84565575;84516925;48650;
08.02.2019;20:44:06;84565681;84516999;48682;
08.02.2019;20:45:08;84565834;84517066;48768;
08.02.2019;20:46:06;84565934;84517126;48808;
08.02.2019;20:47:21;84566078;84517215;48863;
08.02.2019;20:48:06;84566158;84517270;48888;
08.02.2019;20:49:08;84566266;84517331;48935;
08.02.2019;20:50:05;84566386;84517396;48990;
08.02.2019;20:51:05;84566492;84517461;49031;
08.02.2019;20:52:06;84566588;84517527;49061;
08.02.2019;20:53:05;84566688;84517583;49105;
08.02.2019;20:54:06;84566809;84517640;49169;
08.02.2019;20:55:05;84566953;84517705;49248;
08.02.2019;20:56:06;84567063;84517763;49300;
08.02.2019;20:57:05;84567167;84517834;49333;
08.02.2019;20:58:09;84567287;84517896;49391;
08.02.2019;20:59:05;84567389;84517957;49432;
08.02.2019;21:00:06;84567536;84518030;49506;
08.02.2019;21:01:06;84567663;84518092;49571;
08.02.2019;21:02:10;84567772;84518159;49613;
08.02.2019;21:03:06;84567886;84518211;49675;
08.02.2019;21:04:07;84567998;84518267;49731;
08.02.2019;21:05:05;84568122;84518324;49798;
08.02.2019;21:06:08;84568236;84518366;49870;
08.02.2019;21:07:04;84568337;84518415;49922;
08.02.2019;21:08:05;84568433;84518467;49966;
08.02.2019;21:09:06;84568529;84518532;49997;
08.02.2019;21:10:08;84568658;84518595;50063;
08.02.2019;21:11:05;84568767;84518644;50123;
08.02.2019;21:12:05;84568878;84518705;50173;
08.02.2019;21:13:05;84568992;84518760;50232;
08.02.2019;21:14:08;84569147;84518819;50328;
08.02.2019;21:15:04;84569251;84518860;50391;
08.02.2019;21:16:04;84569360;84518910;50450;
08.02.2019;21:17:09;84569479;84518962;50517;
08.02.2019;21:18:07;84569594;84519015;50579;
08.02.2019;21:19:05;84569713;84519061;50652;
08.02.2019;21:20:04;84569832;84519118;50714;
08.02.2019;21:21:05;84569938;84519174;50764;
08.02.2019;21:22:08;84570070;84519223;50847;
08.02.2019;21:23:05;84570199;84519279;50920;
08.02.2019;21:24:06;84570313;84519323;50990;
08.02.2019;21:25:05;84570432;84519368;51064;
08.02.2019;21:26:07;84570530;84519407;51123;
08.02.2019;21:27:04;84570650;84519455;51195;
08.02.2019;21:28:04;84570762;84519504;51258;
08.02.2019;21:29:04;84570882;84519560;51322;
08.02.2019;21:30:07;84570994;84519612;51382;
08.02.2019;21:31:05;84571098;84519658;51440;
08.02.2019;21:32:05;84571203;84519693;51510;
08.02.2019;21:33:05;84571304;84519733;51571;
08.02.2019;21:34:06;84571408;84519785;51623;
08.02.2019;21:35:05;84571523;84519831;51692;
08.02.2019;21:36:05;84571646;84519880;51766;
08.02.2019;21:37:05;84571773;84519920;51853;
08.02.2019;21:38:05;84571896;84519958;51938;
08.02.2019;21:39:09;84572059;84520010;52049;
08.02.2019;21:40:05;84572184;84520050;52134;
08.02.2019;21:41:05;84572323;84520086;52237;
08.02.2019;21:42:05;84572459;84520121;52338;
08.02.2019;21:43:08;84572606;84520159;52447;
08.02.2019;21:44:05;84572723;84520198;52525;
08.02.2019;21:45:05;84572845;84520254;52591;
08.02.2019;21:46:08;84572991;84520302;52689;
08.02.2019;21:47:07;84573121;84520355;52766;
08.02.2019;21:48:04;84573276;84520396;52880;
08.02.2019;21:49:05;84573423;84520450;52973;
08.02.2019;21:50:04;84573550;84520469;53081;
08.02.2019;21:51:08;84573684;84520526;53158;
08.02.2019;21:52:06;84573816;84520565;53251;
08.02.2019;21:53:04;84573942;84520596;53346;
08.02.2019;21:54:05;84574067;84520641;53426;
08.02.2019;21:55:09;84574214;84520694;53520;
08.02.2019;21:56:05;84574336;84520741;53595;
08.02.2019;21:57:06;84574468;84520782;53686;
08.02.2019;21:58:10;84574569;84520824;53745;
08.02.2019;21:59:13;84574716;84520859;53857;
08.02.2019;22:00:05;84574819;84520892;53927;
08.02.2019;22:01:05;84574917;84520913;54004;
08.02.2019;22:02:04;84575012;84520914;54098;
08.02.2019;22:03:07;84575130;84520957;54173;
08.02.2019;22:04:05;84575250;84520996;54254;
08.02.2019;22:05:05;84575355;84521000;54355;
08.02.2019;22:06:06;84575464;84521035;54429;
08.02.2019;22:07:08;84575582;84521078;54504;
08.02.2019;22:08:05;84575692;84521132;54560;
08.02.2019;22:09:07;84575810;84521186;54624;
08.02.2019;22:10:20;84576013;84521237;54776;
08.02.2019;22:11:07;84576096;84521262;54834;
08.02.2019;22:12:05;84576203;84521298;54905;
08.02.2019;22:13:10;84576333;84521340;54993;
08.02.2019;22:14:05;84576420;84521389;55031;
08.02.2019;22:15:09;84576537;84521415;55122;
08.02.2019;22:16:05;84576624;84521462;55162;
08.02.2019;22:17:06;84576743;84521481;55262;
08.02.2019;22:18:06;84576850;84521508;55342;
08.02.2019;22:19:06;84576974;84521528;55446;
08.02.2019;22:20:06;84577050;84521534;55516;
08.02.2019;22:21:05;84577145;84521556;55589;
08.02.2019;22:22:05;84577222;84521578;55644;
08.02.2019;22:23:05;84577316;84521601;55715;
08.02.2019;22:24:08;84577424;84521617;55807;
08.02.2019;22:25:05;84577535;84521639;55896;
08.02.2019;22:26:06;84577620;84521671;55949;
08.02.2019;22:27:06;84577705;84521688;56017;
08.02.2019;22:28:08;84577806;84521735;56071;
08.02.2019;22:29:06;84577924;84521760;56164;
08.02.2019;22:30:05;84578026;84521793;56233;
08.02.2019;22:31:06;84578111;84521813;56298;
08.02.2019;22:32:08;84578203;84521842;56361;
08.02.2019;22:33:05;84578296;84521855;56441;
08.02.2019;22:34:05;84578388;84521886;56502;
08.02.2019;22:35:06;84578508;84521900;56608;
08.02.2019;22:36:17;84578638;84521947;56691;
08.02.2019;22:37:04;84578721;84521969;56752;
08.02.2019;22:38:07;84578845;84521995;56850;
08.02.2019;22:39:08;84578953;84522038;56915;
08.02.2019;22:40:07;84579059;84522070;56989;
08.02.2019;22:41:05;84579152;84522099;57053;
08.02.2019;22:42:09;84579282;84522125;57157;
08.02.2019;22:43:06;84579387;84522166;57221;
08.02.2019;22:44:05;84579491;84522192;57299;
08.02.2019;22:45:05;84579618;84522218;57400;
08.02.2019;22:46:05;84579716;84522264;57452;
08.02.2019;22:47:07;84579825;84522294;57531;
08.02.2019;22:48:04;84579928;84522320;57608;
08.02.2019;22:49:04;84580054;84522351;57703;
08.02.2019;22:50:05;84580145;84522377;57768;
08.02.2019;22:51:07;84580262;84522406;57856;
08.02.2019;22:52:06;84580386;84522447;57939;
08.02.2019;22:53:05;84580498;84522476;58022;
08.02.2019;22:54:05;84580591;84522496;58095;
08.02.2019;22:55:09;84580710;84522540;58170;
08.02.2019;22:56:05;84580822;84522565;58257;
08.02.2019;22:57:06;84580948;84522609;58339;
08.02.2019;22:58:08;84581086;84522643;58443;
08.02.2019;22:59:05;84581236;84522669;58567;
08.02.2019;23:00:05;84581381;84522709;58672;
08.02.2019;23:01:05;84581524;84522738;58786;
08.02.2019;23:02:08;84581639;84522776;58863;
08.02.2019;23:03:05;84581756;84522797;58959;
08.02.2019;23:04:06;84581873;84522835;59038;
08.02.2019;23:05:05;84581984;84522867;59117;
08.02.2019;23:06:08;84582114;84522901;59213;
08.02.2019;23:07:05;84582205;84522921;59284;
08.02.2019;23:08:05;84582297;84522955;59342;
08.02.2019;23:09:10;84582429;84522976;59453;
08.02.2019;23:10:06;84582530;84523013;59517;
08.02.2019;23:11:04;84582630;84523034;59596;
08.02.2019;23:12:05;84582735;84523071;59664;
08.02.2019;23:13:07;84582850;84523099;59751;
08.02.2019;23:14:04;84582953;84523117;59836;
08.02.2019;23:15:04;84583063;84523148;59915;
08.02.2019;23:16:04;84583174;84523170;60004;
08.02.2019;23:17:09;84583280;84523206;60074;
08.02.2019;23:18:05;84583366;84523234;60132;
08.02.2019;23:19:05;84583486;84523254;60232;
08.02.2019;23:20:05;84583585;84523277;60308;
08.02.2019;23:21:07;84583690;84523296;60394;
08.02.2019;23:22:06;84583803;84523322;60481;
08.02.2019;23:23:05;84583912;84523349;60563;
08.02.2019;23:24:04;84583969;84523367;60602;
08.02.2019;23:25:09;84584135;84523402;60733;
08.02.2019;23:26:05;84584231;84523420;60811;
08.02.2019;23:27:05;84584353;84523441;60912;
08.02.2019;23:28:07;84584468;84523471;60997;
08.02.2019;23:29:10;84584567;84523490;61077;
08.02.2019;23:30:05;84584686;84523510;61176;
08.02.2019;23:31:06;84584803;84523548;61255;
08.02.2019;23:32:06;84584910;84523587;61323;
08.02.2019;23:33:07;84585021;84523609;61412;
08.02.2019;23:34:06;84585108;84523629;61479;
08.02.2019;23:35:05;84585218;84523654;61564;
08.02.2019;23:36:06;84585343;84523671;61672;
08.02.2019;23:37:13;84585433;84523707;61726;
08.02.2019;23:38:08;84585526;84523728;61798;
08.02.2019;23:39:09;84585624;84523742;61882;
08.02.2019;23:40:12;84585758;84523768;61990;
08.02.2019;23:41:07;84585846;84523785;62061;
08.02.2019;23:42:05;84585933;84523805;62128;
08.02.2019;23:43:12;84586048;84523824;62224;
08.02.2019;23:44:07;84586163;84523858;62305;
08.02.2019;23:45:06;84586253;84523873;62380;
08.02.2019;23:46:11;84586360;84523913;62447;
08.02.2019;23:47:07;84586441;84523958;62483;
08.02.2019;23:48:09;84586536;84523992;62544;
08.02.2019;23:49:11;84586653;84524030;62623;
08.02.2019;23:50:05;84586722;84524055;62667;
08.02.2019;23:51:05;84586783;84524082;62701;
08.02.2019;23:52:11;84586987;84524115;62872;
08.02.2019;23:53:05;84587067;84524148;62919;
08.02.2019;23:54:06;84587165;84524173;62992;
08.02.2019;23:55:05;84587267;84524194;63073;
08.02.2019;23:56:09;84587378;84524226;63152;
08.02.2019;23:57:05;84587494;84524237;63257;
08.02.2019;23:58:04;84587628;84524252;63376;
08.02.2019;23:59:05;84587787;84524272;63515;
09.02.2019;00:00:10;84587900;84524286;63614;
09.02.2019;00:01:10;84588009;84524310;63699;
09.02.2019;00:02:10;84588110;84524336;63774;
09.02.2019;00:03:14;84588232;84524350;63882;
09.02.2019;00:04:11;84588346;84524376;63970;
09.02.2019;00:05:15;84588472;84524409;64063;
09.02.2019;00:06:16;84588579;84524430;64149;
09.02.2019;00:07:18;84588700;84524465;64235;
09.02.2019;00:08:15;84588791;84524488;64303;
09.02.2019;00:09:19;84588907;84524528;64379;
09.02.2019;00:10:15;84588964;84524542;64422;
09.02.2019;00:11:17;84589050;84524574;64476;
09.02.2019;00:12:16;84589120;84524588;64532;
09.02.2019;00:13:19;84589174;84524600;64574;
09.02.2019;00:14:19;84589239;84524609;64630;
09.02.2019;00:15:16;84589273;84524624;64649;
09.02.2019;00:16:19;84589334;84524650;64684;
09.02.2019;00:17:17;84589389;84524666;64723;
09.02.2019;00:18:19;84589456;84524687;64769;
09.02.2019;00:19:20;84589529;84524704;64825;
09.02.2019;00:20:21;84589609;84524718;64891;
09.02.2019;00:22:21;84589739;84524752;64987;
09.02.2019;00:23:23;84589823;84524772;65051;
09.02.2019;00:24:23;84589909;84524796;65113;
09.02.2019;00:25:19;84589997;84524808;65189;
09.02.2019;00:26:22;84590089;84524840;65249;
09.02.2019;00:27:19;84590190;84524854;65336;
09.02.2019;00:28:25;84590300;84524887;65413;
09.02.2019;00:29:23;84590403;84524913;65490;
09.02.2019;00:30:23;84590506;84524934;65572;
09.02.2019;00:31:25;84590608;84524968;65640;
09.02.2019;00:32:24;84590698;84524986;65712;
09.02.2019;00:33:24;84590805;84525003;65802;
09.02.2019;00:34:27;84590901;84525028;65873;
09.02.2019;00:35:26;84590995;84525044;65951;
09.02.2019;00:36:23;84591078;84525063;66015;
09.02.2019;00:37:27;84591193;84525086;66107;
09.02.2019;00:38:25;84591284;84525110;66174;
09.02.2019;00:39:24;84591365;84525134;66231;
09.02.2019;00:40:25;84591451;84525150;66301;
09.02.2019;00:41:25;84591549;84525179;66370;
09.02.2019;00:42:23;84591657;84525195;66462;
09.02.2019;00:43:28;84591769;84525209;66560;
09.02.2019;00:44:27;84591858;84525232;66626;
09.02.2019;00:45:31;84591957;84525270;66687;
09.02.2019;00:46:27;84592053;84525291;66762;
09.02.2019;00:47:28;84592152;84525325;66827;
09.02.2019;00:48:26;84592239;84525350;66889;
09.02.2019;00:49:25;84592310;84525367;66943;
09.02.2019;00:50:25;84592403;84525402;67001;
09.02.2019;00:51:23;84592489;84525429;67060;
09.02.2019;00:52:24;84592589;84525459;67130;
09.02.2019;00:53:23;84592673;84525484;67189;
09.02.2019;00:54:22;84592761;84525511;67250;
09.02.2019;00:55:23;84592857;84525538;67319;
09.02.2019;00:56:24;84592951;84525563;67388;
09.02.2019;00:57:23;84593045;84525595;67450;
09.02.2019;00:58:22;84593128;84525610;67518;
09.02.2019;00:59:20;84593217;84525633;67584;
09.02.2019;01:00:15;84593290;84525661;67629;
09.02.2019;01:01:12;84593340;84525683;67657;
09.02.2019;01:02:05;84593438;84525706;67732;
09.02.2019;01:03:05;84593547;84525740;67807;
09.02.2019;01:04:04;84593632;84525766;67866;
09.02.2019;01:05:04;84593720;84525791;67929;
09.02.2019;01:06:05;84593807;84525818;67989;
09.02.2019;01:07:05;84593907;84525842;68065;
09.02.2019;01:08:05;84593989;84525843;68146;
09.02.2019;01:09:07;84594051;84525831;68220;
09.02.2019;01:10:05;84594129;84525860;68269;
09.02.2019;01:11:04;84594218;84525882;68336;
09.02.2019;01:12:04;84594306;84525921;68385;
09.02.2019;01:13:05;84594408;84525940;68468;
09.02.2019;01:14:04;84594513;84525984;68529;
09.02.2019;01:15:04;84594618;84526011;68607;
09.02.2019;01:16:05;84594715;84526043;68672;
09.02.2019;01:17:04;84594792;84526072;68720;
09.02.2019;01:18:04;84594886;84526099;68787;
09.02.2019;01:19:05;84594974;84526120;68854;
09.02.2019;01:20:05;84595059;84526153;68906;
09.02.2019;01:21:04;84595146;84526183;68963;
09.02.2019;01:22:04;84595242;84526209;69033;
09.02.2019;01:23:05;84595327;84526253;69074;
09.02.2019;01:24:04;84595425;84526281;69144;
09.02.2019;01:25:05;84595548;84526323;69225;
09.02.2019;01:26:05;84595626;84526354;69272;
09.02.2019;01:27:05;84595706;84526383;69323;
09.02.2019;01:28:05;84595791;84526416;69375;
09.02.2019;01:29:05;84595884;84526451;69433;
09.02.2019;01:30:05;84595974;84526482;69492;
09.02.2019;01:31:05;84596065;84526514;69551;
09.02.2019;01:32:06;84596143;84526551;69592;
09.02.2019;01:33:05;84596229;84526581;69648;
09.02.2019;01:34:05;84596297;84526624;69673;
09.02.2019;01:35:05;84596390;84526651;69739;
09.02.2019;01:36:06;84596481;84526691;69790;
09.02.2019;01:37:05;84596571;84526718;69853;
09.02.2019;01:38:05;84596665;84526755;69910;
09.02.2019;01:39:05;84596761;84526796;69965;
09.02.2019;01:40:05;84596841;84526836;70005;
09.02.2019;01:41:06;84596924;84526895;70029;
09.02.2019;01:42:05;84597020;84526926;70094;
09.02.2019;01:43:05;84597107;84526961;70146;
09.02.2019;01:44:05;84597212;84526995;70217;
09.02.2019;01:45:05;84597306;84527032;70274;
09.02.2019;01:46:04;84597407;84527069;70338;
09.02.2019;01:47:04;84597508;84527099;70409;
09.02.2019;01:48:06;84597597;84527141;70456;
09.02.2019;01:49:05;84597690;84527176;70514;
09.02.2019;01:50:05;84597778;84527215;70563;
09.02.2019;01:51:05;84597878;84527262;70616;
09.02.2019;01:52:05;84597957;84527288;70669;
09.02.2019;01:53:04;84598044;84527322;70722;
09.02.2019;01:54:05;84598156;84527369;70787;
09.02.2019;01:55:05;84598235;84527413;70822;
09.02.2019;01:56:04;84598318;84527456;70862;
09.02.2019;01:57:05;84598425;84527514;70911;
09.02.2019;01:58:04;84598493;84527562;70931;
09.02.2019;01:59:05;84598587;84527617;70970;
09.02.2019;02:00:04;84598674;84527656;71018;
09.02.2019;02:01:05;84598747;84527707;71040;
09.02.2019;02:02:04;84598816;84527750;71066;
09.02.2019;02:03:05;84598918;84527789;71129;
09.02.2019;02:04:05;84599000;84527835;71165;
09.02.2019;02:05:06;84599065;84527885;71180;
09.02.2019;02:06:05;84599189;84527936;71253;
09.02.2019;02:07:05;84599300;84527985;71315;
09.02.2019;02:08:06;84599388;84528005;71383;
09.02.2019;02:09:07;84599486;84528083;71403;
09.02.2019;02:10:04;84599563;84528136;71427;
09.02.2019;02:11:04;84599655;84528189;71466;
09.02.2019;02:12:05;84599703;84528219;71484;
09.02.2019;02:13:04;84599735;84528264;71471;
09.02.2019;02:14:04;84599776;84528315;71461;
09.02.2019;02:15:04;84599813;84528360;71453;
09.02.2019;02:16:05;84599874;84528414;71460;
09.02.2019;02:17:04;84599913;84528457;71456;
09.02.2019;02:18:05;84599963;84528514;71449;
09.02.2019;02:19:04;84600015;84528574;71441;
09.02.2019;02:20:04;84600079;84528612;71467;
09.02.2019;02:21:06;84600148;84528670;71478;
09.02.2019;02:22:04;84600228;84528725;71503;
09.02.2019;02:23:05;84600284;84528773;71511;
09.02.2019;02:24:04;84600358;84528827;71531;
09.02.2019;02:25:04;84600437;84528883;71554;
09.02.2019;02:26:05;84600524;84528931;71593;
09.02.2019;02:27:04;84600597;84528979;71618;
09.02.2019;02:28:05;84600683;84529046;71637;
09.02.2019;02:29:06;84600777;84529104;71673;
09.02.2019;02:30:05;84600862;84529148;71714;
09.02.2019;02:31:04;84600957;84529233;71724;
09.02.2019;02:32:04;84601022;84529286;71736;
09.02.2019;02:33:05;84601106;84529345;71761;
09.02.2019;02:34:04;84601196;84529398;71798;
09.02.2019;02:35:05;84601274;84529475;71799;
09.02.2019;02:36:04;84601364;84529553;71811;
09.02.2019;02:37:04;84601441;84529610;71831;
09.02.2019;02:38:05;84601557;84529682;71875;
09.02.2019;02:39:06;84601654;84529759;71895;
09.02.2019;02:40:05;84601747;84529835;71912;
09.02.2019;02:41:05;84601850;84529911;71939;
09.02.2019;02:42:05;84601923;84529971;71952;
09.02.2019;02:43:04;84602023;84530026;71997;
09.02.2019;02:44:04;84602096;84530087;72009;
09.02.2019;02:45:05;84602151;84530146;72005;
09.02.2019;02:46:05;84602279;84530212;72067;
09.02.2019;02:47:06;84602363;84530277;72086;
09.02.2019;02:48:05;84602455;84530347;72108;
09.02.2019;02:49:05;84602559;84530424;72135;
09.02.2019;02:50:05;84602660;84530478;72182;
09.02.2019;02:51:05;84602739;84530554;72185;
09.02.2019;02:52:05;84602821;84530646;72175;
09.02.2019;02:53:04;84602901;84530722;72179;
09.02.2019;02:54:05;84602985;84530798;72187;
09.02.2019;02:55:04;84603069;84530867;72202;
09.02.2019;02:56:04;84603148;84530930;72218;
09.02.2019;02:57:05;84603233;84530999;72234;
09.02.2019;02:58:04;84603330;84531070;72260;
09.02.2019;02:59:05;84603456;84531160;72296;
09.02.2019;03:00:04;84603520;84531215;72305;
09.02.2019;03:01:04;84603617;84531323;72294;
09.02.2019;03:02:05;84603706;84531418;72288;
09.02.2019;03:03:06;84603786;84531515;72271;
09.02.2019;03:04:05;84603858;84531586;72272;
09.02.2019;03:05:04;84603932;84531681;72251;
09.02.2019;03:06:05;84604028;84531762;72266;
09.02.2019;03:07:05;84604118;84531841;72277;
09.02.2019;03:08:04;84604230;84531918;72312;
09.02.2019;03:09:04;84604324;84532007;72317;
09.02.2019;03:10:06;84604424;84532105;72319;
09.02.2019;03:11:05;84604511;84532180;72331;
09.02.2019;03:12:05;84604593;84532268;72325;
09.02.2019;03:13:05;84604664;84532359;72305;
09.02.2019;03:14:06;84604754;84532456;72298;
09.02.2019;03:15:04;84604843;84532543;72300;
09.02.2019;03:16:04;84604927;84532621;72306;
09.02.2019;03:17:05;84605014;84532706;72308;
09.02.2019;03:18:04;84605135;84532792;72343;
09.02.2019;03:19:05;84605253;84532885;72368;
09.02.2019;03:20:05;84605349;84532968;72381;
09.02.2019;03:21:06;84605438;84533055;72383;
09.02.2019;03:22:05;84605527;84533143;72384;
09.02.2019;03:23:10;84605632;84533238;72394;
09.02.2019;03:24:06;84605720;84533312;72408;
09.02.2019;03:25:05;84605793;84533400;72393;
09.02.2019;03:26:04;84605873;84533502;72371;
09.02.2019;03:27:05;84605959;84533612;72347;
09.02.2019;03:28:05;84606032;84533722;72310;
09.02.2019;03:29:04;84606120;84533819;72301;
09.02.2019;03:30:05;84606212;84533914;72298;
09.02.2019;03:31:05;84606300;84534019;72281;
09.02.2019;03:32:05;84606399;84534110;72289;
09.02.2019;03:33:04;84606490;84534214;72276;
09.02.2019;03:34:04;84606586;84534312;72274;
09.02.2019;03:35:05;84606672;84534396;72276;
09.02.2019;03:36:05;84606769;84534500;72269;
09.02.2019;03:37:05;84606847;84534613;72234;
09.02.2019;03:38:05;84606923;84534710;72213;
09.02.2019;03:39:07;84607006;84534797;72209;
09.02.2019;03:40:05;84607092;84534886;72206;
09.02.2019;03:41:05;84607181;84534989;72192;
09.02.2019;03:42:05;84607271;84535108;72163;
09.02.2019;03:43:04;84607382;84535189;72193;
09.02.2019;03:44:05;84607490;84535297;72193;
09.02.2019;03:45:04;84607558;84535402;72156;
09.02.2019;03:46:05;84607644;84535513;72131;
09.02.2019;03:47:05;84607736;84535630;72106;
09.02.2019;03:48:05;84607807;84535718;72089;
09.02.2019;03:49:05;84607898;84535817;72081;
09.02.2019;03:50:05;84607981;84535919;72062;
09.02.2019;03:51:06;84608079;84536034;72045;
09.02.2019;03:52:05;84608165;84536125;72040;
09.02.2019;03:53:05;84608248;84536234;72014;
09.02.2019;03:54:04;84608324;84536328;71996;
09.02.2019;03:55:05;84608403;84536428;71975;
09.02.2019;03:56:04;84608490;84536519;71971;
09.02.2019;03:57:05;84608570;84536625;71945;
09.02.2019;03:58:04;84608670;84536723;71947;
09.02.2019;03:59:05;84608749;84536822;71927;
09.02.2019;04:00:05;84608847;84536920;71927;
09.02.2019;04:01:04;84608909;84537001;71908;
09.02.2019;04:02:05;84608976;84537112;71864;
09.02.2019;04:03:04;84609068;84537199;71869;
09.02.2019;04:04:05;84609174;84537305;71869;
09.02.2019;04:05:04;84609269;84537416;71853;
09.02.2019;04:06:04;84609341;84537531;71810;
09.02.2019;04:07:05;84609452;84537614;71838;
09.02.2019;04:08:05;84609542;84537717;71825;
09.02.2019;04:09:04;84609623;84537826;71797;
09.02.2019;04:10:05;84609722;84537947;71775;
09.02.2019;04:11:04;84609781;84538067;71714;
09.02.2019;04:12:05;84609894;84538172;71722;
09.02.2019;04:13:04;84609974;84538265;71709;
09.02.2019;04:14:04;84610027;84538376;71651;
09.02.2019;04:15:04;84610090;84538461;71629;
09.02.2019;04:16:05;84610121;84538576;71545;
09.02.2019;04:17:05;84610180;84538679;71501;
09.02.2019;04:18:05;84610238;84538770;71468;
09.02.2019;04:19:06;84610311;84538895;71416;
09.02.2019;04:20:05;84610367;84538989;71378;
09.02.2019;04:21:05;84610405;84539099;71306;
09.02.2019;04:22:04;84610472;84539204;71268;
09.02.2019;04:23:04;84610484;84539250;71234;
09.02.2019;04:24:05;84610558;84539359;71199;
09.02.2019;04:25:04;84610633;84539460;71173;
09.02.2019;04:26:05;84610731;84539577;71154;
09.02.2019;04:27:04;84610817;84539692;71125;
09.02.2019;04:28:04;84610903;84539797;71106;
09.02.2019;04:29:05;84610982;84539921;71061;
09.02.2019;04:30:05;84611094;84540040;71054;
09.02.2019;04:31:06;84611181;84540143;71038;
09.02.2019;04:32:05;84611277;84540251;71026;
09.02.2019;04:33:05;84611368;84540363;71005;
09.02.2019;04:34:05;84611452;84540476;70976;
09.02.2019;04:35:05;84611548;84540594;70954;
09.02.2019;04:36:05;84611632;84540694;70938;
09.02.2019;04:37:05;84611732;84540776;70956;
09.02.2019;04:38:05;84611797;84540929;70868;
09.02.2019;04:39:07;84611890;84541050;70840;
09.02.2019;04:40:05;84611965;84541162;70803;
09.02.2019;04:41:04;84612033;84541261;70772;
09.02.2019;04:42:04;84612131;84541376;70755;
09.02.2019;04:43:05;84612216;84541511;70705;
09.02.2019;04:44:04;84612277;84541610;70667;
09.02.2019;04:45:05;84612349;84541741;70608;
09.02.2019;04:46:05;84612441;84541854;70587;
09.02.2019;04:47:04;84612517;84541971;70546;
09.02.2019;04:48:06;84612594;84542094;70500;
09.02.2019;04:49:05;84612681;84542207;70474;
09.02.2019;04:50:04;84612766;84542326;70440;
09.02.2019;04:51:04;84612866;84542435;70431;
09.02.2019;04:52:05;84612940;84542561;70379;
09.02.2019;04:53:04;84613019;84542669;70350;
09.02.2019;04:54:04;84613131;84542782;70349;
09.02.2019;04:55:05;84613218;84542921;70297;
09.02.2019;04:56:04;84613304;84543020;70284;
09.02.2019;04:57:04;84613412;84543143;70269;
09.02.2019;04:58:05;84613517;84543251;70266;
09.02.2019;04:59:05;84613611;84543362;70249;
09.02.2019;05:00:04;84613712;84543458;70254;
09.02.2019;05:01:05;84613795;84543574;70221;
09.02.2019;05:02:05;84613862;84543666;70196;
09.02.2019;05:03:04;84613947;84543782;70165;
09.02.2019;05:04:06;84614026;84543894;70132;
09.02.2019;05:05:04;84614109;84544000;70109;
09.02.2019;05:06:04;84614201;84544105;70096;
09.02.2019;05:07:05;84614294;84544216;70078;
09.02.2019;05:08:04;84614353;84544337;70016;
09.02.2019;05:09:04;84614439;84544450;69989;
09.02.2019;05:10:06;84614520;84544589;69931;
09.02.2019;05:11:05;84614594;84544717;69877;
09.02.2019;05:12:05;84614663;84544813;69850;
09.02.2019;05:13:05;84614744;84544937;69807;
09.02.2019;05:14:05;84614813;84545056;69757;
09.02.2019;05:15:05;84614880;84545158;69722;
09.02.2019;05:16:04;84614953;84545270;69683;
09.02.2019;05:17:05;84615025;84545385;69640;
09.02.2019;05:18:05;84615105;84545496;69609;
09.02.2019;05:19:04;84615196;84545611;69585;
09.02.2019;05:20:05;84615280;84545720;69560;
09.02.2019;05:21:06;84615363;84545835;69528;
09.02.2019;05:22:05;84615422;84545952;69470;
09.02.2019;05:23:05;84615537;84546081;69456;
09.02.2019;05:24:04;84615622;84546205;69417;
09.02.2019;05:25:04;84615701;84546337;69364;
09.02.2019;05:26:04;84615792;84546454;69338;
09.02.2019;05:27:05;84615875;84546580;69295;
09.02.2019;05:28:05;84615957;84546687;69270;
09.02.2019;05:29:05;84616047;84546811;69236;
09.02.2019;05:30:05;84616133;84546936;69197;
09.02.2019;05:31:05;84616211;84547052;69159;
09.02.2019;05:32:05;84616273;84547153;69120;
09.02.2019;05:33:05;84616358;84547267;69091;
09.02.2019;05:34:06;84616425;84547359;69066;
09.02.2019;05:35:05;84616505;84547448;69057;
09.02.2019;05:36:05;84616571;84547572;68999;
09.02.2019;05:37:04;84616641;84547659;68982;
09.02.2019;05:38:06;84616720;84547752;68968;
09.02.2019;05:39:07;84616823;84547841;68982;
09.02.2019;05:40:05;84616909;84547923;68986;
09.02.2019;05:41:05;84616991;84548038;68953;
09.02.2019;05:42:04;84617068;84548152;68916;
09.02.2019;05:43:04;84617134;84548243;68891;
09.02.2019;05:44:05;84617221;84548345;68876;
09.02.2019;05:45:04;84617302;84548422;68880;
09.02.2019;05:46:05;84617369;84548531;68838;
09.02.2019;05:47:05;84617419;84548648;68771;
09.02.2019;05:48:06;84617508;84548731;68777;
09.02.2019;05:49:04;84617574;84548857;68717;
09.02.2019;05:50:05;84617673;84548959;68714;
09.02.2019;05:51:05;84617749;84549077;68672;
09.02.2019;05:52:04;84617834;84549205;68629;
09.02.2019;05:53:05;84617914;84549337;68577;
09.02.2019;05:54:04;84618005;84549466;68539;
09.02.2019;05:55:04;84618093;84549591;68502;
09.02.2019;05:56:05;84618157;84549744;68413;
09.02.2019;05:57:04;84618252;84549873;68379;
09.02.2019;05:58:04;84618327;84550015;68312;
09.02.2019;05:59:05;84618405;84550161;68244;
09.02.2019;06:00:05;84618485;84550257;68228;
09.02.2019;06:01:05;84618560;84550363;68197;
09.02.2019;06:02:06;84618620;84550472;68148;
09.02.2019;06:03:05;84618691;84550586;68105;
09.02.2019;06:04:05;84618765;84550725;68040;
09.02.2019;06:05:04;84618849;84550836;68013;
09.02.2019;06:06:04;84618925;84550953;67972;
09.02.2019;06:07:07;84618997;84551067;67930;
09.02.2019;06:08:05;84619074;84551181;67893;
09.02.2019;06:09:05;84619156;84551290;67866;
09.02.2019;06:10:05;84619230;84551391;67839;
09.02.2019;06:11:05;84619308;84551500;67808;
09.02.2019;06:12:05;84619364;84551600;67764;
09.02.2019;06:13:05;84619435;84551710;67725;
09.02.2019;06:14:05;84619481;84551811;67670;
09.02.2019;06:15:04;84619550;84551912;67638;
09.02.2019;06:16:05;84619621;84552027;67594;
09.02.2019;06:17:04;84619672;84552147;67525;
09.02.2019;06:18:04;84619731;84552259;67472;
09.02.2019;06:19:05;84619800;84552374;67426;
09.02.2019;06:20:05;84619856;84552471;67385;
09.02.2019;06:21:05;84619895;84552590;67305;
09.02.2019;06:22:06;84619943;84552735;67208;
09.02.2019;06:23:05;84619999;84552816;67183;
09.02.2019;06:24:06;84620048;84552926;67122;
09.02.2019;06:25:08;84620124;84553040;67084;
09.02.2019;06:26:05;84620182;84553177;67005;
09.02.2019;06:27:05;84620238;84553287;66951;
09.02.2019;06:28:05;84620317;84553411;66906;
09.02.2019;06:29:05;84620391;84553516;66875;
09.02.2019;06:30:05;84620444;84553638;66806;
09.02.2019;06:31:04;84620485;84553773;66712;
09.02.2019;06:32:05;84620585;84553864;66721;
09.02.2019;06:33:04;84620668;84553947;66721;
09.02.2019;06:34:04;84620725;84554087;66638;
09.02.2019;06:35:05;84620805;84554199;66606;
09.02.2019;06:36:04;84620867;84554285;66582;
09.02.2019;06:37:05;84620927;84554426;66501;
09.02.2019;06:38:04;84621014;84554530;66484;
09.02.2019;06:39:06;84621073;84554643;66430;
09.02.2019;06:40:04;84621145;84554765;66380;
09.02.2019;06:41:05;84621214;84554894;66320;
09.02.2019;06:42:05;84621286;84555025;66261;
09.02.2019;06:43:05;84621375;84555141;66234;
09.02.2019;06:44:04;84621428;84555255;66173;
09.02.2019;06:45:05;84621489;84555366;66123;
09.02.2019;06:46:04;84621578;84555516;66062;
09.02.2019;06:47:04;84621665;84555615;66050;
09.02.2019;06:48:05;84621756;84555734;66022;
09.02.2019;06:49:05;84621833;84555855;65978;
09.02.2019;06:50:05;84621915;84555955;65960;
09.02.2019;06:51:05;84621963;84556076;65887;
09.02.2019;06:52:05;84622021;84556219;65802;
09.02.2019;06:53:06;84622105;84556341;65764;
09.02.2019;06:54:05;84622198;84556451;65747;
09.02.2019;06:55:05;84622253;84556603;65650;
09.02.2019;06:56:05;84622334;84556723;65611;
09.02.2019;06:57:05;84622406;84556866;65540;
09.02.2019;06:58:05;84622479;84557000;65479;
09.02.2019;06:59:04;84622565;84557137;65428;
09.02.2019;07:00:04;84622633;84557268;65365;
09.02.2019;07:01:05;84622714;84557431;65283;
09.02.2019;07:02:04;84622786;84557575;65211;
09.02.2019;07:03:05;84622861;84557700;65161;
09.02.2019;07:04:04;84622912;84557800;65112;
09.02.2019;07:05:04;84622990;84557923;65067;
09.02.2019;07:06:05;84623043;84557981;65062;
09.02.2019;07:07:04;84623109;84558113;64996;
09.02.2019;07:08:05;84623168;84558235;64933;
09.02.2019;07:09:05;84623229;84558393;64836;
09.02.2019;07:10:05;84623296;84558541;64755;
09.02.2019;07:11:05;84623355;84558667;64688;
09.02.2019;07:12:05;84623424;84558793;64631;
09.02.2019;07:13:05;84623513;84558917;64596;
09.02.2019;07:14:05;84623564;84559053;64511;
09.02.2019;07:15:06;84623630;84559186;64444;
09.02.2019;07:16:05;84623687;84559329;64358;
09.02.2019;07:17:05;84623740;84559456;64284;
09.02.2019;07:18:05;84623813;84559570;64243;
09.02.2019;07:19:05;84623881;84559704;64177;
09.02.2019;07:20:06;84623978;84559842;64136;
09.02.2019;07:21:05;84624049;84559986;64063;
09.02.2019;07:22:05;84624130;84560096;64034;
09.02.2019;07:23:05;84624206;84560222;63984;
09.02.2019;07:24:05;84624287;84560361;63926;
09.02.2019;07:25:05;84624345;84560498;63847;
09.02.2019;07:26:05;84624410;84560650;63760;
09.02.2019;07:27:05;84624481;84560782;63699;
09.02.2019;07:28:05;84624550;84560916;63634;
09.02.2019;07:29:05;84624616;84561050;63566;
09.02.2019;07:30:06;84624693;84561163;63530;
09.02.2019;07:31:05;84624764;84561291;63473;
09.02.2019;07:32:05;84624837;84561447;63390;
09.02.2019;07:33:06;84624898;84561599;63299;
09.02.2019;07:34:05;84624976;84561733;63243;
09.02.2019;07:35:05;84625047;84561853;63194;
09.02.2019;07:36:04;84625118;84561977;63141;
09.02.2019;07:37:05;84625204;84562096;63108;
09.02.2019;07:38:04;84625291;84562225;63066;
09.02.2019;07:39:06;84625344;84562400;62944;
09.02.2019;07:40:05;84625389;84562520;62869;
09.02.2019;07:41:04;84625459;84562646;62813;
09.02.2019;07:42:05;84625519;84562780;62739;
09.02.2019;07:43:05;84625582;84562923;62659;
09.02.2019;07:44:04;84625632;84563062;62570;
09.02.2019;07:45:06;84625703;84563208;62495;
09.02.2019;07:46:05;84625764;84563348;62416;
09.02.2019;07:47:05;84625835;84563505;62330;
09.02.2019;07:48:05;84625904;84563642;62262;
09.02.2019;07:49:05;84625982;84563778;62204;
09.02.2019;07:50:05;84626071;84563914;62157;
09.02.2019;07:51:05;84626139;84564036;62103;
09.02.2019;07:52:04;84626200;84564155;62045;
09.02.2019;07:53:05;84626266;84564276;61990;
09.02.2019;07:54:04;84626345;84564422;61923;
09.02.2019;07:55:04;84626407;84564550;61857;
09.02.2019;07:56:05;84626473;84564685;61788;
09.02.2019;07:57:04;84626545;84564807;61738;
09.02.2019;07:58:04;84626631;84564949;61682;
09.02.2019;07:59:05;84626692;84565076;61616;
09.02.2019;08:00:04;84626750;84565176;61574;
09.02.2019;08:01:06;84626817;84565313;61504;
09.02.2019;08:02:05;84626895;84565463;61432;
09.02.2019;08:03:06;84626961;84565591;61370;
09.02.2019;08:04:05;84627024;84565698;61326;
09.02.2019;08:05:05;84627042;84565832;61210;
09.02.2019;08:06:05;84627081;84565965;61116;
09.02.2019;08:07:05;84627144;84566087;61057;
09.02.2019;08:08:04;84627211;84566235;60976;
09.02.2019;08:09:07;84627258;84566366;60892;
09.02.2019;08:10:04;84627289;84566496;60793;
09.02.2019;08:11:04;84627345;84566601;60744;
09.02.2019;08:12:04;84627400;84566703;60697;
09.02.2019;08:13:05;84627473;84566835;60638;
09.02.2019;08:14:04;84627539;84566972;60567;
09.02.2019;08:15:05;84627585;84567084;60501;
09.02.2019;08:16:04;84627622;84567215;60407;
09.02.2019;08:17:04;84627657;84567319;60338;
09.02.2019;08:18:05;84627700;84567466;60234;
09.02.2019;08:19:07;84627747;84567611;60136;
09.02.2019;08:20:05;84627811;84567747;60064;
09.02.2019;08:21:05;84627871;84567852;60019;
09.02.2019;08:22:05;84627945;84567969;59976;
09.02.2019;08:23:05;84628011;84568087;59924;
09.02.2019;08:24:05;84628062;84568209;59853;
09.02.2019;08:25:05;84628143;84568342;59801;
09.02.2019;08:26:05;84628192;84568482;59710;
09.02.2019;08:27:04;84628250;84568603;59647;
09.02.2019;08:28:04;84628298;84568726;59572;
09.02.2019;08:29:05;84628372;84568859;59513;
09.02.2019;08:30:04;84628436;84568990;59446;
09.02.2019;08:31:05;84628502;84569143;59359;
09.02.2019;08:32:05;84628577;84569289;59288;
09.02.2019;08:33:05;84628643;84569404;59239;
09.02.2019;08:34:05;84628716;84569543;59173;
09.02.2019;08:35:06;84628789;84569682;59107;
09.02.2019;08:36:05;84628851;84569812;59039;
09.02.2019;08:37:05;84628948;84569942;59006;
09.02.2019;08:38:05;84629001;84570064;58937;
09.02.2019;08:39:06;84629072;84570201;58871;
09.02.2019;08:40:05;84629156;84570337;58819;
09.02.2019;08:41:04;84629222;84570478;58744;
09.02.2019;08:42:04;84629291;84570617;58674;
09.02.2019;08:43:05;84629373;84570744;58629;
09.02.2019;08:44:04;84629438;84570858;58580;
09.02.2019;08:45:06;84629509;84570995;58514;
09.02.2019;08:46:05;84629595;84571135;58460;
09.02.2019;08:47:05;84629656;84571261;58395;
09.02.2019;08:48:05;84629715;84571420;58295;
09.02.2019;08:49:06;84629803;84571570;58233;
09.02.2019;08:50:05;84629895;84571686;58209;
09.02.2019;08:51:05;84629971;84571818;58153;
09.02.2019;08:52:05;84630051;84571955;58096;
09.02.2019;08:53:05;84630113;84572083;58030;
09.02.2019;08:54:05;84630206;84572224;57982;
09.02.2019;08:55:06;84630281;84572352;57929;
09.02.2019;08:56:05;84630362;84572472;57890;
09.02.2019;08:57:06;84630438;84572613;57825;
09.02.2019;08:58:04;84630479;84572763;57716;
09.02.2019;08:59:05;84630557;84572907;57650;
09.02.2019;09:00:04;84630634;84573016;57618;
09.02.2019;09:01:04;84630716;84573159;57557;
09.02.2019;09:02:05;84630789;84573298;57491;
09.02.2019;09:03:04;84630848;84573426;57422;
09.02.2019;09:04:05;84630910;84573572;57338;
09.02.2019;09:05:04;84630994;84573687;57307;
09.02.2019;09:06:04;84631088;84573811;57277;
09.02.2019;09:07:04;84631169;84573944;57225;
09.02.2019;09:08:05;84631264;84574086;57178;
09.02.2019;09:09:07;84631332;84574229;57103;
09.02.2019;09:10:05;84631404;84574389;57015;
09.02.2019;09:11:05;84631480;84574540;56940;
09.02.2019;09:12:05;84631555;84574698;56857;
09.02.2019;09:13:05;84631637;84574848;56789;
09.02.2019;09:14:05;84631726;84574991;56735;
09.02.2019;09:15:05;84631802;84575129;56673;
09.02.2019;09:16:06;84631881;84575280;56601;
09.02.2019;09:17:05;84631967;84575424;56543;
09.02.2019;09:18:04;84632040;84575572;56468;
09.02.2019;09:19:05;84632132;84575722;56410;
09.02.2019;09:20:04;84632209;84575860;56349;
09.02.2019;09:21:04;84632267;84576011;56256;
09.02.2019;09:22:05;84632326;84576155;56171;
09.02.2019;09:23:04;84632428;84576286;56142;
09.02.2019;09:24:04;84632506;84576426;56080;
09.02.2019;09:25:04;84632593;84576588;56005;
09.02.2019;09:26:05;84632681;84576730;55951;
09.02.2019;09:27:05;84632754;84576862;55892;
09.02.2019;09:28:04;84632830;84577029;55801;
09.02.2019;09:29:04;84632889;84577167;55722;
09.02.2019;09:30:05;84632971;84577349;55622;
09.02.2019;09:31:05;84633059;84577473;55586;
09.02.2019;09:32:04;84633151;84577633;55518;
09.02.2019;09:33:06;84633225;84577814;55411;
09.02.2019;09:34:05;84633296;84577952;55344;
09.02.2019;09:35:04;84633376;84578068;55308;
09.02.2019;09:36:04;84633444;84578209;55235;
09.02.2019;09:37:04;84633532;84578353;55179;
09.02.2019;09:38:05;84633593;84578506;55087;
09.02.2019;09:39:07;84633667;84578663;55004;
09.02.2019;09:40:06;84633736;84578813;54923;
09.02.2019;09:41:04;84633823;84578955;54868;
09.02.2019;09:42:05;84633898;84579079;54819;
09.02.2019;09:43:04;84633971;84579208;54763;
09.02.2019;09:44:04;84634057;84579333;54724;
09.02.2019;09:45:06;84634126;84579515;54611;
09.02.2019;09:46:04;84634204;84579675;54529;
09.02.2019;09:47:05;84634289;84579841;54448;
09.02.2019;09:48:05;84634357;84579959;54398;
09.02.2019;09:49:04;84634426;84580090;54336;
09.02.2019;09:50:04;84634480;84580244;54236;
09.02.2019;09:51:04;84634567;84580395;54172;
09.02.2019;09:52:05;84634645;84580554;54091;
09.02.2019;09:53:06;84634731;84580695;54036;
09.02.2019;09:54:05;84634803;84580845;53958;
09.02.2019;09:55:04;84634879;84581005;53874;
09.02.2019;09:56:04;84634945;84581136;53809;
09.02.2019;09:57:04;84635016;84581280;53736;
09.02.2019;09:58:05;84635112;84581431;53681;
09.02.2019;09:59:04;84635192;84581573;53619;
09.02.2019;10:00:05;84635259;84581725;53534;
09.02.2019;10:01:05;84635342;84581869;53473;
09.02.2019;10:02:05;84635429;84582024;53405;
09.02.2019;10:03:04;84635503;84582197;53306;
09.02.2019;10:04:04;84635542;84582309;53233;
09.02.2019;10:05:06;84635626;84582426;53200;
09.02.2019;10:06:05;84635736;84582550;53186;
09.02.2019;10:07:06;84635828;84582704;53124;
09.02.2019;10:08:05;84635900;84582859;53041;
09.02.2019;10:09:07;84635985;84583018;52967;
09.02.2019;10:10:05;84636072;84583131;52941;
09.02.2019;10:11:06;84636134;84583251;52883;
09.02.2019;10:12:05;84636217;84583399;52818;
09.02.2019;10:13:06;84636267;84583510;52757;
09.02.2019;10:14:06;84636334;84583635;52699;
09.02.2019;10:15:05;84636386;84583746;52640;
09.02.2019;10:16:06;84636438;84583893;52545;
09.02.2019;10:17:05;84636492;84584003;52489;
09.02.2019;10:18:05;84636541;84584119;52422;
09.02.2019;10:19:05;84636576;84584228;52348;
09.02.2019;10:20:04;84636638;84584339;52299;
09.02.2019;10:21:08;84636687;84584475;52212;
09.02.2019;10:22:05;84636752;84584606;52146;
09.02.2019;10:23:05;84636808;84584754;52054;
09.02.2019;10:24:04;84636864;84584911;51953;
09.02.2019;10:25:06;84636923;84585057;51866;
09.02.2019;10:26:05;84636993;84585200;51793;
09.02.2019;10:27:05;84637071;84585344;51727;
09.02.2019;10:28:05;84637133;84585480;51653;
09.02.2019;10:29:05;84637211;84585634;51577;
09.02.2019;10:30:04;84637280;84585790;51490;
09.02.2019;10:31:04;84637346;84585950;51396;
09.02.2019;10:32:04;84637427;84586099;51328;
09.02.2019;10:33:05;84637497;84586245;51252;
09.02.2019;10:34:05;84637569;84586392;51177;
09.02.2019;10:35:04;84637661;84586535;51126;
09.02.2019;10:36:05;84637753;84586674;51079;
09.02.2019;10:37:05;84637838;84586822;51016;
09.02.2019;10:38:04;84637926;84586966;50960;
09.02.2019;10:39:06;84638016;84587107;50909;
09.02.2019;10:40:05;84638123;84587244;50879;
09.02.2019;10:41:04;84638200;84587387;50813;
09.02.2019;10:42:04;84638289;84587514;50775;
09.02.2019;10:43:05;84638368;84587668;50700;
09.02.2019;10:44:05;84638451;84587780;50671;
09.02.2019;10:45:10;84638549;84587959;50590;
09.02.2019;10:46:04;84638643;84588079;50564;
09.02.2019;10:47:04;84638723;84588222;50501;
09.02.2019;10:48:05;84638826;84588374;50452;
09.02.2019;10:49:04;84638928;84588518;50410;
09.02.2019;10:50:04;84638996;84588656;50340;
09.02.2019;10:51:05;84639074;84588779;50295;
09.02.2019;10:52:05;84639159;84588944;50215;
09.02.2019;10:53:06;84639243;84589088;50155;
09.02.2019;10:54:05;84639323;84589214;50109;
09.02.2019;10:55:07;84639423;84589333;50090;
09.02.2019;10:56:05;84639503;84589469;50034;
09.02.2019;10:57:05;84639631;84589595;50036;
09.02.2019;10:58:06;84639732;84589739;49993;
09.02.2019;10:59:05;84639823;84589893;49930;
09.02.2019;11:00:06;84639898;84590057;49841;
09.02.2019;11:01:06;84640001;84590208;49793;
09.02.2019;11:02:08;84640094;84590360;49734;
09.02.2019;11:03:04;84640172;84590496;49676;
09.02.2019;11:04:04;84640262;84590629;49633;
09.02.2019;11:05:05;84640356;84590781;49575;
09.02.2019;11:06:06;84640457;84590931;49526;
09.02.2019;11:07:05;84640525;84591069;49456;
09.02.2019;11:08:05;84640599;84591215;49384;
09.02.2019;11:09:06;84640692;84591365;49327;
09.02.2019;11:10:04;84640760;84591528;49232;
09.02.2019;11:11:06;84640839;84591658;49181;
09.02.2019;11:12:05;84640920;84591830;49090;
09.02.2019;11:13:05;84641028;84591959;49069;
09.02.2019;11:14:05;84641111;84592090;49021;
09.02.2019;11:15:10;84641194;84592240;48954;
09.02.2019;11:16:05;84641265;84592360;48905;
09.02.2019;11:17:05;84641363;84592526;48837;
09.02.2019;11:18:05;84641468;84592683;48785;
09.02.2019;11:19:04;84641565;84592823;48742;
09.02.2019;11:20:04;84641663;84592963;48700;
09.02.2019;11:21:05;84641775;84593108;48667;
09.02.2019;11:22:05;84641855;84593248;48607;
09.02.2019;11:23:07;84641967;84593404;48563;
09.02.2019;11:24:06;84642051;84593555;48496;
09.02.2019;11:25:05;84642153;84593686;48467;
09.02.2019;11:26:06;84642245;84593831;48414;
09.02.2019;11:27:05;84642356;84593978;48378;
09.02.2019;11:28:09;84642422;84594161;48261;
09.02.2019;11:29:04;84642510;84594314;48196;
09.02.2019;11:30:05;84642595;84594487;48108;
09.02.2019;11:31:05;84642699;84594632;48067;
09.02.2019;11:32:05;84642789;84594782;48007;
09.02.2019;11:33:05;84642879;84594923;47956;
09.02.2019;11:34:04;84642961;84595075;47886;
09.02.2019;11:35:05;84643076;84595224;47852;
09.02.2019;11:36:05;84643142;84595366;47776;
09.02.2019;11:37:05;84643240;84595513;47727;
09.02.2019;11:38:06;84643322;84595679;47643;
09.02.2019;11:39:12;84643416;84595843;47573;
09.02.2019;11:40:06;84643515;84595996;47519;
09.02.2019;11:41:05;84643579;84596133;47446;
09.02.2019;11:42:06;84643678;84596274;47404;
09.02.2019;11:43:05;84643759;84596394;47365;
09.02.2019;11:44:04;84643836;84596520;47316;
09.02.2019;11:45:05;84643911;84596664;47247;
09.02.2019;11:46:05;84643971;84596817;47154;
09.02.2019;11:47:04;84644071;84596957;47114;
09.02.2019;11:48:04;84644182;84597098;47084;
09.02.2019;11:49:04;84644247;84597241;47006;
09.02.2019;11:50:05;84644380;84597386;46994;
09.02.2019;11:51:05;84644482;84597530;46952;
09.02.2019;11:52:04;84644561;84597682;46879;
09.02.2019;11:53:04;84644658;84597830;46828;
09.02.2019;11:54:05;84644759;84597985;46774;
09.02.2019;11:55:06;84644835;84598138;46697;
09.02.2019;11:56:04;84644915;84598276;46639;
09.02.2019;11:57:05;84645000;84598408;46592;
09.02.2019;11:58:06;84645103;84598573;46530;
09.02.2019;11:59:04;84645202;84598748;46454;
09.02.2019;12:00:04;84645276;84598900;46376;
09.02.2019;12:01:05;84645372;84599021;46351;
09.02.2019;12:02:05;84645455;84599159;46296;
09.02.2019;12:03:04;84645521;84599311;46210;
09.02.2019;12:04:05;84645606;84599453;46153;
09.02.2019;12:05:12;84645688;84599595;46093;
09.02.2019;12:06:05;84645769;84599732;46037;
09.02.2019;12:07:06;84645872;84599885;45987;
09.02.2019;12:08:05;84645954;84600039;45915;
09.02.2019;12:09:08;84645996;84600137;45859;
09.02.2019;12:10:05;84646034;84600275;45759;
09.02.2019;12:11:06;84646087;84600421;45666;
09.02.2019;12:12:05;84646146;84600560;45586;
09.02.2019;12:13:05;84646158;84600689;45469;
09.02.2019;12:14:05;84646257;84600817;45440;
09.02.2019;12:15:06;84646306;84600942;45364;
09.02.2019;12:16:05;84646356;84601064;45292;
09.02.2019;12:17:06;84646416;84601162;45254;
09.02.2019;12:18:05;84646477;84601307;45170;
09.02.2019;12:19:05;84646564;84601434;45130;
09.02.2019;12:20:05;84646640;84601569;45071;
09.02.2019;12:21:06;84646747;84601715;45032;
09.02.2019;12:22:05;84646829;84601852;44977;
09.02.2019;12:23:05;84646927;84601989;44938;
09.02.2019;12:24:04;84647046;84602136;44910;
09.02.2019;12:25:04;84647137;84602258;44879;
09.02.2019;12:26:05;84647228;84602408;44820;
09.02.2019;12:27:05;84647330;84602545;44785;
09.02.2019;12:28:04;84647405;84602699;44706;
09.02.2019;12:29:05;84647509;84602849;44660;
09.02.2019;12:30:06;84647601;84602987;44614;
09.02.2019;12:31:06;84647707;84603136;44571;
09.02.2019;12:32:05;84647802;84603273;44529;
09.02.2019;12:33:05;84647884;84603463;44421;
09.02.2019;12:34:05;84647979;84603601;44378;
09.02.2019;12:35:05;84648090;84603719;44371;
09.02.2019;12:36:06;84648180;84603871;44309;
09.02.2019;12:37:05;84648276;84603991;44285;
09.02.2019;12:38:06;84648361;84604128;44233;
09.02.2019;12:39:07;84648473;84604291;44182;
09.02.2019;12:40:05;84648575;84604444;44131;
09.02.2019;12:41:05;84648645;84604586;44059;
09.02.2019;12:42:05;84648735;84604727;44008;
09.02.2019;12:43:04;84648821;84604862;43959;
09.02.2019;12:44:06;84648925;84605005;43920;
09.02.2019;12:45:06;84649014;84605166;43848;
09.02.2019;12:46:05;84649124;84605327;43797;
09.02.2019;12:47:05;84649225;84605487;43738;
09.02.2019;12:48:05;84649313;84605653;43660;
09.02.2019;12:49:05;84649437;84605811;43626;
09.02.2019;12:50:05;84649497;84605935;43562;
09.02.2019;12:51:05;84649407;84605818;43589;
09.02.2019;12:52:04;84649186;84605222;43964;
09.02.2019;12:53:05;84649257;84605382;43875;
09.02.2019;12:55:04;84649443;84605672;43771;
09.02.2019;12:56:05;84649543;84605845;43698;
09.02.2019;12:57:05;84649636;84605963;43673;
09.02.2019;12:58:04;84649750;84606133;43617;
09.02.2019;12:59:04;84649857;84606277;43580;
09.02.2019;13:00:04;84649950;84606425;43525;
09.02.2019;13:01:04;84650054;84606568;43486;
09.02.2019;13:02:05;84650158;84606695;43463;
09.02.2019;13:03:04;84650267;84606816;43451;
09.02.2019;13:04:04;84650368;84606952;43416;
09.02.2019;13:05:05;84650460;84607114;43346;
09.02.2019;13:06:05;84650548;84607239;43309;
09.02.2019;13:07:04;84650635;84607385;43250;
09.02.2019;13:08:04;84650748;84607523;43225;
09.02.2019;13:09:06;84650843;84607678;43165;
09.02.2019;13:10:05;84650934;84607815;43119;
09.02.2019;13:11:04;84651006;84607939;43067;
09.02.2019;13:12:05;84651134;84608089;43045;
09.02.2019;13:13:05;84651251;84608242;43009;
09.02.2019;13:14:05;84651331;84608392;42939;
09.02.2019;13:15:05;84651405;84608531;42874;
09.02.2019;13:16:05;84651511;84608704;42807;
09.02.2019;13:17:07;84651586;84608859;42727;
09.02.2019;13:18:05;84651700;84608985;42715;
09.02.2019;13:19:05;84651802;84609137;42665;
09.02.2019;13:20:05;84651890;84609260;42630;
09.02.2019;13:21:04;84651980;84609424;42556;
09.02.2019;13:22:04;84652100;84609578;42522;
09.02.2019;13:23:06;84652181;84609730;42451;
09.02.2019;13:24:05;84652291;84609877;42414;
09.02.2019;13:25:05;84652403;84610045;42358;
09.02.2019;13:26:05;84652491;84610176;42315;
09.02.2019;13:27:06;84652587;84610325;42262;
09.02.2019;13:28:05;84652700;84610497;42203;
09.02.2019;13:29:05;84652804;84610651;42153;
09.02.2019;13:30:05;84652886;84610800;42086;
09.02.2019;13:31:06;84652998;84610944;42054;
09.02.2019;13:32:05;84653109;84611109;42000;
09.02.2019;13:33:05;84653218;84611272;41946;
09.02.2019;13:34:05;84653340;84611398;41942;
09.02.2019;13:35:06;84653436;84611550;41886;
09.02.2019;13:36:05;84653527;84611722;41805;
09.02.2019;13:37:05;84653626;84611876;41750;
09.02.2019;13:38:05;84653737;84612028;41709;
09.02.2019;13:39:10;84653833;84612173;41660;
09.02.2019;13:40:05;84653914;84612307;41607;
09.02.2019;13:41:06;84654021;84612479;41542;
09.02.2019;13:42:05;84654118;84612627;41491;
09.02.2019;13:43:06;84654211;84612770;41441;
09.02.2019;13:44:05;84654292;84612917;41375;
09.02.2019;13:45:06;84654401;84613069;41332;
09.02.2019;13:46:05;84654502;84613207;41295;
09.02.2019;13:47:12;84654616;84613362;41254;
09.02.2019;13:48:06;84654709;84613475;41234;
09.02.2019;13:49:05;84654826;84613629;41197;
09.02.2019;13:50:04;84654914;84613776;41138;
09.02.2019;13:51:11;84655000;84613972;41028;
09.02.2019;13:52:06;84655100;84614101;40999;
09.02.2019;13:53:12;84655209;84614253;40956;
09.02.2019;13:54:05;84655316;84614398;40918;
09.02.2019;13:55:06;84655417;84614556;40861;
09.02.2019;13:56:06;84655526;84614719;40807;
09.02.2019;13:57:04;84655627;84614858;40769;
09.02.2019;13:58:05;84655719;84615029;40690;
09.02.2019;13:59:05;84655807;84615165;40642;
09.02.2019;14:00:05;84655916;84615301;40615;
09.02.2019;14:01:05;84656000;84615437;40563;
09.02.2019;14:02:06;84656085;84615604;40481;
09.02.2019;14:03:05;84656185;84615761;40424;
09.02.2019;14:04:05;84656300;84615917;40383;
09.02.2019;14:05:05;84656400;84616072;40328;
09.02.2019;14:06:05;84656512;84616211;40301;
09.02.2019;14:07:05;84656601;84616385;40216;
09.02.2019;14:08:05;84656713;84616544;40169;
09.02.2019;14:09:05;84656795;84616691;40104;
09.02.2019;14:10:05;84656872;84616842;40030;
09.02.2019;14:11:05;84656963;84616974;39989;
09.02.2019;14:12:05;84657048;84617112;39936;
09.02.2019;14:13:05;84657141;84617272;39869;
09.02.2019;14:14:05;84657240;84617417;39823;
09.02.2019;14:15:05;84657337;84617581;39756;
09.02.2019;14:16:06;84657462;84617757;39705;
09.02.2019;14:17:05;84657589;84617910;39679;
09.02.2019;14:18:05;84657687;84618053;39634;
09.02.2019;14:19:06;84657777;84618214;39563;
09.02.2019;14:20:06;84657884;84618294;39590;
09.02.2019;14:21:05;84657975;84618484;39491;
09.02.2019;14:22:05;84658046;84618668;39378;
09.02.2019;14:23:06;84658104;84618811;39293;
09.02.2019;14:24:06;84658181;84618960;39221;
09.02.2019;14:25:05;84658272;84619100;39172;
09.02.2019;14:26:05;84658344;84619252;39092;
09.02.2019;14:27:05;84658439;84619405;39034;
09.02.2019;14:28:04;84658548;84619584;38964;
09.02.2019;14:29:05;84658653;84619767;38886;
09.02.2019;14:30:05;84658794;84619923;38871;
09.02.2019;14:31:04;84658902;84620060;38842;
09.02.2019;14:32:05;84659013;84620255;38758;
09.02.2019;14:33:05;84659137;84620407;38730;
09.02.2019;14:34:04;84659254;84620582;38672;
09.02.2019;14:35:04;84659367;84620744;38623;
09.02.2019;14:36:04;84659505;84620904;38601;
09.02.2019;14:37:05;84659621;84621080;38541;
09.02.2019;14:38:04;84659736;84621252;38484;
09.02.2019;14:39:07;84659862;84621430;38432;
09.02.2019;14:40:04;84659961;84621572;38389;
09.02.2019;14:41:04;84660079;84621732;38347;
09.02.2019;14:42:05;84660204;84621891;38313;
09.02.2019;14:43:04;84660335;84622047;38288;
09.02.2019;14:44:04;84660460;84622223;38237;
09.02.2019;14:45:05;84660588;84622397;38191;
09.02.2019;14:46:05;84660712;84622543;38169;
09.02.2019;14:47:04;84660848;84622706;38142;
09.02.2019;14:48:05;84660966;84622877;38089;
09.02.2019;14:49:04;84661085;84623044;38041;
09.02.2019;14:50:05;84661195;84623230;37965;
09.02.2019;14:51:04;84661318;84623420;37898;
09.02.2019;14:52:05;84661456;84623586;37870;
09.02.2019;14:53:05;84661590;84623775;37815;
09.02.2019;14:54:05;84661711;84623945;37766;
09.02.2019;14:55:04;84661842;84624128;37714;
09.02.2019;14:56:04;84661975;84624294;37681;
09.02.2019;14:57:05;84662098;84624478;37620;
09.02.2019;14:58:05;84662211;84624650;37561;
09.02.2019;14:59:10;84662374;84624832;37542;
09.02.2019;15:00:07;84662476;84624996;37480;
09.02.2019;15:01:08;84662618;84625174;37444;
09.02.2019;15:02:08;84662724;84625350;37374;
09.02.2019;15:03:13;84662861;84625541;37320;
09.02.2019;15:04:08;84662969;84625679;37290;
09.02.2019;15:05:08;84663111;84625851;37260;
09.02.2019;15:06:07;84663235;84626016;37219;
09.02.2019;15:07:07;84663347;84626166;37181;
09.02.2019;15:08:07;84663475;84626321;37154;
09.02.2019;15:09:07;84663619;84626552;37067;
09.02.2019;15:10:13;84663726;84626747;36979;
09.02.2019;15:11:08;84663846;84626897;36949;
09.02.2019;15:13:09;84664130;84627230;36900;
09.02.2019;15:14:09;84664235;84627390;36845;
09.02.2019;15:15:08;84664345;84627538;36807;
09.02.2019;15:16:09;84664488;84627722;36766;
09.02.2019;15:17:07;84664642;84627886;36756;
09.02.2019;15:18:08;84664791;84628056;36735;
09.02.2019;15:19:13;84664917;84628251;36666;
09.02.2019;15:20:08;84665046;84628380;36666;
09.02.2019;15:21:07;84665170;84628585;36585;
09.02.2019;15:22:09;84665314;84628773;36541;
09.02.2019;15:23:08;84665435;84628955;36480;
09.02.2019;15:24:11;84665539;84629137;36402;
09.02.2019;15:25:10;84665692;84629318;36374;
09.02.2019;15:26:08;84665830;84629479;36351;
09.02.2019;15:27:09;84665927;84629661;36266;
09.02.2019;15:28:08;84666068;84629859;36209;
09.02.2019;15:29:10;84666239;84630049;36190;
09.02.2019;15:30:09;84666384;84630209;36175;
09.02.2019;15:31:10;84666518;84630400;36118;
09.02.2019;15:32:09;84666657;84630599;36058;
09.02.2019;15:33:10;84666807;84630789;36018;
09.02.2019;15:34:08;84666938;84630934;36004;
09.02.2019;15:35:08;84667092;84631111;35981;
09.02.2019;15:36:08;84667244;84631284;35960;
09.02.2019;15:37:08;84667419;84631462;35957;
09.02.2019;15:38:09;84667556;84631646;35910;
09.02.2019;15:39:07;84667692;84631805;35887;
09.02.2019;15:40:09;84667836;84631996;35840;
09.02.2019;15:41:14;84667959;84632151;35808;
09.02.2019;15:42:10;84668083;84632319;35764;
09.02.2019;15:43:07;84668201;84632508;35693;
09.02.2019;15:44:08;84668357;84632695;35662;
09.02.2019;15:45:07;84668498;84632875;35623;
09.02.2019;15:46:13;84668669;84633058;35611;
09.02.2019;15:47:12;84668812;84633229;35583;
09.02.2019;15:48:11;84668957;84633391;35566;
09.02.2019;15:49:13;84669075;84633566;35509;
09.02.2019;15:50:10;84669208;84633730;35478;
09.02.2019;15:51:07;84669386;84633878;35508;
09.02.2019;15:52:09;84669541;84634037;35504;
09.02.2019;15:53:08;84669648;84634173;35475;
09.02.2019;15:54:10;84669794;84634358;35436;
09.02.2019;15:55:09;84669932;84634545;35387;
09.02.2019;15:56:07;84670085;84634694;35391;
09.02.2019;15:57:08;84670218;84634882;35336;
09.02.2019;15:58:08;84670358;84635076;35282;
09.02.2019;15:59:09;84670494;84635260;35234;
09.02.2019;16:00:05;84670650;84635439;35211;
09.02.2019;16:01:06;84670792;84635629;35163;
09.02.2019;16:02:04;84670949;84635798;35151;
09.02.2019;16:03:05;84671087;84635963;35124;
09.02.2019;16:04:08;84671217;84636151;35066;
09.02.2019;16:05:05;84671348;84636340;35008;
09.02.2019;16:06:06;84671485;84636513;34972;
09.02.2019;16:07:05;84671629;84636706;34923;
09.02.2019;16:08:06;84671762;84636883;34879;
09.02.2019;16:09:07;84671882;84637049;34833;
09.02.2019;16:10:06;84672000;84637208;34792;
09.02.2019;16:11:04;84672151;84637384;34767;
09.02.2019;16:12:04;84672284;84637535;34749;
09.02.2019;16:13:05;84672407;84637698;34709;
09.02.2019;16:14:04;84672563;84637855;34708;
09.02.2019;16:15:05;84672721;84638027;34694;
09.02.2019;16:16:05;84672872;84638231;34641;
09.02.2019;16:17:05;84673020;84638394;34626;
09.02.2019;16:18:05;84673139;84638541;34598;
09.02.2019;16:19:06;84673291;84638699;34592;
09.02.2019;16:20:06;84673442;84638892;34550;
09.02.2019;16:21:05;84673582;84639087;34495;
09.02.2019;16:22:04;84673706;84639258;34448;
09.02.2019;16:23:04;84673844;84639458;34386;
09.02.2019;16:24:05;84673969;84639580;34389;
09.02.2019;16:25:04;84674109;84639747;34362;
09.02.2019;16:26:06;84674238;84639924;34314;
09.02.2019;16:27:05;84674366;84640081;34285;
09.02.2019;16:28:04;84674518;84640243;34275;
09.02.2019;16:29:04;84674666;84640436;34230;
09.02.2019;16:30:04;84674802;84640617;34185;
09.02.2019;16:31:04;84674933;84640818;34115;
09.02.2019;16:32:05;84675087;84641006;34081;
09.02.2019;16:33:05;84675190;84641165;34025;
09.02.2019;16:34:06;84675316;84641364;33952;
09.02.2019;16:35:05;84675484;84641510;33974;
09.02.2019;16:36:05;84675606;84641681;33925;
09.02.2019;16:37:04;84675768;84641870;33898;
09.02.2019;16:38:04;84675951;84642033;33918;
09.02.2019;16:39:07;84676147;84642240;33907;
09.02.2019;16:40:05;84676312;84642416;33896;
09.02.2019;16:41:05;84676450;84642592;33858;
09.02.2019;16:42:06;84676593;84642765;33828;
09.02.2019;16:43:04;84676726;84642975;33751;
09.02.2019;16:44:04;84676876;84643149;33727;
09.02.2019;16:45:05;84677045;84643350;33695;
09.02.2019;16:46:05;84677187;84643528;33659;
09.02.2019;16:47:04;84677344;84643728;33616;
09.02.2019;16:48:05;84677498;84643919;33579;
09.02.2019;16:49:05;84677640;84644111;33529;
09.02.2019;16:50:05;84677805;84644267;33538;
09.02.2019;16:51:06;84677967;84644488;33479;
09.02.2019;16:52:06;84678111;84644681;33430;
09.02.2019;16:53:04;84678249;84644857;33392;
09.02.2019;16:54:04;84678391;84645045;33346;
09.02.2019;16:55:05;84678556;84645226;33330;
09.02.2019;16:56:05;84678704;84645398;33306;
09.02.2019;16:57:05;84678882;84645596;33286;
09.02.2019;16:58:04;84679042;84645783;33259;
09.02.2019;16:59:05;84679161;84645988;33173;
09.02.2019;17:00:04;84679317;84646180;33137;
09.02.2019;17:01:04;84679482;84646371;33111;
09.02.2019;17:02:04;84679627;84646562;33065;
09.02.2019;17:03:06;84679749;84646762;32987;
09.02.2019;17:04:05;84679940;84646943;32997;
09.02.2019;17:05:06;84680122;84647127;32995;
09.02.2019;17:06:05;84680282;84647289;32993;
09.02.2019;17:07:06;84680441;84647495;32946;
09.02.2019;17:08:04;84680577;84647677;32900;
09.02.2019;17:09:07;84680758;84647896;32862;
09.02.2019;17:10:05;84680930;84648071;32859;
09.02.2019;17:11:05;84681102;84648258;32844;
09.02.2019;17:12:05;84681286;84648438;32848;
09.02.2019;17:13:04;84681449;84648600;32849;
09.02.2019;17:14:05;84681592;84648748;32844;
09.02.2019;17:15:05;84681734;84648916;32818;
09.02.2019;17:16:05;84681890;84649102;32788;
09.02.2019;17:17:05;84682050;84649268;32782;
09.02.2019;17:18:04;84682226;84649478;32748;
09.02.2019;17:19:04;84682359;84649669;32690;
09.02.2019;17:20:06;84682514;84649855;32659;
09.02.2019;17:21:05;84682664;84650037;32627;
09.02.2019;17:22:05;84682826;84650234;32592;
09.02.2019;17:23:05;84682998;84650394;32604;
09.02.2019;17:24:05;84683163;84650581;32582;
09.02.2019;17:25:04;84683314;84650747;32567;
09.02.2019;17:26:05;84683467;84650931;32536;
09.02.2019;17:27:05;84683617;84651122;32495;
09.02.2019;17:28:04;84683777;84651292;32485;
09.02.2019;17:29:04;84683951;84651486;32465;
09.02.2019;17:30:04;84684087;84651694;32393;
09.02.2019;17:31:05;84684276;84651870;32406;
09.02.2019;17:32:05;84684400;84652059;32341;
09.02.2019;17:33:04;84684585;84652234;32351;
09.02.2019;17:34:06;84684745;84652388;32357;
09.02.2019;17:35:04;84684877;84652556;32321;
09.02.2019;17:36:04;84685042;84652738;32304;
09.02.2019;17:37:05;84685187;84652908;32279;
09.02.2019;17:38:05;84685333;84653085;32248;
09.02.2019;17:39:07;84685516;84653276;32240;
09.02.2019;17:40:05;84685664;84653450;32214;
09.02.2019;17:41:05;84685877;84653630;32247;
09.02.2019;17:42:06;84686043;84653788;32255;
09.02.2019;17:43:05;84686227;84653978;32249;
09.02.2019;17:44:05;84686399;84654150;32249;
09.02.2019;17:45:04;84686566;84654346;32220;
09.02.2019;17:46:04;84686697;84654539;32158;
09.02.2019;17:47:05;84686843;84654727;32116;
09.02.2019;17:48:04;84687039;84654900;32139;
09.02.2019;17:49:05;84687198;84655088;32110;
09.02.2019;17:50:04;84687379;84655260;32119;
09.02.2019;17:51:05;84687530;84655445;32085;
09.02.2019;17:52:05;84687680;84655634;32046;
09.02.2019;17:53:04;84687825;84655817;32008;
09.02.2019;17:54:05;84687989;84655980;32009;
09.02.2019;17:55:05;84688130;84656160;31970;
09.02.2019;17:56:05;84688301;84656304;31997;
09.02.2019;17:57:05;84688447;84656438;32009;
09.02.2019;17:58:04;84688623;84656632;31991;
09.02.2019;17:59:04;84688782;84656773;32009;
09.02.2019;18:00:04;84688951;84656943;32008;
09.02.2019;18:01:05;84689106;84657125;31981;
09.02.2019;18:02:05;84689297;84657302;31995;
09.02.2019;18:03:05;84689461;84657464;31997;
09.02.2019;18:04:05;84689638;84657602;32036;
09.02.2019;18:05:05;84689807;84657766;32041;
09.02.2019;18:06:05;84689968;84657933;32035;
09.02.2019;18:07:04;84690147;84658090;32057;
09.02.2019;18:08:04;84690299;84658239;32060;
09.02.2019;18:09:07;84690469;84658436;32033;
09.02.2019;18:10:05;84690643;84658609;32034;
09.02.2019;18:11:04;84690814;84658761;32053;
09.02.2019;18:12:04;84690957;84658928;32029;
09.02.2019;18:13:04;84691082;84659095;31987;
09.02.2019;18:14:04;84691227;84659237;31990;
09.02.2019;18:15:05;84691357;84659392;31965;
09.02.2019;18:16:05;84691483;84659542;31941;
09.02.2019;18:17:05;84691621;84659702;31919;
09.02.2019;18:18:05;84691753;84659842;31911;
09.02.2019;18:19:05;84691911;84659993;31918;
09.02.2019;18:20:04;84692008;84660142;31866;
09.02.2019;18:21:04;84692133;84660252;31881;
09.02.2019;18:22:05;84692253;84660388;31865;
09.02.2019;18:23:05;84692382;84660562;31820;
09.02.2019;18:24:04;84692499;84660721;31778;
09.02.2019;18:25:04;84692627;84660886;31741;
09.02.2019;18:26:05;84692725;84661024;31701;
09.02.2019;18:27:05;84692848;84661175;31673;
09.02.2019;18:28:05;84692980;84661340;31640;
09.02.2019;18:29:04;84693098;84661491;31607;
09.02.2019;18:30:04;84693198;84661599;31599;
09.02.2019;18:31:05;84693367;84661778;31589;
09.02.2019;18:32:05;84693528;84661908;31620;
09.02.2019;18:33:04;84693666;84662045;31621;
09.02.2019;18:34:05;84693792;84662222;31570;
09.02.2019;18:35:05;84693924;84662368;31556;
09.02.2019;18:36:05;84694055;84662499;31556;
09.02.2019;18:37:04;84694198;84662613;31585;
09.02.2019;18:38:04;84694340;84662741;31599;
09.02.2019;18:39:08;84694498;84662901;31597;
09.02.2019;18:40:05;84694641;84663041;31600;
09.02.2019;18:41:05;84694701;84663105;31596;
09.02.2019;18:42:05;84694851;84663235;31616;
09.02.2019;18:43:05;84695024;84663371;31653;
09.02.2019;18:44:05;84695198;84663492;31706;
09.02.2019;18:45:05;84695385;84663640;31745;
09.02.2019;18:46:04;84695544;84663787;31757;
09.02.2019;18:47:04;84695697;84663940;31757;
09.02.2019;18:48:05;84695841;84664089;31752;
09.02.2019;18:49:05;84695966;84664245;31721;
09.02.2019;18:50:06;84696154;84664381;31773;
09.02.2019;18:51:05;84696325;84664535;31790;
09.02.2019;18:52:06;84696489;84664659;31830;
09.02.2019;18:53:05;84696634;84664793;31841;
09.02.2019;18:54:05;84696782;84664917;31865;
09.02.2019;18:55:05;84696956;84665060;31896;
09.02.2019;18:56:06;84697127;84665201;31926;
09.02.2019;18:57:05;84697263;84665341;31922;
09.02.2019;18:58:06;84697430;84665506;31924;
09.02.2019;18:59:05;84697576;84665642;31934;
09.02.2019;19:00:05;84697749;84665797;31952;
09.02.2019;19:01:05;84697935;84665944;31991;
09.02.2019;19:02:05;84698117;84666067;32050;
09.02.2019;19:03:05;84698278;84666220;32058;
09.02.2019;19:04:04;84698421;84666346;32075;
09.02.2019;19:05:05;84698578;84666490;32088;
09.02.2019;19:06:15;84698765;84666634;32131;
09.02.2019;19:07:06;84698941;84666739;32202;
09.02.2019;19:08:05;84699102;84666866;32236;
09.02.2019;19:09:06;84699230;84667005;32225;
09.02.2019;19:10:04;84699373;84667123;32250;
09.02.2019;19:11:05;84699544;84667246;32298;
09.02.2019;19:12:05;84699691;84667375;32316;
09.02.2019;19:13:05;84699850;84667501;32349;
09.02.2019;19:14:04;84700000;84667627;32373;
09.02.2019;19:15:04;84700167;84667772;32395;
09.02.2019;19:16:05;84700337;84667920;32417;
09.02.2019;19:17:05;84700507;84668046;32461;
09.02.2019;19:18:05;84700674;84668185;32489;
09.02.2019;19:19:04;84700820;84668324;32496;
09.02.2019;19:20:04;84700982;84668443;32539;
09.02.2019;19:21:05;84701151;84668587;32564;
09.02.2019;19:22:05;84701300;84668718;32582;
09.02.2019;19:23:05;84701456;84668823;32633;
09.02.2019;19:24:05;84701610;84668933;32677;
09.02.2019;19:25:05;84701779;84669050;32729;
09.02.2019;19:26:05;84701949;84669185;32764;
09.02.2019;19:27:05;84702089;84669302;32787;
09.02.2019;19:28:04;84702232;84669432;32800;
09.02.2019;19:29:05;84702371;84669543;32828;
09.02.2019;19:30:05;84702512;84669652;32860;
09.02.2019;19:31:05;84702671;84669764;32907;
09.02.2019;19:32:04;84702782;84669853;32929;
09.02.2019;19:33:05;84702949;84669970;32979;
09.02.2019;19:34:05;84703070;84670098;32972;
09.02.2019;19:35:05;84703239;84670239;33000;
09.02.2019;19:36:06;84703396;84670355;33041;
09.02.2019;19:37:05;84703549;84670450;33099;
09.02.2019;19:38:06;84703710;84670546;33164;
09.02.2019;19:39:07;84703879;84670655;33224;
09.02.2019;19:40:05;84704043;84670766;33277;
09.02.2019;19:41:06;84704195;84670875;33320;
09.02.2019;19:42:06;84704375;84670986;33389;
09.02.2019;19:43:05;84704526;84671100;33426;
09.02.2019;19:44:05;84704682;84671232;33450;
09.02.2019;19:45:05;84704840;84671350;33490;
09.02.2019;19:46:04;84704986;84671477;33509;
09.02.2019;19:47:04;84705133;84671574;33559;
09.02.2019;19:48:05;84705289;84671686;33603;
09.02.2019;19:49:05;84705455;84671783;33672;
09.02.2019;19:50:05;84705619;84671865;33754;
09.02.2019;19:51:04;84705761;84671961;33800;
09.02.2019;19:52:05;84705913;84672051;33862;
09.02.2019;19:53:05;84706061;84672162;33899;
09.02.2019;19:54:05;84706226;84672256;33970;
09.02.2019;19:55:05;84706371;84672350;34021;
09.02.2019;19:56:04;84706549;84672460;34089;
09.02.2019;19:57:04;84706694;84672598;34096;
09.02.2019;19:58:05;84706862;84672697;34165;
09.02.2019;19:59:06;84707015;84672789;34226;
09.02.2019;20:00:05;84707178;84672876;34302;
09.02.2019;20:01:06;84707343;84672965;34378;
09.02.2019;20:02:05;84707518;84673071;34447;
09.02.2019;20:03:06;84707698;84673156;34542;
09.02.2019;20:04:06;84707850;84673245;34605;
09.02.2019;20:05:05;84707979;84673348;34631;
09.02.2019;20:06:04;84708132;84673436;34696;
09.02.2019;20:07:04;84708277;84673523;34754;
09.02.2019;20:08:04;84708428;84673637;34791;
09.02.2019;20:09:07;84708576;84673708;34868;
09.02.2019;20:10:05;84708715;84673808;34907;
09.02.2019;20:11:05;84708831;84673883;34948;
09.02.2019;20:12:06;84708937;84673938;34999;
09.02.2019;20:13:06;84709079;84674010;35069;
09.02.2019;20:14:05;84709242;84674071;35171;
09.02.2019;20:15:05;84709372;84674122;35250;
09.02.2019;20:16:05;84709514;84674184;35330;
09.02.2019;20:17:05;84709648;84674238;35410;
09.02.2019;20:18:05;84709741;84674309;35432;
09.02.2019;20:19:04;84709816;84674366;35450;
09.02.2019;20:20:05;84709912;84674458;35454;
09.02.2019;20:21:06;84710012;84674515;35497;
09.02.2019;20:22:05;84710118;84674575;35543;
09.02.2019;20:23:05;84710229;84674652;35577;
09.02.2019;20:24:05;84710367;84674728;35639;
09.02.2019;20:25:05;84710473;84674777;35696;
09.02.2019;20:26:06;84710620;84674825;35795;
09.02.2019;20:27:05;84710742;84674922;35820;
09.02.2019;20:28:06;84710901;84675000;35901;
09.02.2019;20:29:05;84711035;84675064;35971;
09.02.2019;20:30:04;84711162;84675122;36040;
09.02.2019;20:31:04;84711281;84675197;36084;
09.02.2019;20:32:05;84711423;84675263;36160;
09.02.2019;20:33:05;84711567;84675339;36228;
09.02.2019;20:34:04;84711702;84675405;36297;
09.02.2019;20:35:06;84711841;84675463;36378;
09.02.2019;20:36:05;84711983;84675506;36477;
09.02.2019;20:37:06;84712134;84675581;36553;
09.02.2019;20:38:05;84712286;84675635;36651;
09.02.2019;20:39:07;84712446;84675699;36747;
09.02.2019;20:40:05;84712580;84675764;36816;
09.02.2019;20:41:04;84712735;84675833;36902;
09.02.2019;20:42:04;84712858;84675911;36947;
09.02.2019;20:43:05;84712999;84675992;37007;
09.02.2019;20:44:05;84713161;84676053;37108;
09.02.2019;20:45:05;84713297;84676111;37186;
09.02.2019;20:46:10;84713463;84676173;37290;
09.02.2019;20:47:05;84713602;84676242;37360;
09.02.2019;20:48:05;84713756;84676304;37452;
09.02.2019;20:49:05;84713911;84676368;37543;
09.02.2019;20:50:05;84714043;84676435;37608;
09.02.2019;20:51:06;84714184;84676519;37665;
09.02.2019;20:52:05;84714329;84676584;37745;
09.02.2019;20:53:05;84714459;84676641;37818;
09.02.2019;20:54:04;84711069;84683134;27935;
09.02.2019;20:55:05;84711233;84683197;28036;
09.02.2019;20:56:05;84711396;84683285;28111;
09.02.2019;20:57:05;84711552;84683362;28190;
09.02.2019;20:58:06;84711720;84683433;28287;
09.02.2019;20:59:05;84711867;84683515;28352;
09.02.2019;21:00:05;84712069;84683574;28495;
09.02.2019;21:01:05;84712254;84683659;28595;
09.02.2019;21:02:10;84712417;84683732;28685;
09.02.2019;21:03:05;84712547;84683803;28744;
09.02.2019;21:04:06;84712749;84683859;28890;
09.02.2019;21:05:05;84712905;84683926;28979;
09.02.2019;21:06:06;84713035;84684007;29028;
09.02.2019;21:07:05;84713226;84684066;29160;
09.02.2019;21:08:06;84713400;84684148;29252;
09.02.2019;21:09:06;84713566;84684217;29349;
09.02.2019;21:10:06;84713728;84684287;29441;
09.02.2019;21:11:05;84713912;84684353;29559;
09.02.2019;21:12:04;84714077;84684423;29654;
09.02.2019;21:13:04;84714258;84684487;29771;
09.02.2019;21:14:07;84714425;84684558;29867;
09.02.2019;21:15:06;84714606;84684619;29987;
09.02.2019;21:16:05;84714765;84684686;30079;
09.02.2019;21:17:06;84714912;84684741;30171;
09.02.2019;21:18:05;84715087;84684803;30284;
09.02.2019;21:19:06;84715228;84684856;30372;
09.02.2019;21:20:06;84715360;84684903;30457;
09.02.2019;21:21:05;84715501;84684969;30532;
09.02.2019;21:22:05;84715677;84685035;30642;
09.02.2019;21:23:16;84715895;84685103;30792;
09.02.2019;21:24:07;84716044;84685159;30885;
09.02.2019;21:25:07;84716214;84685225;30989;
09.02.2019;21:26:06;84716382;84685271;31111;
09.02.2019;21:27:06;84716533;84685340;31193;
09.02.2019;21:28:05;84716698;84685408;31290;
09.02.2019;21:29:05;84716861;84685462;31399;
09.02.2019;21:30:05;84717023;84685517;31506;
09.02.2019;21:31:06;84717170;84685583;31587;
09.02.2019;21:32:06;84717335;84685638;31697;
09.02.2019;21:33:05;84717484;84685682;31802;
09.02.2019;21:34:06;84717659;84685721;31938;
09.02.2019;21:35:06;84717795;84685781;32014;
09.02.2019;21:36:05;84717921;84685835;32086;
09.02.2019;21:37:06;84718099;84685894;32205;
09.02.2019;21:38:05;84718249;84685958;32291;
09.02.2019;21:39:05;84718392;84686012;32380;
09.02.2019;21:40:05;84718549;84686075;32474;
09.02.2019;21:41:05;84718722;84686123;32599;
09.02.2019;21:42:05;84718882;84686171;32711;
09.02.2019;21:43:05;84719022;84686200;32822;
09.02.2019;21:44:05;84719161;84686260;32901;
09.02.2019;21:45:05;84719253;84686228;33025;
09.02.2019;21:46:04;84719417;84686277;33140;
09.02.2019;21:47:09;84719590;84686313;33277;
09.02.2019;21:48:04;84719733;84686367;33366;
09.02.2019;21:49:05;84719901;84686428;33473;
09.02.2019;21:50:05;84720060;84686509;33551;
09.02.2019;21:51:06;84720220;84686545;33675;
09.02.2019;21:52:04;84720362;84686590;33772;
09.02.2019;21:53:04;84720525;84686641;33884;
09.02.2019;21:54:05;84720667;84686695;33972;
09.02.2019;21:55:05;84720831;84686741;34090;
09.02.2019;21:56:05;84720947;84686778;34169;
09.02.2019;21:57:05;84721087;84686830;34257;
09.02.2019;21:58:05;84721239;84686877;34362;
09.02.2019;21:59:06;84721383;84686937;34446;
09.02.2019;22:00:05;84721552;84686979;34573;
09.02.2019;22:01:05;84721692;84687018;34674;
09.02.2019;22:02:06;84721851;84687053;34798;
09.02.2019;22:03:06;84722003;84687111;34892;
09.02.2019;22:04:05;84722152;84687142;35010;
09.02.2019;22:05:05;84722300;84687182;35118;
09.02.2019;22:06:05;84722453;84687223;35230;
09.02.2019;22:07:05;84722575;84687261;35314;
09.02.2019;22:08:06;84722696;84687307;35389;
09.02.2019;22:09:05;84722826;84687353;35473;
09.02.2019;22:10:06;84722962;84687392;35570;
09.02.2019;22:11:05;84723110;84687435;35675;
09.02.2019;22:12:06;84723234;84687481;35753;
09.02.2019;22:13:12;84723357;84687525;35832;
09.02.2019;22:14:06;84723470;84687562;35908;
09.02.2019;22:15:05;84723591;84687567;36024;
09.02.2019;22:16:07;84723703;84687620;36083;
09.02.2019;22:17:06;84723803;84687652;36151;
09.02.2019;22:18:05;84723912;84687669;36243;
09.02.2019;22:19:05;84723975;84687691;36284;
09.02.2019;22:20:06;84724061;84687728;36333;
09.02.2019;22:21:05;84724141;84687749;36392;
09.02.2019;22:22:04;84724205;84687786;36419;
09.02.2019;22:23:04;84724264;84687800;36464;
09.02.2019;22:24:08;84724373;84687829;36544;
09.02.2019;22:25:04;84724476;84687850;36626;
09.02.2019;22:26:06;84724591;84687873;36718;
09.02.2019;22:27:05;84724690;84687893;36797;
09.02.2019;22:28:09;84724779;84687936;36843;
09.02.2019;22:29:06;84724885;84687968;36917;
09.02.2019;22:30:05;84724970;84687993;36977;
09.02.2019;22:31:04;84725067;84688023;37044;
09.02.2019;22:32:08;84725159;84688054;37105;
09.02.2019;22:33:05;84725263;84688091;37172;
09.02.2019;22:34:05;84725347;84688118;37229;
09.02.2019;22:35:04;84725455;84688148;37307;
09.02.2019;22:36:08;84725587;84688191;37396;
09.02.2019;22:37:05;84725729;84688222;37507;
09.02.2019;22:38:05;84725858;84688258;37600;
09.02.2019;22:39:07;84725983;84688280;37703;
09.02.2019;22:40:08;84726137;84688326;37811;
09.02.2019;22:41:05;84726263;84688364;37899;
09.02.2019;22:42:05;84726391;84688405;37986;
09.02.2019;22:43:06;84726534;84688442;38092;
09.02.2019;22:44:08;84726650;84688467;38183;
09.02.2019;22:45:05;84726769;84688490;38279;
09.02.2019;22:46:06;84726894;84688537;38357;
09.02.2019;22:47:04;84727027;84688586;38441;
09.02.2019;22:48:07;84727191;84688612;38579;
09.02.2019;22:49:05;84727340;84688651;38689;
09.02.2019;22:50:05;84727480;84688684;38796;
09.02.2019;22:51:04;84727612;84688728;38884;
09.02.2019;22:52:07;84727763;84688771;38992;
09.02.2019;22:53:04;84727901;84688798;39103;
09.02.2019;22:54:05;84728053;84688834;39219;
09.02.2019;22:55:05;84728196;84688867;39329;
09.02.2019;22:56:08;84728322;84688905;39417;
09.02.2019;22:57:06;84728462;84688933;39529;
09.02.2019;22:58:05;84728590;84688970;39620;
09.02.2019;22:59:05;84728721;84689007;39714;
09.02.2019;23:00:07;84728859;84689037;39822;
09.02.2019;23:01:05;84728999;84689072;39927;
09.02.2019;23:02:04;84729135;84689112;40023;
09.02.2019;23:03:04;84729268;84689141;40127;
09.02.2019;23:04:06;84729404;84689170;40234;
09.02.2019;23:05:07;84729541;84689202;40339;
09.02.2019;23:06:05;84729619;84689235;40384;
09.02.2019;23:07:05;84729788;84689270;40518;
09.02.2019;23:10:05;84730181;84689376;40805;
09.02.2019;23:11:04;84730321;84689404;40917;
09.02.2019;23:12:05;84730457;84689424;41033;
09.02.2019;23:13:05;84730594;84689461;41133;
09.02.2019;23:14:05;84730727;84689493;41234;
09.02.2019;23:15:05;84730867;84689529;41338;
09.02.2019;23:16:08;84731008;84689546;41462;
09.02.2019;23:17:05;84731115;84689578;41537;
09.02.2019;23:18:05;84731251;84689619;41632;
09.02.2019;23:19:08;84731385;84689659;41726;
09.02.2019;23:20:08;84731554;84689696;41858;
09.02.2019;23:21:05;84731672;84689729;41943;
09.02.2019;23:22:05;84731829;84689759;42070;
09.02.2019;23:23:07;84731998;84689799;42199;
09.02.2019;23:24:08;84732142;84689830;42312;
09.02.2019;23:25:05;84732266;84689852;42414;
09.02.2019;23:26:05;84732403;84689882;42521;
09.02.2019;23:27:06;84732573;84689905;42668;
09.02.2019;23:28:06;84732701;84689938;42763;
09.02.2019;23:29:05;84732822;84689973;42849;
09.02.2019;23:30:05;84732966;84690014;42952;
09.02.2019;23:31:05;84733110;84690036;43074;
09.02.2019;23:32:08;84733246;84690073;43173;
09.02.2019;23:33:04;84733367;84690107;43260;
09.02.2019;23:34:05;84733500;84690137;43363;
09.02.2019;23:35:04;84733634;84690162;43472;
09.02.2019;23:36:08;84733758;84690197;43561;
09.02.2019;23:37:05;84733882;84690228;43654;
09.02.2019;23:38:05;84734030;84690254;43776;
09.02.2019;23:39:06;84734158;84690282;43876;
09.02.2019;23:40:08;84734278;84690305;43973;
09.02.2019;23:41:05;84734399;84690330;44069;
09.02.2019;23:42:04;84734528;84690358;44170;
09.02.2019;23:43:04;84734648;84690383;44265;
09.02.2019;23:44:08;84734784;84690416;44368;
09.02.2019;23:45:05;84734888;84690446;44442;
09.02.2019;23:46:06;84735012;84690492;44520;
09.02.2019;23:47:05;84735133;84690524;44609;
09.02.2019;23:48:08;84735239;84690555;44684;
09.02.2019;23:49:04;84735346;84690578;44768;
09.02.2019;23:50:05;84735483;84690599;44884;
09.02.2019;23:51:05;84735599;84690627;44972;
09.02.2019;23:52:07;84735730;84690662;45068;
09.02.2019;23:53:04;84735851;84690697;45154;
09.02.2019;23:54:04;84735985;84690733;45252;
09.02.2019;23:55:05;84736143;84690765;45378;
09.02.2019;23:56:08;84736281;84690789;45492;
09.02.2019;23:57:05;84736394;84690811;45583;
09.02.2019;23:58:04;84736544;84690835;45709;
09.02.2019;23:59:04;84736675;84690874;45801;
10.02.2019;00:00:11;84736840;84690907;45933;
10.02.2019;00:01:11;84736952;84690952;46000;
10.02.2019;00:02:10;84737070;84690980;46090;
10.02.2019;00:03:14;84737175;84691028;46147;
10.02.2019;00:04:12;84737295;84691055;46240;
10.02.2019;00:05:14;84737437;84691102;46335;
10.02.2019;00:06:10;84737552;84691130;46422;
10.02.2019;00:07:17;84737664;84691162;46502;
10.02.2019;00:08:13;84737820;84691193;46627;
10.02.2019;00:09:19;84737963;84691231;46732;
10.02.2019;00:10:13;84738053;84691243;46810;
10.02.2019;00:11:16;84738135;84691275;46860;
10.02.2019;00:12:14;84738205;84691290;46915;
10.02.2019;00:13:16;84738275;84691319;46956;
10.02.2019;00:14:16;84738333;84691342;46991;
10.02.2019;00:15:19;84738362;84691372;46990;
10.02.2019;00:16:18;84738387;84691394;46993;
10.02.2019;00:17:20;84738432;84691415;47017;
10.02.2019;00:18:20;84738480;84691436;47044;
10.02.2019;00:19:17;84738501;84691467;47034;
10.02.2019;00:20:20;84738569;84691477;47092;
10.02.2019;00:21:15;84738636;84691486;47150;
10.02.2019;00:22:19;84738736;84691508;47228;
10.02.2019;00:24:17;84738849;84691553;47296;
10.02.2019;00:25:23;84738926;84691583;47343;
10.02.2019;00:26:19;84738968;84691599;47369;
10.02.2019;00:27:22;84739021;84691608;47413;
10.02.2019;00:28:22;84739087;84691624;47463;
10.02.2019;00:29:19;84739178;84691646;47532;
10.02.2019;00:30:23;84739250;84691681;47569;
10.02.2019;00:31:21;84739305;84691708;47597;
10.02.2019;00:32:19;84739386;84691738;47648;
10.02.2019;00:33:21;84739496;84691762;47734;
10.02.2019;00:34:19;84739611;84691791;47820;
10.02.2019;00:35:22;84739730;84691822;47908;
10.02.2019;00:36:22;84739853;84691849;48004;
10.02.2019;00:37:19;84739932;84691867;48065;
10.02.2019;00:38:21;84740052;84691901;48151;
10.02.2019;00:39:25;84740164;84691925;48239;
10.02.2019;00:40:19;84740253;84691955;48298;
10.02.2019;00:41:24;84740356;84691992;48364;
10.02.2019;00:42:23;84740471;84692020;48451;
10.02.2019;00:43:23;84740577;84692040;48537;
10.02.2019;00:44:24;84740674;84692087;48587;
10.02.2019;00:45:23;84740774;84692110;48664;
10.02.2019;00:46:21;84740873;84692138;48735;
10.02.2019;00:47:25;84740934;84692123;48811;
10.02.2019;00:48:25;84741036;84692155;48881;
10.02.2019;00:49:23;84741147;84692179;48968;
10.02.2019;00:50:26;84741244;84692212;49032;
10.02.2019;00:51:23;84741358;84692234;49124;
10.02.2019;00:52:23;84741477;84692277;49200;
10.02.2019;00:53:25;84741605;84692309;49296;
10.02.2019;00:54:22;84741700;84692337;49363;
10.02.2019;00:55:24;84741798;84692374;49424;
10.02.2019;00:56:25;84741903;84692398;49505;
10.02.2019;00:57:22;84741998;84692418;49580;
10.02.2019;00:58:25;84742131;84692453;49678;
10.02.2019;00:59:24;84742237;84692480;49757;
10.02.2019;01:00:19;84742347;84692507;49840;
10.02.2019;01:01:19;84742469;84692540;49929;
10.02.2019;01:02:14;84742568;84692566;50002;
10.02.2019;01:03:04;84742648;84692603;50045;
10.02.2019;01:04:07;84742754;84692631;50123;
10.02.2019;01:05:07;84742849;84692656;50193;
10.02.2019;01:06:05;84742949;84692677;50272;
10.02.2019;01:07:04;84743046;84692706;50340;
10.02.2019;01:08:07;84743160;84692737;50423;
10.02.2019;01:09:09;84743271;84692784;50487;
10.02.2019;01:10:04;84743353;84692820;50533;
10.02.2019;01:11:05;84743446;84692849;50597;
10.02.2019;01:12:07;84743562;84692888;50674;
10.02.2019;01:13:07;84743669;84692912;50757;
10.02.2019;01:14:05;84743780;84692944;50836;
10.02.2019;01:15:05;84743895;84692971;50924;
10.02.2019;01:16:07;84744009;84693007;51002;
10.02.2019;01:17:07;84744096;84693050;51046;
10.02.2019;01:18:05;84744194;84693077;51117;
10.02.2019;01:19:05;84744296;84693103;51193;
10.02.2019;01:20:08;84744400;84693134;51266;
10.02.2019;01:21:08;84744495;84693156;51339;
10.02.2019;01:22:04;84744569;84693207;51362;
10.02.2019;01:23:06;84744693;84693254;51439;
10.02.2019;01:24:08;84744800;84693292;51508;
10.02.2019;01:25:09;84744901;84693329;51572;
10.02.2019;01:26:06;84745000;84693374;51626;
10.02.2019;01:27:05;84745081;84693411;51670;
10.02.2019;01:28:04;84745215;84693442;51773;
10.02.2019;01:29:06;84745310;84693468;51842;
10.02.2019;01:30:04;84745416;84693501;51915;
10.02.2019;01:31:04;84745519;84693532;51987;
10.02.2019;01:32:05;84745643;84693569;52074;
10.02.2019;01:33:05;84745755;84693604;52151;
10.02.2019;01:34:04;84745870;84693634;52236;
10.02.2019;01:35:05;84745964;84693668;52296;
10.02.2019;01:36:04;84746067;84693719;52348;
10.02.2019;01:37:04;84746194;84693744;52450;
10.02.2019;01:38:04;84746307;84693780;52527;
10.02.2019;01:39:06;84746411;84693821;52590;
10.02.2019;01:40:04;84746495;84693839;52656;
10.02.2019;01:41:04;84746600;84693878;52722;
10.02.2019;01:42:05;84746702;84693927;52775;
10.02.2019;01:43:05;84746826;84693972;52854;
10.02.2019;01:44:04;84746913;84694008;52905;
10.02.2019;01:45:06;84747012;84694064;52948;
10.02.2019;01:46:05;84747115;84694093;53022;
10.02.2019;01:47:05;84747227;84694130;53097;
10.02.2019;01:48:05;84747339;84694176;53163;
10.02.2019;01:49:05;84747415;84694221;53194;
10.02.2019;01:50:05;84747522;84694261;53261;
10.02.2019;01:51:04;84747617;84694309;53308;
10.02.2019;01:52:05;84747711;84694357;53354;
10.02.2019;01:53:05;84747816;84694403;53413;
10.02.2019;01:54:06;84747906;84694455;53451;
10.02.2019;01:55:05;84748015;84694505;53510;
10.02.2019;01:56:05;84748125;84694558;53567;
10.02.2019;01:57:04;84748236;84694610;53626;
10.02.2019;01:58:05;84748296;84694670;53626;
10.02.2019;01:59:05;84748423;84694727;53696;
10.02.2019;02:00:04;84748518;84694787;53731;
10.02.2019;02:01:04;84748635;84694831;53804;
10.02.2019;02:02:10;84748743;84694897;53846;
10.02.2019;02:03:04;84748856;84694924;53932;
10.02.2019;02:04:05;84748940;84694967;53973;
10.02.2019;02:05:05;84749033;84695030;54003;
10.02.2019;02:06:04;84749085;84695075;54010;
10.02.2019;02:07:04;84749137;84695107;54030;
10.02.2019;02:08:05;84749195;84695160;54035;
10.02.2019;02:09:07;84749234;84695206;54028;
10.02.2019;02:10:05;84749253;84695238;54015;
10.02.2019;02:11:06;84749307;84695299;54008;
10.02.2019;02:12:05;84749377;84695360;54017;
10.02.2019;02:13:05;84749417;84695409;54008;
10.02.2019;02:14:05;84749461;84695456;54005;
10.02.2019;02:15:05;84749506;84695519;53987;
10.02.2019;02:16:06;84749574;84695578;53996;
10.02.2019;02:17:05;84749635;84695621;54014;
10.02.2019;02:18:05;84749719;84695663;54056;
10.02.2019;02:19:04;84749788;84695716;54072;
10.02.2019;02:20:05;84749848;84695776;54072;
10.02.2019;02:21:05;84749969;84695834;54135;
10.02.2019;02:22:04;84750043;84695891;54152;
10.02.2019;02:23:04;84750125;84695950;54175;
10.02.2019;02:24:05;84750227;84696029;54198;
10.02.2019;02:25:05;84750321;84696086;54235;
10.02.2019;02:26:04;84750412;84696146;54266;
10.02.2019;02:27:04;84750523;84696213;54310;
10.02.2019;02:28:05;84750612;84696290;54322;
10.02.2019;02:29:04;84750704;84696351;54353;
10.02.2019;02:30:05;84750803;84696406;54397;
10.02.2019;02:31:05;84750911;84696463;54448;
10.02.2019;02:32:05;84750997;84696540;54457;
10.02.2019;02:33:05;84751096;84696606;54490;
10.02.2019;02:34:06;84751182;84696676;54506;
10.02.2019;02:35:05;84751269;84696735;54534;
10.02.2019;02:36:04;84751355;84696822;54533;
10.02.2019;02:37:05;84751453;84696895;54558;
10.02.2019;02:38:05;84751548;84696958;54590;
10.02.2019;02:39:06;84751662;84697024;54638;
10.02.2019;02:40:06;84751750;84697117;54633;
10.02.2019;02:41:05;84751822;84697193;54629;
10.02.2019;02:42:05;84751920;84697270;54650;
10.02.2019;02:43:05;84752005;84697342;54663;
10.02.2019;02:44:05;84752123;84697417;54706;
10.02.2019;02:45:06;84752227;84697495;54732;
10.02.2019;02:46:04;84752311;84697574;54737;
10.02.2019;02:47:04;84752423;84697650;54773;
10.02.2019;02:48:05;84752528;84697741;54787;
10.02.2019;02:49:05;84752623;84697782;54841;
10.02.2019;02:50:05;84752721;84697873;54848;
10.02.2019;02:51:04;84752807;84697960;54847;
10.02.2019;02:52:05;84752932;84698061;54871;
10.02.2019;02:53:05;84753036;84698143;54893;
10.02.2019;02:54:04;84753134;84698228;54906;
10.02.2019;02:55:04;84753230;84698292;54938;
10.02.2019;02:56:06;84753312;84698371;54941;
10.02.2019;02:57:04;84753441;84698447;54994;
10.02.2019;02:58:04;84753560;84698530;55030;
10.02.2019;02:59:05;84753647;84698606;55041;
10.02.2019;03:00:05;84753756;84698689;55067;
10.02.2019;03:01:04;84753857;84698772;55085;
10.02.2019;03:02:05;84753964;84698876;55088;
10.02.2019;03:03:04;84754066;84698959;55107;
10.02.2019;03:04:05;84754161;84699043;55118;
10.02.2019;03:05:05;84754292;84699134;55158;
10.02.2019;03:06:09;84754400;84699233;55167;
10.02.2019;03:07:04;84754508;84699316;55192;
10.02.2019;03:08:05;84754616;84699418;55198;
10.02.2019;03:09:06;84754726;84699503;55223;
10.02.2019;03:10:08;84754812;84699601;55211;
10.02.2019;03:11:05;84754913;84699696;55217;
10.02.2019;03:12:04;84755006;84699788;55218;
10.02.2019;03:13:05;84755113;84699891;55222;
10.02.2019;03:14:05;84755223;84699985;55238;
10.02.2019;03:15:04;84755349;84700086;55263;
10.02.2019;03:16:05;84755451;84700200;55251;
10.02.2019;03:17:05;84755549;84700275;55274;
10.02.2019;03:18:04;84755677;84700376;55301;
10.02.2019;03:19:04;84755780;84700470;55310;
10.02.2019;03:20:05;84755891;84700554;55337;
10.02.2019;03:21:05;84755994;84700659;55335;
10.02.2019;03:22:04;84756101;84700770;55331;
10.02.2019;03:23:05;84756219;84700905;55314;
10.02.2019;03:24:05;84756321;84701013;55308;
10.02.2019;03:25:04;84756422;84701123;55299;
10.02.2019;03:26:05;84756527;84701227;55300;
10.02.2019;03:27:04;84756637;84701326;55311;
10.02.2019;03:28:04;84756731;84701428;55303;
10.02.2019;03:29:04;84756821;84701508;55313;
10.02.2019;03:30:05;84756886;84701628;55258;
10.02.2019;03:31:04;84757034;84701727;55307;
10.02.2019;03:32:04;84757128;84701821;55307;
10.02.2019;03:33:05;84757223;84701905;55318;
10.02.2019;03:34:06;84757318;84702012;55306;
10.02.2019;03:35:06;84757422;84702113;55309;
10.02.2019;03:36:06;84757533;84702192;55341;
10.02.2019;03:37:05;84757627;84702328;55299;
10.02.2019;03:38:05;84757721;84702450;55271;
10.02.2019;03:39:06;84757832;84702561;55271;
10.02.2019;03:40:04;84757948;84702658;55290;
10.02.2019;03:41:06;84758061;84702780;55281;
10.02.2019;03:42:04;84758159;84702879;55280;
10.02.2019;03:43:04;84758252;84702986;55266;
10.02.2019;03:44:04;84758351;84703085;55266;
10.02.2019;03:45:04;84758408;84703172;55236;
10.02.2019;03:46:05;84758518;84703303;55215;
10.02.2019;03:47:05;84758623;84703405;55218;
10.02.2019;03:48:05;84758716;84703485;55231;
10.02.2019;03:49:05;84758827;84703604;55223;
10.02.2019;03:50:05;84758942;84703712;55230;
10.02.2019;03:51:05;84759052;84703838;55214;
10.02.2019;03:52:06;84759159;84703948;55211;
10.02.2019;03:53:04;84759255;84704048;55207;
10.02.2019;03:54:05;84759355;84704176;55179;
10.02.2019;03:55:05;84759429;84704291;55138;
10.02.2019;03:56:05;84759518;84704407;55111;
10.02.2019;03:57:05;84759617;84704504;55113;
10.02.2019;03:58:05;84759733;84704618;55115;
10.02.2019;03:59:06;84759833;84704748;55085;
10.02.2019;04:00:05;84759937;84704872;55065;
10.02.2019;04:01:06;84760045;84704996;55049;
10.02.2019;04:02:06;84760164;84705139;55025;
10.02.2019;04:03:06;84760265;84705262;55003;
10.02.2019;04:04:05;84760370;84705391;54979;
10.02.2019;04:05:07;84760474;84705536;54938;
10.02.2019;04:06:05;84760582;84705661;54921;
10.02.2019;04:07:06;84760666;84705799;54867;
10.02.2019;04:08:05;84760778;84705928;54850;
10.02.2019;04:09:07;84760886;84706051;54835;
10.02.2019;04:10:05;84760975;84706154;54821;
10.02.2019;04:11:05;84761029;84706203;54826;
10.02.2019;04:12:04;84761105;84706384;54721;
10.02.2019;04:13:04;84761157;84706498;54659;
10.02.2019;04:14:05;84761219;84706548;54671;
10.02.2019;04:15:04;84761263;84706728;54535;
10.02.2019;04:16:04;84761308;84706819;54489;
10.02.2019;04:17:05;84761397;84706924;54473;
10.02.2019;04:18:05;84761451;84707025;54426;
10.02.2019;04:19:05;84761535;84707145;54390;
10.02.2019;04:20:06;84761602;84707269;54333;
10.02.2019;04:21:04;84761674;84707356;54318;
10.02.2019;04:22:04;84761785;84707479;54306;
10.02.2019;04:23:05;84761865;84707608;54257;
10.02.2019;04:24:04;84761981;84707725;54256;
10.02.2019;04:25:04;84762070;84707839;54231;
10.02.2019;04:26:05;84762183;84707967;54216;
10.02.2019;04:27:05;84762294;84708077;54217;
10.02.2019;04:28:06;84762384;84708185;54199;
10.02.2019;04:29:04;84762470;84708298;54172;
10.02.2019;04:30:05;84762572;84708401;54171;
10.02.2019;04:31:05;84762628;84708527;54101;
10.02.2019;04:32:04;84762786;84708636;54150;
10.02.2019;04:33:05;84762888;84708756;54132;
10.02.2019;04:34:05;84762975;84708890;54085;
10.02.2019;04:35:05;84763078;84709006;54072;
10.02.2019;04:36:05;84763170;84709122;54048;
10.02.2019;04:37:06;84763268;84709276;53992;
10.02.2019;04:38:05;84763367;84709402;53965;
10.02.2019;04:39:06;84763484;84709515;53969;
10.02.2019;04:40:05;84763584;84709636;53948;
10.02.2019;04:41:06;84763700;84709749;53951;
10.02.2019;04:42:05;84763788;84709879;53909;
10.02.2019;04:43:05;84763870;84710013;53857;
10.02.2019;04:44:04;84763973;84710139;53834;
10.02.2019;04:45:05;84764084;84710276;53808;
10.02.2019;04:46:04;84764171;84710395;53776;
10.02.2019;04:47:04;84764292;84710534;53758;
10.02.2019;04:48:05;84764395;84710659;53736;
10.02.2019;04:49:05;84764524;84710791;53733;
10.02.2019;04:50:05;84764616;84710936;53680;
10.02.2019;04:51:05;84764734;84711067;53667;
10.02.2019;04:52:05;84764837;84711193;53644;
10.02.2019;04:53:06;84764938;84711329;53609;
10.02.2019;04:54:05;84765052;84711467;53585;
10.02.2019;04:55:05;84765138;84711592;53546;
10.02.2019;04:56:04;84765229;84711729;53500;
10.02.2019;04:57:05;84765346;84711870;53476;
10.02.2019;04:58:05;84765436;84712004;53432;
10.02.2019;04:59:04;84765541;84712149;53392;
10.02.2019;05:00:05;84765660;84712286;53374;
10.02.2019;05:01:04;84765764;84712417;53347;
10.02.2019;05:02:04;84765854;84712531;53323;
10.02.2019;05:03:05;84765974;84712664;53310;
10.02.2019;05:04:05;84766086;84712798;53288;
10.02.2019;05:05:04;84766194;84712944;53250;
10.02.2019;05:06:06;84766285;84713068;53217;
10.02.2019;05:07:04;84766410;84713217;53193;
10.02.2019;05:08:05;84766526;84713363;53163;
10.02.2019;05:09:07;84766606;84713530;53076;
10.02.2019;05:10:04;84766719;84713663;53056;
10.02.2019;05:11:04;84766831;84713813;53018;
10.02.2019;05:12:06;84766943;84713976;52967;
10.02.2019;05:13:05;84767051;84714117;52934;
10.02.2019;05:14:04;84767158;84714229;52929;
10.02.2019;05:15:05;84767256;84714360;52896;
10.02.2019;05:16:04;84767355;84714489;52866;
10.02.2019;05:17:04;84767463;84714645;52818;
10.02.2019;05:18:05;84767578;84714778;52800;
10.02.2019;05:19:06;84767677;84714938;52739;
10.02.2019;05:20:04;84767762;84715073;52689;
10.02.2019;05:21:04;84767868;84715208;52660;
10.02.2019;05:22:05;84767963;84715339;52624;
10.02.2019;05:23:04;84768062;84715472;52590;
10.02.2019;05:24:04;84768177;84715586;52591;
10.02.2019;05:25:06;84768258;84715729;52529;
10.02.2019;05:26:05;84768357;84715868;52489;
10.02.2019;05:27:05;84768459;84716023;52436;
10.02.2019;05:28:05;84768571;84716165;52406;
10.02.2019;05:29:04;84768684;84716315;52369;
10.02.2019;05:30:04;84768799;84716433;52366;
10.02.2019;05:31:05;84768917;84716585;52332;
10.02.2019;05:32:05;84769012;84716732;52280;
10.02.2019;05:33:05;84769101;84716879;52222;
10.02.2019;05:34:04;84769195;84717035;52160;
10.02.2019;05:35:05;84769298;84717194;52104;
10.02.2019;05:36:04;84769387;84717315;52072;
10.02.2019;05:37:04;84769488;84717463;52025;
10.02.2019;05:38:05;84769601;84717619;51982;
10.02.2019;05:39:06;84769696;84717785;51911;
10.02.2019;05:40:05;84769803;84717934;51869;
10.02.2019;05:41:04;84769886;84718061;51825;
10.02.2019;05:42:04;84769975;84718205;51770;
10.02.2019;05:43:05;84770093;84718352;51741;
10.02.2019;05:44:06;84770204;84718501;51703;
10.02.2019;05:45:05;84770312;84718666;51646;
10.02.2019;05:46:05;84770397;84718807;51590;
10.02.2019;05:47:05;84770506;84718917;51589;
10.02.2019;05:48:05;84770614;84719074;51540;
10.02.2019;05:49:05;84770701;84719220;51481;
10.02.2019;05:50:05;84770814;84719360;51454;
10.02.2019;05:51:04;84770893;84719481;51412;
10.02.2019;05:52:04;84771015;84719641;51374;
10.02.2019;05:53:04;84771104;84719799;51305;
10.02.2019;05:54:05;84771199;84719935;51264;
10.02.2019;05:55:05;84771298;84720091;51207;
10.02.2019;05:56:05;84771378;84720217;51161;
10.02.2019;05:57:06;84771487;84720364;51123;
10.02.2019;05:58:04;84771567;84720515;51052;
10.02.2019;05:59:05;84771656;84720648;51008;
10.02.2019;06:00:05;84771758;84720818;50940;
10.02.2019;06:01:05;84771849;84720980;50869;
10.02.2019;06:02:04;84771966;84721130;50836;
10.02.2019;06:03:05;84772063;84721269;50794;
10.02.2019;06:04:05;84772168;84721436;50732;
10.02.2019;06:05:06;84772277;84721597;50680;
10.02.2019;06:06:05;84772383;84721755;50628;
10.02.2019;06:07:05;84772493;84721909;50584;
10.02.2019;06:08:06;84772577;84722063;50514;
10.02.2019;06:09:07;84772670;84722196;50474;
10.02.2019;06:10:05;84772785;84722385;50400;
10.02.2019;06:11:06;84772904;84722533;50371;
10.02.2019;06:12:05;84772999;84722690;50309;
10.02.2019;06:13:04;84773048;84722827;50221;
10.02.2019;06:14:05;84773126;84722941;50185;
10.02.2019;06:15:05;84773218;84723072;50146;
10.02.2019;06:16:04;84773273;84723215;50058;
10.02.2019;06:17:04;84773314;84723365;49949;
10.02.2019;06:18:05;84773432;84723514;49918;
10.02.2019;06:19:04;84773503;84723614;49889;
10.02.2019;06:20:04;84773575;84723753;49822;
10.02.2019;06:21:05;84773645;84723872;49773;
10.02.2019;06:22:04;84773736;84724011;49725;
10.02.2019;06:23:05;84773800;84724126;49674;
10.02.2019;06:24:05;84773848;84724281;49567;
10.02.2019;06:25:08;84773926;84724450;49476;
10.02.2019;06:26:06;84774009;84724595;49414;
10.02.2019;06:27:05;84774093;84724714;49379;
10.02.2019;06:28:05;84774185;84724850;49335;
10.02.2019;06:29:05;84774261;84725008;49253;
10.02.2019;06:30:05;84774351;84725147;49204;
10.02.2019;06:31:05;84774438;84725292;49146;
10.02.2019;06:32:05;84774523;84725433;49090;
10.02.2019;06:33:05;84774635;84725578;49057;
10.02.2019;06:34:05;84774719;84725736;48983;
10.02.2019;06:35:04;84774795;84725891;48904;
10.02.2019;06:36:05;84774908;84726053;48855;
10.02.2019;06:37:04;84775004;84726205;48799;
10.02.2019;06:38:04;84775093;84726347;48746;
10.02.2019;06:39:07;84775221;84726484;48737;
10.02.2019;06:40:05;84775287;84726626;48661;
10.02.2019;06:41:06;84775448;84726778;48670;
10.02.2019;06:42:05;84775556;84726952;48604;
10.02.2019;06:43:05;84775619;84727068;48551;
10.02.2019;06:44:05;84775728;84727241;48487;
10.02.2019;06:45:05;84775813;84727396;48417;
10.02.2019;06:46:04;84775913;84727562;48351;
10.02.2019;06:47:07;84776019;84727737;48282;
10.02.2019;06:48:05;84776092;84727875;48217;
10.02.2019;06:49:04;84776176;84728031;48145;
10.02.2019;06:50:04;84776276;84728210;48066;
10.02.2019;06:51:05;84776384;84728375;48009;
10.02.2019;06:52:05;84776491;84728529;47962;
10.02.2019;06:53:05;84776600;84728679;47921;
10.02.2019;06:54:04;84776703;84728843;47860;
10.02.2019;06:55:05;84776785;84729003;47782;
10.02.2019;06:56:05;84776879;84729165;47714;
10.02.2019;06:57:05;84776977;84729340;47637;
10.02.2019;06:58:04;84777076;84729491;47585;
10.02.2019;06:59:05;84777180;84729666;47514;
10.02.2019;07:00:04;84777268;84729834;47434;
10.02.2019;07:01:04;84777371;84729998;47373;
10.02.2019;07:02:04;84777461;84730148;47313;
10.02.2019;07:03:05;84777548;84730318;47230;
10.02.2019;07:04:05;84777641;84730461;47180;
10.02.2019;07:05:05;84777738;84730617;47121;
10.02.2019;07:06:05;84777835;84730781;47054;
10.02.2019;07:07:05;84777923;84730960;46963;
10.02.2019;07:08:06;84778034;84731126;46908;
10.02.2019;07:09:07;84778110;84731320;46790;
10.02.2019;07:10:05;84778192;84731473;46719;
10.02.2019;07:11:06;84778283;84731625;46658;
10.02.2019;07:12:05;84778354;84731791;46563;
10.02.2019;07:13:05;84778464;84731955;46509;
10.02.2019;07:14:05;84778537;84732113;46424;
10.02.2019;07:15:05;84778646;84732273;46373;
10.02.2019;07:16:05;84778734;84732436;46298;
10.02.2019;07:17:05;84778822;84732587;46235;
10.02.2019;07:18:05;84778906;84732728;46178;
10.02.2019;07:19:05;84778977;84732906;46071;
10.02.2019;07:20:05;84779073;84733078;45995;
10.02.2019;07:21:05;84779170;84733226;45944;
10.02.2019;07:22:06;84779279;84733420;45859;
10.02.2019;07:23:05;84779371;84733598;45773;
10.02.2019;07:24:05;84779468;84733755;45713;
10.02.2019;07:25:04;84779559;84733907;45652;
10.02.2019;07:26:05;84779640;84734064;45576;
10.02.2019;07:27:05;84779731;84734233;45498;
10.02.2019;07:28:04;84779848;84734403;45445;
10.02.2019;07:29:06;84779931;84734577;45354;
10.02.2019;07:30:05;84780010;84734741;45269;
10.02.2019;07:31:06;84780103;84734907;45196;
10.02.2019;07:32:05;84780202;84735082;45120;
10.02.2019;07:33:05;84780302;84735236;45066;
10.02.2019;07:34:05;84780398;84735419;44979;
10.02.2019;07:35:06;84780496;84735605;44891;
10.02.2019;07:36:05;84780578;84735784;44794;
10.02.2019;07:37:05;84780670;84735946;44724;
10.02.2019;07:38:05;84780774;84736106;44668;
10.02.2019;07:39:05;84780875;84736271;44604;
10.02.2019;07:40:04;84780958;84736429;44529;
10.02.2019;07:41:05;84781056;84736576;44480;
10.02.2019;07:42:04;84781164;84736718;44446;
10.02.2019;07:43:04;84781235;84736890;44345;
10.02.2019;07:44:05;84781318;84737055;44263;
10.02.2019;07:45:05;84781424;84737222;44202;
10.02.2019;07:46:05;84781492;84737373;44119;
10.02.2019;07:47:05;84781585;84737533;44052;
10.02.2019;07:48:04;84781671;84737677;43994;
10.02.2019;07:49:04;84781756;84737859;43897;
10.02.2019;07:50:05;84781834;84738024;43810;
10.02.2019;07:51:05;84781923;84738197;43726;
10.02.2019;07:52:04;84782017;84738356;43661;
10.02.2019;07:53:04;84782120;84738511;43609;
10.02.2019;07:54:05;84782197;84738668;43529;
10.02.2019;07:55:05;84782275;84738825;43450;
10.02.2019;07:56:04;84782363;84738977;43386;
10.02.2019;07:57:05;84782444;84739143;43301;
10.02.2019;07:58:05;84782517;84739308;43209;
10.02.2019;07:59:04;84782607;84739478;43129;
10.02.2019;08:00:05;84782695;84739647;43048;
10.02.2019;08:01:05;84782794;84739813;42981;
10.02.2019;08:02:04;84782877;84739988;42889;
10.02.2019;08:03:06;84782963;84740144;42819;
10.02.2019;08:04:05;84783043;84740298;42745;
10.02.2019;08:05:05;84783125;84740434;42691;
10.02.2019;08:06:05;84783195;84740576;42619;
10.02.2019;08:07:05;84783275;84740720;42555;
10.02.2019;08:08:06;84783325;84740847;42478;
10.02.2019;08:09:07;84783384;84740960;42424;
10.02.2019;08:10:05;84783415;84741078;42337;
10.02.2019;08:11:05;84783431;84741191;42240;
10.02.2019;08:12:05;84783485;84741286;42199;
10.02.2019;08:13:04;84783528;84741391;42137;
10.02.2019;08:14:04;84783555;84741525;42030;
10.02.2019;08:15:05;84783600;84741653;41947;
10.02.2019;08:16:05;84783657;84741786;41871;
10.02.2019;08:17:04;84783715;84741921;41794;
10.02.2019;08:18:05;84783775;84742063;41712;
10.02.2019;08:19:04;84783838;84742217;41621;
10.02.2019;08:20:04;84783930;84742341;41589;
10.02.2019;08:21:05;84783998;84742492;41506;
10.02.2019;08:22:04;84784056;84742652;41404;
10.02.2019;08:23:05;84784149;84742823;41326;
10.02.2019;08:24:04;84784229;84742967;41262;
10.02.2019;08:25:04;84784305;84743127;41178;
10.02.2019;08:26:04;84784380;84743308;41072;
10.02.2019;08:27:05;84784480;84743463;41017;
10.02.2019;08:28:04;84784555;84743608;40947;
10.02.2019;08:29:05;84784638;84743760;40878;
10.02.2019;08:30:04;84784723;84743891;40832;
10.02.2019;08:31:05;84784806;84744041;40765;
10.02.2019;08:32:04;84784911;84744220;40691;
10.02.2019;08:33:04;84785010;84744380;40630;
10.02.2019;08:34:05;84785122;84744517;40605;
10.02.2019;08:35:05;84785219;84744652;40567;
10.02.2019;08:36:04;84785308;84744780;40528;
10.02.2019;08:37:04;84785414;84744936;40478;
10.02.2019;08:38:05;84785522;84745095;40427;
10.02.2019;08:39:06;84785615;84745252;40363;
10.02.2019;08:40:05;84785706;84745388;40318;
10.02.2019;08:41:04;84785791;84745542;40249;
10.02.2019;08:42:04;84785884;84745677;40207;
10.02.2019;08:43:05;84785945;84745820;40125;
10.02.2019;08:44:04;84786021;84745961;40060;
10.02.2019;08:45:04;84786102;84746107;39995;
10.02.2019;08:46:05;84786194;84746253;39941;
10.02.2019;08:47:05;84786272;84746399;39873;
10.02.2019;08:48:05;84786372;84746531;39841;
10.02.2019;08:49:05;84786463;84746690;39773;
10.02.2019;08:50:05;84786551;84746854;39697;
10.02.2019;08:51:04;84786658;84747001;39657;
10.02.2019;08:52:05;84786757;84747194;39563;
10.02.2019;08:53:04;84786838;84747359;39479;
10.02.2019;08:54:04;84786924;84747513;39411;
10.02.2019;08:55:05;84787019;84747665;39354;
10.02.2019;08:56:04;84787116;84747811;39305;
10.02.2019;08:57:04;84787209;84747964;39245;
10.02.2019;08:58:05;84787297;84748090;39207;
10.02.2019;08:59:04;84787393;84748227;39166;
10.02.2019;09:00:05;84787479;84748402;39077;
10.02.2019;09:01:05;84787574;84748563;39011;
10.02.2019;09:02:04;84787653;84748716;38937;
10.02.2019;09:03:05;84787738;84748883;38855;
10.02.2019;09:04:04;84787816;84749048;38768;
10.02.2019;09:05:04;84787903;84749197;38706;
10.02.2019;09:06:05;84787994;84749298;38696;
10.02.2019;09:07:05;84788090;84749502;38588;
10.02.2019;09:08:06;84788187;84749649;38538;
10.02.2019;09:09:05;84788289;84749808;38481;
10.02.2019;09:10:05;84788404;84749948;38456;
10.02.2019;09:11:05;84788494;84750115;38379;
10.02.2019;09:12:05;84788588;84750270;38318;
10.02.2019;09:13:05;84788688;84750429;38259;
10.02.2019;09:14:06;84788771;84750554;38217;
10.02.2019;09:15:05;84788861;84750730;38131;
10.02.2019;09:16:05;84788942;84750856;38086;
10.02.2019;09:17:05;84789024;84750987;38037;
10.02.2019;09:18:05;84789124;84751143;37981;
10.02.2019;09:19:05;84789217;84751277;37940;
10.02.2019;09:20:04;84789336;84751412;37924;
10.02.2019;09:21:04;84789431;84751545;37886;
10.02.2019;09:22:05;84789532;84751674;37858;
10.02.2019;09:23:05;84789622;84751840;37782;
10.02.2019;09:24:05;84789692;84752005;37687;
10.02.2019;09:25:06;84789803;84752170;37633;
10.02.2019;09:26:05;84789896;84752290;37606;
10.02.2019;09:27:05;84789963;84752442;37521;
10.02.2019;09:28:04;84790067;84752574;37493;
10.02.2019;09:29:04;84790163;84752743;37420;
10.02.2019;09:30:05;84790235;84752899;37336;
10.02.2019;09:31:04;84790326;84753057;37269;
10.02.2019;09:32:05;84790417;84753206;37211;
10.02.2019;09:33:05;84790489;84753360;37129;
10.02.2019;09:34:04;84790572;84753499;37073;
10.02.2019;09:35:04;84790674;84753654;37020;
10.02.2019;09:36:05;84790800;84753815;36985;
10.02.2019;09:37:05;84790881;84753955;36926;
10.02.2019;09:38:05;84790978;84754096;36882;
10.02.2019;09:39:07;84791068;84754261;36807;
10.02.2019;09:40:05;84791167;84754401;36766;
10.02.2019;09:41:05;84791248;84754575;36673;
10.02.2019;09:42:05;84791332;84754720;36612;
10.02.2019;09:43:05;84791395;84754805;36590;
10.02.2019;09:44:05;84791495;84754981;36514;
10.02.2019;09:45:04;84791568;84755161;36407;
10.02.2019;09:46:06;84791658;84755325;36333;
10.02.2019;09:47:05;84791761;84755465;36296;
10.02.2019;09:48:05;84791832;84755627;36205;
10.02.2019;09:49:05;84791914;84755791;36123;
10.02.2019;09:50:05;84792010;84755925;36085;
10.02.2019;09:51:06;84792104;84756069;36035;
10.02.2019;09:52:05;84792188;84756235;35953;
10.02.2019;09:53:05;84792282;84756394;35888;
10.02.2019;09:54:04;84792379;84756551;35828;
10.02.2019;09:55:05;84792486;84756729;35757;
10.02.2019;09:56:04;84792558;84756880;35678;
10.02.2019;09:57:05;84792645;84757047;35598;
10.02.2019;09:58:05;84792739;84757179;35560;
10.02.2019;09:59:05;84792838;84757312;35526;
10.02.2019;10:00:05;84792919;84757473;35446;
10.02.2019;10:01:06;84793017;84757650;35367;
10.02.2019;10:02:05;84793126;84757804;35322;
10.02.2019;10:03:05;84793231;84757942;35289;
10.02.2019;10:04:06;84793326;84758111;35215;
10.02.2019;10:05:05;84793417;84758287;35130;
10.02.2019;10:06:06;84793526;84758452;35074;
10.02.2019;10:07:05;84793632;84758595;35037;
10.02.2019;10:08:05;84793729;84758779;34950;
10.02.2019;10:09:04;84793847;84758942;34905;
10.02.2019;10:10:05;84793947;84759106;34841;
10.02.2019;10:11:06;84794042;84759264;34778;
10.02.2019;10:12:04;84794124;84759392;34732;
10.02.2019;10:13:05;84794179;84759530;34649;
10.02.2019;10:14:05;84794285;84759676;34609;
10.02.2019;10:15:05;84794359;84759829;34530;
10.02.2019;10:16:05;84794439;84759989;34450;
10.02.2019;10:17:05;84794527;84760138;34389;
10.02.2019;10:18:06;84794594;84760288;34306;
10.02.2019;10:19:05;84794642;84760402;34240;
10.02.2019;10:20:05;84794737;84760523;34214;
10.02.2019;10:21:06;84794787;84760656;34131;
10.02.2019;10:22:04;84794828;84760788;34040;
10.02.2019;10:23:05;84794878;84760906;33972;
10.02.2019;10:24:05;84794945;84761033;33912;
10.02.2019;10:25:05;84795022;84761157;33865;
10.02.2019;10:26:04;84795098;84761313;33785;
10.02.2019;10:27:05;84795198;84761460;33738;
10.02.2019;10:28:04;84795287;84761605;33682;
10.02.2019;10:29:04;84795373;84761735;33638;
10.02.2019;10:30:05;84795476;84761899;33577;
10.02.2019;10:31:05;84795584;84762071;33513;
10.02.2019;10:32:04;84795673;84762216;33457;
10.02.2019;10:33:04;84795760;84762381;33379;
10.02.2019;10:34:05;84795863;84762536;33327;
10.02.2019;10:35:05;84795988;84762682;33306;
10.02.2019;10:36:04;84796085;84762826;33259;
10.02.2019;10:37:04;84796160;84763009;33151;
10.02.2019;10:38:05;84796255;84763157;33098;
10.02.2019;10:39:05;84796354;84763340;33014;
10.02.2019;10:40:04;84796433;84763501;32932;
10.02.2019;10:41:04;84796524;84763654;32870;
10.02.2019;10:42:05;84796600;84763792;32808;
10.02.2019;10:43:04;84796690;84763948;32742;
10.02.2019;10:44:06;84796787;84764095;32692;
10.02.2019;10:45:05;84796880;84764253;32627;
10.02.2019;10:46:07;84796976;84764418;32558;
10.02.2019;10:47:05;84797085;84764573;32512;
10.02.2019;10:48:05;84797177;84764706;32471;
10.02.2019;10:49:05;84797302;84764846;32456;
10.02.2019;10:50:05;84797389;84765009;32380;
10.02.2019;10:51:04;84797503;84765151;32352;
10.02.2019;10:52:05;84797611;84765328;32283;
10.02.2019;10:53:04;84797710;84765494;32216;
10.02.2019;10:54:05;84797794;84765672;32122;
10.02.2019;10:55:05;84797889;84765815;32074;
10.02.2019;10:56:05;84797997;84765969;32028;
10.02.2019;10:57:05;84798091;84766098;31993;
10.02.2019;10:58:06;84798196;84766248;31948;
10.02.2019;10:59:05;84798302;84766423;31879;
10.02.2019;11:00:04;84798396;84766574;31822;
10.02.2019;11:01:04;84798483;84766715;31768;
10.02.2019;11:02:05;84798585;84766858;31727;
10.02.2019;11:03:05;84798654;84767016;31638;
10.02.2019;11:04:05;84798758;84767147;31611;
10.02.2019;11:05:07;84798858;84767306;31552;
10.02.2019;11:06:04;84798944;84767474;31470;
10.02.2019;11:07:04;84799034;84767634;31400;
10.02.2019;11:08:05;84799111;84767813;31298;
10.02.2019;11:09:08;84799219;84767988;31231;
10.02.2019;11:10:05;84799297;84768146;31151;
10.02.2019;11:11:06;84799380;84768310;31070;
10.02.2019;11:12:07;84799482;84768469;31013;
10.02.2019;11:13:05;84799582;84768633;30949;
10.02.2019;11:14:05;84799679;84768767;30912;
10.02.2019;11:15:05;84799764;84768913;30851;
10.02.2019;11:16:05;84799862;84769072;30790;
10.02.2019;11:17:04;84799954;84769208;30746;
10.02.2019;11:18:04;84800040;84769341;30699;
10.02.2019;11:19:08;84800132;84769481;30651;
10.02.2019;11:20:05;84800227;84769619;30608;
10.02.2019;11:21:05;84800320;84769768;30552;
10.02.2019;11:22:05;84800391;84769929;30462;
10.02.2019;11:23:05;84800470;84770050;30420;
10.02.2019;11:24:06;84800556;84770199;30357;
10.02.2019;11:25:05;84800651;84770345;30306;
10.02.2019;11:26:06;84800734;84770485;30249;
10.02.2019;11:27:05;84800821;84770645;30176;
10.02.2019;11:28:04;84800926;84770802;30124;
10.02.2019;11:29:04;84801029;84770942;30087;
10.02.2019;11:30:05;84801121;84771108;30013;
10.02.2019;11:31:05;84801223;84771247;29976;
10.02.2019;11:32:05;84801323;84771423;29900;
10.02.2019;11:33:04;84801418;84771615;29803;
10.02.2019;11:34:04;84801536;84771794;29742;
10.02.2019;11:35:05;84801640;84771938;29702;
10.02.2019;11:36:06;84801736;84772096;29640;
10.02.2019;11:37:05;84801800;84772254;29546;
10.02.2019;11:38:05;84801952;84772400;29552;
10.02.2019;11:39:05;84802048;84772571;29477;
10.02.2019;11:40:04;84802150;84772718;29432;
10.02.2019;11:41:05;84802263;84772859;29404;
10.02.2019;11:42:04;84802349;84773000;29349;
10.02.2019;11:43:04;84802440;84773163;29277;
10.02.2019;11:44:05;84802537;84773333;29204;
10.02.2019;11:45:05;84802623;84773504;29119;
10.02.2019;11:46:06;84802692;84773650;29042;
10.02.2019;11:47:05;84802803;84773807;28996;
10.02.2019;11:48:08;84802924;84773967;28957;
10.02.2019;11:49:05;84803036;84774130;28906;
10.02.2019;11:50:05;84803121;84774299;28822;
10.02.2019;11:51:05;84803235;84774470;28765;
10.02.2019;11:52:04;84803359;84774620;28739;
10.02.2019;11:53:05;84803459;84774771;28688;
10.02.2019;11:54:04;84803554;84774923;28631;
10.02.2019;11:55:04;84803649;84775074;28575;
10.02.2019;11:56:05;84803761;84775247;28514;
10.02.2019;11:57:05;84803866;84775421;28445;
10.02.2019;11:58:05;84803968;84775615;28353;
10.02.2019;11:59:04;84804071;84775790;28281;
10.02.2019;12:00:04;84804179;84775943;28236;
10.02.2019;12:01:06;84804278;84776104;28174;
10.02.2019;12:02:05;84804362;84776286;28076;
10.02.2019;12:03:06;84804483;84776446;28037;
10.02.2019;12:04:05;84804612;84776626;27986;
10.02.2019;12:05:05;84804729;84776798;27931;
10.02.2019;12:06:05;84804853;84776961;27892;
10.02.2019;12:07:05;84804910;84777100;27810;
10.02.2019;12:08:05;84804988;84777239;27749;
10.02.2019;12:09:05;84805053;84777379;27674;
10.02.2019;12:10:05;84805106;84777495;27611;
10.02.2019;12:11:05;84805117;84777618;27499;
10.02.2019;12:12:05;84805130;84777711;27419;
10.02.2019;12:13:05;84805182;84777800;27382;
10.02.2019;12:14:05;84805289;84777946;27343;
10.02.2019;12:15:04;84805419;84778101;27318;
10.02.2019;12:16:05;84805540;84778249;27291;
10.02.2019;12:17:05;84805663;84778396;27267;
10.02.2019;12:18:05;84805784;84778556;27228;
10.02.2019;12:19:05;84805899;84778690;27209;
10.02.2019;12:20:05;84806034;84778837;27197;
10.02.2019;12:21:06;84806167;84779032;27135;
10.02.2019;12:22:05;84806271;84779181;27090;
10.02.2019;12:23:06;84806386;84779315;27071;
10.02.2019;12:24:05;84806508;84779479;27029;
10.02.2019;12:25:05;84806629;84779669;26960;
10.02.2019;12:26:05;84806744;84779830;26914;
10.02.2019;12:27:04;84806873;84779981;26892;
10.02.2019;12:28:04;84807014;84780165;26849;
10.02.2019;12:29:05;84807141;84780336;26805;
10.02.2019;12:30:05;84807277;84780483;26794;
10.02.2019;12:31:05;84807392;84780664;26728;
10.02.2019;12:32:05;84807530;84780830;26700;
10.02.2019;12:33:05;84807647;84781000;26647;
10.02.2019;12:34:04;84807760;84781166;26594;
10.02.2019;12:35:05;84807897;84781326;26571;
10.02.2019;12:36:05;84808035;84781505;26530;
10.02.2019;12:37:05;84808177;84781675;26502;
10.02.2019;12:38:05;84808290;84781824;26466;
10.02.2019;12:39:05;84808438;84782005;26433;
10.02.2019;12:40:05;84808577;84782167;26410;
10.02.2019;12:41:06;84808719;84782359;26360;
10.02.2019;12:42:05;84808829;84782506;26323;
10.02.2019;12:43:04;84808965;84782686;26279;
10.02.2019;12:44:04;84809055;84782844;26211;
10.02.2019;12:45:05;84808988;84782787;26201;
10.02.2019;12:46:05;84808934;84782513;26421;
10.02.2019;12:47:05;84809054;84782710;26344;
10.02.2019;12:48:06;84809180;84782873;26307;
10.02.2019;12:49:05;84809302;84783037;26265;
10.02.2019;12:50:05;84809433;84783201;26232;
10.02.2019;12:51:05;84809547;84783368;26179;
10.02.2019;12:52:04;84809685;84783506;26179;
10.02.2019;12:53:05;84809843;84783677;26166;
10.02.2019;12:54:06;84809988;84783828;26160;
10.02.2019;12:55:04;84810095;84783960;26135;
10.02.2019;12:56:04;84810221;84784135;26086;
10.02.2019;12:57:05;84810313;84784277;26036;
10.02.2019;12:58:04;84810442;84784433;26009;
10.02.2019;12:59:04;84810580;84784590;25990;
10.02.2019;13:00:05;84810693;84784751;25942;
10.02.2019;13:01:05;84810829;84784904;25925;
10.02.2019;13:02:05;84810948;84785068;25880;
10.02.2019;13:03:06;84811077;84785237;25840;
10.02.2019;13:04:05;84811195;84785420;25775;
10.02.2019;13:05:04;84811326;84785589;25737;
10.02.2019;13:06:07;84811436;84785745;25691;
10.02.2019;13:07:06;84811547;84785913;25634;
10.02.2019;13:08:05;84811671;84786062;25609;
10.02.2019;13:09:05;84811797;84786230;25567;
10.02.2019;13:10:06;84811908;84786389;25519;
10.02.2019;13:11:05;84812042;84786558;25484;
10.02.2019;13:12:05;84812175;84786706;25469;
10.02.2019;13:13:06;84812303;84786847;25456;
10.02.2019;13:14:05;84812403;84787020;25383;
10.02.2019;13:15:05;84812527;84787180;25347;
10.02.2019;13:16:05;84812647;84787340;25307;
10.02.2019;13:17:05;84812747;84787509;25238;
10.02.2019;13:18:05;84812864;84787688;25176;
10.02.2019;13:19:05;84812968;84787823;25145;
10.02.2019;13:20:04;84813089;84788005;25084;
10.02.2019;13:21:05;84813200;84788164;25036;
10.02.2019;13:22:05;84813298;84788332;24966;
10.02.2019;13:23:05;84813415;84788518;24897;
10.02.2019;13:24:05;84813529;84788701;24828;
10.02.2019;13:25:05;84813647;84788871;24776;
10.02.2019;13:26:05;84813766;84789046;24720;
10.02.2019;13:27:05;84813891;84789236;24655;
10.02.2019;13:28:04;84814036;84789411;24625;
10.02.2019;13:29:04;84814156;84789577;24579;
10.02.2019;13:30:06;84814258;84789725;24533;
10.02.2019;13:31:06;84814388;84789905;24483;
10.02.2019;13:32:05;84814497;84790083;24414;
10.02.2019;13:33:05;84814616;84790281;24335;
10.02.2019;13:34:04;84814734;84790447;24287;
10.02.2019;13:35:05;84814838;84790595;24243;
10.02.2019;13:37:06;84815061;84790943;24118;
10.02.2019;13:38:04;84815182;84791116;24066;
10.02.2019;13:39:06;84815311;84791270;24041;
10.02.2019;13:40:05;84815439;84791449;23990;
10.02.2019;13:41:06;84815559;84791616;23943;
10.02.2019;13:42:05;84815702;84791769;23933;
10.02.2019;13:43:05;84815855;84791925;23930;
10.02.2019;13:44:06;84815996;84792101;23895;
10.02.2019;13:45:05;84816115;84792244;23871;
10.02.2019;13:46:04;84816256;84792419;23837;
10.02.2019;13:47:05;84816372;84792621;23751;
10.02.2019;13:48:04;84816499;84792781;23718;
10.02.2019;13:49:05;84816648;84792965;23683;
10.02.2019;13:50:05;84816787;84793119;23668;
10.02.2019;13:51:05;84816925;84793292;23633;
10.02.2019;13:52:04;84817045;84793437;23608;
10.02.2019;13:53:04;84817173;84793582;23591;
10.02.2019;13:54:07;84817321;84793769;23552;
10.02.2019;13:55:04;84817387;84793939;23448;
10.02.2019;13:56:04;84817567;84794103;23464;
10.02.2019;13:57:05;84817711;84794262;23449;
10.02.2019;13:58:05;84817846;84794419;23427;
10.02.2019;13:59:05;84817985;84794600;23385;
10.02.2019;14:00:04;84818097;84794760;23337;
10.02.2019;14:01:05;84818219;84794922;23297;
10.02.2019;14:02:05;84818361;84795066;23295;
10.02.2019;14:03:05;84818505;84795240;23265;
10.02.2019;14:04:04;84818647;84795424;23223;
10.02.2019;14:05:04;84818754;84795589;23165;
10.02.2019;14:06:05;84818873;84795784;23089;
10.02.2019;14:07:04;84819011;84795952;23059;
10.02.2019;14:08:05;84819152;84796107;23045;
10.02.2019;14:09:04;84819278;84796281;22997;
10.02.2019;14:10:04;84819396;84796443;22953;
10.02.2019;14:11:05;84819506;84796590;22916;
10.02.2019;14:12:05;84819616;84796747;22869;
10.02.2019;14:13:04;84819679;84796858;22821;
10.02.2019;14:14:04;84819754;84796986;22768;
10.02.2019;14:15:04;84819867;84797113;22754;
10.02.2019;14:16:05;84819972;84797262;22710;
10.02.2019;14:17:05;84820063;84797418;22645;
10.02.2019;14:18:05;84820154;84797555;22599;
10.02.2019;14:19:05;84820247;84797686;22561;
10.02.2019;14:20:05;84820336;84797871;22465;
10.02.2019;14:21:05;84820415;84798034;22381;
10.02.2019;14:22:04;84820471;84798153;22318;
10.02.2019;14:23:05;84820589;84798368;22221;
10.02.2019;14:24:05;84820719;84798537;22182;
10.02.2019;14:25:06;84820844;84798682;22162;
10.02.2019;14:26:04;84820953;84798840;22113;
10.02.2019;14:27:06;84821028;84799014;22014;
10.02.2019;14:28:05;84821177;84799166;22011;
10.02.2019;14:29:05;84821300;84799331;21969;
10.02.2019;14:30:06;84821413;84799514;21899;
10.02.2019;14:31:05;84821533;84799662;21871;
10.02.2019;14:32:05;84821642;84799892;21750;
10.02.2019;14:33:05;84821759;84800098;21661;
10.02.2019;14:34:05;84821908;84800260;21648;
10.02.2019;14:35:05;84822042;84800448;21594;
10.02.2019;14:36:06;84822159;84800643;21516;
10.02.2019;14:37:05;84822318;84800841;21477;
10.02.2019;14:38:05;84822461;84801032;21429;
10.02.2019;14:39:05;84822579;84801215;21364;
10.02.2019;14:40:04;84822726;84801402;21324;
10.02.2019;14:41:04;84822863;84801589;21274;
10.02.2019;14:42:06;84823012;84801800;21212;
10.02.2019;14:43:06;84823156;84801973;21183;
10.02.2019;14:44:04;84823314;84802124;21190;
10.02.2019;14:45:04;84823473;84802307;21166;
10.02.2019;14:46:04;84823591;84802482;21109;
10.02.2019;14:47:05;84823735;84802654;21081;
10.02.2019;14:48:05;84823875;84802838;21037;
10.02.2019;14:49:06;84824038;84803007;21031;
10.02.2019;14:50:05;84824189;84803212;20977;
10.02.2019;14:51:05;84824349;84803389;20960;
10.02.2019;14:52:05;84824500;84803563;20937;
10.02.2019;14:53:06;84824661;84803733;20928;
10.02.2019;14:54:06;84824804;84803903;20901;
10.02.2019;14:55:05;84824952;84804099;20853;
10.02.2019;14:56:06;84825097;84804288;20809;
10.02.2019;14:57:05;84825232;84804487;20745;
10.02.2019;14:58:06;84825382;84804693;20689;
10.02.2019;14:59:05;84825541;84804882;20659;
10.02.2019;15:00:07;84825692;84805099;20593;
10.02.2019;15:01:09;84825838;84805298;20540;
10.02.2019;15:02:12;84825976;84805478;20498;
10.02.2019;15:03:07;84826109;84805668;20441;
10.02.2019;15:04:08;84826246;84805873;20373;
10.02.2019;15:05:08;84826434;84806074;20360;
10.02.2019;15:06:07;84826569;84806235;20334;
10.02.2019;15:07:08;84826734;84806435;20299;
10.02.2019;15:08:07;84826868;84806611;20257;
10.02.2019;15:09:07;84827007;84806793;20214;
10.02.2019;15:10:09;84827150;84807003;20147;
10.02.2019;15:11:08;84827292;84807217;20075;
10.02.2019;15:12:07;84827449;84807429;20020;
10.02.2019;15:13:07;84827588;84807589;19999;
10.02.2019;15:14:08;84827751;84807801;19950;
10.02.2019;15:15:08;84827936;84808006;19930;
10.02.2019;15:16:07;84828124;84808201;19923;
10.02.2019;15:17:08;84828307;84808384;19923;
10.02.2019;15:18:13;84828484;84808590;19894;
10.02.2019;15:19:10;84828659;84808760;19899;
10.02.2019;15:20:14;84828888;84808971;19917;
10.02.2019;15:21:11;84829020;84809149;19871;
10.02.2019;15:22:12;84829206;84809362;19844;
10.02.2019;15:23:13;84829413;84809534;19879;
10.02.2019;15:24:16;84829565;84809739;19826;
10.02.2019;15:25:13;84829734;84809945;19789;
10.02.2019;15:26:18;84829949;84810103;19846;
10.02.2019;15:27:14;84830085;84810342;19743;
10.02.2019;15:28:17;84830257;84810543;19714;
10.02.2019;15:29:19;84830414;84810715;19699;
10.02.2019;15:30:16;84830543;84810919;19624;
10.02.2019;15:31:20;84830733;84811139;19594;
10.02.2019;15:32:17;84830898;84811336;19562;
10.02.2019;15:33:19;84831085;84811559;19526;
10.02.2019;15:34:21;84831261;84811760;19501;
10.02.2019;15:35:16;84831412;84811921;19491;
10.02.2019;15:36:23;84831601;84812105;19496;
10.02.2019;15:37:20;84831750;84812289;19461;
10.02.2019;15:38:23;84831944;84812517;19427;
10.02.2019;15:39:23;84832111;84812776;19335;
10.02.2019;15:40:18;84832259;84812930;19329;
10.02.2019;15:41:22;84832425;84813091;19334;
10.02.2019;15:42:23;84832569;84813163;19406;
10.02.2019;15:43:19;84832738;84813326;19412;
10.02.2019;15:44:22;84832962;84813582;19380;
10.02.2019;15:45:24;84833149;84813807;19342;
10.02.2019;15:46:20;84833340;84814007;19333;
10.02.2019;15:47:25;84833535;84814242;19293;
10.02.2019;15:48:22;84833712;84814423;19289;
10.02.2019;15:49:23;84833909;84814645;19264;
10.02.2019;15:50:25;84834108;84814846;19262;
10.02.2019;15:51:23;84834289;84815030;19259;
10.02.2019;15:52:25;84834494;84815253;19241;
10.02.2019;15:53:26;84834727;84815440;19287;
10.02.2019;15:54:26;84834927;84815622;19305;
10.02.2019;15:55:23;84835090;84815798;19292;
10.02.2019;15:56:24;84835299;84815978;19321;
10.02.2019;15:57:26;84835503;84816198;19305;
10.02.2019;15:58:24;84835669;84816371;19298;
10.02.2019;15:59:26;84835874;84816558;19316;
10.02.2019;16:00:22;84836041;84816768;19273;
10.02.2019;16:01:16;84836202;84816951;19251;
10.02.2019;16:02:17;84836411;84817173;19238;
10.02.2019;16:03:05;84836576;84817341;19235;
10.02.2019;16:04:05;84836782;84817543;19239;
10.02.2019;16:05:05;84836970;84817759;19211;
10.02.2019;16:06:06;84837151;84817982;19169;
10.02.2019;16:07:05;84837360;84818158;19202;
10.02.2019;16:08:06;84837569;84818357;19212;
10.02.2019;16:09:08;84837746;84818542;19204;
10.02.2019;16:10:05;84837928;84818749;19179;
10.02.2019;16:11:04;84838104;84818994;19110;
10.02.2019;16:12:08;84838293;84819215;19078;
10.02.2019;16:13:05;84838451;84819368;19083;
10.02.2019;16:14:05;84838621;84819541;19080;
10.02.2019;16:15:05;84838788;84819719;19069;
10.02.2019;16:16:08;84838950;84819883;19067;
10.02.2019;16:17:05;84839093;84820064;19029;
10.02.2019;16:18:05;84839223;84820209;19014;
10.02.2019;16:19:04;84839344;84820361;18983;
10.02.2019;16:20:07;84839523;84820501;19022;
10.02.2019;16:21:05;84839684;84820709;18975;
10.02.2019;16:22:05;84839860;84820862;18998;
10.02.2019;16:23:05;84840063;84821018;19045;
10.02.2019;16:24:06;84840250;84821201;19049;
10.02.2019;16:25:06;84840432;84821366;19066;
10.02.2019;16:26:06;84840587;84821570;19017;
10.02.2019;16:27:05;84840764;84821741;19023;
10.02.2019;16:28:06;84840935;84821956;18979;
10.02.2019;16:29:06;84841082;84822151;18931;
10.02.2019;16:30:06;84841243;84822350;18893;
10.02.2019;16:31:04;84841417;84822531;18886;
10.02.2019;16:32:05;84841612;84822686;18926;
10.02.2019;16:33:04;84841805;84822858;18947;
10.02.2019;16:34:05;84842023;84823062;18961;
10.02.2019;16:35:05;84842232;84823213;19019;
10.02.2019;16:36:04;84842417;84823392;19025;
10.02.2019;16:37:08;84842625;84823586;19039;
10.02.2019;16:38:05;84842823;84823768;19055;
10.02.2019;16:39:05;84842987;84823960;19027;
10.02.2019;16:40:05;84843181;84824178;19003;
10.02.2019;16:41:08;84843373;84824365;19008;
10.02.2019;16:42:04;84843576;84824529;19047;
10.02.2019;16:43:05;84843781;84824740;19041;
10.02.2019;16:44:05;84843972;84824913;19059;
10.02.2019;16:45:07;84844173;84825128;19045;
10.02.2019;16:46:05;84844360;84825303;19057;
10.02.2019;16:47:05;84844554;84825498;19056;
10.02.2019;16:48:05;84844755;84825695;19060;
10.02.2019;16:49:07;84844920;84825898;19022;
10.02.2019;16:50:04;84845108;84826084;19024;
10.02.2019;16:51:04;84845298;84826268;19030;
10.02.2019;16:52:06;84845485;84826462;19023;
10.02.2019;16:53:08;84845726;84826676;19050;
10.02.2019;16:54:06;84845879;84826860;19019;
10.02.2019;16:55:05;84846125;84827039;19086;
10.02.2019;16:56:06;84846337;84827237;19100;
10.02.2019;16:57:08;84846552;84827417;19135;
10.02.2019;16:58:05;84846773;84827639;19134;
10.02.2019;16:59:06;84847003;84827828;19175;
10.02.2019;17:00:05;84847226;84828013;19213;
10.02.2019;17:01:08;84847421;84828195;19226;
10.02.2019;17:02:05;84847666;84828377;19289;
10.02.2019;17:03:06;84847839;84828569;19270;
10.02.2019;17:04:05;84848113;84828770;19343;
10.02.2019;17:05:08;84848483;84829008;19475;
10.02.2019;17:06:05;84848830;84829209;19621;
10.02.2019;17:07:05;84849329;84829400;19929;
10.02.2019;17:08:05;84849780;84829618;20162;
10.02.2019;17:09:09;84850315;84829811;20504;
10.02.2019;17:10:05;84850599;84830002;20597;
10.02.2019;17:11:06;84850791;84830219;20572;
10.02.2019;17:12:05;84851346;84830427;20919;
10.02.2019;17:13:07;84851789;84830622;21167;
10.02.2019;17:14:04;84852212;84830821;21391;
10.02.2019;17:15:05;84852738;84831038;21700;
10.02.2019;17:16:06;84853165;84831266;21899;
10.02.2019;17:17:05;84853597;84831482;22115;
10.02.2019;17:18:06;84854060;84831678;22382;
10.02.2019;17:19:05;84854427;84831898;22529;
10.02.2019;17:20:09;84854838;84832135;22703;
10.02.2019;17:21:09;84855205;84832336;22869;
10.02.2019;17:22:05;84855555;84832530;23025;
10.02.2019;17:23:06;84855869;84832721;23148;
10.02.2019;17:24:05;84856209;84832931;23278;
10.02.2019;17:25:06;84856611;84833137;23474;
10.02.2019;17:26:06;84857037;84833318;23719;
10.02.2019;17:27:05;84857408;84833509;23899;
10.02.2019;17:28:05;84857781;84833712;24069;
10.02.2019;17:29:08;84858176;84833932;24244;
10.02.2019;17:30:05;84858590;84834153;24437;
10.02.2019;17:31:05;84858915;84834339;24576;
10.02.2019;17:32:06;84859265;84834521;24744;
10.02.2019;17:33:04;84859645;84834692;24953;
10.02.2019;17:34:05;84859988;84834878;25110;
10.02.2019;17:35:05;84860385;84835041;25344;
10.02.2019;17:36:08;84860734;84835257;25477;
10.02.2019;17:37:04;84861062;84835419;25643;
10.02.2019;17:38:05;84861396;84835607;25789;
10.02.2019;17:39:07;84861706;84835797;25909;
10.02.2019;17:40:08;84861999;84835993;26006;
10.02.2019;17:41:04;84862229;84836154;26075;
10.02.2019;17:42:04;84862472;84836382;26090;
10.02.2019;17:43:05;84862751;84836579;26172;
10.02.2019;17:44:05;84863009;84836756;26253;
10.02.2019;17:45:08;84863326;84836925;26401;
10.02.2019;17:46:05;84863589;84837109;26480;
10.02.2019;17:47:05;84863877;84837291;26586;
10.02.2019;17:48:05;84864187;84837489;26698;
10.02.2019;17:49:05;84864447;84837682;26765;
10.02.2019;17:50:05;84864776;84837865;26911;
10.02.2019;17:51:05;84865109;84838044;27065;
10.02.2019;17:52:06;84865373;84838230;27143;
10.02.2019;17:53:05;84865696;84838414;27282;
10.02.2019;17:54:07;84866004;84838591;27413;
10.02.2019;17:55:05;84866259;84838764;27495;
10.02.2019;17:56:05;84866506;84838931;27575;
10.02.2019;17:57:05;84866719;84839105;27614;
10.02.2019;17:58:05;84866908;84839271;27637;
10.02.2019;17:59:05;84867250;84839472;27778;
10.02.2019;18:00:07;84867536;84839686;27850;
10.02.2019;18:01:05;84867788;84839869;27919;
10.02.2019;18:02:05;84868063;84840051;28012;
10.02.2019;18:03:05;84868305;84840256;28049;
10.02.2019;18:04:14;84868667;84840458;28209;
10.02.2019;18:05:05;84868904;84840604;28300;
10.02.2019;18:06:06;84869214;84840772;28442;
10.02.2019;18:07:09;84869519;84840975;28544;
10.02.2019;18:08:05;84869816;84841135;28681;
10.02.2019;18:09:11;84870203;84841329;28874;
10.02.2019;18:10:05;84870507;84841509;28998;
10.02.2019;18:11:05;84870824;84841683;29141;
10.02.2019;18:12:05;84871115;84841840;29275;
10.02.2019;18:13:05;84871422;84842008;29414;
10.02.2019;18:14:04;84871655;84842132;29523;
10.02.2019;18:15:04;84871892;84842284;29608;
10.02.2019;18:16:04;84872166;84842406;29760;
10.02.2019;18:17:04;84872429;84842523;29906;
10.02.2019;18:18:04;84872629;84842653;29976;
10.02.2019;18:19:05;84872890;84842755;30135;
10.02.2019;18:20:05;84873173;84842891;30282;
10.02.2019;18:21:06;84873453;84843035;30418;
10.02.2019;18:22:07;84873771;84843184;30587;
10.02.2019;18:23:04;84874016;84843289;30727;
10.02.2019;18:24:04;84874264;84843417;30847;
10.02.2019;18:25:04;84874537;84843534;31003;
10.02.2019;18:26:05;84874802;84843659;31143;
10.02.2019;18:27:05;84875038;84843766;31272;
10.02.2019;18:28:05;84875336;84843921;31415;
10.02.2019;18:29:04;84875616;84844038;31578;
10.02.2019;18:30:05;84875901;84844198;31703;
10.02.2019;18:31:05;84876172;84844331;31841;
10.02.2019;18:32:05;84876498;84844492;32006;
10.02.2019;18:33:07;84876845;84844619;32226;
10.02.2019;18:34:04;84877112;84844736;32376;
10.02.2019;18:35:04;84877460;84844883;32577;
10.02.2019;18:36:05;84877754;84845026;32728;
10.02.2019;18:37:05;84878039;84845145;32894;
10.02.2019;18:38:06;84878340;84845300;33040;
10.02.2019;18:39:07;84878585;84845434;33151;
10.02.2019;18:40:06;84878930;84845546;33384;
10.02.2019;18:41:06;84879524;84845675;33849;
10.02.2019;18:42:04;84879940;84845733;34207;
10.02.2019;18:43:04;84880564;84845875;34689;
10.02.2019;18:44:05;84881044;84845989;35055;
10.02.2019;18:45:04;84881479;84846121;35358;
10.02.2019;18:46:05;84881906;84846242;35664;
10.02.2019;18:47:06;84882254;84846382;35872;
10.02.2019;18:48:05;84882629;84846504;36125;
10.02.2019;18:49:05;84882977;84846657;36320;
10.02.2019;18:50:05;84883353;84846772;36581;
10.02.2019;18:51:06;84883710;84846906;36804;
10.02.2019;18:52:05;84884056;84847046;37010;
10.02.2019;18:53:04;84884353;84847193;37160;
10.02.2019;18:54:05;84884620;84847332;37288;
10.02.2019;18:55:07;84884876;84847466;37410;
10.02.2019;18:56:04;84885171;84847600;37571;
10.02.2019;18:57:04;84885397;84847741;37656;
10.02.2019;18:58:05;84885603;84847880;37723;
10.02.2019;18:59:05;84885875;84848011;37864;
10.02.2019;19:00:04;84886142;84848140;38002;
10.02.2019;19:01:05;84886359;84848274;38085;
10.02.2019;19:02:05;84886651;84848430;38221;
10.02.2019;19:03:04;84886928;84848556;38372;
10.02.2019;19:04:05;84887309;84848679;38630;
10.02.2019;19:05:05;84887617;84848789;38828;
10.02.2019;19:06:04;84887858;84848955;38903;
10.02.2019;19:07:04;84888123;84849091;39032;
10.02.2019;19:08:04;84888392;84849224;39168;
10.02.2019;19:09:05;84888694;84849371;39323;
10.02.2019;19:10:05;84888961;84849505;39456;
10.02.2019;19:11:05;84889225;84849641;39584;
10.02.2019;19:12:06;84889478;84849779;39699;
10.02.2019;19:13:05;84889869;84849904;39965;
10.02.2019;19:14:06;84890181;84850041;40140;
10.02.2019;19:15:05;84890445;84850142;40303;
10.02.2019;19:16:05;84890731;84850283;40448;
10.02.2019;19:17:06;84891017;84850407;40610;
10.02.2019;19:18:05;84891324;84850507;40817;
10.02.2019;19:19:06;84891644;84850629;41015;
10.02.2019;19:20:05;84891944;84850756;41188;
10.02.2019;19:21:05;84892234;84850879;41355;
10.02.2019;19:22:05;84892494;84851012;41482;
10.02.2019;19:23:05;84892821;84851122;41699;
10.02.2019;19:24:05;84893081;84851257;41824;
10.02.2019;19:25:05;84893341;84851369;41972;
10.02.2019;19:26:05;84893620;84851476;42144;
10.02.2019;19:27:06;84893872;84851573;42299;
10.02.2019;19:28:05;84894185;84851696;42489;
10.02.2019;19:29:05;84894485;84851821;42664;
10.02.2019;19:30:05;84894803;84851917;42886;
10.02.2019;19:31:05;84895125;84852011;43114;
10.02.2019;19:32:05;84895343;84852131;43212;
10.02.2019;19:33:04;84895613;84852263;43350;
10.02.2019;19:34:04;84895840;84852371;43469;
10.02.2019;19:35:05;84896104;84852477;43627;
10.02.2019;19:36:05;84896314;84852557;43757;
10.02.2019;19:37:05;84896563;84852664;43899;
10.02.2019;19:38:10;84896804;84852786;44018;
10.02.2019;19:39:07;84897046;84852899;44147;
10.02.2019;19:40:04;84897241;84853002;44239;
10.02.2019;19:41:05;84897441;84853106;44335;
10.02.2019;19:42:06;84897646;84853218;44428;
10.02.2019;19:43:04;84897888;84853324;44564;
10.02.2019;19:44:06;84898079;84853447;44632;
10.02.2019;19:45:05;84898258;84853545;44713;
10.02.2019;19:46:05;84898433;84853647;44786;
10.02.2019;19:47:05;84898645;84853745;44900;
10.02.2019;19:48:05;84898831;84853844;44987;
10.02.2019;19:49:06;84899016;84853941;45075;
10.02.2019;19:50:06;84899205;84854044;45161;
10.02.2019;19:51:06;84899416;84854135;45281;
10.02.2019;19:52:05;84899621;84854220;45401;
10.02.2019;19:53:05;84899840;84854296;45544;
10.02.2019;19:54:06;84900015;84854389;45626;
10.02.2019;19:55:04;84900231;84854494;45737;
10.02.2019;19:56:04;84900435;84854601;45834;
10.02.2019;19:57:05;84900634;84854696;45938;
10.02.2019;19:58:05;84900820;84854802;46018;
10.02.2019;19:59:06;84901003;84854892;46111;
10.02.2019;20:00:08;84901218;84854996;46222;
10.02.2019;20:01:07;84901443;84855089;46354;
10.02.2019;20:02:08;84901629;84855182;46447;
10.02.2019;20:03:06;84901806;84855278;46528;
10.02.2019;20:04:07;84902004;84855363;46641;
10.02.2019;20:05:06;84902188;84855455;46733;
10.02.2019;20:06:06;84902372;84855541;46831;
10.02.2019;20:07:08;84902553;84855630;46923;
10.02.2019;20:08:08;84902779;84855708;47071;
10.02.2019;20:09:08;84902980;84855791;47189;
10.02.2019;20:10:05;84903163;84855885;47278;
10.02.2019;20:11:07;84903309;84855966;47343;
10.02.2019;20:12:06;84903463;84856051;47412;
10.02.2019;20:13:07;84903616;84856155;47461;
10.02.2019;20:14:04;84903642;84856198;47444;
10.02.2019;20:15:05;84903727;84856279;47448;
10.02.2019;20:16:06;84903783;84856347;47436;
10.02.2019;20:17:05;84903828;84856401;47427;
10.02.2019;20:18:06;84903877;84856451;47426;
10.02.2019;20:19:05;84903826;84856499;47327;
10.02.2019;20:20:05;84903817;84856572;47245;
10.02.2019;20:21:06;84903799;84856600;47199;
10.02.2019;20:22:05;84903780;84856634;47146;
10.02.2019;20:23:06;84903802;84856685;47117;
10.02.2019;20:24:06;84903844;84856753;47091;
10.02.2019;20:25:06;84903910;84856802;47108;
10.02.2019;20:26:05;84903975;84856864;47111;
10.02.2019;20:27:05;84903996;84856894;47102;
10.02.2019;20:28:06;84904012;84856961;47051;
10.02.2019;20:29:06;84904015;84857015;47000;
10.02.2019;20:30:05;84904069;84857078;46991;
10.02.2019;20:31:05;84903978;84857108;46870;
10.02.2019;20:32:06;84904095;84857149;46946;
10.02.2019;20:33:05;84904146;84857210;46936;
10.02.2019;20:34:06;84904210;84857273;46937;
10.02.2019;20:35:06;84904012;84857301;46711;
10.02.2019;20:36:09;84904070;84857369;46701;
10.02.2019;20:37:06;84904205;84857420;46785;
10.02.2019;20:38:05;84904371;84857476;46895;
10.02.2019;20:39:05;84904506;84857527;46979;
10.02.2019;20:40:06;84904646;84857586;47060;
10.02.2019;20:41:05;84904831;84857657;47174;
10.02.2019;20:42:06;84904995;84857720;47275;
10.02.2019;20:43:05;84905164;84857791;47373;
10.02.2019;20:44:05;84911268;84867795;43473;
10.02.2019;20:45:05;84911451;84867853;43598;
10.02.2019;20:46:05;84911624;84867915;43709;
10.02.2019;20:47:05;84911828;84867991;43837;
10.02.2019;20:48:04;84912023;84868055;43968;
10.02.2019;20:49:05;84912198;84868121;44077;
10.02.2019;20:50:06;84912383;84868205;44178;
10.02.2019;20:51:05;84912598;84868257;44341;
10.02.2019;20:52:06;84912775;84868323;44452;
10.02.2019;20:53:05;84912959;84868392;44567;
10.02.2019;20:54:05;84913139;84868439;44700;
10.02.2019;20:55:05;84913332;84868514;44818;
10.02.2019;20:56:05;84913505;84868601;44904;
10.02.2019;20:57:05;84913708;84868664;45044;
10.02.2019;20:58:06;84913859;84868717;45142;
10.02.2019;20:59:05;84914033;84868790;45243;
10.02.2019;21:00:05;84914192;84868848;45344;
10.02.2019;21:01:05;84914363;84868914;45449;
10.02.2019;21:02:05;84914537;84868965;45572;
10.02.2019;21:03:05;84914726;84869024;45702;
10.02.2019;21:04:05;84914899;84869078;45821;
10.02.2019;21:05:05;84915067;84869135;45932;
10.02.2019;21:06:05;84915237;84869192;46045;
10.02.2019;21:07:09;84915430;84869245;46185;
10.02.2019;21:08:06;84915596;84869304;46292;
10.02.2019;21:09:05;84915776;84869364;46412;
10.02.2019;21:10:05;84915982;84869434;46548;
10.02.2019;21:11:06;84916128;84869512;46616;
10.02.2019;21:12:05;84916336;84869582;46754;
10.02.2019;21:13:05;84916528;84869648;46880;
10.02.2019;21:14:06;84916710;84869686;47024;
10.02.2019;21:15:06;84916866;84869746;47120;
10.02.2019;21:16:07;84917015;84869796;47219;
10.02.2019;21:17:06;84917158;84869834;47324;
10.02.2019;21:18:08;84917330;84869894;47436;
10.02.2019;21:19:06;84917506;84869951;47555;
10.02.2019;21:20:04;84917677;84869998;47679;
10.02.2019;21:21:04;84917823;84870046;47777;
10.02.2019;21:22:05;84917996;84870106;47890;
10.02.2019;21:23:05;84918158;84870169;47989;
10.02.2019;21:24:05;84918314;84870232;48082;
10.02.2019;21:25:05;84918508;84870264;48244;
10.02.2019;21:26:05;84918666;84870311;48355;
10.02.2019;21:27:05;84918843;84870362;48481;
10.02.2019;21:28:05;84918999;84870413;48586;
10.02.2019;21:29:04;84919180;84870457;48723;
10.02.2019;21:30:06;84919372;84870507;48865;
10.02.2019;21:31:06;84919532;84870557;48975;
10.02.2019;21:32:09;84919698;84870608;49090;
10.02.2019;21:33:06;84919849;84870658;49191;
10.02.2019;21:34:09;84920036;84870722;49314;
10.02.2019;21:35:06;84920200;84870758;49442;
10.02.2019;21:36:06;84920392;84870800;49592;
10.02.2019;21:37:05;84920564;84870845;49719;
10.02.2019;21:38:06;84920758;84870894;49864;
10.02.2019;21:39:06;84920921;84870928;49993;
10.02.2019;21:40:07;84921069;84870966;50103;
10.02.2019;21:41:04;84921253;84871012;50241;
10.02.2019;21:42:04;84921427;84871065;50362;
10.02.2019;21:43:06;84921609;84871121;50488;
10.02.2019;21:44:04;84921810;84871169;50641;
10.02.2019;21:45:05;84921970;84871212;50758;
10.02.2019;21:46:06;84922136;84871253;50883;
10.02.2019;21:47:09;84922295;84871303;50992;
10.02.2019;21:48:05;84922439;84871348;51091;
10.02.2019;21:49:07;84922584;84871365;51219;
10.02.2019;21:50:05;84922674;84871320;51354;
10.02.2019;21:51:04;84922857;84871362;51495;
10.02.2019;21:52:04;84923043;84871398;51645;
10.02.2019;21:53:05;84923225;84871429;51796;
10.02.2019;21:54:06;84923386;84871443;51943;
10.02.2019;21:55:05;84923578;84871497;52081;
10.02.2019;21:56:05;84923725;84871539;52186;
10.02.2019;21:57:07;84923892;84871601;52291;
10.02.2019;21:58:07;84924077;84871644;52433;
10.02.2019;21:59:05;84924230;84871680;52550;
10.02.2019;22:00:04;84924378;84871735;52643;
10.02.2019;22:01:06;84924576;84871781;52795;
10.02.2019;22:02:13;84924773;84871801;52972;
10.02.2019;22:03:06;84924942;84871839;53103;
10.02.2019;22:04:06;84925140;84871869;53271;
10.02.2019;22:05:05;84925324;84871913;53411;
10.02.2019;22:06:08;84925506;84871963;53543;
10.02.2019;22:07:05;84925668;84872008;53660;
10.02.2019;22:08:06;84925852;84872051;53801;
10.02.2019;22:09:06;84926047;84872109;53938;
10.02.2019;22:10:09;84926233;84872153;54080;
10.02.2019;22:11:05;84926394;84872178;54216;
10.02.2019;22:12:06;84926591;84872227;54364;
10.02.2019;22:13:05;84926753;84872269;54484;
10.02.2019;22:14:08;84926867;84872294;54573;
10.02.2019;22:15:05;84926972;84872330;54642;
10.02.2019;22:16:06;84927104;84872364;54740;
10.02.2019;22:17:06;84927208;84872395;54813;
10.02.2019;22:18:09;84927296;84872418;54878;
10.02.2019;22:19:05;84927364;84872456;54908;
10.02.2019;22:20:05;84927435;84872490;54945;
10.02.2019;22:21:05;84927643;84872527;55116;
10.02.2019;22:22:08;84927715;84872564;55151;
10.02.2019;22:23:05;84927775;84872597;55178;
10.02.2019;22:24:10;84927834;84872620;55214;
10.02.2019;22:25:05;84927918;84872643;55275;
10.02.2019;22:26:08;84928038;84872680;55358;
10.02.2019;22:27:05;84928171;84872708;55463;
10.02.2019;22:28:04;84928272;84872739;55533;
10.02.2019;22:29:05;84928269;84872770;55499;
10.02.2019;22:30:08;84928362;84872805;55557;
10.02.2019;22:31:04;84928503;84872836;55667;
10.02.2019;22:32:04;84928609;84872858;55751;
10.02.2019;22:33:05;84928744;84872880;55864;
10.02.2019;22:34:08;84928882;84872911;55971;
10.02.2019;22:35:05;84928990;84872941;56049;
10.02.2019;22:36:05;84929085;84872969;56116;
10.02.2019;22:37:05;84929230;84873005;56225;
10.02.2019;22:38:07;84929361;84873030;56331;
10.02.2019;22:39:05;84929508;84873057;56451;
10.02.2019;22:40:05;84929653;84873082;56571;
10.02.2019;22:41:05;84929797;84873103;56694;
10.02.2019;22:42:07;84929949;84873148;56801;
10.02.2019;22:43:05;84930081;84873186;56895;
10.02.2019;22:44:05;84930235;84873219;57016;
10.02.2019;22:45:04;84930372;84873257;57115;
10.02.2019;22:46:06;84930508;84873288;57220;
10.02.2019;22:47:05;84930681;84873305;57376;
10.02.2019;22:48:05;84930814;84873352;57462;
10.02.2019;22:49:05;84930957;84873381;57576;
10.02.2019;22:50:06;84931106;84873408;57698;
10.02.2019;22:51:05;84931264;84873458;57806;
10.02.2019;22:52:05;84931415;84873492;57923;
10.02.2019;22:53:07;84931563;84873526;58037;
10.02.2019;22:54:06;84931693;84873549;58144;
10.02.2019;22:55:04;84931842;84873592;58250;
10.02.2019;22:56:04;84931983;84873619;58364;
10.02.2019;22:57:07;84932130;84873652;58478;
10.02.2019;22:58:05;84932255;84873678;58577;
10.02.2019;22:59:04;84932381;84873711;58670;
10.02.2019;23:00:05;84932522;84873742;58780;
10.02.2019;23:01:06;84932693;84873770;58923;
10.02.2019;23:02:04;84932862;84873803;59059;
10.02.2019;23:03:05;84933012;84873828;59184;
10.02.2019;23:04:05;84933158;84873863;59295;
10.02.2019;23:05:06;84933326;84873886;59440;
10.02.2019;23:06:04;84933473;84873917;59556;
10.02.2019;23:07:04;84933580;84873946;59634;
10.02.2019;23:08:04;84933737;84873975;59762;
10.02.2019;23:09:07;84933876;84873998;59878;
10.02.2019;23:10:06;84934026;84874037;59989;
10.02.2019;23:11:04;84934203;84874074;60129;
10.02.2019;23:12:04;84934357;84874098;60259;
10.02.2019;23:13:05;84934508;84874133;60375;
10.02.2019;23:14:08;84934635;84874153;60482;
10.02.2019;23:15:06;84934766;84874172;60594;
10.02.2019;23:16:04;84934909;84874204;60705;
10.02.2019;23:17:05;84935031;84874236;60795;
10.02.2019;23:18:05;84935178;84874268;60910;
10.02.2019;23:19:05;84935303;84874307;60996;
10.02.2019;23:20:05;84935424;84874326;61098;
10.02.2019;23:21:05;84935553;84874368;61185;
10.02.2019;23:22:07;84935696;84874413;61283;
10.02.2019;23:23:06;84935846;84874444;61402;
10.02.2019;23:24:05;84936029;84874475;61554;
10.02.2019;23:25:05;84936175;84874501;61674;
10.02.2019;23:26:09;84936353;84874532;61821;
10.02.2019;23:27:05;84936481;84874564;61917;
10.02.2019;23:28:05;84936614;84874597;62017;
10.02.2019;23:29:05;84936749;84874631;62118;
10.02.2019;23:30:07;84936916;84874658;62258;
10.02.2019;23:31:05;84937065;84874678;62387;
10.02.2019;23:32:05;84937180;84874696;62484;
10.02.2019;23:33:05;84937326;84874734;62592;
10.02.2019;23:34:08;84937453;84874776;62677;
10.02.2019;23:35:06;84937601;84874802;62799;
10.02.2019;23:36:05;84937725;84874820;62905;
10.02.2019;23:37:06;84937881;84874844;63037;
10.02.2019;23:38:05;84938027;84874881;63146;
10.02.2019;23:39:05;84938173;84874906;63267;
10.02.2019;23:40:04;84938313;84874941;63372;
10.02.2019;23:41:04;84938440;84874967;63473;
10.02.2019;23:42:08;84938552;84874999;63553;
10.02.2019;23:43:05;84938689;84875037;63652;
10.02.2019;23:44:05;84938808;84875057;63751;
10.02.2019;23:45:06;84938958;84875077;63881;
10.02.2019;23:46:06;84939096;84875100;63996;
10.02.2019;23:47:05;84939227;84875139;64088;
10.02.2019;23:48:05;84939352;84875156;64196;
10.02.2019;23:49:06;84939504;84875176;64328;
10.02.2019;23:50:05;84939653;84875202;64451;
10.02.2019;23:51:05;84939810;84875223;64587;
10.02.2019;23:52:06;84939971;84875255;64716;
10.02.2019;23:53:05;84940124;84875283;64841;
10.02.2019;23:54:07;84940288;84875314;64974;
10.02.2019;23:55:06;84940456;84875339;65117;
10.02.2019;23:56:05;84940585;84875376;65209;
10.02.2019;23:57:06;84940747;84875412;65335;
10.02.2019;23:58:06;84940888;84875435;65453;
10.02.2019;23:59:06;84941031;84875459;65572;
11.02.2019;00:00:08;84941161;84875478;65683;
11.02.2019;00:01:14;84941285;84875513;65772;
11.02.2019;00:02:11;84941428;84875534;65894;
11.02.2019;00:03:15;84941580;84875558;66022;
11.02.2019;00:04:10;84941723;84875574;66149;
11.02.2019;00:05:08;84941871;84875595;66276;
11.02.2019;00:06:08;84942010;84875630;66380;
11.02.2019;00:07:07;84942118;84875664;66454;
11.02.2019;00:08:08;84942245;84875681;66564;
11.02.2019;00:09:09;84942392;84875700;66692;
11.02.2019;00:10:08;84942527;84875738;66789;
11.02.2019;00:11:09;84942632;84875767;66865;
11.02.2019;00:12:06;84942733;84875778;66955;
11.02.2019;00:13:07;84942797;84875789;67008;
11.02.2019;00:14:06;84942877;84875810;67067;
11.02.2019;00:15:08;84942891;84875815;67076;
11.02.2019;00:16:08;84942961;84875817;67144;
11.02.2019;00:17:09;84943010;84875827;67183;
11.02.2019;00:18:09;84943052;84875837;67215;
11.02.2019;00:19:08;84943116;84875848;67268;
11.02.2019;00:20:08;84943180;84875853;67327;
11.02.2019;00:21:11;84943258;84875869;67389;
11.02.2019;00:22:12;84943343;84875890;67453;
11.02.2019;00:23:11;84943425;84875911;67514;
11.02.2019;00:24:15;84943522;84875929;67593;
11.02.2019;00:25:11;84943633;84875949;67684;
11.02.2019;00:26:13;84943748;84875979;67769;
11.02.2019;00:27:10;84943857;84875997;67860;
11.02.2019;00:28:10;84943970;84876018;67952;
11.02.2019;00:29:11;84944105;84876046;68059;
11.02.2019;00:30:11;84944226;84876070;68156;
11.02.2019;00:31:09;84944337;84876099;68238;
11.02.2019;00:32:08;84944460;84876132;68328;
11.02.2019;00:33:09;84944590;84876154;68436;
11.02.2019;00:34:08;84944721;84876176;68545;
11.02.2019;00:35:08;84944837;84876192;68645;
11.02.2019;00:36:10;84944937;84876226;68711;
11.02.2019;00:37:08;84945069;84876265;68804;
11.02.2019;00:38:08;84945162;84876296;68866;
11.02.2019;00:39:07;84945273;84876340;68933;
11.02.2019;00:40:10;84945384;84876363;69021;
11.02.2019;00:41:08;84945497;84876388;69109;
11.02.2019;00:42:08;84945620;84876418;69202;
11.02.2019;00:43:08;84945743;84876439;69304;
11.02.2019;00:44:07;84945861;84876478;69383;
11.02.2019;00:45:07;84945981;84876503;69478;
11.02.2019;00:46:08;84946112;84876543;69569;
11.02.2019;00:47:08;84946249;84876573;69676;
11.02.2019;00:48:08;84946375;84876595;69780;
11.02.2019;00:49:08;84946496;84876619;69877;
11.02.2019;00:50:07;84946612;84876635;69977;
11.02.2019;00:51:08;84946717;84876625;70092;
11.02.2019;00:52:08;84946828;84876625;70203;
11.02.2019;00:53:07;84946957;84876659;70298;
11.02.2019;00:54:09;84947074;84876688;70386;
11.02.2019;00:55:07;84947206;84876706;70500;
11.02.2019;00:56:07;84947297;84876736;70561;
11.02.2019;00:57:08;84947407;84876771;70636;
11.02.2019;00:58:07;84947522;84876804;70718;
11.02.2019;00:59:08;84947628;84876849;70779;
11.02.2019;01:00:06;84947773;84876881;70892;
11.02.2019;01:01:05;84947882;84876911;70971;
11.02.2019;01:02:05;84947999;84876936;71063;
11.02.2019;01:03:05;84948111;84876971;71140;
11.02.2019;01:04:05;84948234;84876993;71241;
11.02.2019;01:05:05;84948332;84877035;71297;
11.02.2019;01:06:05;84948451;84877066;71385;
11.02.2019;01:07:04;84948582;84877106;71476;
11.02.2019;01:08:04;84948692;84877138;71554;
11.02.2019;01:09:04;84948816;84877167;71649;
11.02.2019;01:10:05;84948927;84877208;71719;
11.02.2019;01:11:05;84949042;84877229;71813;
11.02.2019;01:12:05;84949178;84877274;71904;
11.02.2019;01:13:05;84949328;84877298;72030;
11.02.2019;01:14:05;84949421;84877337;72084;
11.02.2019;01:15:04;84949535;84877361;72174;
11.02.2019;01:16:05;84949655;84877400;72255;
11.02.2019;01:17:06;84949744;84877444;72300;
11.02.2019;01:18:06;84949870;84877479;72391;
11.02.2019;01:19:06;84950017;84877504;72513;
11.02.2019;01:20:05;84950139;84877529;72610;
11.02.2019;01:21:06;84950257;84877561;72696;
11.02.2019;01:22:05;84950411;84877598;72813;
11.02.2019;01:23:06;84950523;84877634;72889;
11.02.2019;01:24:06;84950660;84877660;73000;
11.02.2019;01:25:05;84950771;84877691;73080;
11.02.2019;01:26:06;84950883;84877726;73157;
11.02.2019;01:27:05;84951019;84877749;73270;
11.02.2019;01:28:05;84951131;84877791;73340;
11.02.2019;01:29:05;84951260;84877826;73434;
11.02.2019;01:30:06;84951378;84877852;73526;
11.02.2019;01:31:05;84951484;84877897;73587;
11.02.2019;01:32:06;84951625;84877925;73700;
11.02.2019;01:33:05;84951719;84877946;73773;
11.02.2019;01:34:05;84951810;84877985;73825;
11.02.2019;01:35:04;84951912;84878024;73888;
11.02.2019;01:36:04;84952012;84878057;73955;
11.02.2019;01:37:04;84952119;84878097;74022;
11.02.2019;01:38:05;84952252;84878132;74120;
11.02.2019;01:39:07;84952352;84878140;74212;
11.02.2019;01:40:05;84952480;84878203;74277;
11.02.2019;01:41:06;84952604;84878233;74371;
11.02.2019;01:42:06;84952719;84878275;74444;
11.02.2019;01:43:05;84952815;84878321;74494;
11.02.2019;01:44:05;84952921;84878359;74562;
11.02.2019;01:45:04;84953039;84878410;74629;
11.02.2019;01:46:05;84953149;84878463;74686;
11.02.2019;01:47:05;84953268;84878510;74758;
11.02.2019;01:48:05;84953369;84878542;74827;
11.02.2019;01:49:04;84953476;84878586;74890;
11.02.2019;01:50:05;84953605;84878615;74990;
11.02.2019;01:51:05;84953706;84878651;75055;
11.02.2019;01:52:05;84953819;84878703;75116;
11.02.2019;01:53:05;84953919;84878752;75167;
11.02.2019;01:54:05;84954045;84878810;75235;
11.02.2019;01:55:06;84954128;84878854;75274;
11.02.2019;01:56:05;84954261;84878900;75361;
11.02.2019;01:57:06;84954368;84878933;75435;
11.02.2019;01:58:05;84954473;84878989;75484;
11.02.2019;01:59:05;84954575;84879034;75541;
11.02.2019;02:00:05;84954654;84879100;75554;
11.02.2019;02:01:04;84954759;84879138;75621;
11.02.2019;02:02:04;84954858;84879188;75670;
11.02.2019;02:03:05;84954969;84879228;75741;
11.02.2019;02:04:05;84955036;84879258;75778;
11.02.2019;02:06:04;84955201;84879351;75850;
11.02.2019;02:07:04;84955312;84879410;75902;
11.02.2019;02:08:04;84955398;84879464;75934;
11.02.2019;02:09:05;84955502;84879512;75990;
11.02.2019;02:10:05;84955566;84879563;76003;
11.02.2019;02:11:05;84955631;84879612;76019;
11.02.2019;02:12:04;84955691;84879663;76028;
11.02.2019;02:13:05;84955733;84879716;76017;
11.02.2019;02:14:04;84955797;84879755;76042;
11.02.2019;02:15:04;84955854;84879801;76053;
11.02.2019;02:16:05;84955915;84879859;76056;
11.02.2019;02:17:06;84955986;84879912;76074;
11.02.2019;02:18:04;84956056;84879957;76099;
11.02.2019;02:19:04;84956141;84880014;76127;
11.02.2019;02:20:05;84956238;84880064;76174;
11.02.2019;02:21:04;84956292;84880118;76174;
11.02.2019;02:22:05;84956373;84880167;76206;
11.02.2019;02:23:05;84956453;84880238;76215;
11.02.2019;02:24:04;84956556;84880302;76254;
11.02.2019;02:25:04;84956628;84880351;76277;
11.02.2019;02:26:05;84956737;84880414;76323;
11.02.2019;02:27:05;84956831;84880478;76353;
11.02.2019;02:28:05;84956919;84880548;76371;
11.02.2019;02:29:05;84957008;84880628;76380;
11.02.2019;02:30:05;84957101;84880696;76405;
11.02.2019;02:31:05;84957217;84880752;76465;
11.02.2019;02:32:05;84957330;84880813;76517;
11.02.2019;02:33:05;84957450;84880875;76575;
11.02.2019;02:34:06;84957561;84880933;76628;
11.02.2019;02:35:05;84957651;84880990;76661;
11.02.2019;02:36:05;84957747;84881039;76708;
11.02.2019;02:37:05;84957848;84881108;76740;
11.02.2019;02:38:05;84957935;84881185;76750;
11.02.2019;02:39:05;84958034;84881244;76790;
11.02.2019;02:40:04;84958149;84881322;76827;
11.02.2019;02:41:04;84958251;84881391;76860;
11.02.2019;02:42:05;84958354;84881469;76885;
11.02.2019;02:43:04;84958465;84881535;76930;
11.02.2019;02:44:04;84958594;84881600;76994;
11.02.2019;02:45:04;84958691;84881672;77019;
11.02.2019;02:46:04;84958793;84881742;77051;
11.02.2019;02:47:05;84958888;84881816;77072;
11.02.2019;02:48:04;84958992;84881882;77110;
11.02.2019;02:49:04;84959105;84881944;77161;
11.02.2019;02:50:05;84959211;84882027;77184;
11.02.2019;02:51:05;84959323;84882115;77208;
11.02.2019;02:52:05;84959452;84882185;77267;
11.02.2019;02:53:04;84959547;84882273;77274;
11.02.2019;02:54:05;84959666;84882353;77313;
11.02.2019;02:55:05;84959781;84882415;77366;
11.02.2019;02:56:05;84959897;84882501;77396;
11.02.2019;02:57:05;84960021;84882584;77437;
11.02.2019;02:58:04;84960142;84882668;77474;
11.02.2019;02:59:05;84960268;84882732;77536;
11.02.2019;03:00:04;84960364;84882825;77539;
11.02.2019;03:01:05;84960475;84882936;77539;
11.02.2019;03:02:05;84960657;84883019;77638;
11.02.2019;03:03:05;84960854;84883117;77737;
11.02.2019;03:04:06;84961015;84883196;77819;
11.02.2019;03:05:05;84961165;84883290;77875;
11.02.2019;03:06:05;84961328;84883372;77956;
11.02.2019;03:07:05;84961495;84883459;78036;
11.02.2019;03:08:06;84961654;84883544;78110;
11.02.2019;03:09:04;84961796;84883625;78171;
11.02.2019;03:10:04;84961959;84883711;78248;
11.02.2019;03:11:05;84962102;84883799;78303;
11.02.2019;03:12:05;84962244;84883873;78371;
11.02.2019;03:13:04;84962373;84883964;78409;
11.02.2019;03:14:05;84962522;84884050;78472;
11.02.2019;03:15:05;84962676;84884135;78541;
11.02.2019;03:16:04;84962793;84884223;78570;
11.02.2019;03:17:05;84962917;84884315;78602;
11.02.2019;03:18:05;84963032;84884408;78624;
11.02.2019;03:19:04;84963140;84884480;78660;
11.02.2019;03:20:05;84963288;84884587;78701;
11.02.2019;03:21:05;84963443;84884666;78777;
11.02.2019;03:22:06;84963551;84884769;78782;
11.02.2019;03:23:04;84963656;84884838;78818;
11.02.2019;03:24:04;84963770;84884928;78842;
11.02.2019;03:25:05;84963880;84885024;78856;
11.02.2019;03:26:05;84963988;84885111;78877;
11.02.2019;03:27:04;84964096;84885221;78875;
11.02.2019;03:28:06;84964217;84885311;78906;
11.02.2019;03:29:04;84964328;84885394;78934;
11.02.2019;03:30:04;84964447;84885493;78954;
11.02.2019;03:31:05;84964573;84885581;78992;
11.02.2019;03:32:05;84964712;84885679;79033;
11.02.2019;03:33:07;84964839;84885789;79050;
11.02.2019;03:34:05;84964958;84885883;79075;
11.02.2019;03:35:05;84965077;84885983;79094;
11.02.2019;03:36:04;84965190;84886075;79115;
11.02.2019;03:37:04;84965316;84886165;79151;
11.02.2019;03:38:05;84965421;84886259;79162;
11.02.2019;03:39:05;84965532;84886372;79160;
11.02.2019;03:40:04;84965640;84886475;79165;
11.02.2019;03:41:04;84965751;84886587;79164;
11.02.2019;03:42:06;84965890;84886676;79214;
11.02.2019;03:43:04;84965996;84886762;79234;
11.02.2019;03:44:04;84966115;84886843;79272;
11.02.2019;03:45:05;84966214;84886929;79285;
11.02.2019;03:46:04;84966315;84887024;79291;
11.02.2019;03:47:05;84966434;84887131;79303;
11.02.2019;03:48:05;84966547;84887227;79320;
11.02.2019;03:49:05;84966654;84887348;79306;
11.02.2019;03:50:04;84966764;84887446;79318;
11.02.2019;03:51:05;84966817;84887512;79305;
11.02.2019;03:52:05;84966924;84887613;79311;
11.02.2019;03:53:04;84967041;84887728;79313;
11.02.2019;03:54:04;84967157;84887803;79354;
11.02.2019;03:55:05;84967274;84887902;79372;
11.02.2019;03:56:04;84967404;84887977;79427;
11.02.2019;03:57:05;84967502;84888084;79418;
11.02.2019;03:58:05;84967603;84888202;79401;
11.02.2019;03:59:04;84967717;84888307;79410;
11.02.2019;04:00:04;84967821;84888409;79412;
11.02.2019;04:01:06;84967948;84888506;79442;
11.02.2019;04:02:06;84968063;84888602;79461;
11.02.2019;04:03:05;84968180;84888702;79478;
11.02.2019;04:04:06;84968283;84888805;79478;
11.02.2019;04:05:05;84968388;84888907;79481;
11.02.2019;04:06:05;84968508;84889006;79502;
11.02.2019;04:07:05;84968631;84889115;79516;
11.02.2019;04:08:05;84968725;84889207;79518;
11.02.2019;04:09:08;84968781;84889292;79489;
11.02.2019;04:10:06;84968877;84889389;79488;
11.02.2019;04:11:05;84968913;84889488;79425;
11.02.2019;04:12:06;84968978;84889587;79391;
11.02.2019;04:13:05;84969032;84889680;79352;
11.02.2019;04:14:06;84969069;84889786;79283;
11.02.2019;04:15:06;84969160;84889877;79283;
11.02.2019;04:16:05;84969242;84889933;79309;
11.02.2019;04:17:06;84969348;84890016;79332;
11.02.2019;04:18:05;84969427;84890098;79329;
11.02.2019;04:19:06;84969508;84890198;79310;
11.02.2019;04:20:05;84969612;84890300;79312;
11.02.2019;04:21:07;84969720;84890389;79331;
11.02.2019;04:22:04;84969839;84890492;79347;
11.02.2019;04:23:05;84969913;84890600;79313;
11.02.2019;04:24:05;84970019;84890719;79300;
11.02.2019;04:25:04;84970099;84890831;79268;
11.02.2019;04:26:05;84970201;84890955;79246;
11.02.2019;04:27:05;84970318;84891058;79260;
11.02.2019;04:28:05;84970431;84891158;79273;
11.02.2019;04:29:04;84970554;84891240;79314;
11.02.2019;04:30:05;84970668;84891329;79339;
11.02.2019;04:31:05;84970788;84891439;79349;
11.02.2019;04:32:04;84970938;84891540;79398;
11.02.2019;04:33:04;84971039;84891652;79387;
11.02.2019;04:34:05;84971158;84891755;79403;
11.02.2019;04:35:05;84971275;84891869;79406;
11.02.2019;04:36:06;84971393;84891969;79424;
11.02.2019;04:37:05;84971506;84892075;79431;
11.02.2019;04:38:05;84971615;84892186;79429;
11.02.2019;04:39:05;84971715;84892293;79422;
11.02.2019;04:40:05;84971823;84892412;79411;
11.02.2019;04:41:04;84971885;84892529;79356;
11.02.2019;04:42:05;84972035;84892629;79406;
11.02.2019;04:43:06;84972165;84892732;79433;
11.02.2019;04:44:05;84972282;84892848;79434;
11.02.2019;04:45:05;84972436;84892955;79481;
11.02.2019;04:46:05;84972552;84893048;79504;
11.02.2019;04:47:05;84972678;84893183;79495;
11.02.2019;04:48:05;84972797;84893297;79500;
11.02.2019;04:49:04;84972884;84893407;79477;
11.02.2019;04:50:05;84972999;84893528;79471;
11.02.2019;04:51:04;84973107;84893650;79457;
11.02.2019;04:52:04;84973202;84893741;79461;
11.02.2019;04:53:05;84973308;84893830;79478;
11.02.2019;04:54:04;84973418;84893943;79475;
11.02.2019;04:55:04;84973535;84894035;79500;
11.02.2019;04:56:05;84973639;84894132;79507;
11.02.2019;04:57:05;84973746;84894258;79488;
11.02.2019;04:58:05;84973854;84894356;79498;
11.02.2019;04:59:05;84973944;84894494;79450;
11.02.2019;05:00:04;84974052;84894620;79432;
11.02.2019;05:01:05;84974175;84894714;79461;
11.02.2019;05:02:05;84974263;84894828;79435;
11.02.2019;05:03:04;84974354;84894918;79436;
11.02.2019;05:04:06;84974492;84895042;79450;
11.02.2019;05:05:05;84974597;84895153;79444;
11.02.2019;05:06:05;84974705;84895266;79439;
11.02.2019;05:07:05;84974815;84895366;79449;
11.02.2019;05:08:05;84974933;84895473;79460;
11.02.2019;05:09:06;84975016;84895589;79427;
11.02.2019;05:10:05;84975154;84895712;79442;
11.02.2019;05:11:05;84975248;84895833;79415;
11.02.2019;05:12:06;84975343;84895936;79407;
11.02.2019;05:13:05;84975415;84896051;79364;
11.02.2019;05:14:05;84975540;84896145;79395;
11.02.2019;05:15:04;84975644;84896247;79397;
11.02.2019;05:16:04;84975749;84896348;79401;
11.02.2019;05:17:05;84975853;84896450;79403;
11.02.2019;05:18:04;84975935;84896551;79384;
11.02.2019;05:19:04;84976041;84896657;79384;
11.02.2019;05:20:05;84976134;84896769;79365;
11.02.2019;05:21:04;84976230;84896891;79339;
11.02.2019;05:22:05;84976332;84897006;79326;
11.02.2019;05:23:04;84976449;84897128;79321;
11.02.2019;05:24:04;84976545;84897249;79296;
11.02.2019;05:25:05;84976656;84897364;79292;
11.02.2019;05:26:05;84976771;84897469;79302;
11.02.2019;05:27:04;84976871;84897568;79303;
11.02.2019;05:28:04;84976969;84897693;79276;
11.02.2019;05:29:04;84977078;84897813;79265;
11.02.2019;05:30:04;84977176;84897900;79276;
11.02.2019;05:31:05;84977270;84898017;79253;
11.02.2019;05:32:05;84977363;84898116;79247;
11.02.2019;05:33:04;84977446;84898225;79221;
11.02.2019;05:34:04;84977548;84898348;79200;
11.02.2019;05:35:04;84977648;84898491;79157;
11.02.2019;05:36:04;84977748;84898599;79149;
11.02.2019;05:37:05;84977841;84898715;79126;
11.02.2019;05:38:04;84977955;84898840;79115;
11.02.2019;05:39:06;84978046;84898938;79108;
11.02.2019;05:40:05;84978159;84899058;79101;
11.02.2019;05:41:06;84978249;84899166;79083;
11.02.2019;05:42:05;84978347;84899268;79079;
11.02.2019;05:43:06;84978445;84899371;79074;
11.02.2019;05:44:06;84978544;84899488;79056;
11.02.2019;05:45:05;84978652;84899593;79059;
11.02.2019;05:46:05;84978736;84899718;79018;
11.02.2019;05:47:04;84978824;84899833;78991;
11.02.2019;05:48:05;84978910;84899968;78942;
11.02.2019;05:49:05;84978981;84900093;78888;
11.02.2019;05:50:04;84979070;84900221;78849;
11.02.2019;05:51:05;84979162;84900335;78827;
11.02.2019;05:52:05;84979250;84900446;78804;
11.02.2019;05:53:06;84979349;84900559;78790;
11.02.2019;05:54:05;84979432;84900676;78756;
11.02.2019;05:55:05;84979519;84900799;78720;
11.02.2019;05:56:05;84979634;84900914;78720;
11.02.2019;05:57:05;84979739;84901029;78710;
11.02.2019;05:58:05;84979851;84901151;78700;
11.02.2019;05:59:05;84979952;84901256;78696;
11.02.2019;06:00:05;84980044;84901374;78670;
11.02.2019;06:01:04;84980141;84901502;78639;
11.02.2019;06:02:05;84980247;84901627;78620;
11.02.2019;06:03:04;84980336;84901749;78587;
11.02.2019;06:04:04;84980429;84901861;78568;
11.02.2019;06:05:05;84980532;84901977;78555;
11.02.2019;06:06:05;84980616;84902078;78538;
11.02.2019;06:07:05;84980703;84902200;78503;
11.02.2019;06:08:05;84980791;84902293;78498;
11.02.2019;06:09:05;84980888;84902428;78460;
11.02.2019;06:10:05;84980950;84902549;78401;
11.02.2019;06:11:04;84980992;84902664;78328;
11.02.2019;06:12:05;84981067;84902787;78280;
11.02.2019;06:13:04;84981122;84902903;78219;
11.02.2019;06:14:04;84981187;84903025;78162;
11.02.2019;06:15:04;84981237;84903118;78119;
11.02.2019;06:16:05;84981293;84903231;78062;
11.02.2019;06:17:05;84981355;84903334;78021;
11.02.2019;06:18:04;84981398;84903440;77958;
11.02.2019;06:19:05;84981443;84903534;77909;
11.02.2019;06:20:05;84981510;84903665;77845;
11.02.2019;06:21:04;84981553;84903770;77783;
11.02.2019;06:22:05;84981563;84903898;77665;
11.02.2019;06:23:05;84981612;84903974;77638;
11.02.2019;06:24:04;84981675;84904084;77591;
11.02.2019;06:25:07;84981749;84904201;77548;
11.02.2019;06:26:04;84981785;84904320;77465;
11.02.2019;06:27:05;84981850;84904444;77406;
11.02.2019;06:28:05;84981902;84904552;77350;
11.02.2019;06:29:05;84981979;84904674;77305;
11.02.2019;06:30:06;84982065;84904789;77276;
11.02.2019;06:31:05;84982154;84904882;77272;
11.02.2019;06:32:05;84982249;84905002;77247;
11.02.2019;06:33:05;84982323;84905106;77217;
11.02.2019;06:34:05;84982398;84905218;77180;
11.02.2019;06:35:05;84982493;84905353;77140;
11.02.2019;06:36:05;84982582;84905466;77116;
11.02.2019;06:37:05;84982685;84905577;77108;
11.02.2019;06:38:05;84982761;84905698;77063;
11.02.2019;06:39:05;84982843;84905828;77015;
11.02.2019;06:40:05;84982942;84905962;76980;
11.02.2019;06:41:05;84983018;84906091;76927;
11.02.2019;06:42:06;84983106;84906213;76893;
11.02.2019;06:43:05;84983202;84906323;76879;
11.02.2019;06:44:04;84983279;84906413;76866;
11.02.2019;06:45:05;84983363;84906519;76844;
11.02.2019;06:46:04;84983421;84906559;76862;
11.02.2019;06:47:04;84983525;84906697;76828;
11.02.2019;06:48:05;84983617;84906821;76796;
11.02.2019;06:49:05;84983721;84906942;76779;
11.02.2019;06:50:06;84983802;84907060;76742;
11.02.2019;06:51:05;84983883;84907169;76714;
11.02.2019;06:52:05;84983961;84907297;76664;
11.02.2019;06:53:05;84984061;84907433;76628;
11.02.2019;06:54:04;84984147;84907549;76598;
11.02.2019;06:55:04;84984227;84907673;76554;
11.02.2019;06:56:04;84984309;84907788;76521;
11.02.2019;06:57:04;84984414;84907909;76505;
11.02.2019;06:58:05;84984479;84908033;76446;
11.02.2019;06:59:05;84984564;84908148;76416;
11.02.2019;07:00:04;84984634;84908285;76349;
11.02.2019;07:01:05;84984728;84908394;76334;
11.02.2019;07:02:05;84984835;84908519;76316;
11.02.2019;07:03:04;84984899;84908642;76257;
11.02.2019;07:04:04;84984972;84908766;76206;
11.02.2019;07:05:05;84985055;84908879;76176;
11.02.2019;07:06:04;84985138;84909013;76125;
11.02.2019;07:07:05;84985221;84909125;76096;
11.02.2019;07:08:04;84985298;84909257;76041;
11.02.2019;07:09:06;84985373;84909369;76004;
11.02.2019;07:10:05;84985447;84909502;75945;
11.02.2019;07:11:05;84985518;84909629;75889;
11.02.2019;07:12:05;84985608;84909753;75855;
11.02.2019;07:13:05;84985681;84909878;75803;
11.02.2019;07:14:04;84985775;84909996;75779;
11.02.2019;07:15:05;84985860;84910107;75753;
11.02.2019;07:16:05;84985940;84910232;75708;
11.02.2019;07:17:05;84986012;84910340;75672;
11.02.2019;07:18:04;84986098;84910465;75633;
11.02.2019;07:19:05;84986192;84910590;75602;
11.02.2019;07:20:05;84986254;84910719;75535;
11.02.2019;07:21:04;84986346;84910841;75505;
11.02.2019;07:22:04;84986430;84910971;75459;
11.02.2019;07:23:08;84986520;84911089;75431;
11.02.2019;07:24:04;84986586;84911204;75382;
11.02.2019;07:25:05;84986671;84911316;75355;
11.02.2019;07:26:05;84986778;84911428;75350;
11.02.2019;07:27:04;84986867;84911555;75312;
11.02.2019;07:28:04;84986954;84911661;75293;
11.02.2019;07:29:05;84987035;84911784;75251;
11.02.2019;07:30:05;84987102;84911917;75185;
11.02.2019;07:31:07;84987198;84912046;75152;
11.02.2019;07:32:05;84987277;84912177;75100;
11.02.2019;07:33:05;84987344;84912317;75027;
11.02.2019;07:34:05;84987432;84912440;74992;
11.02.2019;07:35:05;84987500;84912552;74948;
11.02.2019;07:36:05;84987592;84912665;74927;
11.02.2019;07:37:05;84987673;84912767;74906;
11.02.2019;07:38:04;84987758;84912902;74856;
11.02.2019;07:39:04;84987804;84913020;74784;
11.02.2019;07:40:04;84987883;84913146;74737;
11.02.2019;07:41:06;84987982;84913256;74726;
11.02.2019;07:42:05;84988057;84913370;74687;
11.02.2019;07:43:06;84988161;84913495;74666;
11.02.2019;07:44:05;84988242;84913629;74613;
11.02.2019;07:45:05;84988314;84913739;74575;
11.02.2019;07:46:04;84988392;84913833;74559;
11.02.2019;07:47:04;84988451;84913950;74501;
11.02.2019;07:48:04;84988542;84914062;74480;
11.02.2019;07:49:04;84988611;84914182;74429;
11.02.2019;07:50:05;84988702;84914303;74399;
11.02.2019;07:51:05;84988785;84914409;74376;
11.02.2019;07:52:06;84988872;84914533;74339;
11.02.2019;07:53:06;84988943;84914656;74287;
11.02.2019;07:54:05;84989036;84914777;74259;
11.02.2019;07:55:06;84989103;84914900;74203;
11.02.2019;07:56:05;84989173;84915010;74163;
11.02.2019;07:57:06;84989237;84915109;74128;
11.02.2019;07:58:05;84989318;84915224;74094;
11.02.2019;07:59:05;84989402;84915343;74059;
11.02.2019;08:00:05;84989479;84915447;74032;
11.02.2019;08:01:05;84989576;84915556;74020;
11.02.2019;08:02:05;84989665;84915680;73985;
11.02.2019;08:03:05;84989741;84915807;73934;
11.02.2019;08:04:06;84989813;84915923;73890;
11.02.2019;08:05:05;84989886;84916046;73840;
11.02.2019;08:06:05;84989985;84916151;73834;
11.02.2019;08:07:05;84990042;84916308;73734;
11.02.2019;08:08:05;84990107;84916414;73693;
11.02.2019;08:09:07;84990152;84916531;73621;
11.02.2019;08:10:05;84990188;84916631;73557;
11.02.2019;08:12:05;84990227;84916835;73392;
11.02.2019;08:13:06;84990253;84916950;73303;
11.02.2019;08:14:05;84990277;84917067;73210;
11.02.2019;08:15:05;84990282;84917163;73119;
11.02.2019;08:16:05;84990318;84917258;73060;
11.02.2019;08:17:05;84990359;84917363;72996;
11.02.2019;08:18:04;84990428;84917460;72968;
11.02.2019;08:19:04;84990525;84917584;72941;
11.02.2019;08:20:05;84990604;84917713;72891;
11.02.2019;08:21:04;84990682;84917838;72844;
11.02.2019;08:22:05;84990764;84917944;72820;
11.02.2019;08:23:06;84990846;84918068;72778;
11.02.2019;08:24:05;84990935;84918190;72745;
11.02.2019;08:25:06;84991005;84918316;72689;
11.02.2019;08:26:05;84991074;84918423;72651;
11.02.2019;08:27:05;84991138;84918567;72571;
11.02.2019;08:28:05;84991219;84918663;72556;
11.02.2019;08:29:05;84991282;84918773;72509;
11.02.2019;08:30:06;84991324;84918908;72416;
11.02.2019;08:31:05;84991412;84919007;72405;
11.02.2019;08:32:05;84991479;84919116;72363;
11.02.2019;08:33:05;84991550;84919249;72301;
11.02.2019;08:34:05;84991641;84919373;72268;
11.02.2019;08:35:06;84991715;84919495;72220;
11.02.2019;08:36:06;84991784;84919590;72194;
11.02.2019;08:37:05;84991857;84919727;72130;
11.02.2019;08:38:05;84991946;84919854;72092;
11.02.2019;08:39:06;84992023;84919973;72050;
11.02.2019;08:40:05;84992113;84920126;71987;
11.02.2019;08:41:05;84992194;84920245;71949;
11.02.2019;08:42:05;84992286;84920363;71923;
11.02.2019;08:43:04;84992390;84920483;71907;
11.02.2019;08:44:04;84992465;84920617;71848;
11.02.2019;08:45:05;84992551;84920756;71795;
11.02.2019;08:46:04;84992626;84920882;71744;
11.02.2019;08:47:04;84992696;84921005;71691;
11.02.2019;08:48:05;84992783;84921118;71665;
11.02.2019;08:49:04;84992848;84921261;71587;
11.02.2019;08:50:04;84992922;84921386;71536;
11.02.2019;08:51:09;84992990;84921542;71448;
11.02.2019;08:52:05;84993086;84921667;71419;
11.02.2019;08:53:05;84993151;84921808;71343;
11.02.2019;08:54:05;84993246;84921932;71314;
11.02.2019;08:55:04;84993317;84922076;71241;
11.02.2019;08:56:04;84993412;84922206;71206;
11.02.2019;08:57:05;84993483;84922326;71157;
11.02.2019;08:58:04;84993580;84922472;71108;
11.02.2019;08:59:04;84993660;84922597;71063;
11.02.2019;09:00:05;84993739;84922727;71012;
11.02.2019;09:01:05;84993817;84922880;70937;
11.02.2019;09:02:05;84993890;84923000;70890;
11.02.2019;09:03:05;84993979;84923139;70840;
11.02.2019;09:04:05;84994056;84923292;70764;
11.02.2019;09:05:04;84994120;84923420;70700;
11.02.2019;09:06:04;84994190;84923545;70645;
11.02.2019;09:07:04;84994291;84923671;70620;
11.02.2019;09:08:05;84994363;84923822;70541;
11.02.2019;09:09:06;84994438;84923954;70484;
11.02.2019;09:10:05;84994506;84924106;70400;
11.02.2019;09:11:05;84994573;84924241;70332;
11.02.2019;09:12:05;84994642;84924375;70267;
11.02.2019;09:13:05;84994707;84924496;70211;
11.02.2019;09:14:05;84994799;84924561;70238;
11.02.2019;09:15:05;84994882;84924710;70172;
11.02.2019;09:16:05;84994964;84924857;70107;
11.02.2019;09:17:05;84995019;84924996;70023;
11.02.2019;09:18:04;84995096;84925130;69966;
11.02.2019;09:19:04;84995159;84925284;69875;
11.02.2019;09:20:04;84995232;84925418;69814;
11.02.2019;09:21:04;84995311;84925472;69839;
11.02.2019;09:22:05;84995385;84925553;69832;
11.02.2019;09:23:04;84995460;84925660;69800;
11.02.2019;09:24:05;84995546;84925767;69779;
11.02.2019;09:25:04;84995614;84925891;69723;
11.02.2019;09:26:05;84995702;84926025;69677;
11.02.2019;09:27:04;84995783;84926116;69667;
11.02.2019;09:28:04;84995854;84926215;69639;
11.02.2019;09:29:04;84995925;84926344;69581;
11.02.2019;09:30:04;84996000;84926456;69544;
11.02.2019;09:31:05;84996070;84926589;69481;
11.02.2019;09:32:05;84996131;84926714;69417;
11.02.2019;09:33:06;84996223;84926816;69407;
11.02.2019;09:34:05;84996303;84926932;69371;
11.02.2019;09:35:05;84996382;84927070;69312;
11.02.2019;09:36:05;84996457;84927218;69239;
11.02.2019;09:37:04;84996506;84927326;69180;
11.02.2019;09:38:05;84996602;84927456;69146;
11.02.2019;09:39:06;84996694;84927596;69098;
11.02.2019;09:40:04;84996778;84927707;69071;
11.02.2019;09:41:05;84996848;84927814;69034;
11.02.2019;09:42:05;84996930;84927959;68971;
11.02.2019;09:43:05;84997024;84928097;68927;
11.02.2019;09:44:05;84997095;84928220;68875;
11.02.2019;09:45:05;84997161;84928349;68812;
11.02.2019;09:46:05;84997196;84928413;68783;
11.02.2019;09:47:05;84997283;84928534;68749;
11.02.2019;09:48:05;84997366;84928667;68699;
11.02.2019;09:49:05;84997435;84928780;68655;
11.02.2019;09:50:05;84997516;84928920;68596;
11.02.2019;09:51:05;84997601;84929047;68554;
11.02.2019;09:52:05;84997673;84929186;68487;
11.02.2019;09:53:05;84997765;84929335;68430;
11.02.2019;09:54:05;84997846;84929450;68396;
11.02.2019;09:55:05;84997930;84929538;68392;
11.02.2019;09:56:05;84998024;84929660;68364;
11.02.2019;09:57:05;84998100;84929789;68311;
11.02.2019;09:58:05;84998185;84929934;68251;
11.02.2019;09:59:05;84998261;84930069;68192;
11.02.2019;10:00:05;84998328;84930182;68146;
11.02.2019;10:01:05;84998410;84930301;68109;
11.02.2019;10:02:05;84998473;84930428;68045;
11.02.2019;10:03:05;84998543;84930553;67990;
11.02.2019;10:04:04;84998635;84930682;67953;
11.02.2019;10:05:04;84998704;84930806;67898;
11.02.2019;10:06:05;84998771;84930954;67817;
11.02.2019;10:07:04;84998845;84931086;67759;
11.02.2019;10:08:05;84998923;84931221;67702;
11.02.2019;10:09:05;84998994;84931335;67659;
11.02.2019;10:10:04;84999040;84931447;67593;
11.02.2019;10:11:05;84999114;84931541;67573;
11.02.2019;10:12:05;84999173;84931642;67531;
11.02.2019;10:13:05;84999211;84931757;67454;
11.02.2019;10:14:05;84999268;84931864;67404;
11.02.2019;10:15:05;84999312;84931974;67338;
11.02.2019;10:16:05;84999387;84932081;67306;
11.02.2019;10:17:04;84999459;84932192;67267;
11.02.2019;10:18:04;84999527;84932288;67239;
11.02.2019;10:19:05;84999603;84932413;67190;
11.02.2019;10:20:05;84999693;84932534;67159;
11.02.2019;10:21:04;84999779;84932661;67118;
11.02.2019;10:22:06;84999852;84932779;67073;
11.02.2019;10:23:05;84999953;84932924;67029;
11.02.2019;10:24:05;85000122;84933075;67047;
11.02.2019;10:25:05;85000204;84933214;66990;
11.02.2019;10:26:05;85000299;84933345;66954;
11.02.2019;10:27:05;85000418;84933473;66945;
11.02.2019;10:28:04;85000481;84933584;66897;
11.02.2019;10:29:05;85000549;84933710;66839;
11.02.2019;10:30:05;85000630;84933840;66790;
11.02.2019;10:31:09;85000716;84933980;66736;
11.02.2019;10:32:05;85000794;84934099;66695;
11.02.2019;10:33:05;85000871;84934223;66648;
11.02.2019;10:34:04;85000933;84934304;66629;
11.02.2019;10:35:05;85001018;84934377;66641;
11.02.2019;10:36:05;85001101;84934499;66602;
11.02.2019;10:37:05;85001163;84934610;66553;
11.02.2019;10:38:05;85001243;84934733;66510;
11.02.2019;10:39:06;85001314;84934854;66460;
11.02.2019;10:40:05;85001368;84934969;66399;
11.02.2019;10:41:05;85001434;84935071;66363;
11.02.2019;10:42:06;85001499;84935187;66312;
11.02.2019;10:43:05;85001560;84935299;66261;
11.02.2019;10:44:05;85001621;84935426;66195;
11.02.2019;10:45:05;85001692;84935571;66121;
11.02.2019;10:46:06;85001754;84935697;66057;
11.02.2019;10:47:04;85001828;84935803;66025;
11.02.2019;10:48:05;85001908;84935926;65982;
11.02.2019;10:49:04;85001976;84936030;65946;
11.02.2019;10:50:04;85002046;84936145;65901;
11.02.2019;10:51:05;85002125;84936248;65877;
11.02.2019;10:52:05;85002183;84936368;65815;
11.02.2019;10:53:06;85002258;84936481;65777;
11.02.2019;10:54:05;85002337;84936614;65723;
11.02.2019;10:55:05;85002426;84936738;65688;
11.02.2019;10:56:05;85002497;84936855;65642;
11.02.2019;10:57:05;85002566;84936953;65613;
11.02.2019;10:58:05;85002629;84937068;65561;
11.02.2019;10:59:05;85002704;84937221;65483;
11.02.2019;11:00:05;85002754;84937372;65382;
11.02.2019;11:01:05;85002809;84937494;65315;
11.02.2019;11:02:05;85002897;84937605;65292;
11.02.2019;11:03:04;85002974;84937697;65277;
11.02.2019;11:04:05;85003056;84937806;65250;
11.02.2019;11:05:05;85003141;84937919;65222;
11.02.2019;11:06:05;85003218;84938015;65203;
11.02.2019;11:07:04;85003285;84938186;65099;
11.02.2019;11:08:05;85003349;84938317;65032;
11.02.2019;11:09:08;85003422;84938434;64988;
11.02.2019;11:10:05;85003483;84938543;64940;
11.02.2019;11:11:05;85003560;84938655;64905;
11.02.2019;11:12:05;85003644;84938772;64872;
11.02.2019;11:13:06;85003721;84938920;64801;
11.02.2019;11:14:04;85003789;84939061;64728;
11.02.2019;11:15:05;85003845;84939173;64672;
11.02.2019;11:16:04;85003917;84939294;64623;
11.02.2019;11:17:05;85003963;84939424;64539;
11.02.2019;11:18:04;85004066;84939544;64522;
11.02.2019;11:19:05;85004130;84939698;64432;
11.02.2019;11:20:05;85004191;84939814;64377;
11.02.2019;11:21:05;85004246;84939942;64304;
11.02.2019;11:22:05;85004306;84940067;64239;
11.02.2019;11:23:04;85004394;84940231;64163;
11.02.2019;11:24:05;85004469;84940364;64105;
11.02.2019;11:25:05;85004556;84940521;64035;
11.02.2019;11:26:05;85004634;84940665;63969;
11.02.2019;11:27:05;85004701;84940811;63890;
11.02.2019;11:28:05;85004772;84940950;63822;
11.02.2019;11:29:06;85004847;84941084;63763;
11.02.2019;11:30:05;85004918;84941197;63721;
11.02.2019;11:31:04;85005008;84941325;63683;
11.02.2019;11:32:05;85005080;84941463;63617;
11.02.2019;11:33:04;85005162;84941591;63571;
11.02.2019;11:34:04;85005246;84941742;63504;
11.02.2019;11:35:06;85005325;84941868;63457;
11.02.2019;11:36:04;85005406;84941990;63416;
11.02.2019;11:37:04;85005481;84942109;63372;
11.02.2019;11:38:05;85005557;84942231;63326;
11.02.2019;11:39:04;85005641;84942362;63279;
11.02.2019;11:40:05;85005732;84942502;63230;
11.02.2019;11:41:05;85005807;84942638;63169;
11.02.2019;11:42:04;85005873;84942786;63087;
11.02.2019;11:43:05;85005948;84942903;63045;
11.02.2019;11:44:04;85006026;84943014;63012;
11.02.2019;11:45:04;85006100;84943141;62959;
11.02.2019;11:46:04;85006185;84943300;62885;
11.02.2019;11:47:04;85006248;84943417;62831;
11.02.2019;11:48:05;85006330;84943562;62768;
11.02.2019;11:49:04;85006432;84943688;62744;
11.02.2019;11:50:05;85006520;84943808;62712;
11.02.2019;11:51:05;85006625;84943946;62679;
11.02.2019;11:52:05;85006699;84944064;62635;
11.02.2019;11:53:05;85006796;84944197;62599;
11.02.2019;11:54:05;85006871;84944326;62545;
11.02.2019;11:55:05;85006960;84944445;62515;
11.02.2019;11:56:05;85007044;84944575;62469;
11.02.2019;11:57:05;85007131;84944710;62421;
11.02.2019;11:58:05;85007194;84944869;62325;
11.02.2019;11:59:05;85007268;84945012;62256;
11.02.2019;12:00:05;85007351;84945133;62218;
11.02.2019;12:01:05;85007439;84945259;62180;
11.02.2019;12:02:05;85007515;84945342;62173;
11.02.2019;12:03:05;85007616;84945468;62148;
11.02.2019;12:04:05;85007716;84945576;62140;
11.02.2019;12:05:05;85007809;84945721;62088;
11.02.2019;12:06:05;85007862;84945869;61993;
11.02.2019;12:07:05;85007910;84945972;61938;
11.02.2019;12:08:05;85007939;84946094;61845;
11.02.2019;12:09:07;85007999;84946189;61810;
11.02.2019;12:10:05;85008045;84946300;61745;
11.02.2019;12:11:05;85008063;84946408;61655;
11.02.2019;12:12:04;85008062;84946525;61537;
11.02.2019;12:13:04;85008040;84946608;61432;
11.02.2019;12:14:05;85008048;84946683;61365;
11.02.2019;12:15:05;85008108;84946794;61314;
11.02.2019;12:16:05;85008192;84946908;61284;
11.02.2019;12:17:05;85008291;84947028;61263;
11.02.2019;12:18:05;85008367;84947171;61196;
11.02.2019;12:19:05;85008439;84947301;61138;
11.02.2019;12:20:05;85008528;84947429;61099;
11.02.2019;12:21:05;85008629;84947554;61075;
11.02.2019;12:22:04;85008696;84947685;61011;
11.02.2019;12:23:04;85008789;84947795;60994;
11.02.2019;12:24:05;85008887;84947923;60964;
11.02.2019;12:25:04;85008972;84948043;60929;
11.02.2019;12:26:05;85009066;84948178;60888;
11.02.2019;12:27:05;85009148;84948284;60864;
11.02.2019;12:28:05;85009249;84948434;60815;
11.02.2019;12:29:05;85009345;84948550;60795;
11.02.2019;12:30:05;85009425;84948671;60754;
11.02.2019;12:31:06;85009528;84948792;60736;
11.02.2019;12:32:05;85009602;84948917;60685;
11.02.2019;12:33:05;85009697;84949026;60671;
11.02.2019;12:34:05;85009793;84949152;60641;
11.02.2019;12:35:05;85009881;84949268;60613;
11.02.2019;12:36:05;85009921;84949315;60606;
11.02.2019;12:37:05;85009957;84949377;60580;
11.02.2019;12:38:05;85010050;84949511;60539;
11.02.2019;12:39:05;85010123;84949624;60499;
11.02.2019;12:40:05;85010214;84949743;60471;
11.02.2019;12:41:04;85010312;84949864;60448;
11.02.2019;12:42:04;85010434;84949990;60444;
11.02.2019;12:43:04;85010537;84950105;60432;
11.02.2019;12:44:05;85010634;84950231;60403;
11.02.2019;12:45:05;85010713;84950341;60372;
11.02.2019;12:46:05;85010807;84950477;60330;
11.02.2019;12:47:05;85010889;84950592;60297;
11.02.2019;12:48:05;85010969;84950713;60256;
11.02.2019;12:49:05;85011060;84950839;60221;
11.02.2019;12:50:06;85011145;84950983;60162;
11.02.2019;12:51:05;85011237;84951136;60101;
11.02.2019;12:52:05;85011332;84951262;60070;
11.02.2019;12:53:04;85011429;84951383;60046;
11.02.2019;12:54:04;85011531;84951509;60022;
11.02.2019;12:55:04;85011612;84951627;59985;
11.02.2019;12:56:04;85011714;84951751;59963;
11.02.2019;12:57:06;85011833;84951866;59967;
11.02.2019;12:58:05;85011916;84951995;59921;
11.02.2019;12:59:04;85012011;84952115;59896;
11.02.2019;13:00:04;85012112;84952240;59872;
11.02.2019;13:01:05;85012197;84952360;59837;
11.02.2019;13:02:04;85012291;84952498;59793;
11.02.2019;13:03:05;85012368;84952654;59714;
11.02.2019;13:04:05;85012458;84952789;59669;
11.02.2019;13:05:04;85012549;84952915;59634;
11.02.2019;13:06:05;85012637;84953029;59608;
11.02.2019;13:07:04;85012725;84953179;59546;
11.02.2019;13:08:05;85012836;84953327;59509;
11.02.2019;13:09:05;85012941;84953477;59464;
11.02.2019;13:10:04;85013043;84953604;59439;
11.02.2019;13:11:04;85013154;84953720;59434;
11.02.2019;13:12:05;85013265;84953864;59401;
11.02.2019;13:13:04;85013371;84953971;59400;
11.02.2019;13:14:05;85013476;84954094;59382;
11.02.2019;13:15:05;85013585;84954216;59369;
11.02.2019;13:16:04;85013713;84954333;59380;
11.02.2019;13:17:05;85013806;84954452;59354;
11.02.2019;13:18:04;85013913;84954595;59318;
11.02.2019;13:19:06;85013991;84954731;59260;
11.02.2019;13:20:05;85014090;84954868;59222;
11.02.2019;13:21:05;85014184;84955010;59174;
11.02.2019;13:22:05;85014269;84955143;59126;
11.02.2019;13:23:05;85014376;84955287;59089;
11.02.2019;13:24:06;85014464;84955438;59026;
11.02.2019;13:25:05;85014553;84955580;58973;
11.02.2019;13:26:05;85014672;84955721;58951;
11.02.2019;13:27:05;85014751;84955872;58879;
11.02.2019;13:28:05;85014855;84955994;58861;
11.02.2019;13:29:05;85014957;84956133;58824;
11.02.2019;13:30:05;85015061;84956251;58810;
11.02.2019;13:31:05;85015159;84956408;58751;
11.02.2019;13:32:05;85015244;84956540;58704;
11.02.2019;13:33:05;85015333;84956663;58670;
11.02.2019;13:34:05;85015478;84956799;58679;
11.02.2019;13:35:05;85015587;84956943;58644;
11.02.2019;13:36:05;85015689;84957114;58575;
11.02.2019;13:37:06;85015793;84957220;58573;
11.02.2019;13:38:05;85015897;84957343;58554;
11.02.2019;13:39:10;85016025;84957487;58538;
11.02.2019;13:40:08;85016135;84957602;58533;
11.02.2019;13:41:05;85016256;84957736;58520;
11.02.2019;13:42:04;85016384;84957855;58529;
11.02.2019;13:43:04;85016498;84957986;58512;
11.02.2019;13:44:05;85016606;84958115;58491;
11.02.2019;13:45:04;85016727;84958254;58473;
11.02.2019;13:46:05;85016840;84958390;58450;
11.02.2019;13:47:05;85016941;84958530;58411;
11.02.2019;13:48:05;85017046;84958664;58382;
11.02.2019;13:49:05;85017158;84958803;58355;
11.02.2019;13:50:05;85017275;84958953;58322;
11.02.2019;13:51:05;85017383;84959083;58300;
11.02.2019;13:52:05;85017492;84959221;58271;
11.02.2019;13:53:06;85017611;84959364;58247;
11.02.2019;13:54:05;85017710;84959518;58192;
11.02.2019;13:55:06;85017839;84959649;58190;
11.02.2019;13:56:05;85017945;84959793;58152;
11.02.2019;13:57:04;85018079;84959914;58165;
11.02.2019;13:58:05;85018196;84960028;58168;
11.02.2019;13:59:06;85018325;84960108;58217;
11.02.2019;14:00:05;85018429;84960210;58219;
11.02.2019;14:01:05;85018538;84960347;58191;
11.02.2019;14:02:05;85018656;84960475;58181;
11.02.2019;14:03:05;85018787;84960571;58216;
11.02.2019;14:04:05;85018873;84960668;58205;
11.02.2019;14:05:05;85018973;84960760;58213;
11.02.2019;14:06:04;85019062;84960856;58206;
11.02.2019;14:07:04;85019159;84960925;58234;
11.02.2019;14:08:05;85019231;84961051;58180;
11.02.2019;14:09:04;85019311;84961184;58127;
11.02.2019;14:10:04;85019423;84961302;58121;
11.02.2019;14:11:05;85019518;84961441;58077;
11.02.2019;14:12:05;85019636;84961558;58078;
11.02.2019;14:13:05;85019758;84961698;58060;
11.02.2019;14:14:05;85019876;84961835;58041;
11.02.2019;14:15:05;85019986;84961960;58026;
11.02.2019;14:16:06;85020049;84962084;57965;
11.02.2019;14:17:05;85020177;84962186;57991;
11.02.2019;14:18:05;85020271;84962295;57976;
11.02.2019;14:19:05;85020370;84962416;57954;
11.02.2019;14:20:05;85020471;84962539;57932;
11.02.2019;14:21:04;85020569;84962664;57905;
11.02.2019;14:22:05;85020694;84962776;57918;
11.02.2019;14:23:04;85020819;84962907;57912;
11.02.2019;14:24:04;85020927;84963034;57893;
11.02.2019;14:25:04;85021057;84963204;57853;
11.02.2019;14:26:05;85021181;84963327;57854;
11.02.2019;14:27:04;85021288;84963436;57852;
11.02.2019;14:28:09;85021422;84963599;57823;
11.02.2019;14:29:05;85021526;84963730;57796;
11.02.2019;14:30:05;85021663;84963894;57769;
11.02.2019;14:31:05;85021794;84964003;57791;
11.02.2019;14:32:05;85021924;84964160;57764;
11.02.2019;14:33:04;85022004;84964287;57717;
11.02.2019;14:34:06;85022134;84964432;57702;
11.02.2019;14:35:05;85022260;84964569;57691;
11.02.2019;14:36:05;85022380;84964686;57694;
11.02.2019;14:37:05;85022498;84964808;57690;
11.02.2019;14:38:07;85022618;84964962;57656;
11.02.2019;14:39:07;85022769;84965081;57688;
11.02.2019;14:40:10;85022911;84965237;57674;
11.02.2019;14:41:04;85023021;84965349;57672;
11.02.2019;14:42:05;85023146;84965468;57678;
11.02.2019;14:43:05;85023256;84965602;57654;
11.02.2019;14:44:05;85023367;84965685;57682;
11.02.2019;14:45:06;85023506;84965872;57634;
11.02.2019;14:46:06;85023631;84966013;57618;
11.02.2019;14:47:05;85023739;84966147;57592;
11.02.2019;14:48:05;85023877;84966265;57612;
11.02.2019;14:49:05;85023991;84966426;57565;
11.02.2019;14:50:05;85024098;84966574;57524;
11.02.2019;14:51:07;85024223;84966728;57495;
11.02.2019;14:52:05;85024345;84966858;57487;
11.02.2019;14:53:05;85024475;84967029;57446;
11.02.2019;14:54:06;85024591;84967184;57407;
11.02.2019;14:55:04;85024707;84967333;57374;
11.02.2019;14:56:04;85024839;84967477;57362;
11.02.2019;14:57:04;85024968;84967618;57350;
11.02.2019;14:58:05;85025097;84967775;57322;
11.02.2019;14:59:05;85025228;84967940;57288;
11.02.2019;15:00:09;85025352;84968088;57264;
11.02.2019;15:01:08;85025450;84968221;57229;
11.02.2019;15:02:07;85025572;84968337;57235;
11.02.2019;15:03:07;85025692;84968500;57192;
11.02.2019;15:04:09;85025759;84968656;57103;
11.02.2019;15:05:08;85025922;84968763;57159;
11.02.2019;15:06:08;85026009;84968886;57123;
11.02.2019;15:07:07;85026143;84969051;57092;
11.02.2019;15:08:09;85026251;84969178;57073;
11.02.2019;15:09:09;85026362;84969329;57033;
11.02.2019;15:10:08;85026488;84969467;57021;
11.02.2019;15:11:07;85026613;84969620;56993;
11.02.2019;15:12:08;85026747;84969781;56966;
11.02.2019;15:13:08;85026872;84969920;56952;
11.02.2019;15:14:08;85027004;84970084;56920;
11.02.2019;15:15:08;85027115;84970242;56873;
11.02.2019;15:16:09;85027247;84970388;56859;
11.02.2019;15:17:09;85027365;84970521;56844;
11.02.2019;15:18:07;85027490;84970662;56828;
11.02.2019;15:19:09;85027619;84970828;56791;
11.02.2019;15:20:08;85027754;84970973;56781;
11.02.2019;15:21:08;85027865;84971104;56761;
11.02.2019;15:22:08;85027976;84971250;56726;
11.02.2019;15:23:07;85028091;84971384;56707;
11.02.2019;15:24:07;85028206;84971513;56693;
11.02.2019;15:25:08;85028300;84971639;56661;
11.02.2019;15:26:08;85028404;84971766;56638;
11.02.2019;15:27:08;85028526;84971929;56597;
11.02.2019;15:28:08;85028649;84972071;56578;
11.02.2019;15:29:08;85028780;84972196;56584;
11.02.2019;15:30:08;85028899;84972348;56551;
11.02.2019;15:31:09;85028994;84972512;56482;
11.02.2019;15:32:08;85029115;84972665;56450;
11.02.2019;15:33:08;85029218;84972824;56394;
11.02.2019;15:34:08;85029326;84972947;56379;
11.02.2019;15:35:07;85029447;84973104;56343;
11.02.2019;15:36:13;85029591;84973258;56333;
11.02.2019;15:37:08;85029687;84973391;56296;
11.02.2019;15:38:06;85029793;84973525;56268;
11.02.2019;15:39:08;85029912;84973693;56219;
11.02.2019;15:40:07;85030032;84973868;56164;
11.02.2019;15:41:07;85030142;84974032;56110;
11.02.2019;15:42:07;85030260;84974172;56088;
11.02.2019;15:43:08;85030374;84974327;56047;
11.02.2019;15:44:08;85030475;84974465;56010;
11.02.2019;15:45:08;85030569;84974591;55978;
11.02.2019;15:46:08;85030691;84974744;55947;
11.02.2019;15:47:09;85030782;84974881;55901;
11.02.2019;15:48:09;85030886;84975044;55842;
11.02.2019;15:49:08;85031005;84975186;55819;
11.02.2019;15:50:06;85031129;84975325;55804;
11.02.2019;15:51:08;85031240;84975461;55779;
11.02.2019;15:52:08;85031346;84975612;55734;
11.02.2019;15:53:08;85031479;84975767;55712;
11.02.2019;15:54:07;85031576;84975922;55654;
11.02.2019;15:55:07;85031673;84976065;55608;
11.02.2019;15:56:07;85031804;84976204;55600;
11.02.2019;15:57:08;85031930;84976387;55543;
11.02.2019;15:58:08;85032021;84976557;55464;
11.02.2019;15:59:08;85032128;84976742;55386;
11.02.2019;16:00:07;85032256;84976878;55378;
11.02.2019;16:01:04;85032362;84977039;55323;
11.02.2019;16:02:05;85032503;84977181;55322;
11.02.2019;16:03:06;85032624;84977324;55300;
11.02.2019;16:04:11;85032779;84977497;55282;
11.02.2019;16:05:05;85032883;84977638;55245;
11.02.2019;16:06:05;85033003;84977802;55201;
11.02.2019;16:07:05;85033115;84977984;55131;
11.02.2019;16:08:05;85033248;84978141;55107;
11.02.2019;16:09:05;85033321;84978291;55030;
11.02.2019;16:10:05;85033419;84978453;54966;
11.02.2019;16:11:05;85033562;84978604;54958;
11.02.2019;16:12:06;85033668;84978753;54915;
11.02.2019;16:13:06;85033768;84978888;54880;
11.02.2019;16:14:05;85033891;84979030;54861;
11.02.2019;16:15:05;85033984;84979182;54802;
11.02.2019;16:16:05;85034084;84979341;54743;
11.02.2019;16:17:06;85034169;84979488;54681;
11.02.2019;16:18:05;85034252;84979627;54625;
11.02.2019;16:19:05;85034333;84979797;54536;
11.02.2019;16:20:05;85034418;84979953;54465;
11.02.2019;16:21:08;85034549;84980114;54435;
11.02.2019;16:22:05;85034645;84980253;54392;
11.02.2019;16:23:07;85034772;84980400;54372;
11.02.2019;16:24:05;85034897;84980538;54359;
11.02.2019;16:25:05;85035025;84980663;54362;
11.02.2019;16:26:07;85035132;84980817;54315;
11.02.2019;16:27:05;85035235;84980962;54273;
11.02.2019;16:28:06;85035317;84981121;54196;
11.02.2019;16:29:04;85035471;84981247;54224;
11.02.2019;16:30:04;85035654;84981386;54268;
11.02.2019;16:31:05;85035789;84981519;54270;
11.02.2019;16:32:05;85035925;84981674;54251;
11.02.2019;16:33:05;85036048;84981815;54233;
11.02.2019;16:34:04;85036162;84981974;54188;
11.02.2019;16:35:04;85036258;84982106;54152;
11.02.2019;16:36:05;85036377;84982284;54093;
11.02.2019;16:37:05;85036515;84982458;54057;
11.02.2019;16:38:05;85036636;84982600;54036;
11.02.2019;16:39:05;85036747;84982738;54009;
11.02.2019;16:40:04;85036879;84982889;53990;
11.02.2019;16:41:05;85037003;84983056;53947;
11.02.2019;16:42:05;85037102;84983195;53907;
11.02.2019;16:43:04;85037234;84983381;53853;
11.02.2019;16:44:04;85037380;84983520;53860;
11.02.2019;16:45:05;85037484;84983653;53831;
11.02.2019;16:46:05;85037602;84983795;53807;
11.02.2019;16:47:10;85037732;84983961;53771;
11.02.2019;16:48:11;85037837;84984116;53721;
11.02.2019;16:49:05;85037937;84984269;53668;
11.02.2019;16:50:06;85038056;84984437;53619;
11.02.2019;16:51:05;85038170;84984568;53602;
11.02.2019;16:52:05;85038296;84984744;53552;
11.02.2019;16:53:04;85038413;84984903;53510;
11.02.2019;16:54:04;85038540;84985046;53494;
11.02.2019;16:55:07;85038661;84985203;53458;
11.02.2019;16:56:05;85038798;84985365;53433;
11.02.2019;16:57:05;85038922;84985496;53426;
11.02.2019;16:58:05;85039059;84985662;53397;
11.02.2019;16:59:06;85039185;84985802;53383;
11.02.2019;17:00:05;85039305;84985988;53317;
11.02.2019;17:01:05;85039421;84986139;53282;
11.02.2019;17:02:05;85039551;84986299;53252;
11.02.2019;17:03:05;85039659;84986468;53191;
11.02.2019;17:04:06;85039759;84986616;53143;
11.02.2019;17:05:06;85039886;84986764;53122;
11.02.2019;17:06:06;85040016;84986944;53072;
11.02.2019;17:07:06;85040117;84987078;53039;
11.02.2019;17:08:04;85040227;84987244;52983;
11.02.2019;17:09:05;85040359;84987410;52949;
11.02.2019;17:10:04;85040470;84987569;52901;
11.02.2019;17:11:05;85040565;84987709;52856;
11.02.2019;17:12:05;85040688;84987866;52822;
11.02.2019;17:13:05;85040812;84988038;52774;
11.02.2019;17:14:04;85040941;84988200;52741;
11.02.2019;17:15:05;85041067;84988353;52714;
11.02.2019;17:16:04;85041214;84988495;52719;
11.02.2019;17:17:04;85041345;84988632;52713;
11.02.2019;17:18:05;85041462;84988778;52684;
11.02.2019;17:19:05;85041600;84988947;52653;
11.02.2019;17:20:05;85041724;84989109;52615;
11.02.2019;17:21:05;85041858;84989280;52578;
11.02.2019;17:22:05;85041994;84989449;52545;
11.02.2019;17:23:05;85042111;84989600;52511;
11.02.2019;17:24:05;85042234;84989734;52500;
11.02.2019;17:25:04;85042348;84989888;52460;
11.02.2019;17:26:04;85042471;84990050;52421;
11.02.2019;17:27:06;85042594;84990221;52373;
11.02.2019;17:28:04;85042696;84990394;52302;
11.02.2019;17:29:05;85042803;84990550;52253;
11.02.2019;17:30:05;85042916;84990701;52215;
11.02.2019;17:31:06;85043024;84990872;52152;
11.02.2019;17:32:05;85043129;84991019;52110;
11.02.2019;17:33:05;85043274;84991194;52080;
11.02.2019;17:34:04;85043388;84991339;52049;
11.02.2019;17:35:05;85043503;84991496;52007;
11.02.2019;17:36:05;85043651;84991654;51997;
11.02.2019;17:37:06;85043786;84991803;51983;
11.02.2019;17:38:04;85043902;84991989;51913;
11.02.2019;17:39:04;85044024;84992117;51907;
11.02.2019;17:40:05;85044133;84992291;51842;
11.02.2019;17:41:04;85044265;84992451;51814;
11.02.2019;17:42:04;85044371;84992618;51753;
11.02.2019;17:43:04;85044478;84992760;51718;
11.02.2019;17:44:05;85044613;84992915;51698;
11.02.2019;17:45:04;85044732;84993089;51643;
11.02.2019;17:46:05;85044857;84993246;51611;
11.02.2019;17:47:04;85044964;84993381;51583;
11.02.2019;17:48:05;85045082;84993534;51548;
11.02.2019;17:49:07;85045218;84993682;51536;
11.02.2019;17:50:06;85045342;84993820;51522;
11.02.2019;17:51:08;85045452;84993961;51491;
11.02.2019;17:52:06;85045555;84994112;51443;
11.02.2019;17:53:05;85045675;84994259;51416;
11.02.2019;17:54:05;85045776;84994390;51386;
11.02.2019;17:55:05;85045884;84994572;51312;
11.02.2019;17:56:04;85046003;84994718;51285;
11.02.2019;17:57:04;85046113;84994889;51224;
11.02.2019;17:58:04;85046209;84995054;51155;
11.02.2019;17:59:04;85046314;84995192;51122;
11.02.2019;18:00:05;85046437;84995326;51111;
11.02.2019;18:01:05;85046566;84995485;51081;
11.02.2019;18:02:04;85046681;84995618;51063;
11.02.2019;18:03:04;85046804;84995774;51030;
11.02.2019;18:04:07;85046907;84995896;51011;
11.02.2019;18:05:05;85047026;84996022;51004;
11.02.2019;18:06:08;85047145;84996191;50954;
11.02.2019;18:07:05;85047265;84996341;50924;
11.02.2019;18:08:05;85047356;84996481;50875;
11.02.2019;18:09:04;85047479;84996622;50857;
11.02.2019;18:10:05;85047591;84996785;50806;
11.02.2019;18:11:06;85047716;84996908;50808;
11.02.2019;18:12:08;85047815;84997063;50752;
11.02.2019;18:13:06;85047906;84997174;50732;
11.02.2019;18:14:06;85048007;84997299;50708;
11.02.2019;18:15:05;85048130;84997421;50709;
11.02.2019;18:16:09;85048224;84997568;50656;
11.02.2019;18:17:06;85048314;84997684;50630;
11.02.2019;18:18:05;85048395;84997821;50574;
11.02.2019;18:19:05;85048470;84997936;50534;
11.02.2019;18:20:08;85048579;84998058;50521;
11.02.2019;18:21:04;85048683;84998190;50493;
11.02.2019;18:22:04;85048760;84998312;50448;
11.02.2019;18:23:05;85048858;84998438;50420;
11.02.2019;18:24:09;85048956;84998585;50371;
11.02.2019;18:25:06;85049050;84998702;50348;
11.02.2019;18:26:05;85049145;84998816;50329;
11.02.2019;18:27:06;85049237;84998974;50263;
11.02.2019;18:28:10;85049373;84999113;50260;
11.02.2019;18:29:05;85049458;84999222;50236;
11.02.2019;18:30:07;85049548;84999357;50191;
11.02.2019;18:31:07;85049661;84999469;50192;
11.02.2019;18:32:07;85049769;84999579;50190;
11.02.2019;18:33:05;85049848;84999707;50141;
11.02.2019;18:34:05;85049947;84999845;50102;
11.02.2019;18:35:05;85050040;84999956;50084;
11.02.2019;18:36:04;85050142;85000091;50051;
11.02.2019;18:37:04;85050255;85000218;50037;
11.02.2019;18:38:05;85050392;85000331;50061;
11.02.2019;18:39:05;85050495;85000400;50095;
11.02.2019;18:40:06;85050605;85000520;50085;
11.02.2019;18:41:05;85050711;85000639;50072;
11.02.2019;18:42:05;85050830;85000770;50060;
11.02.2019;18:43:05;85050964;85000907;50057;
11.02.2019;18:44:05;85051094;85001025;50069;
11.02.2019;18:45:05;85051155;85001155;50000;
11.02.2019;18:46:05;85051320;85001275;50045;
11.02.2019;18:47:06;85051414;85001397;50017;
11.02.2019;18:48:05;85051514;85001513;50001;
11.02.2019;18:49:06;85051642;85001610;50032;
11.02.2019;18:50:05;85051764;85001736;50028;
11.02.2019;18:51:04;85051877;85001851;50026;
11.02.2019;18:52:05;85052013;85001987;50026;
11.02.2019;18:53:05;85052103;85002118;49985;
11.02.2019;18:54:04;85052292;85002220;50072;
11.02.2019;18:55:06;85052390;85002338;50052;
11.02.2019;18:56:05;85052513;85002458;50055;
11.02.2019;18:57:05;85052611;85002586;50025;
11.02.2019;18:58:06;85052718;85002692;50026;
11.02.2019;18:59:05;85052829;85002794;50035;
11.02.2019;19:00:05;85052961;85002917;50044;
11.02.2019;19:01:05;85053067;85003038;50029;
11.02.2019;19:02:05;85053186;85003150;50036;
11.02.2019;19:03:05;85053283;85003283;50000;
11.02.2019;19:04:05;85053378;85003395;49983;
11.02.2019;19:05:05;85053492;85003496;49996;
11.02.2019;19:06:05;85053609;85003604;50005;
11.02.2019;19:07:05;85053698;85003712;49986;
11.02.2019;19:08:10;85053831;85003845;49986;
11.02.2019;19:09:12;85053934;85003952;49982;
11.02.2019;19:10:05;85054053;85004005;50048;
11.02.2019;19:11:06;85054170;85004131;50039;
11.02.2019;19:12:05;85054280;85004233;50047;
11.02.2019;19:13:06;85054396;85004342;50054;
11.02.2019;19:14:10;85054521;85004470;50051;
11.02.2019;19:15:06;85054601;85004552;50049;
11.02.2019;19:16:06;85054670;85004644;50026;
11.02.2019;19:17:05;85054697;85004738;49959;
11.02.2019;19:18:05;85054780;85004860;49920;
11.02.2019;19:19:05;85054872;85004966;49906;
11.02.2019;19:20:06;85054957;85005060;49897;
11.02.2019;19:21:05;85055067;85005163;49904;
11.02.2019;19:22:05;85055155;85005272;49883;
11.02.2019;19:23:11;85055247;85005398;49849;
11.02.2019;19:24:06;85055327;85005473;49854;
11.02.2019;19:25:05;85055425;85005502;49923;
11.02.2019;19:26:05;85055521;85005689;49832;
11.02.2019;19:27:06;85055594;85005804;49790;
11.02.2019;19:28:04;85055709;85005906;49803;
11.02.2019;19:29:04;85055829;85005996;49833;
11.02.2019;19:30:04;85055910;85006082;49828;
11.02.2019;19:31:04;85056015;85006177;49838;
11.02.2019;19:32:05;85056102;85006277;49825;
11.02.2019;19:33:05;85056226;85006377;49849;
11.02.2019;19:34:05;85056323;85006464;49859;
11.02.2019;19:35:05;85056405;85006548;49857;
11.02.2019;19:36:04;85056500;85006626;49874;
11.02.2019;19:37:06;85056580;85006692;49888;
11.02.2019;19:38:05;85056651;85006796;49855;
11.02.2019;19:39:07;85056764;85006862;49902;
11.02.2019;19:40:05;85056854;85006942;49912;
11.02.2019;19:41:06;85056967;85007025;49942;
11.02.2019;19:42:05;85057052;85007115;49937;
11.02.2019;19:43:10;85057178;85007216;49962;
11.02.2019;19:44:04;85057275;85007286;49989;
11.02.2019;19:45:04;85057380;85007374;50006;
11.02.2019;19:46:05;85057489;85007464;50025;
11.02.2019;19:47:06;85057572;85007533;50039;
11.02.2019;19:48:05;85057675;85007618;50057;
11.02.2019;19:49:05;85057761;85007713;50048;
11.02.2019;19:50:09;85057876;85007824;50052;
11.02.2019;19:51:04;85057974;85007910;50064;
11.02.2019;19:52:05;85058085;85007994;50091;
11.02.2019;19:53:05;85058182;85008085;50097;
11.02.2019;19:54:05;85058304;85008169;50135;
11.02.2019;19:55:05;85058397;85008225;50172;
11.02.2019;19:56:05;85058494;85008337;50157;
11.02.2019;19:57:05;85058578;85008435;50143;
11.02.2019;19:58:05;85058671;85008499;50172;
11.02.2019;19:59:05;85058801;85008569;50232;
11.02.2019;20:00:04;85058919;85008655;50264;
11.02.2019;20:01:05;85059020;85008721;50299;
11.02.2019;20:02:05;85059120;85008791;50329;
11.02.2019;20:03:05;85059202;85008843;50359;
11.02.2019;20:04:06;85059281;85008913;50368;
11.02.2019;20:05:05;85059354;85009001;50353;
11.02.2019;20:06:04;85059489;85009048;50441;
11.02.2019;20:07:04;85059603;85009131;50472;
11.02.2019;20:08:04;85059692;85009197;50495;
11.02.2019;20:09:06;85059772;85009257;50515;
11.02.2019;20:10:06;85059881;85009316;50565;
11.02.2019;20:11:05;85059966;85009349;50617;
11.02.2019;20:12:05;85060069;85009403;50666;
11.02.2019;20:13:05;85060133;85009447;50686;
11.02.2019;20:14:05;85060188;85009503;50685;
11.02.2019;20:15:05;85060237;85009564;50673;
11.02.2019;20:16:04;85060294;85009590;50704;
11.02.2019;20:17:04;85060382;85009639;50743;
11.02.2019;20:18:05;85060465;85009686;50779;
11.02.2019;20:19:05;85060544;85009715;50829;
11.02.2019;20:20:05;85060621;85009756;50865;
11.02.2019;20:21:05;85060698;85009823;50875;
11.02.2019;20:22:05;85060793;85009884;50909;
11.02.2019;20:23:05;85060878;85009930;50948;
11.02.2019;20:24:05;85060948;85009999;50949;
11.02.2019;20:25:05;85061041;85010046;50995;
11.02.2019;20:26:05;85061126;85010116;51010;
11.02.2019;20:27:08;85061215;85010187;51028;
11.02.2019;20:28:05;85061306;85010238;51068;
11.02.2019;20:29:06;85061410;85010295;51115;
11.02.2019;20:30:05;85061506;85010346;51160;
11.02.2019;20:31:07;85061620;85010407;51213;
11.02.2019;20:32:05;85061728;85010456;51272;
11.02.2019;20:33:04;85061843;85010513;51330;
11.02.2019;20:34:05;85061945;85010575;51370;
11.02.2019;20:35:08;85062038;85010637;51401;
11.02.2019;20:36:05;85062155;85010692;51463;
11.02.2019;20:37:06;85062274;85010746;51528;
11.02.2019;20:38:06;85062377;85010804;51573;
11.02.2019;20:39:08;85062497;85010879;51618;
11.02.2019;20:40:06;85062593;85010950;51643;
11.02.2019;20:41:07;85062694;85011012;51682;
11.02.2019;20:42:04;85062785;85011078;51707;
11.02.2019;20:43:06;85061545;85011136;50409;
11.02.2019;20:44:04;85061646;85011183;50463;
11.02.2019;20:45:04;85061741;85017691;44050;
11.02.2019;20:46:05;85061846;85017739;44107;
11.02.2019;20:47:05;85061932;85017813;44119;
11.02.2019;20:48:04;85062053;85017872;44181;
11.02.2019;20:49:05;85062153;85017932;44221;
11.02.2019;20:50:06;85062283;85017987;44296;
11.02.2019;20:51:04;85062408;85018035;44373;
11.02.2019;20:52:05;85062511;85018092;44419;
11.02.2019;20:53:06;85062616;85018153;44463;
11.02.2019;20:54:07;85062753;85018201;44552;
11.02.2019;20:55:10;85062887;85018254;44633;
11.02.2019;20:56:05;85062969;85018309;44660;
11.02.2019;20:57:10;85063074;85018356;44718;
11.02.2019;20:58:08;85063183;85018417;44766;
11.02.2019;20:59:04;85063294;85018463;44831;
11.02.2019;21:00:05;85063403;85018517;44886;
11.02.2019;21:01:04;85063520;85018563;44957;
11.02.2019;21:02:08;85063637;85018602;45035;
11.02.2019;21:03:05;85063774;85018667;45107;
11.02.2019;21:04:05;85063900;85018708;45192;
11.02.2019;21:05:06;85064016;85018772;45244;
11.02.2019;21:06:08;85064152;85018830;45322;
11.02.2019;21:07:06;85064254;85018885;45369;
11.02.2019;21:08:06;85064353;85018938;45415;
11.02.2019;21:09:06;85064487;85018975;45512;
11.02.2019;21:10:13;85064605;85019020;45585;
11.02.2019;21:11:04;85064682;85019069;45613;
11.02.2019;21:12:05;85064795;85019105;45690;
11.02.2019;21:13:05;85064907;85019147;45760;
11.02.2019;21:14:07;85065025;85019196;45829;
11.02.2019;21:15:06;85065156;85019253;45903;
11.02.2019;21:16:04;85065268;85019298;45970;
11.02.2019;21:17:07;85065401;85019329;46072;
11.02.2019;21:18:05;85065513;85019390;46123;
11.02.2019;21:19:05;85065639;85019439;46200;
11.02.2019;21:20:05;85065781;85019502;46279;
11.02.2019;21:21:09;85065929;85019563;46366;
11.02.2019;21:22:07;85066046;85019603;46443;
11.02.2019;21:23:06;85066154;85019630;46524;
11.02.2019;21:24:05;85066258;85019673;46585;
11.02.2019;21:25:08;85066369;85019721;46648;
11.02.2019;21:26:05;85066484;85019769;46715;
11.02.2019;21:27:06;85066578;85019817;46761;
11.02.2019;21:28:05;85066693;85019877;46816;
11.02.2019;21:29:08;85066806;85019920;46886;
11.02.2019;21:30:05;85066918;85019971;46947;
11.02.2019;21:31:05;85067035;85020024;47011;
11.02.2019;21:32:05;85067144;85020069;47075;
11.02.2019;21:33:07;85067267;85020116;47151;
11.02.2019;21:34:05;85067402;85020152;47250;
11.02.2019;21:35:05;85067518;85020192;47326;
11.02.2019;21:36:05;85067662;85020220;47442;
11.02.2019;21:37:08;85067788;85020264;47524;
11.02.2019;21:38:06;85067887;85020302;47585;
11.02.2019;21:39:08;85068016;85020338;47678;
11.02.2019;21:40:05;85068117;85020372;47745;
11.02.2019;21:41:08;85068244;85020408;47836;
11.02.2019;21:42:05;85068395;85020443;47952;
11.02.2019;21:43:06;85068517;85020491;48026;
11.02.2019;21:44:09;85068645;85020549;48096;
11.02.2019;21:45:06;85068783;85020589;48194;
11.02.2019;21:46:07;85068905;85020625;48280;
11.02.2019;21:47:07;85068992;85020619;48373;
11.02.2019;21:48:05;85069105;85020620;48485;
11.02.2019;21:49:08;85069237;85020651;48586;
11.02.2019;21:50:05;85069329;85020698;48631;
11.02.2019;21:51:06;85069457;85020726;48731;
11.02.2019;21:52:09;85069604;85020781;48823;
11.02.2019;21:53:06;85069706;85020817;48889;
11.02.2019;21:54:06;85069818;85020853;48965;
11.02.2019;21:55:08;85069936;85020877;49059;
11.02.2019;21:56:04;85070024;85020901;49123;
11.02.2019;21:57:08;85070159;85020952;49207;
11.02.2019;21:58:04;85070264;85020986;49278;
11.02.2019;21:59:05;85070386;85021025;49361;
11.02.2019;22:00:08;85070541;85021056;49485;
11.02.2019;22:01:05;85070638;85021085;49553;
11.02.2019;22:03:07;85070893;85021146;49747;
11.02.2019;22:04:05;85071015;85021173;49842;
11.02.2019;22:05:07;85071145;85021216;49929;
11.02.2019;22:06:06;85071293;85021254;50039;
11.02.2019;22:07:06;85071430;85021289;50141;
11.02.2019;22:08:08;85071560;85021308;50252;
11.02.2019;22:09:06;85071633;85021350;50283;
11.02.2019;22:10:08;85071746;85021371;50375;
11.02.2019;22:11:06;85071856;85021399;50457;
11.02.2019;22:12:05;85071985;85021440;50545;
11.02.2019;22:13:08;85072109;85021477;50632;
11.02.2019;22:14:05;85072233;85021516;50717;
11.02.2019;22:15:08;85072351;85021547;50804;
11.02.2019;22:16:04;85072453;85021574;50879;
11.02.2019;22:17:05;85072553;85021618;50935;
11.02.2019;22:18:08;85072669;85021644;51025;
11.02.2019;22:19:06;85072738;85021664;51074;
11.02.2019;22:20:08;85072828;85021697;51131;
11.02.2019;22:21:06;85072928;85021721;51207;
11.02.2019;22:22:05;85073043;85021767;51276;
11.02.2019;22:23:08;85073144;85021786;51358;
11.02.2019;22:24:06;85073224;85021815;51409;
11.02.2019;22:25:09;85073326;85021827;51499;
11.02.2019;22:26:06;85073435;85021839;51596;
11.02.2019;22:27:05;85073528;85021854;51674;
11.02.2019;22:28:08;85073623;85021871;51752;
11.02.2019;22:29:05;85073707;85021881;51826;
11.02.2019;22:30:07;85073801;85021902;51899;
11.02.2019;22:31:06;85073892;85021935;51957;
11.02.2019;22:32:05;85073970;85021962;52008;
11.02.2019;22:33:08;85074092;85021982;52110;
11.02.2019;22:34:05;85074176;85021987;52189;
11.02.2019;22:35:05;85074283;85022024;52259;
11.02.2019;22:36:08;85074393;85022049;52344;
11.02.2019;22:37:10;85074469;85022072;52397;
11.02.2019;22:38:07;85074567;85022110;52457;
11.02.2019;22:39:07;85074682;85022132;52550;
11.02.2019;22:40:04;85074792;85022155;52637;
11.02.2019;22:41:07;85074895;85022177;52718;
11.02.2019;22:42:04;85074983;85022188;52795;
11.02.2019;22:43:05;85075080;85022201;52879;
11.02.2019;22:44:07;85075205;85022237;52968;
11.02.2019;22:45:05;85075307;85022254;53053;
11.02.2019;22:46:05;85075431;85022287;53144;
11.02.2019;22:47:08;85075564;85022314;53250;
11.02.2019;22:48:05;85075664;85022327;53337;
11.02.2019;22:49:05;85075795;85022363;53432;
11.02.2019;22:50:09;85075916;85022390;53526;
11.02.2019;22:51:05;85076023;85022414;53609;
11.02.2019;22:52:06;85076140;85022439;53701;
11.02.2019;22:53:07;85076271;85022466;53805;
11.02.2019;22:54:05;85076368;85022490;53878;
11.02.2019;22:55:04;85076501;85022530;53971;
11.02.2019;22:56:04;85076612;85022563;54049;
11.02.2019;22:57:05;85076727;85022588;54139;
11.02.2019;22:58:05;85076834;85022618;54216;
11.02.2019;22:59:06;85076947;85022638;54309;
11.02.2019;23:00:05;85077029;85022665;54364;
11.02.2019;23:01:05;85077152;85022692;54460;
11.02.2019;23:02:05;85077290;85022715;54575;
11.02.2019;23:03:05;85077390;85022747;54643;
11.02.2019;23:04:06;85077500;85022767;54733;
11.02.2019;23:05:05;85077601;85022805;54796;
11.02.2019;23:06:05;85077723;85022823;54900;
11.02.2019;23:07:04;85077820;85022834;54986;
11.02.2019;23:08:04;85077960;85022872;55088;
11.02.2019;23:09:04;85078073;85022888;55185;
11.02.2019;23:10:04;85078190;85022902;55288;
11.02.2019;23:11:05;85078288;85022915;55373;
11.02.2019;23:12:05;85078394;85022944;55450;
11.02.2019;23:13:05;85078495;85022980;55515;
11.02.2019;23:14:05;85078611;85023005;55606;
11.02.2019;23:15:05;85078725;85023030;55695;
11.02.2019;23:16:05;85078847;85023067;55780;
11.02.2019;23:17:05;85078944;85023085;55859;
11.02.2019;23:18:05;85079049;85023121;55928;
11.02.2019;23:19:05;85079154;85023145;56009;
11.02.2019;23:20:05;85079256;85023178;56078;
11.02.2019;23:21:05;85079362;85023183;56179;
11.02.2019;23:22:05;85079462;85023201;56261;
11.02.2019;23:23:06;85079569;85023240;56329;
11.02.2019;23:24:05;85079675;85023274;56401;
11.02.2019;23:25:05;85079779;85023290;56489;
11.02.2019;23:26:05;85079899;85023310;56589;
11.02.2019;23:27:05;85079991;85023336;56655;
11.02.2019;23:28:04;85080081;85023366;56715;
11.02.2019;23:29:04;85080164;85023388;56776;
11.02.2019;23:30:05;85080285;85023431;56854;
11.02.2019;23:31:04;85080385;85023440;56945;
11.02.2019;23:32:04;85080495;85023476;57019;
11.02.2019;23:33:05;85080621;85023495;57126;
11.02.2019;23:34:04;85080723;85023521;57202;
11.02.2019;23:35:05;85080853;85023549;57304;
11.02.2019;23:36:05;85080974;85023571;57403;
11.02.2019;23:37:05;85081050;85023596;57454;
11.02.2019;23:38:05;85081157;85023609;57548;
11.02.2019;23:39:05;85081272;85023641;57631;
11.02.2019;23:40:04;85081390;85023670;57720;
11.02.2019;23:41:06;85081479;85023700;57779;
11.02.2019;23:42:05;85081568;85023722;57846;
11.02.2019;23:43:06;85081670;85023750;57920;
11.02.2019;23:44:05;85081771;85023777;57994;
11.02.2019;23:45:05;85081867;85023799;58068;
11.02.2019;23:46:05;85081983;85023824;58159;
11.02.2019;23:47:05;85082068;85023841;58227;
11.02.2019;23:48:05;85082157;85023867;58290;
11.02.2019;23:49:05;85082278;85023888;58390;
11.02.2019;23:50:05;85082377;85023915;58462;
11.02.2019;23:51:04;85082456;85023930;58526;
11.02.2019;23:52:04;85082574;85023958;58616;
11.02.2019;23:53:05;85082693;85023965;58728;
11.02.2019;23:54:05;85082798;85023979;58819;
11.02.2019;23:55:05;85082927;85023990;58937;
11.02.2019;23:56:05;85083044;85024010;59034;
11.02.2019;23:57:05;85083131;85024032;59099;
11.02.2019;23:58:05;85083224;85024051;59173;
11.02.2019;23:59:04;85083327;85024080;59247;
12.02.2019;00:00:07;85083428;85024109;59319;
12.02.2019;00:01:08;85083518;85024130;59388;
12.02.2019;00:02:07;85083604;85024158;59446;
12.02.2019;00:03:08;85083692;85024183;59509;
12.02.2019;00:04:08;85083789;85024204;59585;
12.02.2019;00:05:09;85083876;85024230;59646;
12.02.2019;00:06:08;85083974;85024248;59726;
12.02.2019;00:07:08;85084067;85024268;59799;
12.02.2019;00:08:07;85084162;85024283;59879;
12.02.2019;00:09:09;85084255;85024309;59946;
12.02.2019;00:10:07;85084346;85024325;60021;
12.02.2019;00:11:09;85084446;85024350;60096;
12.02.2019;00:12:07;85084525;85024375;60150;
12.02.2019;00:13:08;85084613;85024398;60215;
12.02.2019;00:14:08;85084718;85024425;60293;
12.02.2019;00:15:08;85084815;85024446;60369;
12.02.2019;00:16:07;85084914;85024485;60429;
12.02.2019;00:17:09;85085019;85024510;60509;
12.02.2019;00:18:08;85085125;85024527;60598;
12.02.2019;00:19:08;85085219;85024542;60677;
12.02.2019;00:20:08;85085325;85024561;60764;
12.02.2019;00:21:09;85085427;85024572;60855;
12.02.2019;00:22:08;85085515;85024596;60919;
12.02.2019;00:23:08;85085627;85024623;61004;
12.02.2019;00:24:08;85085703;85024646;61057;
12.02.2019;00:25:08;85085805;85024659;61146;
12.02.2019;00:26:08;85085888;85024678;61210;
12.02.2019;00:27:08;85085956;85024694;61262;
12.02.2019;00:28:08;85086040;85024715;61325;
12.02.2019;00:29:08;85086139;85024732;61407;
12.02.2019;00:30:08;85086241;85024754;61487;
12.02.2019;00:31:08;85086336;85024785;61551;
12.02.2019;00:32:08;85086418;85024813;61605;
12.02.2019;00:33:08;85086508;85024820;61688;
12.02.2019;00:34:08;85086605;85024851;61754;
12.02.2019;00:35:07;85086690;85024871;61819;
12.02.2019;00:36:08;85086761;85024904;61857;
12.02.2019;00:37:08;85086850;85024926;61924;
12.02.2019;00:38:08;85086946;85024944;62002;
12.02.2019;00:39:11;85087028;85024970;62058;
12.02.2019;00:40:10;85087109;85025002;62107;
12.02.2019;00:41:09;85087199;85025022;62177;
12.02.2019;00:42:08;85087246;85025044;62202;
12.02.2019;00:43:08;85087383;85025067;62316;
12.02.2019;00:44:08;85087484;85025081;62403;
12.02.2019;00:45:08;85087569;85025112;62457;
12.02.2019;00:46:09;85087646;85025131;62515;
12.02.2019;00:47:08;85087750;85025171;62579;
12.02.2019;00:48:08;85087823;85025188;62635;
12.02.2019;00:49:08;85087899;85025217;62682;
12.02.2019;00:50:09;85087986;85025234;62752;
12.02.2019;00:51:09;85088091;85025272;62819;
12.02.2019;00:52:08;85088180;85025298;62882;
12.02.2019;00:53:08;85088246;85025325;62921;
12.02.2019;00:54:08;85088330;85025350;62980;
12.02.2019;00:55:08;85088423;85025378;63045;
12.02.2019;00:56:08;85088491;85025405;63086;
12.02.2019;00:57:10;85088569;85025428;63141;
12.02.2019;00:58:09;85088647;85025453;63194;
12.02.2019;00:59:09;85088721;85025475;63246;
12.02.2019;01:00:06;85088788;85025504;63284;
12.02.2019;01:01:06;85088859;85025532;63327;
12.02.2019;01:02:07;85088944;85025564;63380;
12.02.2019;01:03:05;85089022;85025587;63435;
12.02.2019;01:04:05;85089114;85025621;63493;
12.02.2019;01:05:04;85089199;85025647;63552;
12.02.2019;01:06:05;85089285;85025675;63610;
12.02.2019;01:07:05;85089366;85025701;63665;
12.02.2019;01:08:05;85089452;85025728;63724;
12.02.2019;01:09:06;85089527;85025743;63784;
12.02.2019;01:10:06;85089599;85025775;63824;
12.02.2019;01:11:05;85089679;85025792;63887;
12.02.2019;01:12:05;85089747;85025825;63922;
12.02.2019;01:13:04;85089846;85025850;63996;
12.02.2019;01:14:04;85089933;85025881;64052;
12.02.2019;01:15:04;85090019;85025912;64107;
12.02.2019;01:16:05;85090090;85025939;64151;
12.02.2019;01:17:06;85090177;85025971;64206;
12.02.2019;01:18:04;85090264;85025998;64266;
12.02.2019;01:19:05;85090337;85026029;64308;
12.02.2019;01:20:04;85090446;85026052;64394;
12.02.2019;01:21:05;85090544;85026065;64479;
12.02.2019;01:22:04;85090621;85026093;64528;
12.02.2019;01:23:05;85090725;85026121;64604;
12.02.2019;01:24:05;85090802;85026163;64639;
12.02.2019;01:25:05;85090886;85026205;64681;
12.02.2019;01:26:06;85090956;85026245;64711;
12.02.2019;01:27:05;85091023;85026273;64750;
12.02.2019;01:28:06;85091100;85026291;64809;
12.02.2019;01:29:06;85091188;85026314;64874;
12.02.2019;01:30:06;85091262;85026336;64926;
12.02.2019;01:31:05;85091361;85026367;64994;
12.02.2019;01:32:05;85091457;85026394;65063;
12.02.2019;01:33:06;85091518;85026426;65092;
12.02.2019;01:34:05;85091601;85026461;65140;
12.02.2019;01:35:05;85091693;85026490;65203;
12.02.2019;01:36:05;85091785;85026514;65271;
12.02.2019;01:37:05;85091885;85026544;65341;
12.02.2019;01:38:06;85091980;85026581;65399;
12.02.2019;01:39:06;85092059;85026615;65444;
12.02.2019;01:40:05;85092158;85026659;65499;
12.02.2019;01:41:05;85092226;85026679;65547;
12.02.2019;01:42:05;85092303;85026721;65582;
12.02.2019;01:43:05;85092390;85026748;65642;
12.02.2019;01:44:05;85092486;85026775;65711;
12.02.2019;01:45:05;85092568;85026818;65750;
12.02.2019;01:46:05;85092639;85026847;65792;
12.02.2019;01:47:05;85092723;85026895;65828;
12.02.2019;01:48:05;85092816;85026927;65889;
12.02.2019;01:49:05;85092893;85026961;65932;
12.02.2019;01:50:05;85092984;85027004;65980;
12.02.2019;01:51:05;85093078;85027053;66025;
12.02.2019;01:52:06;85093159;85027091;66068;
12.02.2019;01:53:05;85093250;85027125;66125;
12.02.2019;01:54:06;85093333;85027172;66161;
12.02.2019;01:55:05;85093422;85027222;66200;
12.02.2019;01:56:06;85093483;85027269;66214;
12.02.2019;01:57:06;85093553;85027308;66245;
12.02.2019;01:58:05;85093640;85027356;66284;
12.02.2019;01:59:05;85093701;85027403;66298;
12.02.2019;02:00:06;85093789;85027450;66339;
12.02.2019;02:01:05;85093890;85027504;66386;
12.02.2019;02:02:05;85093992;85027550;66442;
12.02.2019;02:03:05;85094065;85027580;66485;
12.02.2019;02:04:05;85094149;85027618;66531;
12.02.2019;02:05:05;85094234;85027647;66587;
12.02.2019;02:06:05;85094300;85027708;66592;
12.02.2019;02:07:06;85094384;85027747;66637;
12.02.2019;02:08:05;85094473;85027791;66682;
12.02.2019;02:09:06;85094563;85027842;66721;
12.02.2019;02:10:04;85094636;85027872;66764;
12.02.2019;02:11:04;85094713;85027915;66798;
12.02.2019;02:12:05;85094783;85027976;66807;
12.02.2019;02:13:05;85094862;85028018;66844;
12.02.2019;02:14:06;85094949;85028057;66892;
12.02.2019;02:15:06;85095016;85028108;66908;
12.02.2019;02:16:05;85095096;85028162;66934;
12.02.2019;02:17:06;85095175;85028207;66968;
12.02.2019;02:18:05;85095250;85028270;66980;
12.02.2019;02:19:05;85095345;85028332;67013;
12.02.2019;02:20:04;85095314;85028379;66935;
12.02.2019;02:21:04;85095378;85028422;66956;
12.02.2019;02:22:05;85095461;85028467;66994;
12.02.2019;02:23:05;85095559;85028519;67040;
12.02.2019;02:24:05;85095632;85028571;67061;
12.02.2019;02:25:05;85095710;85028633;67077;
12.02.2019;02:26:05;85095791;85028687;67104;
12.02.2019;02:27:04;85095861;85028737;67124;
12.02.2019;02:28:05;85095949;85028784;67165;
12.02.2019;02:29:05;85096005;85028843;67162;
12.02.2019;02:30:05;85096036;85028877;67159;
12.02.2019;02:31:04;85096122;85028946;67176;
12.02.2019;02:32:04;85096203;85029008;67195;
12.02.2019;02:33:05;85096302;85029064;67238;
12.02.2019;02:34:04;85096338;85029121;67217;
12.02.2019;02:35:05;85096392;85029171;67221;
12.02.2019;02:36:05;85096372;85029210;67162;
12.02.2019;02:37:06;85096366;85029284;67082;
12.02.2019;02:38:05;85096387;85029319;67068;
12.02.2019;02:39:06;85096405;85029354;67051;
12.02.2019;02:40:05;85096465;85029415;67050;
12.02.2019;02:41:06;85096494;85029491;67003;
12.02.2019;02:42:06;85096523;85029549;66974;
12.02.2019;02:43:05;85096571;85029639;66932;
12.02.2019;02:44:06;85096658;85029693;66965;
12.02.2019;02:45:05;85096713;85029766;66947;
12.02.2019;02:46:05;85096849;85029829;67020;
12.02.2019;02:47:05;85096928;85029900;67028;
12.02.2019;02:48:06;85097000;85029965;67035;
12.02.2019;02:49:04;85097102;85030037;67065;
12.02.2019;02:50:04;85097190;85030099;67091;
12.02.2019;02:51:05;85097279;85030163;67116;
12.02.2019;02:52:05;85097349;85030238;67111;
12.02.2019;02:53:04;85097428;85030319;67109;
12.02.2019;02:54:05;85097511;85030394;67117;
12.02.2019;02:55:07;85097593;85030478;67115;
12.02.2019;02:56:05;85097701;85030563;67138;
12.02.2019;02:57:05;85097768;85030647;67121;
12.02.2019;02:58:05;85097842;85030738;67104;
12.02.2019;02:59:06;85097947;85030819;67128;
12.02.2019;03:00:06;85098011;85030904;67107;
12.02.2019;03:01:06;85098116;85030989;67127;
12.02.2019;03:02:05;85098227;85031086;67141;
12.02.2019;03:03:05;85098318;85031147;67171;
12.02.2019;03:04:05;85098389;85031247;67142;
12.02.2019;03:05:05;85098482;85031327;67155;
12.02.2019;03:06:06;85098546;85031417;67129;
12.02.2019;03:07:05;85098645;85031503;67142;
12.02.2019;03:08:06;85098738;85031582;67156;
12.02.2019;03:09:08;85098848;85031674;67174;
12.02.2019;03:10:04;85098920;85031765;67155;
12.02.2019;03:11:05;85099002;85031836;67166;
12.02.2019;03:12:04;85099098;85031920;67178;
12.02.2019;03:13:04;85099185;85032008;67177;
12.02.2019;03:14:05;85099276;85032073;67203;
12.02.2019;03:15:05;85099386;85032166;67220;
12.02.2019;03:16:05;85099460;85032249;67211;
12.02.2019;03:17:05;85099530;85032335;67195;
12.02.2019;03:18:05;85099618;85032426;67192;
12.02.2019;03:19:04;85099705;85032512;67193;
12.02.2019;03:20:04;85099791;85032587;67204;
12.02.2019;03:21:04;85099890;85032687;67203;
12.02.2019;03:22:05;85099963;85032779;67184;
12.02.2019;03:23:06;85100046;85032877;67169;
12.02.2019;03:24:04;85100125;85032960;67165;
12.02.2019;03:25:04;85100229;85033045;67184;
12.02.2019;03:26:05;85100326;85033153;67173;
12.02.2019;03:27:06;85100378;85033233;67145;
12.02.2019;03:28:06;85100479;85033312;67167;
12.02.2019;03:29:05;85100547;85033402;67145;
12.02.2019;03:30:06;85100619;85033500;67119;
12.02.2019;03:31:05;85100696;85033594;67102;
12.02.2019;03:32:06;85100761;85033678;67083;
12.02.2019;03:33:05;85100859;85033761;67098;
12.02.2019;03:34:05;85100959;85033858;67101;
12.02.2019;03:35:05;85101040;85033946;67094;
12.02.2019;03:36:07;85101127;85034060;67067;
12.02.2019;03:37:06;85101186;85034144;67042;
12.02.2019;03:38:05;85101257;85034239;67018;
12.02.2019;03:39:06;85101326;85034351;66975;
12.02.2019;03:40:04;85101405;85034430;66975;
12.02.2019;03:41:05;85101511;85034537;66974;
12.02.2019;03:42:05;85101596;85034648;66948;
12.02.2019;03:43:05;85101705;85034757;66948;
12.02.2019;03:44:06;85101812;85034856;66956;
12.02.2019;03:45:05;85101900;85034933;66967;
12.02.2019;03:46:05;85101982;85035035;66947;
12.02.2019;03:47:05;85102082;85035115;66967;
12.02.2019;03:48:04;85102159;85035200;66959;
12.02.2019;03:49:05;85102259;85035289;66970;
12.02.2019;03:50:05;85102365;85035394;66971;
12.02.2019;03:51:05;85102456;85035490;66966;
12.02.2019;03:52:05;85102543;85035590;66953;
12.02.2019;03:53:06;85102630;85035711;66919;
12.02.2019;03:54:05;85102724;85035790;66934;
12.02.2019;03:55:06;85102819;85035895;66924;
12.02.2019;03:56:06;85102904;85035982;66922;
12.02.2019;03:57:05;85102994;85036085;66909;
12.02.2019;03:58:06;85103083;85036180;66903;
12.02.2019;03:59:05;85103178;85036271;66907;
12.02.2019;04:00:06;85103251;85036367;66884;
12.02.2019;04:01:06;85103361;85036465;66896;
12.02.2019;04:02:05;85103457;85036572;66885;
12.02.2019;04:03:05;85103530;85036669;66861;
12.02.2019;04:04:05;85103606;85036771;66835;
12.02.2019;04:05:05;85103687;85036866;66821;
12.02.2019;04:06:05;85103775;85036966;66809;
12.02.2019;04:07:05;85103863;85037080;66783;
12.02.2019;04:08:05;85103952;85037174;66778;
12.02.2019;04:09:06;85104015;85037248;66767;
12.02.2019;04:10:05;85104090;85037351;66739;
12.02.2019;04:11:05;85104160;85037428;66732;
12.02.2019;04:12:05;85104218;85037510;66708;
12.02.2019;04:13:05;85104251;85037601;66650;
12.02.2019;04:14:05;85104329;85037691;66638;
12.02.2019;04:15:06;85104374;85037794;66580;
12.02.2019;04:16:05;85104431;85037876;66555;
12.02.2019;04:17:06;85104488;85037981;66507;
12.02.2019;04:18:04;85104552;85038074;66478;
12.02.2019;04:19:04;85104616;85038157;66459;
12.02.2019;04:20:05;85104704;85038257;66447;
12.02.2019;04:21:04;85104755;85038353;66402;
12.02.2019;04:22:04;85104847;85038452;66395;
12.02.2019;04:23:06;85104896;85038550;66346;
12.02.2019;04:24:05;85104980;85038645;66335;
12.02.2019;04:25:05;85105081;85038717;66364;
12.02.2019;04:26:05;85105171;85038811;66360;
12.02.2019;04:27:04;85105256;85038905;66351;
12.02.2019;04:28:05;85105354;85039002;66352;
12.02.2019;04:29:04;85105415;85039086;66329;
12.02.2019;04:30:05;85105505;85039207;66298;
12.02.2019;04:31:04;85105581;85039303;66278;
12.02.2019;04:32:04;85105664;85039396;66268;
12.02.2019;04:33:04;85105764;85039477;66287;
12.02.2019;04:34:04;85105841;85039561;66280;
12.02.2019;04:35:05;85105920;85039660;66260;
12.02.2019;04:36:05;85105990;85039743;66247;
12.02.2019;04:37:05;85106066;85039870;66196;
12.02.2019;04:38:05;85106131;85039972;66159;
12.02.2019;04:39:05;85106204;85040057;66147;
12.02.2019;04:40:06;85106284;85040139;66145;
12.02.2019;04:41:05;85106350;85040248;66102;
12.02.2019;04:42:06;85106444;85040346;66098;
12.02.2019;04:43:05;85106511;85040459;66052;
12.02.2019;04:44:05;85106580;85040537;66043;
12.02.2019;04:45:05;85106648;85040640;66008;
12.02.2019;04:46:05;85106730;85040736;65994;
12.02.2019;04:47:05;85106807;85040807;66000;
12.02.2019;04:48:05;85106887;85040904;65983;
12.02.2019;04:49:05;85106963;85041010;65953;
12.02.2019;04:50:05;85107038;85041102;65936;
12.02.2019;04:51:05;85107125;85041193;65932;
12.02.2019;04:52:05;85107198;85041285;65913;
12.02.2019;04:53:07;85107271;85041379;65892;
12.02.2019;04:54:06;85107338;85041483;65855;
12.02.2019;04:55:05;85107415;85041569;65846;
12.02.2019;04:56:04;85107505;85041668;65837;
12.02.2019;04:57:04;85107577;85041772;65805;
12.02.2019;04:58:05;85107628;85041901;65727;
12.02.2019;04:59:05;85107720;85042025;65695;
12.02.2019;05:00:04;85107796;85042098;65698;
12.02.2019;05:01:04;85107866;85042202;65664;
12.02.2019;05:02:11;85107928;85042322;65606;
12.02.2019;05:03:05;85108006;85042399;65607;
12.02.2019;05:04:04;85108064;85042492;65572;
12.02.2019;05:05:05;85108110;85042606;65504;
12.02.2019;05:06:06;85108172;85042709;65463;
12.02.2019;05:07:06;85108251;85042810;65441;
12.02.2019;05:08:05;85108319;85042903;65416;
12.02.2019;05:09:05;85108381;85043001;65380;
12.02.2019;05:10:05;85108454;85043106;65348;
12.02.2019;05:11:06;85108532;85043197;65335;
12.02.2019;05:12:05;85108599;85043303;65296;
12.02.2019;05:13:04;85108668;85043415;65253;
12.02.2019;05:14:04;85108743;85043520;65223;
12.02.2019;05:15:05;85108807;85043617;65190;
12.02.2019;05:16:05;85108865;85043703;65162;
12.02.2019;05:17:05;85108935;85043798;65137;
12.02.2019;05:18:04;85109015;85043881;65134;
12.02.2019;05:19:04;85109105;85043974;65131;
12.02.2019;05:20:05;85109180;85044079;65101;
12.02.2019;05:21:04;85109243;85044203;65040;
12.02.2019;05:22:05;85109312;85044322;64990;
12.02.2019;05:23:04;85109369;85044411;64958;
12.02.2019;05:24:04;85109449;85044503;64946;
12.02.2019;05:25:05;85109536;85044617;64919;
12.02.2019;05:26:05;85109616;85044726;64890;
12.02.2019;05:27:04;85109693;85044823;64870;
12.02.2019;05:28:04;85109776;85044927;64849;
12.02.2019;05:29:05;85109839;85045016;64823;
12.02.2019;05:30:04;85109921;85045125;64796;
12.02.2019;05:31:05;85109978;85045226;64752;
12.02.2019;05:32:05;85110050;85045329;64721;
12.02.2019;05:33:07;85110118;85045446;64672;
12.02.2019;05:34:05;85110189;85045550;64639;
12.02.2019;05:35:05;85110259;85045642;64617;
12.02.2019;05:36:06;85110329;85045742;64587;
12.02.2019;05:37:05;85110394;85045849;64545;
12.02.2019;05:38:06;85110457;85045953;64504;
12.02.2019;05:39:05;85110508;85046033;64475;
12.02.2019;05:40:05;85110565;85046137;64428;
12.02.2019;05:41:05;85110647;85046234;64413;
12.02.2019;05:42:05;85110711;85046347;64364;
12.02.2019;05:43:05;85110770;85046457;64313;
12.02.2019;05:44:05;85110837;85046574;64263;
12.02.2019;05:45:04;85110911;85046679;64232;
12.02.2019;05:46:04;85110985;85046764;64221;
12.02.2019;05:47:05;85111064;85046863;64201;
12.02.2019;05:48:05;85111129;85046971;64158;
12.02.2019;05:49:05;85111199;85047077;64122;
12.02.2019;05:50:05;85111272;85047194;64078;
12.02.2019;05:51:06;85111324;85047283;64041;
12.02.2019;05:52:07;85111390;85047375;64015;
12.02.2019;05:53:05;85111452;85047465;63987;
12.02.2019;05:54:04;85111512;85047566;63946;
12.02.2019;05:55:05;85111597;85047679;63918;
12.02.2019;05:56:06;85111661;85047779;63882;
12.02.2019;05:57:05;85111718;85047893;63825;
12.02.2019;05:58:05;85111791;85047997;63794;
12.02.2019;05:59:06;85111858;85048111;63747;
12.02.2019;06:00:05;85111921;85048214;63707;
12.02.2019;06:01:05;85111992;85048310;63682;
12.02.2019;06:02:05;85112048;85048397;63651;
12.02.2019;06:03:05;85112108;85048514;63594;
12.02.2019;06:04:05;85112182;85048613;63569;
12.02.2019;06:05:05;85112239;85048708;63531;
12.02.2019;06:06:05;85112303;85048813;63490;
12.02.2019;06:07:05;85112367;85048931;63436;
12.02.2019;06:08:05;85112423;85049032;63391;
12.02.2019;06:09:05;85112498;85049148;63350;
12.02.2019;06:10:05;85112564;85049254;63310;
12.02.2019;06:11:05;85112619;85049324;63295;
12.02.2019;06:12:04;85112678;85049453;63225;
12.02.2019;06:13:04;85112717;85049547;63170;
12.02.2019;06:14:05;85112767;85049644;63123;
12.02.2019;06:15:05;85112813;85049741;63072;
12.02.2019;06:16:05;85112851;85049852;62999;
12.02.2019;06:17:05;85112890;85049970;62920;
12.02.2019;06:18:05;85112956;85050079;62877;
12.02.2019;06:19:05;85113018;85050164;62854;
12.02.2019;06:20:04;85113053;85050244;62809;
12.02.2019;06:21:04;85113105;85050340;62765;
12.02.2019;06:22:05;85113151;85050422;62729;
12.02.2019;06:23:05;85113195;85050522;62673;
12.02.2019;06:24:05;85113244;85050603;62641;
12.02.2019;06:25:08;85113300;85050710;62590;
12.02.2019;06:26:05;85113354;85050808;62546;
12.02.2019;06:27:06;85113408;85050911;62497;
12.02.2019;06:28:05;85113467;85051018;62449;
12.02.2019;06:29:06;85113533;85051123;62410;
12.02.2019;06:30:05;85113601;85051224;62377;
12.02.2019;06:31:05;85113665;85051328;62337;
12.02.2019;06:32:05;85113702;85051422;62280;
12.02.2019;06:33:05;85113782;85051536;62246;
12.02.2019;06:34:05;85113851;85051651;62200;
12.02.2019;06:35:05;85113907;85051736;62171;
12.02.2019;06:36:05;85113962;85051849;62113;
12.02.2019;06:37:05;85114025;85051964;62061;
12.02.2019;06:38:05;85114099;85052086;62013;
12.02.2019;06:39:06;85114160;85052178;61982;
12.02.2019;06:40:05;85114236;85052275;61961;
12.02.2019;06:41:06;85114289;85052409;61880;
12.02.2019;06:42:05;85114353;85052526;61827;
12.02.2019;06:44:05;85114493;85052756;61737;
12.02.2019;06:45:05;85114552;85052852;61700;
12.02.2019;06:46:06;85114620;85052944;61676;
12.02.2019;06:47:05;85114681;85053069;61612;
12.02.2019;06:48:05;85114742;85053175;61567;
12.02.2019;06:49:05;85114814;85053273;61541;
12.02.2019;06:50:05;85114865;85053395;61470;
12.02.2019;06:51:04;85114929;85053492;61437;
12.02.2019;06:52:04;85114989;85053615;61374;
12.02.2019;06:53:05;85115047;85053720;61327;
12.02.2019;06:54:05;85115113;85053831;61282;
12.02.2019;06:55:07;85115186;85053925;61261;
12.02.2019;06:56:05;85115231;85054026;61205;
12.02.2019;06:57:06;85115290;85054127;61163;
12.02.2019;06:58:05;85115343;85054227;61116;
12.02.2019;06:59:05;85115400;85054338;61062;
12.02.2019;07:00:04;85115446;85054479;60967;
12.02.2019;07:01:05;85115512;85054624;60888;
12.02.2019;07:02:04;85115576;85054738;60838;
12.02.2019;07:03:05;85115618;85054862;60756;
12.02.2019;07:04:04;85115656;85054960;60696;
12.02.2019;07:05:05;85115737;85055077;60660;
12.02.2019;07:06:05;85115790;85055198;60592;
12.02.2019;07:07:04;85115843;85055295;60548;
12.02.2019;07:08:05;85115921;85055399;60522;
12.02.2019;07:09:06;85115979;85055512;60467;
12.02.2019;07:10:04;85116054;85055621;60433;
12.02.2019;07:11:05;85116114;85055738;60376;
12.02.2019;07:12:05;85116171;85055847;60324;
12.02.2019;07:13:05;85116236;85055954;60282;
12.02.2019;07:14:05;85116283;85056069;60214;
12.02.2019;07:15:05;85116329;85056184;60145;
12.02.2019;07:16:05;85116393;85056313;60080;
12.02.2019;07:17:06;85116458;85056446;60012;
12.02.2019;07:18:05;85116512;85056564;59948;
12.02.2019;07:19:05;85116575;85056693;59882;
12.02.2019;07:20:05;85116630;85056817;59813;
12.02.2019;07:21:05;85116686;85056939;59747;
12.02.2019;07:22:05;85116730;85057052;59678;
12.02.2019;07:23:05;85116771;85057173;59598;
12.02.2019;07:24:06;85116822;85057286;59536;
12.02.2019;07:25:05;85116879;85057414;59465;
12.02.2019;07:26:05;85116919;85057525;59394;
12.02.2019;07:27:04;85116969;85057636;59333;
12.02.2019;07:28:04;85117014;85057748;59266;
12.02.2019;07:29:04;85117081;85057858;59223;
12.02.2019;07:30:05;85117148;85057976;59172;
12.02.2019;07:31:04;85117205;85058091;59114;
12.02.2019;07:32:05;85117262;85058198;59064;
12.02.2019;07:33:05;85117319;85058307;59012;
12.02.2019;07:34:05;85117385;85058435;58950;
12.02.2019;07:35:05;85117442;85058545;58897;
12.02.2019;07:36:06;85117522;85058659;58863;
12.02.2019;07:37:05;85117573;85058777;58796;
12.02.2019;07:38:04;85117628;85058882;58746;
12.02.2019;07:39:04;85117693;85059013;58680;
12.02.2019;07:40:05;85117738;85059134;58604;
12.02.2019;07:41:05;85117791;85059243;58548;
12.02.2019;07:42:05;85117842;85059351;58491;
12.02.2019;07:43:06;85117908;85059474;58434;
12.02.2019;07:44:05;85117976;85059594;58382;
12.02.2019;07:45:05;85118021;85059708;58313;
12.02.2019;07:46:05;85118081;85059821;58260;
12.02.2019;07:47:04;85118130;85059922;58208;
12.02.2019;07:48:04;85118182;85060031;58151;
12.02.2019;07:49:05;85118237;85060145;58092;
12.02.2019;07:50:04;85118285;85060274;58011;
12.02.2019;07:51:05;85118345;85060387;57958;
12.02.2019;07:52:05;85118406;85060508;57898;
12.02.2019;07:53:04;85118474;85060622;57852;
12.02.2019;07:54:05;85118520;85060754;57766;
12.02.2019;07:55:04;85118574;85060875;57699;
12.02.2019;07:56:04;85118623;85060994;57629;
12.02.2019;07:57:04;85118664;85061116;57548;
12.02.2019;07:58:05;85118716;85061224;57492;
12.02.2019;07:59:04;85118772;85061328;57444;
12.02.2019;08:00:05;85118854;85061442;57412;
12.02.2019;08:01:06;85118903;85061547;57356;
12.02.2019;08:02:05;85118961;85061671;57290;
12.02.2019;08:03:05;85119024;85061788;57236;
12.02.2019;08:04:05;85119069;85061912;57157;
12.02.2019;08:05:05;85119128;85062022;57106;
12.02.2019;08:06:04;85119175;85062153;57022;
12.02.2019;08:07:04;85119238;85062260;56978;
12.02.2019;08:08:05;85119286;85062370;56916;
12.02.2019;08:09:07;85119336;85062501;56835;
12.02.2019;08:10:04;85119389;85062613;56776;
12.02.2019;08:11:05;85119438;85062710;56728;
12.02.2019;08:12:04;85119467;85062813;56654;
12.02.2019;08:13:04;85119486;85062866;56620;
12.02.2019;08:14:05;85119516;85062973;56543;
12.02.2019;08:15:04;85119532;85063057;56475;
12.02.2019;08:16:05;85119544;85063127;56417;
12.02.2019;08:17:06;85119566;85063222;56344;
12.02.2019;08:18:05;85119600;85063298;56302;
12.02.2019;08:19:05;85119638;85063409;56229;
12.02.2019;08:20:06;85119688;85063495;56193;
12.02.2019;08:21:05;85119738;85063599;56139;
12.02.2019;08:22:05;85119781;85063711;56070;
12.02.2019;08:23:06;85119821;85063823;55998;
12.02.2019;08:24:05;85119870;85063928;55942;
12.02.2019;08:25:06;85119916;85064025;55891;
12.02.2019;08:26:05;85119966;85064160;55806;
12.02.2019;08:27:05;85120017;85064275;55742;
12.02.2019;08:28:05;85120089;85064417;55672;
12.02.2019;08:29:05;85120143;85064537;55606;
12.02.2019;08:30:05;85120190;85064636;55554;
12.02.2019;08:31:06;85120257;85064748;55509;
12.02.2019;08:32:05;85120308;85064851;55457;
12.02.2019;08:33:05;85120360;85064959;55401;
12.02.2019;08:34:05;85120422;85065067;55355;
12.02.2019;08:35:05;85120481;85065187;55294;
12.02.2019;08:36:05;85120535;85065291;55244;
12.02.2019;08:37:05;85120599;85065386;55213;
12.02.2019;08:38:06;85120649;85065477;55172;
12.02.2019;08:39:07;85120706;85065575;55131;
12.02.2019;08:40:05;85120755;85065686;55069;
12.02.2019;08:41:05;85120809;85065799;55010;
12.02.2019;08:42:05;85120864;85065907;54957;
12.02.2019;08:43:06;85120901;85066016;54885;
12.02.2019;08:44:05;85120941;85066119;54822;
12.02.2019;08:45:05;85120986;85066246;54740;
12.02.2019;08:46:05;85121041;85066363;54678;
12.02.2019;08:47:05;85121090;85066486;54604;
12.02.2019;08:48:05;85121149;85066569;54580;
12.02.2019;08:49:05;85121208;85066683;54525;
12.02.2019;08:50:06;85121260;85066788;54472;
12.02.2019;08:51:06;85121317;85066901;54416;
12.02.2019;08:52:05;85121388;85067000;54388;
12.02.2019;08:53:05;85121448;85067127;54321;
12.02.2019;08:54:05;85121514;85067256;54258;
12.02.2019;08:55:05;85121574;85067368;54206;
12.02.2019;08:56:04;85121646;85067482;54164;
12.02.2019;08:57:04;85121701;85067598;54103;
12.02.2019;08:58:05;85121764;85067709;54055;
12.02.2019;08:59:05;85121815;85067803;54012;
12.02.2019;09:00:04;85121883;85067941;53942;
12.02.2019;09:01:04;85121935;85068075;53860;
12.02.2019;09:02:05;85122011;85068191;53820;
12.02.2019;09:03:04;85122068;85068308;53760;
12.02.2019;09:04:05;85122127;85068397;53730;
12.02.2019;09:05:05;85122194;85068538;53656;
12.02.2019;09:06:05;85122255;85068676;53579;
12.02.2019;09:07:05;85122311;85068804;53507;
12.02.2019;09:08:05;85122366;85068939;53427;
12.02.2019;09:09:06;85122426;85069078;53348;
12.02.2019;09:10:05;85122493;85069210;53283;
12.02.2019;09:11:05;85122548;85069341;53207;
12.02.2019;09:12:05;85122620;85069467;53153;
12.02.2019;09:13:05;85122679;85069625;53054;
12.02.2019;09:14:06;85122733;85069757;52976;
12.02.2019;09:15:05;85122797;85069877;52920;
12.02.2019;09:16:05;85122849;85069987;52862;
12.02.2019;09:17:04;85122902;85070105;52797;
12.02.2019;09:18:04;85122958;85070233;52725;
12.02.2019;09:19:05;85123000;85070389;52611;
12.02.2019;09:20:04;85123082;85070539;52543;
12.02.2019;09:21:04;85123124;85070690;52434;
12.02.2019;09:22:05;85123173;85070836;52337;
12.02.2019;09:23:04;85123229;85070949;52280;
12.02.2019;09:24:04;85123280;85071069;52211;
12.02.2019;09:25:05;85123322;85071250;52072;
12.02.2019;09:26:04;85123381;85071405;51976;
12.02.2019;09:27:05;85123438;85071556;51882;
12.02.2019;09:28:06;85123492;85071706;51786;
12.02.2019;09:29:05;85123529;85071828;51701;
12.02.2019;09:30:05;85123578;85071966;51612;
12.02.2019;09:31:05;85123615;85072096;51519;
12.02.2019;09:32:05;85123672;85072233;51439;
12.02.2019;09:33:05;85123729;85072386;51343;
12.02.2019;09:34:05;85123776;85072524;51252;
12.02.2019;09:35:05;85123835;85072657;51178;
12.02.2019;09:36:05;85123880;85072774;51106;
12.02.2019;09:37:05;85123933;85072882;51051;
12.02.2019;09:38:05;85123962;85073015;50947;
12.02.2019;09:39:05;85124015;85073147;50868;
12.02.2019;09:40:05;85124077;85073281;50796;
12.02.2019;09:41:05;85124124;85073410;50714;
12.02.2019;09:42:05;85124154;85073556;50598;
12.02.2019;09:43:04;85124214;85073674;50540;
12.02.2019;09:44:05;85124274;85073822;50452;
12.02.2019;09:45:05;85124338;85073962;50376;
12.02.2019;09:46:05;85124387;85074091;50296;
12.02.2019;09:47:05;85124449;85074211;50238;
12.02.2019;09:48:05;85124509;85074333;50176;
12.02.2019;09:49:05;85124553;85074473;50080;
12.02.2019;09:50:06;85124610;85074602;50008;
12.02.2019;09:51:05;85124658;85074720;49938;
12.02.2019;09:52:05;85124721;85074869;49852;
12.02.2019;09:53:06;85124771;85074976;49795;
12.02.2019;09:54:05;85124822;85075091;49731;
12.02.2019;09:55:05;85124876;85075209;49667;
12.02.2019;09:56:05;85124941;85075354;49587;
12.02.2019;09:57:05;85124985;85075458;49527;
12.02.2019;09:58:05;85125053;85075597;49456;
12.02.2019;09:59:05;85125105;85075700;49405;
12.02.2019;10:00:05;85125169;85075839;49330;
12.02.2019;10:01:06;85125212;85075978;49234;
12.02.2019;10:02:05;85125267;85076103;49164;
12.02.2019;10:03:05;85125319;85076228;49091;
12.02.2019;10:04:05;85125371;85076367;49004;
12.02.2019;10:05:05;85125430;85076512;48918;
12.02.2019;10:06:05;85125467;85076653;48814;
12.02.2019;10:07:05;85125522;85076806;48716;
12.02.2019;10:08:05;85125595;85076911;48684;
12.02.2019;10:09:05;85125610;85077037;48573;
12.02.2019;10:10:05;85125648;85077156;48492;
12.02.2019;10:11:05;85125695;85077278;48417;
12.02.2019;10:12:05;85125748;85077415;48333;
12.02.2019;10:13:05;85125768;85077486;48282;
12.02.2019;10:14:04;85125790;85077622;48168;
12.02.2019;10:15:04;85125824;85077742;48082;
12.02.2019;10:16:05;85125875;85077851;48024;
12.02.2019;10:17:05;85125886;85077978;47908;
12.02.2019;10:18:05;85125911;85078056;47855;
12.02.2019;10:19:06;85125955;85078166;47789;
12.02.2019;10:20:05;85125980;85078266;47714;
12.02.2019;10:21:05;85126031;85078401;47630;
12.02.2019;10:22:06;85126094;85078544;47550;
12.02.2019;10:23:05;85126137;85078677;47460;
12.02.2019;10:24:05;85126195;85078794;47401;
12.02.2019;10:25:05;85126240;85078962;47278;
12.02.2019;10:26:04;85126298;85079116;47182;
12.02.2019;10:27:05;85126351;85079249;47102;
12.02.2019;10:28:04;85126393;85079365;47028;
12.02.2019;10:29:04;85126442;85079489;46953;
12.02.2019;10:30:05;85126490;85079642;46848;
12.02.2019;10:31:05;85126544;85079774;46770;
12.02.2019;10:32:05;85126596;85079917;46679;
12.02.2019;10:33:05;85126652;85080069;46583;
12.02.2019;10:34:05;85126716;85080216;46500;
12.02.2019;10:35:06;85126773;85080351;46422;
12.02.2019;10:36:04;85126827;85080499;46328;
12.02.2019;10:37:05;85126870;85080645;46225;
12.02.2019;10:38:04;85126907;85080796;46111;
12.02.2019;10:39:04;85126952;85080948;46004;
12.02.2019;10:40:05;85127004;85081066;45938;
12.02.2019;10:41:05;85127052;85081171;45881;
12.02.2019;10:42:04;85127104;85081265;45839;
12.02.2019;10:43:05;85127172;85081366;45806;
12.02.2019;10:44:04;85127217;85081466;45751;
12.02.2019;10:45:05;85127271;85081572;45699;
12.02.2019;10:46:04;85127313;85081672;45641;
12.02.2019;10:47:04;85127355;85081791;45564;
12.02.2019;10:48:05;85127412;85081933;45479;
12.02.2019;10:49:05;85127458;85082056;45402;
12.02.2019;10:50:04;85127505;85082173;45332;
12.02.2019;10:51:05;85127554;85082281;45273;
12.02.2019;10:52:05;85127610;85082402;45208;
12.02.2019;10:53:05;85127671;85082527;45144;
12.02.2019;10:54:05;85127728;85082662;45066;
12.02.2019;10:55:04;85127774;85082785;44989;
12.02.2019;10:56:04;85127828;85082883;44945;
12.02.2019;10:57:04;85127871;85083026;44845;
12.02.2019;10:58:05;85127936;85083147;44789;
12.02.2019;10:59:05;85128009;85083262;44747;
12.02.2019;11:00:05;85128055;85083366;44689;
12.02.2019;11:01:05;85128115;85083522;44593;
12.02.2019;11:02:05;85128160;85083643;44517;
12.02.2019;11:03:05;85128217;85083767;44450;
12.02.2019;11:04:05;85128253;85083890;44363;
12.02.2019;11:05:05;85128307;85084013;44294;
12.02.2019;11:06:05;85128362;85084152;44210;
12.02.2019;11:07:06;85128418;85084265;44153;
12.02.2019;11:08:05;85128460;85084371;44089;
12.02.2019;11:09:06;85128522;85084490;44032;
12.02.2019;11:10:04;85128561;85084634;43927;
12.02.2019;11:11:04;85128612;85084750;43862;
12.02.2019;11:12:05;85128669;85084876;43793;
12.02.2019;11:13:04;85128724;85085014;43710;
12.02.2019;11:14:05;85128778;85085129;43649;
12.02.2019;11:15:05;85128843;85085249;43594;
12.02.2019;11:16:06;85128896;85085378;43518;
12.02.2019;11:17:05;85128957;85085489;43468;
12.02.2019;11:18:05;85129009;85085594;43415;
12.02.2019;11:19:05;85129077;85085722;43355;
12.02.2019;11:20:06;85129133;85085864;43269;
12.02.2019;11:21:05;85129180;85085992;43188;
12.02.2019;11:22:05;85129242;85086126;43116;
12.02.2019;11:23:06;85129294;85086250;43044;
12.02.2019;11:24:05;85129335;85086367;42968;
12.02.2019;11:25:05;85129395;85086504;42891;
12.02.2019;11:26:04;85129439;85086623;42816;
12.02.2019;11:27:04;85129502;85086760;42742;
12.02.2019;11:28:05;85129576;85086902;42674;
12.02.2019;11:29:05;85129623;85087036;42587;
12.02.2019;11:30:05;85129684;85087173;42511;
12.02.2019;11:31:05;85129745;85087286;42459;
12.02.2019;11:32:04;85129811;85087397;42414;
12.02.2019;11:33:05;85129851;85087518;42333;
12.02.2019;11:34:04;85129909;85087641;42268;
12.02.2019;11:35:05;85129964;85087735;42229;
12.02.2019;11:36:04;85130036;85087843;42193;
12.02.2019;11:37:06;85130075;85087973;42102;
12.02.2019;11:38:05;85130144;85088085;42059;
12.02.2019;11:39:06;85130204;85088205;41999;
12.02.2019;11:40:05;85130269;85088301;41968;
12.02.2019;11:41:05;85130332;85088396;41936;
12.02.2019;11:42:05;85130367;85088513;41854;
12.02.2019;11:43:05;85130442;85088610;41832;
12.02.2019;11:44:05;85130496;85088699;41797;
12.02.2019;11:45:05;85130548;85088825;41723;
12.02.2019;11:46:06;85130596;85088930;41666;
12.02.2019;11:47:05;85130661;85089026;41635;
12.02.2019;11:48:05;85130712;85089148;41564;
12.02.2019;11:49:06;85130768;85089274;41494;
12.02.2019;11:50:05;85130826;85089405;41421;
12.02.2019;11:51:06;85130878;85089514;41364;
12.02.2019;11:52:05;85130934;85089644;41290;
12.02.2019;11:53:05;85130998;85089746;41252;
12.02.2019;11:54:06;85131056;85089858;41198;
12.02.2019;11:55:05;85131112;85089979;41133;
12.02.2019;11:56:05;85131162;85090098;41064;
12.02.2019;11:57:04;85131226;85090227;40999;
12.02.2019;11:58:05;85131301;85090351;40950;
12.02.2019;11:59:04;85131372;85090490;40882;
12.02.2019;12:00:05;85131438;85090612;40826;
12.02.2019;12:01:04;85131503;85090731;40772;
12.02.2019;12:02:05;85131550;85090847;40703;
12.02.2019;12:03:04;85131609;85090981;40628;
12.02.2019;12:04:05;85131669;85091134;40535;
12.02.2019;12:05:05;85131728;85091263;40465;
12.02.2019;12:06:04;85131793;85091388;40405;
12.02.2019;12:07:04;85131840;85091527;40313;
12.02.2019;12:08:05;85131917;85091641;40276;
12.02.2019;12:09:04;85131964;85091758;40206;
12.02.2019;12:10:05;85132024;85091899;40125;
12.02.2019;12:11:04;85132081;85092025;40056;
12.02.2019;12:12:04;85132125;85092070;40055;
12.02.2019;12:13:05;85132149;85092164;39985;
12.02.2019;12:14:06;85132191;85092256;39935;
12.02.2019;12:15:05;85132223;85092342;39881;
12.02.2019;12:16:05;85132277;85092376;39901;
12.02.2019;12:17:05;85132310;85092452;39858;
12.02.2019;12:18:05;85132368;85092562;39806;
12.02.2019;12:19:05;85132447;85092673;39774;
12.02.2019;12:20:05;85132512;85092791;39721;
12.02.2019;12:21:05;85132562;85092903;39659;
12.02.2019;12:22:06;85132628;85093040;39588;
12.02.2019;12:23:05;85132697;85093170;39527;
12.02.2019;12:24:06;85132759;85093278;39481;
12.02.2019;12:25:05;85132836;85093406;39430;
12.02.2019;12:26:05;85132905;85093542;39363;
12.02.2019;12:27:05;85132962;85093664;39298;
12.02.2019;12:28:05;85133030;85093797;39233;
12.02.2019;12:29:05;85133128;85093919;39209;
12.02.2019;12:30:05;85133201;85094053;39148;
12.02.2019;12:31:06;85133268;85094154;39114;
12.02.2019;12:32:05;85133329;85094276;39053;
12.02.2019;12:33:05;85133399;85094403;38996;
12.02.2019;12:34:04;85133449;85094530;38919;
12.02.2019;12:35:04;85133508;85094663;38845;
12.02.2019;12:36:05;85133594;85094805;38789;
12.02.2019;12:37:04;85133675;85094946;38729;
12.02.2019;12:38:05;85133736;85095045;38691;
12.02.2019;12:39:04;85133797;85095171;38626;
12.02.2019;12:40:04;85133862;85095299;38563;
12.02.2019;12:41:05;85133921;85095428;38493;
12.02.2019;12:42:04;85133985;85095540;38445;
12.02.2019;12:43:05;85134041;85095681;38360;
12.02.2019;12:44:04;85134099;85095812;38287;
12.02.2019;12:45:04;85134176;85095929;38247;
12.02.2019;12:46:05;85134236;85096059;38177;
12.02.2019;12:47:04;85134304;85096198;38106;
12.02.2019;12:48:05;85134399;85096317;38082;
12.02.2019;12:49:05;85134478;85096453;38025;
12.02.2019;12:50:06;85134553;85096588;37965;
12.02.2019;12:51:06;85134626;85096730;37896;
12.02.2019;12:52:07;85134706;85096848;37858;
12.02.2019;12:53:06;85134780;85096966;37814;
12.02.2019;12:54:05;85134861;85097074;37787;
12.02.2019;12:55:05;85134924;85097197;37727;
12.02.2019;12:56:05;85135017;85097364;37653;
12.02.2019;12:57:05;85135111;85097498;37613;
12.02.2019;12:58:05;85135175;85097637;37538;
12.02.2019;12:59:05;85135243;85097764;37479;
12.02.2019;13:00:04;85135326;85097900;37426;
12.02.2019;13:01:04;85135406;85098033;37373;
12.02.2019;13:02:05;85135498;85098182;37316;
12.02.2019;13:03:04;85135545;85098346;37199;
12.02.2019;13:04:05;85135627;85098479;37148;
12.02.2019;13:05:05;85135696;85098600;37096;
12.02.2019;13:06:06;85135767;85098741;37026;
12.02.2019;13:07:05;85135847;85098855;36992;
12.02.2019;13:08:06;85135925;85099024;36901;
12.02.2019;13:09:04;85135996;85099151;36845;
12.02.2019;13:10:05;85136091;85099275;36816;
12.02.2019;13:11:05;85136179;85099407;36772;
12.02.2019;13:12:04;85136269;85099558;36711;
12.02.2019;13:13:05;85136353;85099689;36664;
12.02.2019;13:14:05;85136462;85099835;36627;
12.02.2019;13:15:05;85136553;85099998;36555;
12.02.2019;13:16:05;85136626;85100135;36491;
12.02.2019;13:17:06;85136732;85100295;36437;
12.02.2019;13:18:05;85136837;85100464;36373;
12.02.2019;13:19:05;85136927;85100606;36321;
12.02.2019;13:20:04;85137010;85100736;36274;
12.02.2019;13:21:05;85137085;85100897;36188;
12.02.2019;13:22:04;85137183;85101015;36168;
12.02.2019;13:23:04;85137263;85101131;36132;
12.02.2019;13:24:05;85137369;85101266;36103;
12.02.2019;13:25:05;85137440;85101402;36038;
12.02.2019;13:26:04;85137534;85101539;35995;
12.02.2019;13:27:05;85137605;85101684;35921;
12.02.2019;13:28:04;85137692;85101799;35893;
12.02.2019;13:29:05;85137795;85101958;35837;
12.02.2019;13:30:04;85137886;85102110;35776;
12.02.2019;13:31:04;85137969;85102268;35701;
12.02.2019;13:32:05;85138067;85102410;35657;
12.02.2019;13:33:04;85138146;85102563;35583;
12.02.2019;13:34:04;85138247;85102689;35558;
12.02.2019;13:35:06;85138338;85102853;35485;
12.02.2019;13:36:05;85138415;85102993;35422;
12.02.2019;13:37:05;85138502;85103142;35360;
12.02.2019;13:38:05;85138590;85103290;35300;
12.02.2019;13:39:08;85138685;85103436;35249;
12.02.2019;13:40:06;85138777;85103579;35198;
12.02.2019;13:41:06;85138876;85103720;35156;
12.02.2019;13:42:05;85138959;85103866;35093;
12.02.2019;13:43:05;85139061;85104013;35048;
12.02.2019;13:44:04;85139158;85104131;35027;
12.02.2019;13:45:05;85139236;85104279;34957;
12.02.2019;13:46:04;85139319;85104424;34895;
12.02.2019;13:47:05;85139404;85104579;34825;
12.02.2019;13:48:04;85139497;85104724;34773;
12.02.2019;13:49:05;85139586;85104870;34716;
12.02.2019;13:50:05;85139676;85105020;34656;
12.02.2019;13:51:05;85139806;85105168;34638;
12.02.2019;13:52:04;85139918;85105285;34633;
12.02.2019;13:53:05;85139995;85105464;34531;
12.02.2019;13:54:05;85140090;85105614;34476;
12.02.2019;13:55:05;85140198;85105714;34484;
12.02.2019;13:56:04;85140306;85105842;34464;
12.02.2019;13:57:05;85140396;85105962;34434;
12.02.2019;13:58:05;85140486;85106084;34402;
12.02.2019;13:59:05;85140597;85106243;34354;
12.02.2019;14:00:04;85140680;85106371;34309;
12.02.2019;14:01:04;85140783;85106510;34273;
12.02.2019;14:02:04;85140867;85106673;34194;
12.02.2019;14:03:04;85140953;85106824;34129;
12.02.2019;14:04:04;85141051;85106978;34073;
12.02.2019;14:05:22;85141131;85107162;33969;
12.02.2019;14:06:04;85141228;85107267;33961;
12.02.2019;14:07:04;85141358;85107360;33998;
12.02.2019;14:08:06;85141467;85107429;34038;
12.02.2019;14:09:05;85141578;85107547;34031;
12.02.2019;14:10:05;85141664;85107650;34014;
12.02.2019;14:12:05;85141856;85107849;34007;
12.02.2019;14:13:05;85141959;85107938;34021;
12.02.2019;14:14:04;85142039;85108026;34013;
12.02.2019;14:15:04;85142135;85108150;33985;
12.02.2019;14:16:05;85142225;85108279;33946;
12.02.2019;14:17:05;85142292;85108370;33922;
12.02.2019;14:18:07;85142405;85108500;33905;
12.02.2019;14:19:04;85142473;85108633;33840;
12.02.2019;14:20:05;85142560;85108742;33818;
12.02.2019;14:21:05;85142644;85108853;33791;
12.02.2019;14:22:05;85142733;85108971;33762;
12.02.2019;14:23:04;85142820;85109132;33688;
12.02.2019;14:24:05;85142930;85109236;33694;
12.02.2019;14:25:05;85143036;85109366;33670;
12.02.2019;14:26:06;85143130;85109486;33644;
12.02.2019;14:27:05;85143241;85109632;33609;
12.02.2019;14:28:05;85143358;85109781;33577;
12.02.2019;14:29:05;85143464;85109932;33532;
12.02.2019;14:30:06;85143555;85110067;33488;
12.02.2019;14:31:05;85143669;85110215;33454;
12.02.2019;14:32:07;85143795;85110341;33454;
12.02.2019;14:33:06;85143904;85110480;33424;
12.02.2019;14:34:05;85144034;85110638;33396;
12.02.2019;14:35:05;85144146;85110791;33355;
12.02.2019;14:36:04;85144265;85110944;33321;
12.02.2019;14:37:04;85144373;85111086;33287;
12.02.2019;14:38:04;85144486;85111218;33268;
12.02.2019;14:39:07;85144617;85111380;33237;
12.02.2019;14:40:05;85144722;85111529;33193;
12.02.2019;14:41:04;85144813;85111676;33137;
12.02.2019;14:42:05;85144899;85111842;33057;
12.02.2019;14:43:04;85145013;85111979;33034;
12.02.2019;14:44:04;85145121;85112128;32993;
12.02.2019;14:45:05;85145219;85112275;32944;
12.02.2019;14:46:05;85145337;85112404;32933;
12.02.2019;14:47:06;85145454;85112562;32892;
12.02.2019;14:48:05;85145557;85112709;32848;
12.02.2019;14:49:06;85145671;85112862;32809;
12.02.2019;14:50:05;85145775;85113013;32762;
12.02.2019;14:51:05;85145871;85113177;32694;
12.02.2019;14:52:05;85145983;85113296;32687;
12.02.2019;14:53:05;85146117;85113434;32683;
12.02.2019;14:54:06;85146238;85113603;32635;
12.02.2019;14:55:05;85146356;85113780;32576;
12.02.2019;14:56:05;85146482;85113953;32529;
12.02.2019;14:57:05;85146591;85114105;32486;
12.02.2019;14:58:05;85146695;85114252;32443;
12.02.2019;14:59:04;85146801;85114397;32404;
12.02.2019;15:00:07;85146897;85114550;32347;
12.02.2019;15:01:08;85146993;85114713;32280;
12.02.2019;15:02:09;85147122;85114882;32240;
12.02.2019;15:03:09;85147249;85115047;32202;
12.02.2019;15:04:08;85147387;85115200;32187;
12.02.2019;15:05:09;85147501;85115339;32162;
12.02.2019;15:06:07;85147621;85115481;32140;
12.02.2019;15:07:09;85147735;85115675;32060;
12.02.2019;15:08:08;85147851;85115843;32008;
12.02.2019;15:09:11;85147981;85116008;31973;
12.02.2019;15:10:07;85148085;85116175;31910;
12.02.2019;15:11:07;85148152;85116326;31826;
12.02.2019;15:12:07;85148301;85116486;31815;
12.02.2019;15:13:07;85148425;85116639;31786;
12.02.2019;15:14:07;85148533;85116784;31749;
12.02.2019;15:15:07;85148661;85116939;31722;
12.02.2019;15:16:08;85148754;85117083;31671;
12.02.2019;15:17:09;85148878;85117260;31618;
12.02.2019;15:18:07;85149014;85117415;31599;
12.02.2019;15:19:08;85149109;85117554;31555;
12.02.2019;15:20:07;85149234;85117680;31554;
12.02.2019;15:21:08;85149353;85117860;31493;
12.02.2019;15:22:07;85149471;85118020;31451;
12.02.2019;15:23:07;85149618;85118163;31455;
12.02.2019;15:24:08;85149758;85118328;31430;
12.02.2019;15:25:12;85149897;85118491;31406;
12.02.2019;15:26:07;85149997;85118637;31360;
12.02.2019;15:27:08;85150101;85118785;31316;
12.02.2019;15:28:08;85150200;85118940;31260;
12.02.2019;15:29:08;85150314;85119103;31211;
12.02.2019;15:30:08;85150444;85119257;31187;
12.02.2019;15:31:08;85150540;85119409;31131;
12.02.2019;15:32:08;85150661;85119581;31080;
12.02.2019;15:33:09;85150779;85119752;31027;
12.02.2019;15:34:09;85150875;85119928;30947;
12.02.2019;15:35:10;85150987;85120096;30891;
12.02.2019;15:36:10;85151111;85120249;30862;
12.02.2019;15:37:08;85151240;85120407;30833;
12.02.2019;15:38:11;85151327;85120573;30754;
12.02.2019;15:39:08;85151442;85120721;30721;
12.02.2019;15:40:08;85151569;85120878;30691;
12.02.2019;15:41:08;85151662;85121031;30631;
12.02.2019;15:42:08;85151770;85121193;30577;
12.02.2019;15:43:08;85151886;85121345;30541;
12.02.2019;15:44:08;85152013;85121499;30514;
12.02.2019;15:45:08;85152132;85121658;30474;
12.02.2019;15:46:09;85152237;85121801;30436;
12.02.2019;15:47:08;85152352;85121976;30376;
12.02.2019;15:48:09;85152463;85122144;30319;
12.02.2019;15:49:09;85152588;85122310;30278;
12.02.2019;15:50:08;85152714;85122456;30258;
12.02.2019;15:51:08;85152828;85122609;30219;
12.02.2019;15:52:07;85152946;85122785;30161;
12.02.2019;15:53:07;85153074;85122944;30130;
12.02.2019;15:54:08;85153178;85123083;30095;
12.02.2019;15:55:08;85153272;85123263;30009;
12.02.2019;15:56:06;85153373;85123417;29956;
12.02.2019;15:57:07;85153509;85123601;29908;
12.02.2019;15:58:08;85153640;85123757;29883;
12.02.2019;15:59:08;85153778;85123946;29832;
12.02.2019;16:00:04;85153887;85124097;29790;
12.02.2019;16:01:05;85154014;85124259;29755;
12.02.2019;16:02:05;85154159;85124422;29737;
12.02.2019;16:03:05;85154274;85124602;29672;
12.02.2019;16:04:05;85154374;85124745;29629;
12.02.2019;16:05:05;85154507;85124883;29624;
12.02.2019;16:06:05;85154634;85125059;29575;
12.02.2019;16:07:05;85154739;85125230;29509;
12.02.2019;16:08:04;85154854;85125370;29484;
12.02.2019;16:09:06;85154974;85125508;29466;
12.02.2019;16:10:05;85155110;85125674;29436;
12.02.2019;16:11:04;85155213;85125835;29378;
12.02.2019;16:12:04;85155317;85125987;29330;
12.02.2019;16:13:05;85155458;85126135;29323;
12.02.2019;16:14:05;85155559;85126265;29294;
12.02.2019;16:15:05;85155687;85126424;29263;
12.02.2019;16:16:05;85155806;85126589;29217;
12.02.2019;16:17:05;85155927;85126722;29205;
12.02.2019;16:18:05;85156041;85126865;29176;
12.02.2019;16:19:05;85156143;85127021;29122;
12.02.2019;16:20:05;85156270;85127168;29102;
12.02.2019;16:21:10;85156392;85127345;29047;
12.02.2019;16:22:10;85156481;85127507;28974;
12.02.2019;16:23:05;85156567;85127644;28923;
12.02.2019;16:24:05;85156666;85127803;28863;
12.02.2019;16:25:05;85156759;85127959;28800;
12.02.2019;16:26:04;85156855;85128117;28738;
12.02.2019;16:27:04;85156970;85128290;28680;
12.02.2019;16:28:05;85157072;85128455;28617;
12.02.2019;16:30:05;85157289;85128778;28511;
12.02.2019;16:31:06;85157386;85128908;28478;
12.02.2019;16:32:05;85157498;85129038;28460;
12.02.2019;16:33:05;85157637;85129207;28430;
12.02.2019;16:34:05;85157746;85129361;28385;
12.02.2019;16:35:05;85157840;85129484;28356;
12.02.2019;16:36:05;85157965;85129638;28327;
12.02.2019;16:37:05;85158059;85129799;28260;
12.02.2019;16:38:04;85158144;85129928;28216;
12.02.2019;16:39:05;85158237;85130090;28147;
12.02.2019;16:40:05;85158350;85130275;28075;
12.02.2019;16:41:05;85158428;85130429;27999;
12.02.2019;16:42:05;85158556;85130588;27968;
12.02.2019;16:43:05;85158674;85130754;27920;
12.02.2019;16:44:05;85158778;85130939;27839;
12.02.2019;16:45:05;85158892;85131104;27788;
12.02.2019;16:46:05;85159016;85131285;27731;
12.02.2019;16:47:06;85159148;85131447;27701;
12.02.2019;16:48:05;85159257;85131602;27655;
12.02.2019;16:49:04;85159400;85131759;27641;
12.02.2019;16:50:04;85159518;85131915;27603;
12.02.2019;16:51:05;85159659;85132074;27585;
12.02.2019;16:52:06;85159780;85132246;27534;
12.02.2019;16:53:05;85159903;85132396;27507;
12.02.2019;16:54:05;85160037;85132569;27468;
12.02.2019;16:55:06;85160134;85132738;27396;
12.02.2019;16:56:05;85160278;85132920;27358;
12.02.2019;16:57:06;85160424;85133067;27357;
12.02.2019;16:58:04;85160520;85133231;27289;
12.02.2019;16:59:05;85160634;85133410;27224;
12.02.2019;17:00:05;85160756;85133589;27167;
12.02.2019;17:01:04;85160869;85133763;27106;
12.02.2019;17:02:04;85160977;85133913;27064;
12.02.2019;17:03:05;85161126;85134083;27043;
12.02.2019;17:04:05;85161259;85134268;26991;
12.02.2019;17:05:06;85161392;85134438;26954;
12.02.2019;17:06:06;85161523;85134592;26931;
12.02.2019;17:07:05;85161662;85134731;26931;
12.02.2019;17:08:05;85161767;85134894;26873;
12.02.2019;17:09:06;85161894;85135047;26847;
12.02.2019;17:10:05;85162003;85135222;26781;
12.02.2019;17:11:05;85162118;85135382;26736;
12.02.2019;17:12:05;85162235;85135572;26663;
12.02.2019;17:13:06;85162326;85135744;26582;
12.02.2019;17:14:05;85162482;85135901;26581;
12.02.2019;17:15:06;85162588;85136062;26526;
12.02.2019;17:16:05;85162723;85136252;26471;
12.02.2019;17:17:05;85162827;85136412;26415;
12.02.2019;17:18:05;85162928;85136566;26362;
12.02.2019;17:19:05;85163006;85136735;26271;
12.02.2019;17:20:05;85163125;85136900;26225;
12.02.2019;17:21:05;85163244;85137073;26171;
12.02.2019;17:22:04;85163373;85137260;26113;
12.02.2019;17:23:05;85163498;85137433;26065;
12.02.2019;17:24:04;85163610;85137605;26005;
12.02.2019;17:25:04;85163716;85137772;25944;
12.02.2019;17:26:05;85163865;85137960;25905;
12.02.2019;17:27:05;85163986;85138158;25828;
12.02.2019;17:28:05;85164103;85138335;25768;
12.02.2019;17:29:05;85164254;85138493;25761;
12.02.2019;17:30:05;85164352;85138656;25696;
12.02.2019;17:31:06;85164491;85138834;25657;
12.02.2019;17:32:06;85164634;85139003;25631;
12.02.2019;17:33:05;85164777;85139180;25597;
12.02.2019;17:34:05;85164896;85139328;25568;
12.02.2019;17:35:05;85165038;85139490;25548;
12.02.2019;17:36:05;85165177;85139680;25497;
12.02.2019;17:37:07;85165335;85139821;25514;
12.02.2019;17:38:05;85165488;85139983;25505;
12.02.2019;17:39:05;85165611;85140151;25460;
12.02.2019;17:40:05;85165743;85140325;25418;
12.02.2019;17:41:11;85165885;85140498;25387;
12.02.2019;17:42:09;85165996;85140660;25336;
12.02.2019;17:43:06;85166113;85140809;25304;
12.02.2019;17:44:05;85166240;85140978;25262;
12.02.2019;17:45:06;85166370;85141134;25236;
12.02.2019;17:46:05;85166492;85141271;25221;
12.02.2019;17:47:05;85166632;85141415;25217;
12.02.2019;17:48:06;85166768;85141574;25194;
12.02.2019;17:49:04;85166893;85141738;25155;
12.02.2019;17:51:09;85167161;85142092;25069;
12.02.2019;17:52:06;85167295;85142255;25040;
12.02.2019;17:53:06;85167404;85142417;24987;
12.02.2019;17:54:08;85167535;85142582;24953;
12.02.2019;17:55:06;85167678;85142732;24946;
12.02.2019;17:56:09;85167818;85142912;24906;
12.02.2019;17:58:05;85168113;85143241;24872;
12.02.2019;17:59:05;85168229;85143405;24824;
12.02.2019;18:00:07;85168373;85143583;24790;
12.02.2019;18:01:05;85168506;85143745;24761;
12.02.2019;18:02:08;85168660;85143895;24765;
12.02.2019;18:03:05;85168809;85144068;24741;
12.02.2019;18:04:06;85168928;85144240;24688;
12.02.2019;18:05:09;85169085;85144393;24692;
12.02.2019;18:06:08;85169229;85144538;24691;
12.02.2019;18:07:08;85169373;85144670;24703;
12.02.2019;18:08:08;85169533;85144846;24687;
12.02.2019;18:09:05;85169647;85144988;24659;
12.02.2019;18:10:05;85169771;85145155;24616;
12.02.2019;18:11:05;85169905;85145308;24597;
12.02.2019;18:12:08;85170039;85145460;24579;
12.02.2019;18:13:05;85170163;85145610;24553;
12.02.2019;18:14:06;85170306;85145778;24528;
12.02.2019;18:15:09;85170458;85145964;24494;
12.02.2019;18:16:06;85170604;85146108;24496;
12.02.2019;18:17:06;85170750;85146265;24485;
12.02.2019;18:18:08;85170904;85146425;24479;
12.02.2019;18:19:09;85171019;85146589;24430;
12.02.2019;18:20:06;85171148;85146742;24406;
12.02.2019;18:21:05;85171287;85146913;24374;
12.02.2019;18:22:06;85171438;85147067;24371;
12.02.2019;18:23:14;85171588;85147259;24329;
12.02.2019;18:24:05;85171718;85147387;24331;
12.02.2019;18:25:06;85171837;85147547;24290;
12.02.2019;18:26:05;85171997;85147692;24305;
12.02.2019;18:27:08;85172148;85147855;24293;
12.02.2019;18:28:05;85172302;85147993;24309;
12.02.2019;18:29:09;85172474;85148138;24336;
12.02.2019;18:30:05;85172611;85148281;24330;
12.02.2019;18:31:05;85172720;85148407;24313;
12.02.2019;18:32:04;85172831;85148559;24272;
12.02.2019;18:33:08;85172975;85148721;24254;
12.02.2019;18:34:05;85173114;85148880;24234;
12.02.2019;18:35:05;85173263;85149005;24258;
12.02.2019;18:36:04;85173370;85149178;24192;
12.02.2019;18:37:06;85173487;85149326;24161;
12.02.2019;18:38:05;85173618;85149447;24171;
12.02.2019;18:39:04;85173711;85149573;24138;
12.02.2019;18:40:07;85173844;85149712;24132;
12.02.2019;18:41:10;85173954;85149801;24153;
12.02.2019;18:42:04;85174059;85149935;24124;
12.02.2019;18:43:05;85174155;85150030;24125;
12.02.2019;18:44:09;85174293;85150142;24151;
12.02.2019;18:45:06;85174397;85150240;24157;
12.02.2019;18:46:05;85174495;85150346;24149;
12.02.2019;18:47:05;85174596;85150458;24138;
12.02.2019;18:48:07;85174696;85150554;24142;
12.02.2019;18:49:05;85174815;85150659;24156;
12.02.2019;18:50:04;85174947;85150747;24200;
12.02.2019;18:51:04;85175000;85150869;24131;
12.02.2019;18:52:08;85175158;85150971;24187;
12.02.2019;18:53:05;85175266;85151056;24210;
12.02.2019;18:54:06;85175378;85151178;24200;
12.02.2019;18:55:05;85175512;85151292;24220;
12.02.2019;18:56:09;85175692;85151452;24240;
12.02.2019;18:57:05;85175857;85151578;24279;
12.02.2019;18:59:05;85176133;85151837;24296;
12.02.2019;19:00:06;85176282;85151935;24347;
12.02.2019;19:01:05;85176424;85152064;24360;
12.02.2019;19:02:09;85176534;85152197;24337;
12.02.2019;19:03:07;85176676;85152343;24333;
12.02.2019;19:04:05;85176806;85152457;24349;
12.02.2019;19:05:05;85176937;85152601;24336;
12.02.2019;19:06:10;85177082;85152709;24373;
12.02.2019;19:07:08;85177222;85152812;24410;
12.02.2019;19:08:05;85177357;85152934;24423;
12.02.2019;19:09:07;85177482;85153043;24439;
12.02.2019;19:10:05;85177630;85153163;24467;
12.02.2019;19:11:08;85177776;85153289;24487;
12.02.2019;19:12:05;85177881;85153385;24496;
12.02.2019;19:13:05;85178005;85153492;24513;
12.02.2019;19:14:04;85178113;85153596;24517;
12.02.2019;19:15:06;85178250;85153733;24517;
12.02.2019;19:16:05;85178389;85153862;24527;
12.02.2019;19:17:05;85178522;85153978;24544;
12.02.2019;19:18:08;85178658;85154102;24556;
12.02.2019;19:19:05;85178798;85154242;24556;
12.02.2019;19:20:06;85178948;85154343;24605;
12.02.2019;19:21:06;85179071;85154443;24628;
12.02.2019;19:22:09;85179207;85154543;24664;
12.02.2019;19:23:05;85179340;85154640;24700;
12.02.2019;19:24:05;85179486;85154750;24736;
12.02.2019;19:25:05;85179614;85154873;24741;
12.02.2019;19:26:13;85179761;85154990;24771;
12.02.2019;19:27:06;85179889;85155085;24804;
12.02.2019;19:28:06;85180030;85155171;24859;
12.02.2019;19:29:06;85180162;85155268;24894;
12.02.2019;19:30:08;85180297;85155374;24923;
12.02.2019;19:31:05;85180407;85155481;24926;
12.02.2019;19:32:05;85180534;85155558;24976;
12.02.2019;19:33:06;85180658;85155667;24991;
12.02.2019;19:34:05;85180801;85155764;25037;
12.02.2019;19:35:05;85180919;85155866;25053;
12.02.2019;19:36:06;85181059;85155944;25115;
12.02.2019;19:37:08;85181215;85156039;25176;
12.02.2019;19:38:04;85181341;85156127;25214;
12.02.2019;19:39:04;85181460;85156209;25251;
12.02.2019;19:40:05;85181588;85156292;25296;
12.02.2019;19:41:09;85181733;85156368;25365;
12.02.2019;19:42:06;85181845;85156475;25370;
12.02.2019;19:43:05;85182003;85156542;25461;
12.02.2019;19:44:06;85182150;85156623;25527;
12.02.2019;19:45:09;85182256;85156715;25541;
12.02.2019;19:46:06;85182375;85156820;25555;
12.02.2019;19:47:06;85182428;85156907;25521;
12.02.2019;19:48:10;85182512;85157002;25510;
12.02.2019;19:49:08;85182630;85157115;25515;
12.02.2019;19:50:09;85182735;85157217;25518;
12.02.2019;19:51:04;85182836;85157288;25548;
12.02.2019;19:52:05;85182962;85157389;25573;
12.02.2019;19:53:08;85183069;85157470;25599;
12.02.2019;19:54:06;85183152;85157549;25603;
12.02.2019;19:55:06;85183260;85157629;25631;
12.02.2019;19:56:07;85183403;85157725;25678;
12.02.2019;19:57:05;85183511;85157777;25734;
12.02.2019;19:58:05;85183622;85157885;25737;
12.02.2019;19:59:05;85183746;85157968;25778;
12.02.2019;20:00:08;85183876;85158050;25826;
12.02.2019;20:01:05;85183981;85158134;25847;
12.02.2019;20:02:06;85184097;85158217;25880;
12.02.2019;20:03:05;85184188;85158321;25867;
12.02.2019;20:04:08;85184297;85158396;25901;
12.02.2019;20:05:05;85184427;85158472;25955;
12.02.2019;20:06:06;85184548;85158555;25993;
12.02.2019;20:07:05;85184669;85158627;26042;
12.02.2019;20:08:09;85184737;85158619;26118;
12.02.2019;20:09:05;85184565;85158227;26338;
12.02.2019;20:10:05;85184483;85157959;26524;
12.02.2019;20:11:04;85184596;85158024;26572;
12.02.2019;20:12:07;85184733;85158097;26636;
12.02.2019;20:13:05;85184881;85158155;26726;
12.02.2019;20:14:05;85184971;85158164;26807;
12.02.2019;20:15:05;85185054;85158211;26843;
12.02.2019;20:16:07;85185138;85158261;26877;
12.02.2019;20:17:05;85185206;85158312;26894;
12.02.2019;20:18:05;85185272;85158351;26921;
12.02.2019;20:19:08;85185352;85158404;26948;
12.02.2019;20:20:06;85185479;85158440;27039;
12.02.2019;20:21:06;85185584;85158500;27084;
12.02.2019;20:22:06;85185693;85158526;27167;
12.02.2019;20:23:13;85185782;85158574;27208;
12.02.2019;20:24:05;85185852;85158619;27233;
12.02.2019;20:25:04;85185954;85158667;27287;
12.02.2019;20:26:05;85186043;85158713;27330;
12.02.2019;20:27:08;85186102;85158751;27351;
12.02.2019;20:28:05;85186240;85158803;27437;
12.02.2019;20:29:06;85186342;85158849;27493;
12.02.2019;20:30:06;85186453;85158903;27550;
12.02.2019;20:31:09;85186563;85158966;27597;
12.02.2019;20:32:07;85186691;85158979;27712;
12.02.2019;20:33:05;85186784;85159066;27718;
12.02.2019;20:34:13;85186912;85159144;27768;
12.02.2019;20:35:06;85186999;85159199;27800;
12.02.2019;20:36:08;85187126;85159287;27839;
12.02.2019;20:37:05;85187266;85159339;27927;
12.02.2019;20:38:05;85187420;85159401;28019;
12.02.2019;20:39:08;85187559;85159489;28070;
12.02.2019;20:40:05;85187694;85159545;28149;
12.02.2019;20:41:07;85187832;85159603;28229;
12.02.2019;20:42:04;85187965;85159662;28303;
12.02.2019;20:43:09;85188106;85159721;28385;
12.02.2019;20:44:13;85188246;85159778;28468;
12.02.2019;20:45:05;85188363;85159833;28530;
12.02.2019;20:46:09;85188524;85159899;28625;
12.02.2019;20:47:11;85188658;85159977;28681;
12.02.2019;20:48:06;85188783;85160019;28764;
12.02.2019;20:49:13;85188982;85160087;28895;
12.02.2019;20:50:05;85189095;85160119;28976;
12.02.2019;20:51:05;85189252;85160186;29066;
12.02.2019;20:52:08;85189375;85160242;29133;
12.02.2019;20:53:05;85189509;85160291;29218;
12.02.2019;20:54:09;85189671;85160338;29333;
12.02.2019;20:55:05;85189827;85160407;29420;
12.02.2019;20:56:05;85189979;85160475;29504;
12.02.2019;20:57:08;85190128;85160536;29592;
12.02.2019;20:58:05;85190268;85160599;29669;
12.02.2019;20:59:13;85190421;85160655;29766;
12.02.2019;21:00:09;85190564;85160678;29886;
12.02.2019;21:01:05;85190700;85160756;29944;
12.02.2019;21:02:10;85190823;85160808;30015;
12.02.2019;21:03:08;85190951;85160851;30100;
12.02.2019;21:04:06;85191101;85160894;30207;
12.02.2019;21:05:10;85191226;85160955;30271;
12.02.2019;21:06:14;85191384;85161022;30362;
12.02.2019;21:07:06;85191527;85161069;30458;
12.02.2019;21:08:08;85191662;85161108;30554;
12.02.2019;21:09:08;85191803;85161167;30636;
12.02.2019;21:10:06;85191959;85161220;30739;
12.02.2019;21:11:09;85192109;85161287;30822;
12.02.2019;21:12:09;85192271;85161332;30939;
12.02.2019;21:13:06;85192413;85161370;31043;
12.02.2019;21:14:06;85192550;85161403;31147;
12.02.2019;21:15:08;85192720;85161459;31261;
12.02.2019;21:16:05;85192858;85161498;31360;
12.02.2019;21:17:05;85192998;85161526;31472;
12.02.2019;21:18:08;85193132;85161567;31565;
12.02.2019;21:19:08;85193246;85161638;31608;
12.02.2019;21:20:05;85193407;85161691;31716;
12.02.2019;21:21:05;85193541;85161744;31797;
12.02.2019;21:22:09;85193686;85161800;31886;
12.02.2019;21:23:05;85193809;85161835;31974;
13.02.2019;13:38:53;85280188;85270874;9314;
13.02.2019;13:39:12;85280277;85270947;9330;
13.02.2019;13:40:15;85280637;85271267;9370;
13.02.2019;13:41:11;85280896;85271537;9359;
13.02.2019;13:42:10;85281191;85271796;9395;
13.02.2019;13:43:07;85281450;85272117;9333;
13.02.2019;13:44:04;85281765;85272409;9356;
13.02.2019;13:45:05;85282110;85272710;9400;
13.02.2019;13:46:04;85282393;85273027;9366;
13.02.2019;13:47:06;85282675;85273377;9298;
13.02.2019;13:48:05;85283009;85273688;9321;
13.02.2019;13:49:06;85283331;85274002;9329;
13.02.2019;13:50:05;85283633;85274344;9289;
13.02.2019;13:51:05;85283929;85274659;9270;
13.02.2019;13:52:05;85284227;85274956;9271;
13.02.2019;13:53:05;85284517;85275261;9256;
13.02.2019;13:54:05;85284845;85275543;9302;
13.02.2019;13:55:06;85285151;85275831;9320;
13.02.2019;13:56:06;85285498;85276133;9365;
13.02.2019;13:57:09;85285850;85276434;9416;
13.02.2019;13:58:04;85286128;85276708;9420;
13.02.2019;13:59:05;85286449;85276991;9458;
13.02.2019;14:00:04;85286805;85277263;9542;
13.02.2019;14:01:04;85287115;85277565;9550;
13.02.2019;14:02:08;85287431;85277886;9545;
13.02.2019;14:03:05;85287704;85278204;9500;
13.02.2019;14:04:05;85288070;85278509;9561;
13.02.2019;14:05:05;85288432;85278791;9641;
13.02.2019;14:06:08;85288788;85279055;9733;
13.02.2019;14:07:04;85289094;85279327;9767;
13.02.2019;14:08:05;85289395;85279621;9774;
13.02.2019;14:09:05;85289682;85279926;9756;
13.02.2019;14:10:07;85289979;85280196;9783;
13.02.2019;14:11:04;85290196;85280418;9778;
13.02.2019;14:12:05;85290488;85280643;9845;
13.02.2019;14:13:06;85290756;85280943;9813;
13.02.2019;14:14:04;85291082;85281198;9884;
13.02.2019;14:15:04;85291326;85281428;9898;
13.02.2019;14:16:04;85291597;85281658;9939;
13.02.2019;14:17:08;85291791;85281788;10003;
13.02.2019;14:18:05;85291840;85281881;9959;
13.02.2019;14:19:04;85291943;85282063;9880;
13.02.2019;14:20:06;85292249;85282294;9955;
13.02.2019;14:21:07;85292617;85282558;10059;
13.02.2019;14:22:04;85292891;85282834;10057;
13.02.2019;14:23:05;85293252;85283075;10177;
13.02.2019;14:24:08;85293566;85283333;10233;
13.02.2019;14:25:05;85293852;85283548;10304;
13.02.2019;14:26:05;85294136;85283807;10329;
13.02.2019;14:27:08;85294434;85284078;10356;
13.02.2019;14:28:06;85294709;85284353;10356;
13.02.2019;14:29:06;85294951;85284592;10359;
13.02.2019;14:30:05;85295221;85284809;10412;
13.02.2019;14:31:08;85295507;85285042;10465;
13.02.2019;14:32:05;85295776;85285273;10503;
13.02.2019;14:33:05;85296053;85285494;10559;
13.02.2019;14:34:08;85296332;85285707;10625;
13.02.2019;14:35:05;85296572;85285923;10649;
13.02.2019;14:36:05;85296861;85286157;10704;
13.02.2019;14:37:05;85297134;85286388;10746;
13.02.2019;14:38:07;85297410;85286609;10801;
13.02.2019;14:39:05;85297680;85286835;10845;
13.02.2019;14:40:05;85297934;85287084;10850;
13.02.2019;14:41:06;85298178;85287349;10829;
13.02.2019;14:42:04;85298441;85287569;10872;
13.02.2019;14:43:05;85298739;85287806;10933;
13.02.2019;14:44:06;85299008;85288069;10939;
13.02.2019;14:45:08;85299302;85288296;11006;
13.02.2019;14:46:06;85299602;85288507;11095;
13.02.2019;14:47:05;85299882;85288743;11139;
13.02.2019;14:48:05;85300191;85288991;11200;
13.02.2019;14:49:08;85300529;85289227;11302;
13.02.2019;14:50:05;85300825;85289472;11353;
13.02.2019;14:51:07;85301137;85289736;11401;
13.02.2019;14:52:05;85301399;85289955;11444;
13.02.2019;14:53:06;85301692;85290204;11488;
13.02.2019;14:54:08;85302015;85290473;11542;
13.02.2019;14:55:06;85302302;85290678;11624;
13.02.2019;14:56:05;85302553;85290896;11657;
13.02.2019;14:57:05;85302809;85291147;11662;
13.02.2019;14:58:08;85303094;85291381;11713;
13.02.2019;14:59:06;85303343;85291622;11721;
13.02.2019;15:00:08;85303641;85291860;11781;
13.02.2019;15:01:14;85303924;85292137;11787;
13.02.2019;15:02:11;85304199;85292317;11882;
13.02.2019;15:03:14;85304492;85292560;11932;
13.02.2019;15:04:10;85304705;85292768;11937;
13.02.2019;15:05:11;85304975;85292984;11991;
13.02.2019;15:06:07;85305265;85293209;12056;
13.02.2019;15:07:11;85305537;85293437;12100;
13.02.2019;15:08:13;85305789;85293682;12107;
13.02.2019;15:09:11;85306040;85293896;12144;
13.02.2019;15:10:17;85306339;85294123;12216;
13.02.2019;15:11:13;85306583;85294350;12233;
13.02.2019;15:12:16;85306907;85294613;12294;
13.02.2019;15:13:13;85307136;85294872;12264;
13.02.2019;15:14:15;85307414;85295119;12295;
13.02.2019;15:15:20;85307681;85295368;12313;
13.02.2019;15:16:14;85307915;85295621;12294;
13.02.2019;15:17:19;85308172;85295883;12289;
13.02.2019;15:18:16;85308394;85296086;12308;
13.02.2019;15:19:19;85308678;85296323;12355;
13.02.2019;15:20:20;85308934;85296551;12383;
13.02.2019;15:21:16;85309201;85296772;12429;
13.02.2019;15:22:20;85309464;85297042;12422;
13.02.2019;15:23:22;85309736;85297301;12435;
13.02.2019;15:24:19;85309959;85297543;12416;
13.02.2019;15:25:22;85310224;85297800;12424;
13.02.2019;15:26:23;85310480;85298043;12437;
13.02.2019;15:27:20;85310716;85298308;12408;
13.02.2019;15:28:23;85310945;85298565;12380;
13.02.2019;15:29:22;85311182;85298816;12366;
13.02.2019;15:30:19;85311433;85299063;12370;
13.02.2019;15:31:23;85311695;85299311;12384;
13.02.2019;15:32:23;85311923;85299569;12354;
13.02.2019;15:33:20;85312186;85299803;12383;
13.02.2019;15:34:25;85312461;85300073;12388;
13.02.2019;15:35:22;85312684;85300293;12391;
13.02.2019;15:36:25;85312945;85300526;12419;
13.02.2019;15:37:25;85313201;85300745;12456;
13.02.2019;15:38:25;85313434;85300976;12458;
13.02.2019;15:39:27;85313694;85301231;12463;
13.02.2019;15:40:24;85313928;85301468;12460;
13.02.2019;15:41:21;85314155;85301711;12444;
13.02.2019;15:42:22;85314402;85301959;12443;
13.02.2019;15:43:22;85314553;85301984;12569;
13.02.2019;15:44:21;85314600;85301798;12802;
13.02.2019;15:45:21;85314858;85302008;12850;
13.02.2019;15:46:19;85315084;85302267;12817;
13.02.2019;15:47:22;85315353;85302499;12854;
13.02.2019;15:48:16;85315571;85302739;12832;
13.02.2019;15:49:13;85315768;85302995;12773;
13.02.2019;15:50:13;85315983;85303247;12736;
13.02.2019;15:51:13;85316202;85303507;12695;
13.02.2019;15:52:08;85316412;85303745;12667;
13.02.2019;15:53:09;85316658;85303993;12665;
13.02.2019;15:54:08;85316869;85304234;12635;
13.02.2019;15:55:08;85317132;85304496;12636;
13.02.2019;15:56:08;85317340;85304734;12606;
13.02.2019;15:57:09;85317561;85304983;12578;
13.02.2019;15:58:09;85317845;85305221;12624;
13.02.2019;15:59:07;85318082;85305480;12602;
13.02.2019;16:00:05;85318317;85305719;12598;
13.02.2019;16:01:05;85318484;85305942;12542;
13.02.2019;16:02:06;85318719;85306192;12527;
13.02.2019;16:03:05;85318954;85306426;12528;
13.02.2019;16:04:05;85319204;85306620;12584;
13.02.2019;16:05:05;85319442;85306854;12588;
13.02.2019;16:06:05;85319681;85307068;12613;
13.02.2019;16:07:06;85319913;85307335;12578;
13.02.2019;16:08:05;85320151;85307561;12590;
13.02.2019;16:09:05;85320191;85307646;12545;
13.02.2019;16:10:05;85320229;85307793;12436;
13.02.2019;16:11:06;85320287;85307864;12423;
13.02.2019;16:12:04;85320287;85307949;12338;
13.02.2019;16:13:04;85320320;85308066;12254;
13.02.2019;16:14:05;85320347;85308147;12200;
13.02.2019;16:15:05;85320432;85308274;12158;
13.02.2019;16:16:04;85320502;85308396;12106;
13.02.2019;16:17:04;85320584;85308510;12074;
13.02.2019;16:18:05;85320664;85308660;12004;
13.02.2019;16:19:04;85320719;85308763;11956;
13.02.2019;16:20:05;85320741;85308841;11900;
13.02.2019;16:21:05;85320716;85308908;11808;
13.02.2019;16:22:05;85320744;85309039;11705;
13.02.2019;16:23:05;85320828;85309221;11607;
13.02.2019;16:24:05;85320910;85309392;11518;
13.02.2019;16:25:04;85321003;85309544;11459;
13.02.2019;16:26:05;85321170;85309755;11415;
13.02.2019;16:27:05;85321343;85309978;11365;
13.02.2019;16:28:04;85321545;85310178;11367;
13.02.2019;16:29:04;85321743;85310377;11366;
13.02.2019;16:30:05;85321960;85310650;11310;
13.02.2019;16:31:05;85322159;85310866;11293;
13.02.2019;16:32:05;85322393;85311104;11289;
13.02.2019;16:33:05;85322602;85311331;11271;
13.02.2019;16:34:05;85322811;85311521;11290;
13.02.2019;16:35:05;85323024;85311732;11292;
13.02.2019;16:36:04;85323246;85311988;11258;
13.02.2019;16:37:04;85323455;85312201;11254;
13.02.2019;16:38:10;85323664;85312453;11211;
13.02.2019;16:39:05;85323883;85312677;11206;
13.02.2019;16:40:04;85324154;85312953;11201;
13.02.2019;16:42:05;85324728;85313451;11277;
13.02.2019;16:43:04;85325049;85313710;11339;
13.02.2019;16:44:04;85325320;85313931;11389;
13.02.2019;16:45:05;85325591;85314191;11400;
13.02.2019;16:46:05;85325864;85314436;11428;
13.02.2019;16:47:05;85326148;85314689;11459;
13.02.2019;16:48:05;85326449;85314931;11518;
13.02.2019;16:49:05;85326732;85315199;11533;
13.02.2019;16:50:04;85326995;85315466;11529;
13.02.2019;16:51:04;85327253;85315730;11523;
13.02.2019;16:52:05;85327557;85315985;11572;
13.02.2019;16:53:10;85327855;85316258;11597;
13.02.2019;16:54:05;85328090;85316461;11629;
13.02.2019;16:55:06;85328348;85316712;11636;
13.02.2019;16:56:05;85328622;85316957;11665;
13.02.2019;16:57:05;85328923;85317219;11704;
13.02.2019;16:58:05;85329216;85317438;11778;
13.02.2019;16:59:05;85329500;85317673;11827;
13.02.2019;17:00:05;85329755;85317952;11803;
13.02.2019;17:01:05;85330042;85318142;11900;
13.02.2019;17:02:05;85330291;85318372;11919;
13.02.2019;17:03:05;85330574;85318622;11952;
13.02.2019;17:04:05;85330851;85318865;11986;
13.02.2019;17:05:05;85331118;85319133;11985;
13.02.2019;17:06:05;85331382;85319354;12028;
13.02.2019;17:07:07;85331667;85319604;12063;
13.02.2019;17:08:05;85331920;85319823;12097;
13.02.2019;17:09:07;85332154;85320069;12085;
13.02.2019;17:10:05;85332416;85320276;12140;
13.02.2019;17:11:07;85332675;85320511;12164;
13.02.2019;17:12:06;85332944;85320748;12196;
13.02.2019;17:13:06;85333178;85320972;12206;
13.02.2019;17:14:06;85333427;85321209;12218;
13.02.2019;17:15:05;85333683;85321438;12245;
13.02.2019;17:16:04;85333942;85321659;12283;
13.02.2019;17:17:05;85334217;85321917;12300;
13.02.2019;17:18:05;85334502;85322175;12327;
13.02.2019;17:19:05;85334784;85322446;12338;
13.02.2019;17:20:05;85335058;85322682;12376;
13.02.2019;17:21:05;85335343;85322904;12439;
13.02.2019;17:22:05;85335599;85323140;12459;
13.02.2019;17:23:06;85335895;85323385;12510;
13.02.2019;17:24:05;85336159;85323587;12572;
13.02.2019;17:25:04;85336466;85323838;12628;
13.02.2019;17:26:05;85336731;85324051;12680;
13.02.2019;17:27:05;85336997;85324271;12726;
13.02.2019;17:28:04;85337255;85324528;12727;
13.02.2019;17:29:06;85337510;85324785;12725;
13.02.2019;17:30:04;85337763;85324996;12767;
13.02.2019;17:31:05;85338029;85325222;12807;
13.02.2019;17:32:06;85338297;85325474;12823;
13.02.2019;17:33:05;85338551;85325710;12841;
13.02.2019;17:34:06;85338872;85325920;12952;
13.02.2019;17:35:05;85339374;85326129;13245;
13.02.2019;17:36:05;85340279;85326345;13934;
13.02.2019;17:37:04;85341233;85326598;14635;
13.02.2019;17:38:05;85342406;85326861;15545;
13.02.2019;17:39:05;85343370;85327094;16276;
13.02.2019;17:40:04;85344281;85327302;16979;
13.02.2019;17:41:05;85345133;85327513;17620;
13.02.2019;17:42:04;85345962;85327737;18225;
13.02.2019;17:43:04;85347017;85327944;19073;
13.02.2019;17:44:05;85348176;85328175;20001;
13.02.2019;17:46:04;85350250;85328610;21640;
13.02.2019;17:47:05;85351127;85328808;22319;
13.02.2019;17:48:05;85352159;85329024;23135;
13.02.2019;17:49:05;85353002;85329241;23761;
13.02.2019;17:50:06;85353820;85329454;24366;
13.02.2019;17:51:05;85354741;85329677;25064;
13.02.2019;17:52:06;85355570;85329867;25703;
13.02.2019;17:53:07;85356502;85330083;26419;
13.02.2019;17:54:05;85357255;85330259;26996;
13.02.2019;17:55:06;85357941;85330480;27461;
13.02.2019;17:56:04;85358682;85330676;28006;
13.02.2019;17:57:04;85359569;85330881;28688;
13.02.2019;17:58:05;85360281;85331068;29213;
13.02.2019;17:59:05;85360965;85331253;29712;
13.02.2019;18:00:04;85361735;85331451;30284;
13.02.2019;18:01:05;85362430;85331667;30763;
13.02.2019;18:02:05;85363168;85331826;31342;
13.02.2019;18:03:04;85363796;85332031;31765;
13.02.2019;18:04:05;85364424;85332220;32204;
13.02.2019;18:05:06;85365053;85332416;32637;
13.02.2019;18:06:05;85365673;85332577;33096;
13.02.2019;18:07:05;85366367;85332762;33605;
13.02.2019;18:08:05;85367044;85332924;34120;
13.02.2019;18:09:06;85367654;85333118;34536;
13.02.2019;18:10:06;85368308;85333311;34997;
13.02.2019;18:11:06;85368871;85333503;35368;
13.02.2019;18:12:05;85369494;85333702;35792;
13.02.2019;18:13:07;85370028;85333885;36143;
13.02.2019;18:14:05;85370499;85334087;36412;
13.02.2019;18:15:05;85371081;85334282;36799;
13.02.2019;18:16:04;85371642;85334421;37221;
13.02.2019;18:17:05;85372108;85334555;37553;
13.02.2019;18:18:05;85372543;85334693;37850;
13.02.2019;18:19:05;85372935;85334819;38116;
13.02.2019;18:20:05;85373313;85334965;38348;
13.02.2019;18:21:05;85373749;85335109;38640;
13.02.2019;18:22:05;85374190;85335251;38939;
13.02.2019;18:23:06;85374566;85335385;39181;
13.02.2019;18:24:05;85374941;85335506;39435;
13.02.2019;18:25:05;85375416;85335619;39797;
13.02.2019;18:26:04;85375902;85335758;40144;
13.02.2019;18:27:04;85376356;85335884;40472;
13.02.2019;18:28:05;85376767;85336029;40738;
13.02.2019;18:29:06;85377088;85336195;40893;
13.02.2019;18:30:06;85377589;85336336;41253;
13.02.2019;18:31:05;85378073;85336480;41593;
13.02.2019;18:32:05;85378534;85336622;41912;
13.02.2019;18:41:04;85382120;85337713;44407;
13.02.2019;18:42:04;85382440;85337848;44592;
13.02.2019;18:43:05;85382824;85337968;44856;
13.02.2019;18:44:04;85383225;85338090;45135;
13.02.2019;18:45:04;85383781;85338182;45599;
13.02.2019;18:46:04;85384182;85338331;45851;
13.02.2019;18:47:04;85384489;85338478;46011;
13.02.2019;18:48:05;85384879;85338644;46235;
13.02.2019;18:49:05;85385278;85338801;46477;
13.02.2019;18:50:05;85385694;85338976;46718;
13.02.2019;18:51:05;85386045;85339125;46920;
13.02.2019;18:52:06;85386537;85339270;47267;
13.02.2019;18:53:05;85386888;85339424;47464;
13.02.2019;18:54:05;85387247;85339600;47647;
13.02.2019;18:55:06;85387657;85339744;47913;
13.02.2019;18:56:06;85387961;85339889;48072;
13.02.2019;18:57:06;85388314;85340034;48280;
13.02.2019;18:58:05;85388715;85340180;48535;
13.02.2019;18:59:05;85389093;85340337;48756;
13.02.2019;19:00:05;85389430;85340471;48959;
13.02.2019;19:01:05;85389761;85340617;49144;
13.02.2019;19:02:05;85390132;85340765;49367;
13.02.2019;19:03:05;85390539;85340915;49624;
13.02.2019;19:04:06;85390944;85341032;49912;
13.02.2019;19:05:04;85391369;85341183;50186;
13.02.2019;19:06:05;85391695;85341303;50392;
13.02.2019;19:07:05;85392019;85341433;50586;
13.02.2019;19:08:05;85392283;85341584;50699;
13.02.2019;19:09:06;85392558;85341718;50840;
13.02.2019;19:10:04;85392813;85341840;50973;
13.02.2019;19:11:04;85393069;85341970;51099;
13.02.2019;19:12:05;85393330;85342118;51212;
13.02.2019;19:13:05;85393554;85342244;51310;
13.02.2019;19:14:05;85393791;85342368;51423;
13.02.2019;19:15:11;85393999;85342508;51491;
13.02.2019;19:16:05;85394179;85342615;51564;
13.02.2019;19:17:06;85394432;85342753;51679;
13.02.2019;19:18:05;85394625;85342878;51747;
13.02.2019;19:19:05;85394836;85343019;51817;
13.02.2019;19:20:05;85395056;85343162;51894;
13.02.2019;19:21:05;85395256;85343305;51951;
13.02.2019;19:22:05;85395483;85343424;52059;
13.02.2019;19:23:05;85395720;85343557;52163;
13.02.2019;19:24:06;85395999;85343687;52312;
13.02.2019;19:25:04;85396235;85343781;52454;
13.02.2019;19:26:05;85396462;85343962;52500;
13.02.2019;19:27:05;85396680;85344105;52575;
13.02.2019;19:28:05;85396932;85344230;52702;
13.02.2019;19:29:04;85397163;85344364;52799;
13.02.2019;19:30:04;85397423;85344469;52954;
13.02.2019;19:31:04;85397684;85344594;53090;
13.02.2019;19:32:05;85397920;85344728;53192;
13.02.2019;19:33:05;85398179;85344847;53332;
13.02.2019;19:34:05;85398377;85344958;53419;
13.02.2019;19:35:06;85398622;85345114;53508;
13.02.2019;19:36:06;85398838;85345233;53605;
13.02.2019;19:37:05;85399074;85345318;53756;
13.02.2019;19:38:05;85399304;85345425;53879;
13.02.2019;19:39:05;85399553;85345543;54010;
13.02.2019;19:40:05;85399767;85345639;54128;
13.02.2019;19:41:05;85400000;85345751;54249;
13.02.2019;19:42:04;85400241;85345841;54400;
13.02.2019;19:43:05;85400477;85345930;54547;
13.02.2019;19:44:05;85400690;85346053;54637;
13.02.2019;19:45:04;85400996;85346174;54822;
13.02.2019;19:46:05;85401220;85346265;54955;
13.02.2019;19:47:05;85401459;85346374;55085;
13.02.2019;19:48:05;85401696;85346468;55228;
13.02.2019;19:49:05;85401977;85346596;55381;
13.02.2019;19:50:05;85402232;85346681;55551;
13.02.2019;19:51:05;85402476;85346766;55710;
13.02.2019;19:52:06;85402691;85346863;55828;
13.02.2019;19:53:04;85402925;85346964;55961;
13.02.2019;19:54:04;85403187;85347056;56131;
13.02.2019;19:55:04;85403451;85347163;56288;
13.02.2019;19:56:05;85403712;85347240;56472;
13.02.2019;19:57:05;85403990;85347348;56642;
13.02.2019;19:58:05;85404264;85347449;56815;
13.02.2019;19:59:05;85404520;85347550;56970;
13.02.2019;20:00:05;85404788;85347638;57150;
13.02.2019;20:01:04;85405054;85347731;57323;
13.02.2019;20:02:04;85405283;85347847;57436;
13.02.2019;20:03:06;85405512;85347964;57548;
13.02.2019;20:04:10;85405788;85348062;57726;
13.02.2019;20:05:05;85406039;85348145;57894;
13.02.2019;20:06:04;85406255;85348248;58007;
13.02.2019;20:07:05;85406506;85348347;58159;
13.02.2019;20:08:04;85406731;85348430;58301;
13.02.2019;20:09:05;85406974;85348531;58443;
13.02.2019;20:10:05;85406779;85348538;58241;
13.02.2019;20:11:05;85406525;85348508;58017;
13.02.2019;20:12:04;85406229;85348451;57778;
13.02.2019;20:13:05;85406134;85348496;57638;
13.02.2019;20:14:04;85406253;85348540;57713;
13.02.2019;20:15:04;85406402;85348613;57789;
13.02.2019;20:16:05;85406505;85348680;57825;
13.02.2019;20:17:08;85406555;85348772;57783;
13.02.2019;20:18:05;85406618;85348851;57767;
13.02.2019;20:19:04;85406722;85348922;57800;
13.02.2019;20:20:04;85406826;85348993;57833;
13.02.2019;20:21:05;85406968;85349064;57904;
13.02.2019;20:22:04;85407080;85349124;57956;
13.02.2019;20:23:04;85407189;85349189;58000;
13.02.2019;20:24:05;85407262;85349248;58014;
13.02.2019;20:25:05;85407441;85349323;58118;
13.02.2019;20:26:06;85407590;85349407;58183;
13.02.2019;20:27:05;85407781;85349508;58273;
13.02.2019;20:28:05;85407919;85349584;58335;
13.02.2019;20:29:05;85408146;85349664;58482;
13.02.2019;20:30:05;85408342;85349740;58602;
13.02.2019;20:31:06;85408517;85349805;58712;
13.02.2019;20:32:05;85408742;85349891;58851;
13.02.2019;20:33:06;85408954;85349967;58987;
13.02.2019;20:34:05;85409182;85350049;59133;
13.02.2019;20:35:05;85409389;85350144;59245;
13.02.2019;20:36:05;85409592;85350223;59369;
13.02.2019;20:37:05;85409815;85350301;59514;
13.02.2019;20:38:04;85410028;85350371;59657;
13.02.2019;20:39:04;85410230;85350433;59797;
13.02.2019;20:40:04;85410428;85350514;59914;
13.02.2019;20:41:04;85410604;85350600;60004;
13.02.2019;20:42:04;85410806;85350663;60143;
13.02.2019;20:43:05;85411009;85350742;60267;
13.02.2019;20:44:10;85411233;85350809;60424;
13.02.2019;20:45:05;85411428;85350878;60550;
13.02.2019;20:46:05;85411623;85350940;60683;
13.02.2019;20:47:05;85411839;85351006;60833;
13.02.2019;20:48:05;85412080;85351080;61000;
13.02.2019;20:49:05;85412293;85351153;61140;
13.02.2019;20:50:05;85412552;85351243;61309;
13.02.2019;20:51:06;85412751;85351305;61446;
13.02.2019;20:52:05;85412990;85351372;61618;
13.02.2019;20:53:06;85413214;85351447;61767;
13.02.2019;20:54:05;85413429;85351511;61918;
13.02.2019;20:55:06;85413631;85351584;62047;
13.02.2019;20:56:06;85413861;85351641;62220;
13.02.2019;20:57:06;85414097;85351719;62378;
13.02.2019;20:58:06;85414281;85351793;62488;
13.02.2019;20:59:06;85414501;85351861;62640;
13.02.2019;21:00:06;85414721;85351930;62791;
13.02.2019;21:01:05;85414919;85363456;51463;
13.02.2019;21:02:06;85415119;85363566;51553;
13.02.2019;21:03:05;85417090;85363610;53480;
13.02.2019;21:04:10;85417317;85363674;53643;
13.02.2019;21:05:06;85417528;85363746;53782;
13.02.2019;21:06:06;85417635;85363798;53837;
13.02.2019;21:07:06;85417942;85363848;54094;
13.02.2019;21:08:05;85418154;85363895;54259;
13.02.2019;21:09:06;85418325;85363964;54361;
13.02.2019;21:10:04;85418548;85364027;54521;
13.02.2019;21:11:04;85418764;85364090;54674;
13.02.2019;21:12:06;85419042;85364163;54879;
13.02.2019;21:13:04;85419268;85364218;55050;
13.02.2019;21:14:04;85419464;85364257;55207;
13.02.2019;21:15:06;85419697;85364300;55397;
13.02.2019;21:16:05;85419934;85364357;55577;
13.02.2019;21:17:05;85420127;85364418;55709;
13.02.2019;21:18:05;85420331;85364456;55875;
13.02.2019;21:19:04;85420509;85364549;55960;
13.02.2019;21:20:10;85420723;85364603;56120;
13.02.2019;21:21:07;85420922;85364671;56251;
13.02.2019;21:22:05;85421117;85364724;56393;
13.02.2019;21:23:05;85421313;85364785;56528;
13.02.2019;21:24:06;85421505;85364847;56658;
13.02.2019;21:25:05;85421708;85364902;56806;
13.02.2019;21:26:11;85421912;85364965;56947;
13.02.2019;21:27:04;85422115;85365009;57106;
13.02.2019;21:28:04;85422347;85365053;57294;
13.02.2019;21:29:10;85422578;85365110;57468;
13.02.2019;21:30:05;85422773;85365162;57611;
13.02.2019;21:31:06;85422998;85365228;57770;
13.02.2019;21:32:05;85423212;85365285;57927;
13.02.2019;21:33:05;85423424;85365321;58103;
13.02.2019;21:34:06;85423646;85365358;58288;
13.02.2019;21:35:09;85423847;85365411;58436;
13.02.2019;21:36:10;85424114;85365477;58637;
13.02.2019;21:37:05;85424308;85365502;58806;
13.02.2019;21:38:04;85424486;85365551;58935;
13.02.2019;21:39:05;85424647;85365594;59053;
13.02.2019;21:40:04;85424873;85365599;59274;
13.02.2019;21:41:06;85425090;85365653;59437;
13.02.2019;21:42:07;85425315;85365669;59646;
13.02.2019;21:43:05;85425538;85365723;59815;
13.02.2019;21:44:04;85425756;85365781;59975;
13.02.2019;21:45:04;85426002;85365831;60171;
13.02.2019;21:46:05;85426238;85365885;60353;
13.02.2019;21:47:08;85426472;85365951;60521;
13.02.2019;21:48:05;85426684;85365992;60692;
13.02.2019;21:49:06;85426916;85366042;60874;
13.02.2019;21:50:09;85427131;85366096;61035;
13.02.2019;21:51:06;85427380;85366146;61234;
13.02.2019;21:52:05;85427624;85366190;61434;
13.02.2019;21:53:05;85427870;85366235;61635;
13.02.2019;21:54:05;85428107;85366285;61822;
13.02.2019;21:55:05;85428323;85366333;61990;
13.02.2019;21:56:05;85428520;85366387;62133;
13.02.2019;21:57:05;85428753;85366427;62326;
13.02.2019;21:58:05;85428974;85366471;62503;
13.02.2019;21:59:05;85429207;85366524;62683;
13.02.2019;22:00:10;85429458;85366568;62890;
13.02.2019;22:01:07;85429683;85366609;63074;
13.02.2019;22:02:06;85429926;85366650;63276;
13.02.2019;22:03:05;85430207;85366694;63513;
13.02.2019;22:04:06;85430427;85366746;63681;
13.02.2019;22:05:11;85430686;85366791;63895;
13.02.2019;22:06:06;85430896;85366833;64063;
13.02.2019;22:07:05;85431101;85366884;64217;
13.02.2019;22:08:05;85431305;85366913;64392;
13.02.2019;22:09:08;85431525;85366961;64564;
13.02.2019;22:10:04;85431652;85366986;64666;
13.02.2019;22:11:05;85431797;85367043;64754;
13.02.2019;22:12:05;85431978;85367070;64908;
13.02.2019;22:13:05;85432122;85367099;65023;
13.02.2019;22:14:05;85432329;85367138;65191;
13.02.2019;22:15:04;85432515;85367178;65337;
13.02.2019;22:16:05;85432678;85367234;65444;
13.02.2019;22:17:05;85432803;85367260;65543;
13.02.2019;22:18:04;85432927;85367292;65635;
13.02.2019;22:19:04;85433060;85367339;65721;
13.02.2019;22:20:05;85433246;85367370;65876;
13.02.2019;22:21:05;85433351;85367415;65936;
13.02.2019;22:22:04;85433472;85367424;66048;
13.02.2019;22:23:05;85433604;85367463;66141;
13.02.2019;22:24:05;85433773;85367486;66287;
13.02.2019;22:25:05;85433916;85367509;66407;
13.02.2019;22:26:04;85434056;85367534;66522;
13.02.2019;22:27:04;85434173;85367566;66607;
13.02.2019;22:28:04;85434325;85367593;66732;
13.02.2019;22:29:05;85434502;85367624;66878;
13.02.2019;22:30:06;85434674;85367653;67021;
13.02.2019;22:31:05;85434825;85367671;67154;
13.02.2019;22:32:05;85434993;85367717;67276;
13.02.2019;22:33:05;85435167;85367750;67417;
13.02.2019;22:34:05;85435292;85367770;67522;
13.02.2019;22:35:05;85435444;85367788;67656;
13.02.2019;22:36:05;85435577;85367815;67762;
13.02.2019;22:37:05;85435719;85367854;67865;
13.02.2019;22:38:04;85435890;85367878;68012;
13.02.2019;22:39:04;85436063;85367901;68162;
13.02.2019;22:40:05;85436224;85367935;68289;
13.02.2019;22:41:05;85436403;85367966;68437;
13.02.2019;22:42:05;85436574;85367982;68592;
13.02.2019;22:43:05;85436766;85368015;68751;
13.02.2019;22:44:04;85436926;85368054;68872;
13.02.2019;22:45:05;85437102;85368072;69030;
13.02.2019;22:46:05;85437299;85368097;69202;
13.02.2019;22:47:05;85437483;85368143;69340;
13.02.2019;22:48:04;85437686;85368168;69518;
13.02.2019;22:49:04;85437890;85368210;69680;
13.02.2019;22:50:05;85438087;85368245;69842;
13.02.2019;22:51:04;85438304;85368287;70017;
13.02.2019;22:52:05;85438510;85368331;70179;
13.02.2019;22:53:05;85438734;85368372;70362;
13.02.2019;22:54:06;85438898;85368410;70488;
13.02.2019;22:55:05;85439098;85368442;70656;
13.02.2019;22:56:05;85439322;85368486;70836;
13.02.2019;22:57:08;85439515;85368515;71000;
13.02.2019;22:58:04;85439703;85368546;71157;
13.02.2019;22:59:04;85439916;85368580;71336;
13.02.2019;23:00:05;85440112;85368604;71508;
13.02.2019;23:01:07;85440341;85368639;71702;
13.02.2019;23:02:04;85440492;85368679;71813;
13.02.2019;23:03:06;85440692;85368711;71981;
13.02.2019;23:04:05;85440867;85368740;72127;
13.02.2019;23:05:08;85441067;85368784;72283;
13.02.2019;23:06:05;85441266;85368807;72459;
13.02.2019;23:07:05;85441471;85368837;72634;
13.02.2019;23:08:06;85441629;85368862;72767;
13.02.2019;23:09:05;85441825;85368902;72923;
13.02.2019;23:10:05;85442018;85368933;73085;
13.02.2019;23:11:05;85442222;85368965;73257;
13.02.2019;23:12:08;85442434;85368985;73449;
13.02.2019;23:13:05;85442677;85369011;73666;
13.02.2019;23:14:05;85442861;85369042;73819;
13.02.2019;23:15:05;85443085;85369083;74002;
13.02.2019;23:16:08;85443299;85369102;74197;
13.02.2019;23:17:05;85443501;85369130;74371;
13.02.2019;23:18:06;85443694;85369166;74528;
13.02.2019;23:19:05;85443908;85369204;74704;
13.02.2019;23:20:08;85444072;85369240;74832;
13.02.2019;23:21:05;85444264;85369266;74998;
13.02.2019;23:22:05;85444460;85369302;75158;
13.02.2019;23:23:06;85444659;85369347;75312;
13.02.2019;23:24:08;85444881;85369379;75502;
13.02.2019;23:25:04;85445078;85369395;75683;
13.02.2019;23:26:05;85445268;85369417;75851;
13.02.2019;23:27:04;85445447;85369445;76002;
13.02.2019;23:28:05;85445662;85369481;76181;
13.02.2019;23:29:05;85445885;85369512;76373;
13.02.2019;23:30:04;85446084;85369547;76537;
13.02.2019;23:31:05;85446305;85369573;76732;
13.02.2019;23:32:05;85446492;85369597;76895;
13.02.2019;23:33:04;85446679;85369625;77054;
13.02.2019;23:34:05;85446895;85369659;77236;
13.02.2019;23:35:07;85447069;85369681;77388;
13.02.2019;23:36:05;85447267;85369706;77561;
13.02.2019;23:37:06;85447477;85369733;77744;
13.02.2019;23:38:05;85447690;85369758;77932;
13.02.2019;23:39:08;85447900;85369788;78112;
13.02.2019;23:40:05;85448074;85369816;78258;
13.02.2019;23:41:05;85448239;85369862;78377;
13.02.2019;23:42:05;85448497;85369889;78608;
13.02.2019;23:43:08;85448752;85369925;78827;
13.02.2019;23:44:05;85449012;85369949;79063;
13.02.2019;23:45:05;85449288;85369972;79316;
13.02.2019;23:46:05;85449539;85369995;79544;
13.02.2019;23:47:07;85449798;85370023;79775;
13.02.2019;23:48:04;85450040;85370043;79997;
13.02.2019;23:49:05;85450290;85370066;80224;
13.02.2019;23:50:04;85450528;85370101;80427;
13.02.2019;23:51:05;85450761;85370149;80612;
13.02.2019;23:52:06;85450993;85370179;80814;
13.02.2019;23:53:05;85451209;85370203;81006;
13.02.2019;23:54:05;85451414;85370228;81186;
13.02.2019;23:55:05;85451628;85370254;81374;
13.02.2019;23:56:05;85451864;85370266;81598;
13.02.2019;23:57:04;85452108;85370317;81791;
13.02.2019;23:58:04;85452342;85370335;82007;
13.02.2019;23:59:04;85452560;85370364;82196;
14.02.2019;00:00:08;85452768;85370389;82379;
14.02.2019;00:01:08;85453002;85370412;82590;
14.02.2019;00:02:08;85453178;85370440;82738;
14.02.2019;00:03:08;85453411;85370462;82949;
14.02.2019;00:04:08;85453631;85370492;83139;
14.02.2019;00:05:09;85453859;85370519;83340;
14.02.2019;00:06:08;85454107;85370563;83544;
14.02.2019;00:07:08;85454310;85370577;83733;
14.02.2019;00:08:08;85454528;85370616;83912;
14.02.2019;00:09:09;85454687;85370641;84046;
14.02.2019;00:10:08;85454843;85370660;84183;
14.02.2019;00:11:09;85455005;85370693;84312;
14.02.2019;00:12:07;85455187;85370727;84460;
14.02.2019;00:13:07;85455338;85370753;84585;
14.02.2019;00:14:07;85455404;85370777;84627;
14.02.2019;00:15:07;85455522;85370799;84723;
14.02.2019;00:16:07;85455626;85370820;84806;
14.02.2019;00:17:09;85455735;85370843;84892;
14.02.2019;00:18:08;85455828;85370857;84971;
14.02.2019;00:19:09;85455930;85370886;85044;
14.02.2019;00:20:09;85456032;85370905;85127;
14.02.2019;00:21:09;85456157;85370914;85243;
14.02.2019;00:22:08;85456266;85370938;85328;
14.02.2019;00:23:06;85456430;85370955;85475;
14.02.2019;00:24:06;85456573;85370955;85618;
14.02.2019;00:25:08;85456732;85370962;85770;
14.02.2019;00:26:08;85456867;85370980;85887;
14.02.2019;00:27:08;85456977;85371001;85976;
14.02.2019;00:28:08;85457134;85371029;86105;
14.02.2019;00:29:07;85457282;85371053;86229;
14.02.2019;00:30:06;85457408;85371069;86339;
14.02.2019;00:31:08;85457609;85371101;86508;
14.02.2019;00:32:08;85457785;85371132;86653;
14.02.2019;00:33:09;85457965;85371171;86794;
14.02.2019;00:34:08;85458120;85371205;86915;
14.02.2019;00:35:09;85458290;85371227;87063;
14.02.2019;00:36:08;85458436;85371239;87197;
14.02.2019;00:37:09;85458594;85371261;87333;
14.02.2019;00:38:07;85458743;85371290;87453;
14.02.2019;00:39:10;85458915;85371312;87603;
14.02.2019;00:40:09;85459047;85371343;87704;
14.02.2019;00:41:10;85459227;85371374;87853;
14.02.2019;00:42:11;85459371;85371398;87973;
14.02.2019;00:43:07;85459531;85371430;88101;
14.02.2019;00:44:09;85459711;85371464;88247;
14.02.2019;00:45:09;85459876;85371488;88388;
14.02.2019;00:46:10;85460052;85371530;88522;
14.02.2019;00:47:09;85460198;85371564;88634;
14.02.2019;00:48:07;85460315;85371555;88760;
14.02.2019;00:49:07;85460503;85371572;88931;
14.02.2019;00:50:08;85460622;85371603;89019;
14.02.2019;00:51:08;85460800;85371620;89180;
14.02.2019;00:52:07;85460929;85371641;89288;
14.02.2019;00:53:08;85461091;85371669;89422;
14.02.2019;00:54:07;85461260;85371703;89557;
14.02.2019;00:57:08;85461754;85371803;89951;
14.02.2019;00:57:09;85461592;85371805;89787;
14.02.2019;00:57:12;85461600;85371805;89795;
14.02.2019;00:58:10;85461925;85371839;90086;
14.02.2019;00:59:07;85462098;85371860;90238;
14.02.2019;01:00:05;85462244;85371887;90357;
14.02.2019;01:01:06;85462407;85371911;90496;
14.02.2019;01:02:05;85462589;85371942;90647;
14.02.2019;01:03:05;85462733;85371974;90759;
14.02.2019;01:04:05;85462879;85371991;90888;
14.02.2019;01:05:05;85463047;85372029;91018;
14.02.2019;01:06:06;85463195;85372052;91143;
14.02.2019;01:07:05;85463358;85372108;91250;
14.02.2019;01:08:05;85463524;85372127;91397;
14.02.2019;01:09:06;85463675;85372139;91536;
14.02.2019;01:10:05;85463836;85372166;91670;
14.02.2019;01:11:05;85464019;85372200;91819;
14.02.2019;01:12:05;85464181;85372231;91950;
14.02.2019;01:13:06;85464331;85372258;92073;
14.02.2019;01:14:05;85464412;85372295;92117;
14.02.2019;01:15:04;85464625;85372327;92298;
14.02.2019;01:16:04;85464761;85372358;92403;
14.02.2019;01:17:05;85464914;85372392;92522;
14.02.2019;01:18:05;85465085;85372414;92671;
14.02.2019;01:19:05;85465229;85372456;92773;
14.02.2019;01:20:05;85465376;85372495;92881;
14.02.2019;01:21:05;85465520;85372533;92987;
14.02.2019;01:22:05;85465673;85372578;93095;
14.02.2019;01:23:05;85465852;85372610;93242;
14.02.2019;01:24:06;85466009;85372659;93350;
14.02.2019;01:25:05;85466201;85372689;93512;
14.02.2019;01:26:06;85466316;85372724;93592;
14.02.2019;01:27:05;85466442;85372765;93677;
14.02.2019;01:28:06;85466605;85372801;93804;
14.02.2019;01:29:05;85466742;85372845;93897;
14.02.2019;01:30:06;85466908;85372887;94021;
14.02.2019;01:31:05;85467072;85372929;94143;
14.02.2019;01:32:05;85467215;85372964;94251;
14.02.2019;01:33:05;85467353;85373006;94347;
14.02.2019;01:34:04;85467532;85373026;94506;
14.02.2019;01:35:05;85467698;85373070;94628;
14.02.2019;01:36:04;85467785;85373111;94674;
14.02.2019;01:37:05;85467971;85373169;94802;
14.02.2019;01:38:04;85468119;85373207;94912;
14.02.2019;01:39:05;85468274;85373251;95023;
14.02.2019;01:40:04;85468397;85373306;95091;
14.02.2019;01:41:04;85468554;85373344;95210;
14.02.2019;01:42:04;85468694;85373383;95311;
14.02.2019;01:43:05;85468809;85373443;95366;
14.02.2019;01:44:04;85468952;85373491;95461;
14.02.2019;01:45:05;85469072;85373537;95535;
14.02.2019;01:46:05;85469218;85373584;95634;
14.02.2019;01:47:05;85469355;85373626;95729;
14.02.2019;01:48:05;85469492;85373672;95820;
14.02.2019;01:49:06;85469629;85373689;95940;
14.02.2019;01:50:05;85469755;85373762;95993;
14.02.2019;01:51:05;85469898;85373801;96097;
14.02.2019;01:52:05;85470037;85373860;96177;
14.02.2019;01:53:05;85470177;85373927;96250;
14.02.2019;01:54:05;85470324;85373976;96348;
14.02.2019;01:55:05;85470469;85374022;96447;
14.02.2019;01:56:04;85470578;85374066;96512;
14.02.2019;01:57:05;85470752;85374098;96654;
14.02.2019;01:58:04;85470878;85374162;96716;
14.02.2019;01:59:04;85471020;85374221;96799;
14.02.2019;02:00:04;85471151;85374279;96872;
14.02.2019;02:01:04;85471296;85374328;96968;
14.02.2019;02:02:05;85471439;85374392;97047;
14.02.2019;02:03:04;85471568;85374444;97124;
14.02.2019;02:04:04;85471714;85374506;97208;
14.02.2019;02:05:04;85471851;85374566;97285;
14.02.2019;02:06:05;85471965;85374616;97349;
14.02.2019;02:07:05;85472118;85374672;97446;
14.02.2019;02:08:05;85472269;85374724;97545;
14.02.2019;02:09:05;85472413;85374782;97631;
14.02.2019;02:10:05;85472564;85374838;97726;
14.02.2019;02:11:05;85472720;85374893;97827;
14.02.2019;02:12:05;85472841;85374950;97891;
14.02.2019;02:13:04;85472979;85375014;97965;
14.02.2019;02:14:04;85473064;85375059;98005;
14.02.2019;02:15:04;85473120;85375121;97999;
14.02.2019;02:16:05;85473169;85375181;97988;
14.02.2019;02:17:05;85473242;85375234;98008;
14.02.2019;02:18:05;85473307;85375311;97996;
14.02.2019;02:19:05;85473359;85375380;97979;
14.02.2019;02:20:05;85473411;85375432;97979;
14.02.2019;02:21:05;85473457;85375488;97969;
14.02.2019;02:22:05;85473528;85375561;97967;
14.02.2019;02:23:05;85473595;85375621;97974;
14.02.2019;02:24:06;85473659;85375683;97976;
14.02.2019;02:25:05;85473716;85375746;97970;
14.02.2019;02:26:05;85473829;85375817;98012;
14.02.2019;02:27:06;85473935;85375893;98042;
14.02.2019;02:28:05;85474034;85375977;98057;
14.02.2019;02:29:05;85474136;85376061;98075;
14.02.2019;02:30:05;85474256;85376131;98125;
14.02.2019;02:31:04;85474356;85376207;98149;
14.02.2019;02:32:04;85474474;85376278;98196;
14.02.2019;02:33:05;85474634;85376335;98299;
14.02.2019;02:34:04;85474777;85376429;98348;
14.02.2019;02:35:04;85474906;85376528;98378;
14.02.2019;02:36:05;85475038;85376612;98426;
14.02.2019;02:37:05;85475173;85376698;98475;
14.02.2019;02:38:04;85475339;85376764;98575;
14.02.2019;02:39:04;85475439;85376842;98597;
14.02.2019;02:40:04;85475557;85376923;98634;
14.02.2019;02:41:04;85475719;85376987;98732;
14.02.2019;02:42:04;85475885;85377057;98828;
14.02.2019;02:43:05;85476060;85377150;98910;
14.02.2019;02:44:04;85476189;85377234;98955;
14.02.2019;02:45:05;85476336;85377329;99007;
14.02.2019;02:46:04;85476489;85377410;99079;
14.02.2019;02:47:05;85476628;85377481;99147;
14.02.2019;02:48:04;85476740;85377569;99171;
14.02.2019;02:49:04;85476872;85377633;99239;
14.02.2019;02:50:04;85476998;85377750;99248;
14.02.2019;02:51:05;85477154;85377836;99318;
14.02.2019;02:52:05;85477295;85377903;99392;
14.02.2019;02:53:05;85477448;85377970;99478;
14.02.2019;02:54:05;85477590;85378053;99537;
14.02.2019;02:55:05;85477714;85378150;99564;
14.02.2019;02:56:05;85477857;85378254;99603;
14.02.2019;02:57:05;85477989;85378338;99651;
14.02.2019;02:58:05;85478145;85378417;99728;
14.02.2019;02:59:05;85478285;85378508;99777;
14.02.2019;03:00:05;85478431;85378606;99825;
14.02.2019;03:01:05;85478574;85378697;99877;
14.02.2019;03:02:05;85478729;85378815;99914;
14.02.2019;03:03:04;85478850;85378898;99952;
14.02.2019;03:04:04;85479012;85378987;100025;
14.02.2019;03:05:04;85479152;85379082;100070;
14.02.2019;03:06:04;85479292;85379168;100124;
14.02.2019;03:07:05;85479415;85379252;100163;
14.02.2019;03:08:04;85479565;85379356;100209;
14.02.2019;03:09:05;85479707;85379447;100260;
14.02.2019;03:10:04;85479843;85379542;100301;
14.02.2019;03:11:05;85479986;85379647;100339;
14.02.2019;03:12:04;85480137;85379738;100399;
14.02.2019;03:13:05;85480280;85379849;100431;
14.02.2019;03:14:04;85480433;85379947;100486;
14.02.2019;03:15:04;85480575;85380048;100527;
14.02.2019;03:16:04;85480731;85380166;100565;
14.02.2019;03:17:04;85480870;85380253;100617;
14.02.2019;03:18:05;85481007;85380358;100649;
14.02.2019;03:19:05;85481123;85380466;100657;
14.02.2019;03:20:04;85481245;85380571;100674;
14.02.2019;03:21:05;85481400;85380685;100715;
14.02.2019;03:22:05;85481551;85380782;100769;
14.02.2019;03:23:05;85481691;85380891;100800;
14.02.2019;03:24:05;85481834;85380987;100847;
14.02.2019;03:25:05;85481964;85381081;100883;
14.02.2019;03:26:05;85482098;85381198;100900;
14.02.2019;03:27:05;85482249;85381294;100955;
14.02.2019;03:28:05;85482392;85381391;101001;
14.02.2019;03:29:04;85482511;85381490;101021;
14.02.2019;03:30:04;85482645;85381593;101052;
14.02.2019;03:31:04;85482775;85381707;101068;
14.02.2019;03:32:04;85482904;85381809;101095;
14.02.2019;03:33:04;85482994;85381896;101098;
14.02.2019;03:34:05;85483181;85382019;101162;
14.02.2019;03:35:04;85483331;85382142;101189;
14.02.2019;03:36:04;85483475;85382226;101249;
14.02.2019;03:37:04;85483610;85382310;101300;
14.02.2019;03:38:04;85483726;85382422;101304;
14.02.2019;03:39:05;85483888;85382528;101360;
14.02.2019;03:40:05;85484011;85382624;101387;
14.02.2019;03:41:04;85484155;85382730;101425;
14.02.2019;03:42:05;85484289;85382838;101451;
14.02.2019;03:43:04;85484422;85382950;101472;
14.02.2019;03:44:05;85484568;85383080;101488;
14.02.2019;03:45:04;85484687;85383175;101512;
14.02.2019;03:46:04;85484810;85383281;101529;
14.02.2019;03:47:04;85484913;85383402;101511;
14.02.2019;03:48:04;85485059;85383515;101544;
14.02.2019;03:49:04;85485190;85383592;101598;
14.02.2019;03:50:04;85485327;85383685;101642;
14.02.2019;03:51:05;85485466;85383787;101679;
14.02.2019;03:52:04;85485611;85383899;101712;
14.02.2019;03:53:05;85485754;85384007;101747;
14.02.2019;03:54:04;85485882;85384140;101742;
14.02.2019;03:55:05;85486056;85384249;101807;
14.02.2019;03:56:04;85486189;85384373;101816;
14.02.2019;03:57:05;85486335;85384468;101867;
14.02.2019;03:58:04;85486476;85384552;101924;
14.02.2019;03:59:05;85486608;85384671;101937;
14.02.2019;04:00:05;85486730;85384760;101970;
14.02.2019;04:01:05;85486854;85384877;101977;
14.02.2019;04:02:05;85486998;85384976;102022;
14.02.2019;04:03:05;85487128;85385099;102029;
14.02.2019;04:04:05;85487261;85385177;102084;
14.02.2019;04:05:04;85487405;85385305;102100;
14.02.2019;04:06:05;85487554;85385411;102143;
14.02.2019;04:07:05;85487679;85385535;102144;
14.02.2019;04:08:04;85487794;85385635;102159;
14.02.2019;04:09:05;85487914;85385739;102175;
14.02.2019;04:10:05;85488012;85385848;102164;
14.02.2019;04:11:05;85488096;85385965;102131;
14.02.2019;04:12:05;85488238;85386080;102158;
14.02.2019;04:13:05;85488357;85386153;102204;
14.02.2019;04:14:05;85488419;85386241;102178;
14.02.2019;04:15:04;85488433;85386344;102089;
14.02.2019;04:16:05;85488426;85386427;101999;
14.02.2019;04:17:04;85488506;85386529;101977;
14.02.2019;04:18:04;85488577;85386622;101955;
14.02.2019;04:19:05;85488661;85386732;101929;
14.02.2019;04:20:05;85488751;85386842;101909;
14.02.2019;04:21:05;85488821;85386954;101867;
14.02.2019;04:22:06;85488889;85387054;101835;
14.02.2019;04:23:05;85488949;85387146;101803;
14.02.2019;04:24:05;85489038;85387246;101792;
14.02.2019;04:25:05;85489117;85387353;101764;
14.02.2019;04:26:05;85489214;85387455;101759;
14.02.2019;04:27:05;85489328;85387565;101763;
14.02.2019;04:28:05;85489423;85387688;101735;
14.02.2019;04:29:05;85489531;85387816;101715;
14.02.2019;04:30:05;85489674;85387921;101753;
14.02.2019;04:31:05;85489842;85388054;101788;
14.02.2019;04:32:05;85489950;85388164;101786;
14.02.2019;04:33:05;85490063;85388271;101792;
14.02.2019;04:34:05;85490198;85388404;101794;
14.02.2019;04:35:05;85490332;85388534;101798;
14.02.2019;04:36:05;85490472;85388647;101825;
14.02.2019;04:37:05;85490582;85388750;101832;
14.02.2019;04:38:05;85490720;85388878;101842;
14.02.2019;04:39:05;85490862;85388998;101864;
14.02.2019;04:40:05;85490969;85389120;101849;
14.02.2019;04:41:05;85491081;85389244;101837;
14.02.2019;04:42:05;85491210;85389350;101860;
14.02.2019;04:43:04;85491352;85389456;101896;
14.02.2019;04:44:05;85491470;85389573;101897;
14.02.2019;04:45:04;85491607;85389704;101903;
14.02.2019;04:46:04;85491723;85389809;101914;
14.02.2019;04:47:05;85491831;85389937;101894;
14.02.2019;04:48:05;85491948;85390068;101880;
14.02.2019;04:49:05;85492071;85390184;101887;
14.02.2019;04:50:05;85492217;85390301;101916;
14.02.2019;04:51:05;85492325;85390425;101900;
14.02.2019;04:52:05;85492433;85390563;101870;
14.02.2019;04:53:05;85492545;85390673;101872;
14.02.2019;04:54:06;85492673;85390802;101871;
14.02.2019;04:55:05;85492802;85390927;101875;
14.02.2019;04:56:05;85492934;85391059;101875;
14.02.2019;04:57:06;85493036;85391174;101862;
14.02.2019;04:58:05;85493150;85391288;101862;
14.02.2019;04:59:05;85493271;85391413;101858;
14.02.2019;05:00:05;85493410;85391517;101893;
14.02.2019;05:01:05;85493510;85391644;101866;
14.02.2019;05:02:05;85493632;85391778;101854;
14.02.2019;05:03:05;85493756;85391884;101872;
14.02.2019;05:04:05;85493862;85392001;101861;
14.02.2019;05:05:05;85493974;85392115;101859;
14.02.2019;05:06:05;85494105;85392240;101865;
14.02.2019;05:07:05;85494207;85392371;101836;
14.02.2019;05:08:04;85494295;85392486;101809;
14.02.2019;05:09:04;85494409;85392594;101815;
14.02.2019;05:10:04;85494519;85392694;101825;
14.02.2019;05:11:04;85494624;85392806;101818;
14.02.2019;05:12:04;85494737;85392900;101837;
14.02.2019;05:13:05;85494856;85393003;101853;
14.02.2019;05:14:04;85494979;85393116;101863;
14.02.2019;05:15:05;85495117;85393228;101889;
14.02.2019;05:16:04;85495265;85393362;101903;
14.02.2019;05:17:04;85495411;85393471;101940;
14.02.2019;05:18:05;85495552;85393581;101971;
14.02.2019;05:19:04;85495674;85393708;101966;
14.02.2019;05:20:05;85495811;85393811;102000;
14.02.2019;05:21:05;85495938;85393924;102014;
14.02.2019;05:22:05;85496061;85394053;102008;
14.02.2019;05:23:05;85496181;85394194;101987;
14.02.2019;05:24:04;85496284;85394295;101989;
14.02.2019;05:25:05;85496399;85394411;101988;
14.02.2019;05:26:05;85496512;85394536;101976;
14.02.2019;05:27:05;85496626;85394633;101993;
14.02.2019;05:28:06;85496752;85394758;101994;
14.02.2019;05:29:05;85496879;85394869;102010;
14.02.2019;05:30:05;85496997;85394986;102011;
14.02.2019;05:31:05;85497122;85395111;102011;
14.02.2019;05:32:04;85497238;85395241;101997;
14.02.2019;05:33:04;85497350;85395355;101995;
14.02.2019;05:34:04;85497451;85395475;101976;
14.02.2019;05:35:05;85497572;85395554;102018;
14.02.2019;05:36:04;85497701;85395647;102054;
14.02.2019;05:37:06;85497821;85395705;102116;
14.02.2019;05:38:05;85497915;85395815;102100;
14.02.2019;05:39:05;85498033;85395902;102131;
14.02.2019;05:40:05;85498138;85396011;102127;
14.02.2019;05:41:05;85498269;85396114;102155;
14.02.2019;05:42:05;85498361;85396215;102146;
14.02.2019;05:43:05;85498485;85396323;102162;
14.02.2019;05:44:04;85498576;85396449;102127;
14.02.2019;05:45:05;85498693;85396578;102115;
14.02.2019;05:46:04;85498825;85396689;102136;
14.02.2019;05:47:05;85498946;85396797;102149;
14.02.2019;05:48:04;85499071;85396920;102151;
14.02.2019;05:49:05;85499186;85397042;102144;
14.02.2019;05:50:04;85499298;85397157;102141;
14.02.2019;05:51:05;85499412;85397296;102116;
14.02.2019;05:52:04;85499540;85397416;102124;
14.02.2019;05:53:06;85499655;85397534;102121;
14.02.2019;05:54:05;85499767;85397643;102124;
14.02.2019;05:55:05;85499894;85397789;102105;
14.02.2019;05:56:05;85500005;85397896;102109;
14.02.2019;05:57:05;85500125;85398024;102101;
14.02.2019;05:58:05;85500223;85398136;102087;
14.02.2019;05:59:05;85500347;85398260;102087;
14.02.2019;06:00:05;85500451;85398368;102083;
14.02.2019;06:01:05;85500580;85398470;102110;
14.02.2019;06:02:05;85500648;85398589;102059;
14.02.2019;06:03:05;85500747;85398711;102036;
14.02.2019;06:04:04;85500841;85398820;102021;
14.02.2019;06:05:04;85500951;85398945;102006;
14.02.2019;06:06:05;85501055;85399060;101995;
14.02.2019;06:07:05;85501152;85399167;101985;
14.02.2019;06:08:05;85501271;85399296;101975;
14.02.2019;06:09:05;85501378;85399407;101971;
14.02.2019;06:10:05;85501496;85399513;101983;
14.02.2019;06:11:05;85501575;85399613;101962;
14.02.2019;06:12:05;85501639;85399690;101949;
14.02.2019;06:13:05;85501636;85399779;101857;
14.02.2019;06:14:05;85501571;85399847;101724;
14.02.2019;06:15:05;85501542;85399902;101640;
14.02.2019;06:16:05;85501550;85399989;101561;
14.02.2019;06:17:05;85501600;85400139;101461;
14.02.2019;06:18:04;85501711;85400243;101468;
14.02.2019;06:19:04;85501796;85400337;101459;
14.02.2019;06:20:05;85501899;85400440;101459;
14.02.2019;06:21:05;85501992;85400548;101444;
14.02.2019;06:22:05;85502102;85400673;101429;
14.02.2019;06:23:05;85502218;85400816;101402;
14.02.2019;06:24:05;85502348;85400936;101412;
14.02.2019;06:25:08;85502473;85401073;101400;
14.02.2019;06:26:05;85502577;85401198;101379;
14.02.2019;06:27:04;85502636;85401275;101361;
14.02.2019;06:28:05;85502801;85401411;101390;
14.02.2019;06:29:04;85502914;85401528;101386;
14.02.2019;06:30:05;85503058;85401647;101411;
14.02.2019;06:31:04;85503162;85401764;101398;
14.02.2019;06:32:06;85503274;85401890;101384;
14.02.2019;06:33:05;85503382;85402018;101364;
14.02.2019;06:34:05;85503457;85402141;101316;
14.02.2019;06:35:05;85503559;85402272;101287;
14.02.2019;06:36:05;85503670;85402374;101296;
14.02.2019;06:37:06;85503780;85402488;101292;
14.02.2019;06:38:05;85503902;85402592;101310;
14.02.2019;06:39:05;85504022;85402720;101302;
14.02.2019;06:40:05;85504137;85402817;101320;
14.02.2019;06:41:05;85504235;85402931;101304;
14.02.2019;06:42:04;85504334;85403073;101261;
14.02.2019;06:43:05;85504426;85403204;101222;
14.02.2019;06:44:04;85504572;85403329;101243;
14.02.2019;06:45:04;85504691;85403450;101241;
14.02.2019;06:46:04;85504808;85403573;101235;
14.02.2019;06:47:05;85504909;85403700;101209;
14.02.2019;06:48:05;85505027;85403823;101204;
14.02.2019;06:49:05;85505156;85403963;101193;
14.02.2019;06:50:05;85505273;85404072;101201;
14.02.2019;06:51:05;85505405;85404195;101210;
14.02.2019;06:52:05;85505519;85404338;101181;
14.02.2019;06:53:05;85505624;85404449;101175;
14.02.2019;06:54:05;85505732;85404584;101148;
14.02.2019;06:55:05;85505852;85404694;101158;
14.02.2019;06:56:05;85505969;85404815;101154;
14.02.2019;06:57:05;85506085;85404931;101154;
14.02.2019;06:58:05;85506193;85405066;101127;
14.02.2019;06:59:05;85506309;85405206;101103;
14.02.2019;07:00:05;85506409;85405353;101056;
14.02.2019;07:01:06;85506521;85405487;101034;
14.02.2019;07:02:04;85506642;85405597;101045;
14.02.2019;07:03:04;85506741;85405738;101003;
14.02.2019;07:04:04;85506872;85405866;101006;
14.02.2019;07:05:04;85506982;85405971;101011;
14.02.2019;07:06:05;85507079;85406090;100989;
14.02.2019;07:07:05;85507166;85406199;100967;
14.02.2019;07:08:04;85507255;85406325;100930;
14.02.2019;07:09:04;85507364;85406467;100897;
14.02.2019;07:10:05;85507470;85406603;100867;
14.02.2019;07:11:04;85507561;85406744;100817;
14.02.2019;07:12:04;85507654;85406852;100802;
14.02.2019;07:13:05;85507764;85407003;100761;
14.02.2019;07:14:05;85507853;85407117;100736;
14.02.2019;07:15:05;85507943;85407208;100735;
14.02.2019;07:16:05;85508031;85407315;100716;
14.02.2019;07:17:06;85508122;85407429;100693;
14.02.2019;07:18:05;85508208;85407560;100648;
14.02.2019;07:19:05;85508302;85407670;100632;
14.02.2019;07:20:04;85508402;85407823;100579;
14.02.2019;07:21:05;85508509;85407949;100560;
14.02.2019;07:22:04;85508604;85408065;100539;
14.02.2019;07:23:05;85508701;85408188;100513;
14.02.2019;07:24:04;85508801;85408323;100478;
14.02.2019;07:25:04;85508883;85408449;100434;
14.02.2019;07:26:05;85508972;85408579;100393;
14.02.2019;07:27:05;85509061;85408705;100356;
14.02.2019;07:28:05;85509179;85408840;100339;
14.02.2019;07:29:04;85509265;85408970;100295;
14.02.2019;07:30:05;85509369;85409126;100243;
14.02.2019;07:31:06;85509464;85409271;100193;
14.02.2019;07:32:05;85509555;85409402;100153;
14.02.2019;07:33:05;85509645;85409541;100104;
14.02.2019;07:34:05;85509753;85409665;100088;
14.02.2019;07:35:05;85509875;85409815;100060;
14.02.2019;07:36:05;85509993;85409950;100043;
14.02.2019;07:37:04;85510078;85410087;99991;
14.02.2019;07:38:05;85510192;85410202;99990;
14.02.2019;07:39:04;85510306;85410338;99968;
14.02.2019;07:40:04;85510401;85410473;99928;
14.02.2019;07:41:04;85510510;85410596;99914;
14.02.2019;07:42:04;85510589;85410728;99861;
14.02.2019;07:43:05;85510684;85410872;99812;
14.02.2019;07:44:04;85510781;85411000;99781;
14.02.2019;07:45:05;85510864;85411121;99743;
14.02.2019;07:46:04;85510944;85411249;99695;
14.02.2019;07:47:05;85511039;85411380;99659;
14.02.2019;07:48:05;85511120;85411485;99635;
14.02.2019;07:49:05;85511220;85411617;99603;
14.02.2019;07:50:06;85511321;85411747;99574;
14.02.2019;07:51:05;85511423;85411870;99553;
14.02.2019;07:52:10;85511547;85412018;99529;
14.02.2019;07:53:05;85511644;85412133;99511;
14.02.2019;07:54:05;85511719;85412264;99455;
14.02.2019;07:55:05;85511813;85412420;99393;
14.02.2019;07:56:05;85511895;85412547;99348;
14.02.2019;07:57:05;85512003;85412673;99330;
14.02.2019;07:58:05;85512117;85412787;99330;
14.02.2019;07:59:05;85512215;85412953;99262;
14.02.2019;08:00:05;85512323;85413076;99247;
14.02.2019;08:01:05;85512427;85413183;99244;
14.02.2019;08:02:06;85512515;85413322;99193;
14.02.2019;08:03:04;85512621;85413451;99170;
14.02.2019;08:04:04;85512696;85413576;99120;
14.02.2019;08:05:05;85512789;85413688;99101;
14.02.2019;08:06:05;85512850;85413790;99060;
14.02.2019;08:07:05;85512918;85413873;99045;
14.02.2019;08:08:05;85512957;85413965;98992;
14.02.2019;08:09:05;85513025;85414054;98971;
14.02.2019;08:10:05;85513072;85414127;98945;
14.02.2019;08:11:05;85513112;85414247;98865;
14.02.2019;08:12:04;85513160;85414322;98838;
14.02.2019;08:13:04;85513219;85414420;98799;
14.02.2019;08:14:04;85513268;85414540;98728;
14.02.2019;08:15:04;85513318;85414655;98663;
14.02.2019;08:16:04;85513382;85414773;98609;
14.02.2019;08:17:06;85513456;85414914;98542;
14.02.2019;08:18:05;85513519;85415018;98501;
14.02.2019;08:19:05;85513596;85415139;98457;
14.02.2019;08:20:05;85513649;85415213;98436;
14.02.2019;08:21:05;85513706;85415345;98361;
14.02.2019;08:22:05;85513779;85415403;98376;
14.02.2019;08:23:05;85513856;85415489;98367;
14.02.2019;08:24:04;85513936;85415574;98362;
14.02.2019;08:25:04;85514020;85415694;98326;
14.02.2019;08:26:05;85514113;85415798;98315;
14.02.2019;08:27:05;85514207;85415891;98316;
14.02.2019;08:28:05;85514276;85416014;98262;
14.02.2019;08:29:05;85514352;85416131;98221;
14.02.2019;08:30:05;85514437;85416233;98204;
14.02.2019;08:31:05;85514526;85416358;98168;
14.02.2019;08:32:04;85514602;85416464;98138;
14.02.2019;08:33:05;85514701;85416565;98136;
14.02.2019;08:34:04;85514796;85416685;98111;
14.02.2019;08:35:05;85514862;85416806;98056;
14.02.2019;08:36:04;85514943;85416974;97969;
14.02.2019;08:37:05;85515032;85417085;97947;
14.02.2019;08:38:05;85515111;85417213;97898;
14.02.2019;08:39:06;85515181;85417345;97836;
14.02.2019;08:40:05;85515261;85417462;97799;
14.02.2019;08:41:05;85515334;85417578;97756;
14.02.2019;08:42:05;85515439;85417689;97750;
14.02.2019;08:43:05;85515533;85417791;97742;
14.02.2019;08:44:04;85515615;85417887;97728;
14.02.2019;08:45:04;85515677;85418007;97670;
14.02.2019;08:46:05;85515762;85418130;97632;
14.02.2019;08:47:05;85515849;85418251;97598;
14.02.2019;08:48:06;85515935;85418369;97566;
14.02.2019;08:49:05;85516023;85418476;97547;
14.02.2019;08:50:05;85516110;85418610;97500;
14.02.2019;08:51:05;85516205;85418716;97489;
14.02.2019;08:53:05;85516384;85418959;97425;
14.02.2019;08:54:05;85516453;85419077;97376;
14.02.2019;08:55:05;85516542;85419197;97345;
14.02.2019;08:56:06;85516634;85419322;97312;
14.02.2019;08:57:05;85516721;85419445;97276;
14.02.2019;08:58:05;85516817;85419569;97248;
14.02.2019;08:59:06;85516907;85419719;97188;
14.02.2019;09:00:06;85516993;85419813;97180;
14.02.2019;09:01:05;85517072;85419916;97156;
14.02.2019;09:02:05;85517167;85420059;97108;
14.02.2019;09:03:05;85517269;85420172;97097;
14.02.2019;09:04:05;85517370;85420276;97094;
14.02.2019;09:05:06;85517470;85420425;97045;
14.02.2019;09:06:05;85517565;85420542;97023;
14.02.2019;09:07:05;85517661;85420664;96997;
14.02.2019;09:08:05;85517774;85420779;96995;
14.02.2019;09:09:05;85517859;85420899;96960;
14.02.2019;09:10:05;85517953;85421016;96937;
14.02.2019;09:11:05;85518044;85421148;96896;
14.02.2019;09:12:05;85518110;85421280;96830;
14.02.2019;09:13:05;85518206;85421403;96803;
14.02.2019;09:14:06;85518286;85421539;96747;
14.02.2019;09:15:05;85518360;85421668;96692;
14.02.2019;09:16:05;85518435;85421778;96657;
14.02.2019;09:17:05;85518532;85421880;96652;
14.02.2019;09:18:06;85518633;85422027;96606;
14.02.2019;09:19:05;85518716;85422137;96579;
14.02.2019;09:20:05;85518791;85422257;96534;
14.02.2019;09:21:05;85518879;85422377;96502;
14.02.2019;09:22:05;85518967;85422496;96471;
14.02.2019;09:23:05;85519043;85422609;96434;
14.02.2019;09:24:05;85519132;85422713;96419;
14.02.2019;09:25:06;85519235;85422834;96401;
14.02.2019;09:26:05;85519330;85422997;96333;
14.02.2019;09:27:05;85519427;85423139;96288;
14.02.2019;09:28:06;85519510;85423290;96220;
14.02.2019;09:29:05;85519593;85423428;96165;
14.02.2019;09:30:06;85519702;85423568;96134;
14.02.2019;09:31:04;85519793;85423655;96138;
14.02.2019;09:32:05;85519876;85423785;96091;
14.02.2019;09:33:04;85519960;85423926;96034;
14.02.2019;09:34:05;85520045;85424073;95972;
14.02.2019;09:35:04;85520124;85424182;95942;
14.02.2019;09:36:05;85520215;85424320;95895;
14.02.2019;09:37:05;85520308;85424450;95858;
14.02.2019;09:38:05;85520374;85424541;95833;
14.02.2019;09:39:05;85520453;85424690;95763;
14.02.2019;09:40:05;85520532;85424816;95716;
14.02.2019;09:41:05;85520602;85424957;95645;
14.02.2019;09:42:04;85520692;85425083;95609;
14.02.2019;09:43:04;85520758;85425202;95556;
14.02.2019;09:44:05;85520816;85425336;95480;
14.02.2019;09:45:04;85520903;85425444;95459;
14.02.2019;09:46:05;85520991;85425567;95424;
14.02.2019;09:47:04;85521072;85425666;95406;
14.02.2019;09:48:05;85521173;85425762;95411;
14.02.2019;09:49:05;85521254;85425885;95369;
14.02.2019;09:50:05;85521349;85426010;95339;
14.02.2019;09:51:04;85521422;85426140;95282;
14.02.2019;09:52:05;85521493;85426257;95236;
14.02.2019;09:53:06;85521585;85426386;95199;
14.02.2019;09:54:05;85521678;85426515;95163;
14.02.2019;09:55:05;85521735;85426622;95113;
14.02.2019;09:56:05;85521805;85426731;95074;
14.02.2019;09:57:05;85521897;85426851;95046;
14.02.2019;09:58:05;85521976;85426982;94994;
14.02.2019;09:59:05;85522076;85427121;94955;
14.02.2019;10:00:05;85522184;85427252;94932;
14.02.2019;10:01:05;85522251;85427364;94887;
14.02.2019;10:02:05;85522324;85427510;94814;
14.02.2019;10:03:05;85522398;85427656;94742;
14.02.2019;10:04:05;85522485;85427795;94690;
14.02.2019;10:05:06;85522569;85427893;94676;
14.02.2019;10:06:05;85522651;85428017;94634;
14.02.2019;10:07:07;85522736;85428128;94608;
14.02.2019;10:08:06;85522828;85428269;94559;
14.02.2019;10:09:11;85522875;85428406;94469;
14.02.2019;10:10:06;85522927;85428472;94455;
14.02.2019;10:11:11;85522976;85428586;94390;
14.02.2019;10:12:06;85523015;85428687;94328;
14.02.2019;10:13:05;85523087;85428791;94296;
14.02.2019;10:14:05;85523116;85428890;94226;
14.02.2019;10:15:10;85523154;85429027;94127;
14.02.2019;10:16:10;85523196;85429133;94063;
14.02.2019;10:17:05;85523221;85429230;93991;
14.02.2019;10:18:05;85523304;85429352;93952;
14.02.2019;10:19:05;85523380;85429503;93877;
14.02.2019;10:20:04;85523453;85429621;93832;
14.02.2019;10:21:05;85523500;85429745;93755;
14.02.2019;10:22:10;85523583;85429865;93718;
14.02.2019;10:23:06;85523658;85429985;93673;
14.02.2019;10:24:05;85523730;85430108;93622;
14.02.2019;10:25:05;85523798;85430248;93550;
14.02.2019;10:26:05;85523887;85430386;93501;
14.02.2019;10:27:07;85523982;85430523;93459;
14.02.2019;10:28:06;85524057;85430621;93436;
14.02.2019;10:29:05;85524129;85430775;93354;
14.02.2019;10:30:05;85524222;85430921;93301;
14.02.2019;10:31:05;85524297;85431051;93246;
14.02.2019;10:32:05;85524379;85431177;93202;
14.02.2019;10:33:05;85524487;85431324;93163;
14.02.2019;10:34:06;85524562;85431484;93078;
14.02.2019;10:35:05;85524643;85431618;93025;
14.02.2019;10:36:05;85524714;85431737;92977;
14.02.2019;10:37:05;85524803;85431863;92940;
14.02.2019;10:38:06;85524895;85432017;92878;
14.02.2019;10:39:06;85524967;85432158;92809;
14.02.2019;10:40:06;85525039;85432312;92727;
14.02.2019;10:41:05;85525116;85432464;92652;
14.02.2019;10:42:06;85525194;85432611;92583;
14.02.2019;10:43:05;85525274;85432759;92515;
14.02.2019;10:44:05;85525360;85432908;92452;
14.02.2019;10:45:04;85525441;85433023;92418;
14.02.2019;10:46:05;85525538;85433167;92371;
14.02.2019;10:47:05;85525621;85433294;92327;
14.02.2019;10:48:05;85525729;85433423;92306;
14.02.2019;10:49:05;85525833;85433563;92270;
14.02.2019;10:50:04;85525922;85433699;92223;
14.02.2019;10:51:05;85525996;85433841;92155;
14.02.2019;10:52:05;85526087;85433974;92113;
14.02.2019;10:53:05;85526167;85434104;92063;
14.02.2019;10:54:06;85526240;85434250;91990;
14.02.2019;10:55:04;85526340;85434381;91959;
14.02.2019;10:56:05;85526444;85434514;91930;
14.02.2019;10:57:05;85526538;85434632;91906;
14.02.2019;10:58:06;85526614;85434759;91855;
14.02.2019;10:59:07;85526709;85434913;91796;
14.02.2019;11:00:05;85526809;85435044;91765;
14.02.2019;11:01:05;85526905;85435188;91717;
14.02.2019;11:02:04;85526959;85435316;91643;
14.02.2019;11:03:07;85527034;85435476;91558;
14.02.2019;11:04:05;85527113;85435599;91514;
14.02.2019;11:05:04;85527200;85435740;91460;
14.02.2019;11:06:07;85527270;85435883;91387;
14.02.2019;11:07:05;85527363;85436016;91347;
14.02.2019;11:08:05;85527431;85436181;91250;
14.02.2019;11:09:05;85527516;85436337;91179;
14.02.2019;11:10:05;85527618;85436489;91129;
14.02.2019;11:11:05;85527694;85436627;91067;
14.02.2019;11:12:05;85527785;85436766;91019;
14.02.2019;11:13:04;85527883;85436901;90982;
14.02.2019;11:14:05;85527979;85437040;90939;
14.02.2019;11:15:05;85528064;85437186;90878;
14.02.2019;11:16:05;85528162;85437343;90819;
14.02.2019;11:17:05;85528249;85437487;90762;
14.02.2019;11:18:07;85528339;85437618;90721;
14.02.2019;11:19:05;85528413;85437767;90646;
14.02.2019;11:20:06;85528498;85437884;90614;
14.02.2019;11:21:05;85528583;85438022;90561;
14.02.2019;11:22:05;85528661;85438156;90505;
14.02.2019;11:23:05;85528743;85438290;90453;
14.02.2019;11:24:05;85528814;85438429;90385;
14.02.2019;11:25:05;85528926;85438593;90333;
14.02.2019;11:26:05;85529016;85438730;90286;
14.02.2019;11:27:05;85529128;85438886;90242;
14.02.2019;11:28:08;85529229;85439049;90180;
14.02.2019;11:29:05;85529321;85439155;90166;
14.02.2019;11:30:07;85529406;85439279;90127;
14.02.2019;11:31:05;85529501;85439426;90075;
14.02.2019;11:32:06;85529577;85439586;89991;
14.02.2019;11:33:05;85529649;85439722;89927;
14.02.2019;11:34:05;85529734;85439828;89906;
14.02.2019;11:35:06;85529802;85439967;89835;
14.02.2019;11:36:05;85529891;85440103;89788;
14.02.2019;11:37:06;85529960;85440232;89728;
14.02.2019;11:38:05;85530053;85440386;89667;
14.02.2019;11:39:05;85530135;85440522;89613;
14.02.2019;11:40:05;85530217;85440662;89555;
14.02.2019;11:41:06;85530296;85440806;89490;
14.02.2019;11:42:05;85530384;85440921;89463;
14.02.2019;11:43:06;85530461;85441039;89422;
14.02.2019;11:44:05;85530542;85441169;89373;
14.02.2019;11:45:05;85530648;85441329;89319;
14.02.2019;11:46:05;85530722;85441422;89300;
14.02.2019;11:47:05;85530814;85441625;89189;
14.02.2019;11:48:05;85530902;85441747;89155;
14.02.2019;11:49:05;85530975;85441870;89105;
14.02.2019;11:50:05;85531063;85442013;89050;
14.02.2019;11:51:06;85531154;85442151;89003;
14.02.2019;11:52:05;85531227;85442290;88937;
14.02.2019;11:53:05;85531300;85442456;88844;
14.02.2019;11:54:04;85531400;85442597;88803;
14.02.2019;11:55:04;85531503;85442709;88794;
14.02.2019;11:56:05;85531595;85442848;88747;
14.02.2019;11:57:04;85531673;85442987;88686;
14.02.2019;11:58:05;85531754;85443135;88619;
14.02.2019;11:59:04;85531832;85443263;88569;
14.02.2019;12:00:04;85531921;85443404;88517;
14.02.2019;12:01:05;85531996;85443553;88443;
14.02.2019;12:02:05;85532036;85443686;88350;
14.02.2019;12:03:05;85532012;85443790;88222;
14.02.2019;12:04:05;85531926;85443864;88062;
14.02.2019;12:05:05;85531889;85443969;87920;
14.02.2019;12:06:04;85531911;85444043;87868;
14.02.2019;12:07:05;85531983;85444201;87782;
14.02.2019;12:08:04;85532051;85444336;87715;
14.02.2019;12:09:05;85532128;85444479;87649;
14.02.2019;12:10:06;85532202;85444603;87599;
14.02.2019;12:11:05;85532277;85444730;87547;
14.02.2019;12:12:05;85532349;85444866;87483;
14.02.2019;12:13:05;85532444;85445003;87441;
14.02.2019;12:14:06;85532526;85445119;87407;
14.02.2019;12:15:05;85532603;85445244;87359;
14.02.2019;12:16:05;85532711;85445374;87337;
14.02.2019;12:17:05;85532795;85445498;87297;
14.02.2019;12:18:05;85532883;85445613;87270;
14.02.2019;12:19:09;85532982;85445735;87247;
14.02.2019;12:20:05;85533076;85445877;87199;
14.02.2019;12:21:04;85533159;85445996;87163;
14.02.2019;12:22:05;85533242;85446105;87137;
14.02.2019;12:23:05;85533319;85446263;87056;
14.02.2019;12:24:05;85533406;85446386;87020;
14.02.2019;12:25:06;85533506;85446523;86983;
14.02.2019;12:26:05;85533590;85446638;86952;
14.02.2019;12:27:05;85533679;85446801;86878;
14.02.2019;12:28:05;85533779;85446922;86857;
14.02.2019;12:29:06;85533870;85447074;86796;
14.02.2019;12:30:05;85533956;85447196;86760;
14.02.2019;12:31:05;85534027;85447301;86726;
14.02.2019;12:32:05;85534145;85447420;86725;
14.02.2019;12:33:06;85534236;85447545;86691;
14.02.2019;12:34:05;85534340;85447664;86676;
14.02.2019;12:35:05;85534456;85447808;86648;
14.02.2019;12:36:05;85534557;85447953;86604;
14.02.2019;12:37:05;85534657;85448122;86535;
14.02.2019;12:38:05;85534780;85448269;86511;
14.02.2019;12:39:05;85534876;85448405;86471;
14.02.2019;12:40:05;85534981;85448559;86422;
14.02.2019;12:41:08;85535075;85448690;86385;
14.02.2019;12:42:05;85535165;85448819;86346;
14.02.2019;12:43:05;85535268;85448963;86305;
14.02.2019;12:44:05;85535348;85449124;86224;
14.02.2019;12:45:08;85535465;85449268;86197;
14.02.2019;12:46:05;85535548;85449412;86136;
14.02.2019;12:47:05;85535639;85449577;86062;
14.02.2019;12:48:06;85535776;85449731;86045;
14.02.2019;12:49:04;85535873;85449878;85995;
14.02.2019;12:50:05;85535974;85450032;85942;
14.02.2019;12:51:05;85536066;85450170;85896;
14.02.2019;12:52:08;85536162;85450287;85875;
14.02.2019;12:53:05;85536257;85450447;85810;
14.02.2019;12:54:06;85536336;85450584;85752;
14.02.2019;12:55:05;85536443;85450720;85723;
14.02.2019;12:56:08;85536514;85450873;85641;
14.02.2019;12:57:05;85536608;85450996;85612;
14.02.2019;12:58:06;85536721;85451118;85603;
14.02.2019;12:59:08;85536802;85451255;85547;
14.02.2019;13:00:05;85536898;85451391;85507;
14.02.2019;13:01:05;85536982;85451552;85430;
14.02.2019;13:02:04;85537090;85451684;85406;
14.02.2019;13:03:04;85537185;85451810;85375;
14.02.2019;13:04:05;85537292;85451948;85344;
14.02.2019;13:05:05;85537385;85452084;85301;
14.02.2019;13:07:05;85537591;85452316;85275;
14.02.2019;13:08:05;85537677;85452459;85218;
14.02.2019;13:09:10;85537784;85452604;85180;
14.02.2019;13:10:05;85537884;85452742;85142;
14.02.2019;13:11:05;85537965;85452879;85086;
14.02.2019;13:12:04;85538088;85453031;85057;
14.02.2019;13:13:04;85538197;85453177;85020;
14.02.2019;13:14:05;85538328;85453324;85004;
14.02.2019;13:15:05;85538426;85453445;84981;
14.02.2019;13:16:05;85538536;85453595;84941;
14.02.2019;13:17:05;85538644;85453726;84918;
14.02.2019;13:18:05;85538732;85453866;84866;
14.02.2019;13:19:04;85538822;85454031;84791;
14.02.2019;13:20:09;85538938;85454169;84769;
14.02.2019;13:21:04;85539031;85454314;84717;
14.02.2019;13:22:04;85539137;85454453;84684;
14.02.2019;13:23:05;85539243;85454614;84629;
14.02.2019;13:24:05;85539351;85454781;84570;
14.02.2019;13:25:05;85539456;85454939;84517;
14.02.2019;13:26:05;85539586;85455110;84476;
14.02.2019;13:27:07;85539710;85455284;84426;
14.02.2019;13:28:04;85539845;85455425;84420;
14.02.2019;13:29:04;85539951;85455595;84356;
14.02.2019;13:31:05;85540178;85455879;84299;
14.02.2019;13:32:05;85540273;85456032;84241;
14.02.2019;13:33:05;85540410;85456192;84218;
14.02.2019;13:34:06;85540518;85456370;84148;
14.02.2019;13:35:05;85540624;85456488;84136;
14.02.2019;13:36:05;85540724;85456636;84088;
14.02.2019;13:37:05;85540832;85456774;84058;
14.02.2019;13:38:05;85540935;85456934;84001;
14.02.2019;13:39:08;85541058;85457065;83993;
14.02.2019;13:40:05;85541173;85457191;83982;
14.02.2019;13:41:05;85541284;85457335;83949;
14.02.2019;13:42:05;85541380;85457460;83920;
14.02.2019;13:43:05;85541489;85457582;83907;
14.02.2019;13:44:05;85541611;85457717;83894;
14.02.2019;13:45:04;85541737;85457886;83851;
14.02.2019;13:46:04;85541849;85458013;83836;
14.02.2019;13:47:05;85541979;85458158;83821;
14.02.2019;13:48:04;85542124;85458334;83790;
14.02.2019;13:49:05;85542230;85458491;83739;
14.02.2019;13:50:05;85542369;85458642;83727;
14.02.2019;13:51:05;85542509;85458777;83732;
14.02.2019;13:52:05;85542617;85458934;83683;
14.02.2019;13:53:05;85542771;85459090;83681;
14.02.2019;13:54:05;85542899;85459263;83636;
14.02.2019;13:55:05;85543026;85459402;83624;
14.02.2019;13:56:06;85543164;85459566;83598;
14.02.2019;13:57:05;85543298;85459721;83577;
14.02.2019;13:58:05;85543402;85459847;83555;
14.02.2019;13:59:05;85543540;85460021;83519;
14.02.2019;14:00:05;85543660;85460186;83474;
14.02.2019;14:01:04;85543793;85460332;83461;
14.02.2019;14:02:04;85543919;85460472;83447;
14.02.2019;14:03:05;85544066;85460601;83465;
14.02.2019;14:04:04;85544196;85460748;83448;
14.02.2019;14:05:05;85544323;85460882;83441;
14.02.2019;14:06:05;85544448;85461039;83409;
14.02.2019;14:07:05;85544582;85461196;83386;
14.02.2019;14:08:05;85544689;85461327;83362;
14.02.2019;14:09:07;85544794;85461463;83331;
14.02.2019;14:10:05;85544906;85461608;83298;
14.02.2019;14:11:05;85545029;85461762;83267;
14.02.2019;14:12:05;85545096;85461884;83212;
14.02.2019;14:13:05;85545171;85462045;83126;
14.02.2019;14:14:05;85545247;85462184;83063;
14.02.2019;14:15:05;85545288;85462309;82979;
14.02.2019;14:16:05;85545335;85462413;82922;
14.02.2019;14:17:04;85545434;85462531;82903;
14.02.2019;14:18:05;85545527;85462598;82929;
14.02.2019;14:19:04;85545598;85462719;82879;
14.02.2019;14:20:05;85545669;85462901;82768;
14.02.2019;14:21:04;85545750;85463039;82711;
14.02.2019;14:22:04;85545871;85463154;82717;
14.02.2019;14:23:04;85545952;85463303;82649;
14.02.2019;14:24:04;85546049;85463446;82603;
14.02.2019;14:25:05;85546151;85463574;82577;
14.02.2019;14:26:05;85546237;85463704;82533;
14.02.2019;14:27:05;85546382;85463863;82519;
14.02.2019;14:28:05;85546522;85464034;82488;
14.02.2019;14:29:05;85546635;85464169;82466;
14.02.2019;14:30:05;85546761;85464314;82447;
14.02.2019;14:31:04;85546904;85464449;82455;
14.02.2019;14:32:05;85547028;85464620;82408;
14.02.2019;14:33:05;85547174;85464810;82364;
14.02.2019;14:34:05;85547317;85464971;82346;
14.02.2019;14:35:06;85547435;85465154;82281;
14.02.2019;14:36:05;85547575;85465326;82249;
14.02.2019;14:37:05;85547668;85465487;82181;
14.02.2019;14:38:05;85547815;85465639;82176;
14.02.2019;14:39:06;85547956;85465804;82152;
14.02.2019;14:40:05;85548096;85465967;82129;
14.02.2019;14:41:05;85548230;85466131;82099;
14.02.2019;14:42:05;85548368;85466287;82081;
14.02.2019;14:43:06;85548502;85466471;82031;
14.02.2019;14:44:04;85548626;85466626;82000;
14.02.2019;14:45:04;85548737;85466775;81962;
14.02.2019;14:46:05;85548898;85466929;81969;
14.02.2019;14:47:05;85549033;85467108;81925;
14.02.2019;14:48:05;85549168;85467251;81917;
14.02.2019;14:49:05;85549275;85467448;81827;
14.02.2019;14:50:04;85549391;85467588;81803;
14.02.2019;14:51:05;85549515;85467712;81803;
14.02.2019;14:52:06;85549637;85467862;81775;
14.02.2019;14:53:05;85549763;85468026;81737;
14.02.2019;14:54:05;85549889;85468170;81719;
14.02.2019;14:55:05;85550011;85468339;81672;
14.02.2019;14:56:05;85550124;85468514;81610;
14.02.2019;14:57:04;85550256;85468670;81586;
14.02.2019;14:58:05;85550373;85468842;81531;
14.02.2019;14:59:04;85550475;85469008;81467;
14.02.2019;15:00:07;85550615;85469175;81440;
14.02.2019;15:01:07;85550737;85469334;81403;
14.02.2019;15:02:08;85550843;85469493;81350;
14.02.2019;15:03:08;85550968;85469653;81315;
14.02.2019;15:04:09;85551072;85469811;81261;
14.02.2019;15:05:09;85551205;85469978;81227;
14.02.2019;15:06:11;85551359;85470141;81218;
14.02.2019;15:07:09;85551472;85470299;81173;
14.02.2019;15:08:12;85551577;85470460;81117;
14.02.2019;15:09:09;85551677;85470628;81049;
14.02.2019;15:10:07;85551771;85470785;80986;
14.02.2019;15:11:08;85551884;85470949;80935;
14.02.2019;15:12:08;85551999;85471150;80849;
14.02.2019;15:13:08;85552090;85471280;80810;
14.02.2019;15:14:08;85552208;85471405;80803;
14.02.2019;15:15:21;85552338;85471596;80742;
14.02.2019;15:16:12;85552452;85471740;80712;
14.02.2019;15:17:10;85552564;85471896;80668;
14.02.2019;15:18:09;85552686;85472048;80638;
14.02.2019;15:19:08;85552789;85472215;80574;
14.02.2019;15:20:08;85552902;85472389;80513;
14.02.2019;15:21:08;85553041;85472560;80481;
14.02.2019;15:22:08;85553176;85472745;80431;
14.02.2019;15:23:09;85553307;85472890;80417;
14.02.2019;15:24:08;85553426;85473058;80368;
14.02.2019;15:25:16;85553535;85473234;80301;
14.02.2019;15:26:09;85553633;85473381;80252;
14.02.2019;15:27:08;85553749;85473553;80196;
14.02.2019;15:28:07;85553860;85473721;80139;
14.02.2019;15:29:07;85553963;85473901;80062;
14.02.2019;15:30:07;85554083;85474065;80018;
14.02.2019;15:31:07;85554190;85474243;79947;
14.02.2019;15:32:07;85554315;85474428;79887;
14.02.2019;15:33:08;85554451;85474581;79870;
14.02.2019;15:34:08;85554587;85474743;79844;
14.02.2019;15:35:07;85554704;85474910;79794;
14.02.2019;15:36:08;85554818;85475068;79750;
14.02.2019;15:37:08;85554933;85475208;79725;
14.02.2019;15:38:07;85555053;85475379;79674;
14.02.2019;15:39:10;85555180;85475535;79645;
14.02.2019;15:40:13;85555316;85475684;79632;
14.02.2019;15:41:06;85555407;85475794;79613;
14.02.2019;15:42:08;85555533;85475955;79578;
14.02.2019;15:43:08;85555655;85476136;79519;
14.02.2019;15:44:08;85555771;85476290;79481;
14.02.2019;15:45:13;85555881;85476471;79410;
14.02.2019;15:46:07;85555984;85476627;79357;
14.02.2019;15:47:08;85556097;85476815;79282;
14.02.2019;15:48:08;85556211;85476997;79214;
14.02.2019;15:49:08;85556334;85477140;79194;
14.02.2019;15:50:07;85556455;85477325;79130;
14.02.2019;15:51:07;85556607;85477474;79133;
14.02.2019;15:52:08;85556742;85477645;79097;
14.02.2019;15:53:07;85556856;85477820;79036;
14.02.2019;15:54:07;85556980;85477991;78989;
14.02.2019;15:55:07;85557107;85478145;78962;
14.02.2019;15:56:08;85557244;85478307;78937;
14.02.2019;15:57:08;85557372;85478485;78887;
14.02.2019;15:58:08;85557496;85478661;78835;
14.02.2019;15:59:08;85557636;85478828;78808;
14.02.2019;16:00:04;85557762;85479001;78761;
14.02.2019;16:01:04;85557879;85479175;78704;
14.02.2019;16:02:05;85557942;85479364;78578;
14.02.2019;16:03:04;85557789;85479396;78393;
14.02.2019;16:04:04;85557704;85479522;78182;
14.02.2019;16:05:05;85557812;85479670;78142;
14.02.2019;16:06:05;85557956;85479836;78120;
14.02.2019;16:07:04;85558081;85480006;78075;
14.02.2019;16:08:04;85558211;85480210;78001;
14.02.2019;16:09:05;85558340;85480393;77947;
14.02.2019;16:10:05;85558467;85480556;77911;
14.02.2019;16:11:04;85558596;85480724;77872;
14.02.2019;16:12:04;85558723;85480876;77847;
14.02.2019;16:13:05;85558858;85481058;77800;
14.02.2019;16:14:05;85558994;85481238;77756;
14.02.2019;16:15:05;85559132;85481417;77715;
14.02.2019;16:16:05;85559248;85481618;77630;
14.02.2019;16:17:05;85559371;85481802;77569;
14.02.2019;16:18:04;85559502;85481975;77527;
14.02.2019;16:19:05;85559619;85482141;77478;
14.02.2019;16:20:05;85559756;85482286;77470;
14.02.2019;16:21:05;85559883;85482454;77429;
14.02.2019;16:22:05;85560045;85482633;77412;
14.02.2019;16:23:05;85560190;85482818;77372;
14.02.2019;16:25:05;85560421;85483159;77262;
14.02.2019;16:26:05;85560546;85483311;77235;
14.02.2019;16:27:05;85560653;85483506;77147;
14.02.2019;16:28:04;85560783;85483671;77112;
14.02.2019;16:29:05;85560901;85483832;77069;
14.02.2019;16:30:04;85561033;85484001;77032;
14.02.2019;16:31:05;85561157;85484187;76970;
14.02.2019;16:32:06;85561294;85484353;76941;
14.02.2019;16:33:05;85561411;85484534;76877;
14.02.2019;16:34:04;85561551;85484710;76841;
14.02.2019;16:35:05;85561712;85484882;76830;
14.02.2019;16:36:05;85561842;85485031;76811;
14.02.2019;16:37:05;85561993;85485203;76790;
14.02.2019;16:38:05;85562101;85485358;76743;
14.02.2019;16:39:04;85562218;85485522;76696;
14.02.2019;16:40:04;85562340;85485722;76618;
14.02.2019;16:41:05;85562482;85485910;76572;
14.02.2019;16:42:05;85562584;85486083;76501;
14.02.2019;16:43:04;85562717;85486263;76454;
14.02.2019;16:44:04;85562845;85486426;76419;
14.02.2019;16:45:05;85562951;85486606;76345;
14.02.2019;16:46:05;85563054;85486764;76290;
14.02.2019;16:47:05;85563169;85486963;76206;
14.02.2019;16:48:05;85563298;85487124;76174;
14.02.2019;16:49:05;85563433;85487315;76118;
14.02.2019;16:50:05;85563575;85487481;76094;
14.02.2019;16:51:05;85563737;85487658;76079;
14.02.2019;16:52:05;85563876;85487808;76068;
14.02.2019;16:53:04;85564002;85487978;76024;
14.02.2019;16:54:04;85564118;85488144;75974;
14.02.2019;16:55:05;85564236;85488318;75918;
14.02.2019;16:56:05;85564369;85488500;75869;
14.02.2019;16:57:05;85564493;85488693;75800;
14.02.2019;16:58:05;85564632;85488886;75746;
14.02.2019;16:59:05;85564761;85489061;75700;
14.02.2019;17:00:04;85564892;85489234;75658;
14.02.2019;17:01:05;85565025;85489389;75636;
14.02.2019;17:02:05;85565152;85489566;75586;
14.02.2019;17:03:05;85565280;85489741;75539;
14.02.2019;17:04:04;85565417;85489919;75498;
14.02.2019;17:05:05;85565562;85490128;75434;
14.02.2019;17:06:05;85565670;85490280;75390;
14.02.2019;17:07:04;85565809;85490455;75354;
14.02.2019;17:08:04;85565933;85490626;75307;
14.02.2019;17:09:05;85566059;85490728;75331;
14.02.2019;17:10:05;85566180;85491036;75144;
14.02.2019;17:11:04;85566308;85491192;75116;
14.02.2019;17:12:05;85566440;85491365;75075;
14.02.2019;17:13:04;85566575;85491523;75052;
14.02.2019;17:14:04;85566703;85491698;75005;
14.02.2019;17:15:05;85566801;85491874;74927;
14.02.2019;17:16:05;85566937;85492040;74897;
14.02.2019;17:17:05;85567057;85492191;74866;
14.02.2019;17:18:05;85567178;85492380;74798;
14.02.2019;17:19:05;85567294;85492524;74770;
14.02.2019;17:20:05;85567400;85492668;74732;
14.02.2019;17:21:05;85567525;85492825;74700;
14.02.2019;17:22:05;85567646;85492981;74665;
14.02.2019;17:23:04;85567758;85493165;74593;
14.02.2019;17:24:05;85567910;85493339;74571;
14.02.2019;17:25:04;85568031;85493497;74534;
14.02.2019;17:26:04;85568166;85493672;74494;
14.02.2019;17:27:05;85568286;85493831;74455;
14.02.2019;17:28:04;85568400;85494024;74376;
14.02.2019;17:29:05;85568531;85494188;74343;
14.02.2019;17:30:04;85568645;85494337;74308;
14.02.2019;17:31:04;85568771;85494480;74291;
14.02.2019;17:32:04;85568884;85494642;74242;
14.02.2019;17:33:05;85568995;85494798;74197;
14.02.2019;17:34:04;85569095;85494944;74151;
14.02.2019;17:35:05;85569202;85495109;74093;
14.02.2019;17:36:05;85569323;85495288;74035;
14.02.2019;17:37:05;85569451;85495460;73991;
14.02.2019;17:38:05;85569570;85495610;73960;
14.02.2019;17:39:05;85569687;85495784;73903;
14.02.2019;17:40:05;85569828;85495956;73872;
14.02.2019;17:41:06;85569963;85496141;73822;
14.02.2019;17:42:04;85570076;85496298;73778;
14.02.2019;17:43:09;85570165;85496457;73708;
14.02.2019;17:44:05;85570279;85496587;73692;
14.02.2019;17:45:05;85570388;85496743;73645;
14.02.2019;17:46:05;85570526;85496905;73621;
14.02.2019;17:47:05;85570638;85497072;73566;
14.02.2019;17:48:05;85570756;85497274;73482;
14.02.2019;17:49:05;85570874;85497432;73442;
14.02.2019;17:50:05;85571002;85497586;73416;
14.02.2019;17:51:05;85571112;85497743;73369;
14.02.2019;17:52:04;85571232;85497919;73313;
14.02.2019;17:53:05;85571359;85498074;73285;
14.02.2019;17:54:05;85571484;85498226;73258;
14.02.2019;17:55:04;85571592;85498385;73207;
14.02.2019;17:56:09;85571727;85498535;73192;
14.02.2019;17:57:05;85571848;85498680;73168;
14.02.2019;17:58:05;85571978;85498837;73141;
14.02.2019;17:59:05;85572114;85498988;73126;
14.02.2019;18:00:10;85572243;85499149;73094;
14.02.2019;18:01:05;85572353;85499288;73065;
14.02.2019;18:02:05;85572461;85499432;73029;
14.02.2019;18:03:05;85572584;85499585;72999;
14.02.2019;18:04:05;85572695;85499737;72958;
14.02.2019;18:05:05;85572798;85499865;72933;
14.02.2019;18:06:05;85572854;85499987;72867;
14.02.2019;18:07:05;85572956;85500124;72832;
14.02.2019;18:08:04;85573029;85500256;72773;
14.02.2019;18:09:05;85573068;85500362;72706;
14.02.2019;18:10:05;85573085;85500433;72652;
14.02.2019;18:11:05;85573170;85500550;72620;
14.02.2019;18:12:05;85573236;85500666;72570;
14.02.2019;18:13:06;85573301;85500802;72499;
14.02.2019;18:14:05;85573408;85500954;72454;
14.02.2019;18:15:04;85573496;85501075;72421;
14.02.2019;18:16:05;85573623;85501218;72405;
14.02.2019;18:17:05;85573711;85501388;72323;
14.02.2019;18:18:05;85573818;85501567;72251;
14.02.2019;18:19:05;85573905;85501676;72229;
14.02.2019;18:20:04;85574036;85501848;72188;
14.02.2019;18:21:04;85574151;85502001;72150;
14.02.2019;18:22:05;85574254;85502154;72100;
14.02.2019;18:23:05;85574369;85502302;72067;
14.02.2019;18:24:05;85574499;85502436;72063;
14.02.2019;18:25:05;85574620;85502591;72029;
14.02.2019;18:26:05;85574729;85502745;71984;
14.02.2019;18:27:05;85574835;85502883;71952;
14.02.2019;18:28:05;85574952;85503051;71901;
14.02.2019;18:29:11;85575085;85503214;71871;
14.02.2019;18:30:05;85575163;85503347;71816;
14.02.2019;18:31:05;85575291;85503452;71839;
14.02.2019;18:32:06;85575407;85503585;71822;
14.02.2019;18:33:05;85575510;85503737;71773;
14.02.2019;18:34:05;85575606;85503877;71729;
14.02.2019;18:35:04;85575724;85504025;71699;
14.02.2019;18:36:04;85575847;85504165;71682;
14.02.2019;18:37:04;85575962;85504276;71686;
14.02.2019;18:38:05;85576079;85504433;71646;
14.02.2019;18:39:07;85576131;85504503;71628;
14.02.2019;18:40:05;85576258;85504614;71644;
14.02.2019;18:41:04;85576373;85504750;71623;
14.02.2019;18:42:04;85576507;85504882;71625;
14.02.2019;18:43:04;85576614;85504985;71629;
14.02.2019;18:44:06;85576727;85505153;71574;
14.02.2019;18:45:04;85576833;85505279;71554;
14.02.2019;18:46:04;85576949;85505393;71556;
14.02.2019;18:47:06;85577070;85505513;71557;
14.02.2019;18:48:05;85577194;85505609;71585;
14.02.2019;18:49:05;85577311;85505742;71569;
14.02.2019;18:50:05;85577442;85505850;71592;
14.02.2019;18:51:09;85577568;85506000;71568;
14.02.2019;18:52:04;85577676;85506112;71564;
14.02.2019;18:53:05;85577782;85506215;71567;
14.02.2019;18:54:05;85577880;85506336;71544;
14.02.2019;18:55:05;85577956;85506457;71499;
14.02.2019;18:56:05;85578092;85506583;71509;
14.02.2019;18:57:04;85578213;85506697;71516;
14.02.2019;18:58:05;85578312;85506833;71479;
14.02.2019;18:59:05;85578447;85506960;71487;
14.02.2019;19:00:05;85578539;85507057;71482;
14.02.2019;19:01:10;85578642;85507201;71441;
14.02.2019;19:02:05;85578731;85507316;71415;
14.02.2019;19:03:05;85578842;85507453;71389;
14.02.2019;19:04:04;85578950;85507561;71389;
14.02.2019;19:05:04;85579059;85507689;71370;
14.02.2019;19:06:05;85579186;85507801;71385;
14.02.2019;19:07:05;85579286;85507899;71387;
14.02.2019;19:08:05;85579423;85508020;71403;
14.02.2019;19:09:10;85579553;85508137;71416;
14.02.2019;19:10:04;85579673;85508233;71440;
14.02.2019;19:11:05;85579783;85508356;71427;
14.02.2019;19:12:04;85579904;85508454;71450;
14.02.2019;19:13:04;85580015;85508561;71454;
14.02.2019;19:14:05;85580126;85508687;71439;
14.02.2019;19:15:05;85580238;85508807;71431;
14.02.2019;19:16:05;85580325;85508923;71402;
14.02.2019;19:17:05;85580401;85509021;71380;
14.02.2019;19:18:05;85580503;85509147;71356;
14.02.2019;19:19:05;85580619;85509255;71364;
14.02.2019;19:20:04;85580713;85509370;71343;
14.02.2019;19:21:05;85580822;85509475;71347;
14.02.2019;19:22:05;85580938;85509581;71357;
14.02.2019;19:23:05;85581035;85509695;71340;
14.02.2019;19:24:04;85581144;85509799;71345;
14.02.2019;19:25:05;85581254;85509887;71367;
14.02.2019;19:26:04;85581357;85509991;71366;
14.02.2019;19:27:06;85581473;85510110;71363;
14.02.2019;19:28:05;85581591;85510212;71379;
14.02.2019;19:29:05;85581697;85510305;71392;
14.02.2019;19:30:05;85581813;85510402;71411;
14.02.2019;19:31:05;85581924;85510512;71412;
14.02.2019;19:32:09;85582065;85510583;71482;
14.02.2019;19:33:05;85582156;85510659;71497;
14.02.2019;19:34:05;85582276;85510767;71509;
14.02.2019;19:35:05;85582395;85510840;71555;
14.02.2019;19:36:05;85582516;85510931;71585;
14.02.2019;19:37:04;85582626;85511023;71603;
14.02.2019;19:38:05;85582719;85511126;71593;
14.02.2019;19:39:06;85582811;85511244;71567;
14.02.2019;19:40:15;85582925;85511342;71583;
14.02.2019;19:41:05;85583028;85511412;71616;
14.02.2019;19:42:05;85583133;85511512;71621;
14.02.2019;19:43:05;85583247;85511621;71626;
14.02.2019;19:44:05;85583333;85511690;71643;
14.02.2019;19:45:05;85583440;85511777;71663;
14.02.2019;19:46:05;85583557;85511850;71707;
14.02.2019;19:47:04;85583674;85511937;71737;
14.02.2019;19:48:04;85583824;85512029;71795;
14.02.2019;19:49:05;85583946;85512134;71812;
14.02.2019;19:50:05;85584035;85512216;71819;
14.02.2019;19:51:05;85584138;85512278;71860;
14.02.2019;19:52:04;85584241;85512377;71864;
14.02.2019;19:53:05;85584305;85512465;71840;
14.02.2019;19:54:05;85584446;85512550;71896;
14.02.2019;19:55:05;85584539;85512623;71916;
14.02.2019;19:56:05;85584636;85512736;71900;
14.02.2019;19:57:05;85584768;85512805;71963;
14.02.2019;19:58:05;85584865;85512906;71959;
14.02.2019;19:59:05;85584963;85513008;71955;
14.02.2019;20:00:05;85585065;85513085;71980;
14.02.2019;20:01:05;85585165;85513165;72000;
14.02.2019;20:02:05;85585266;85513253;72013;
14.02.2019;20:03:05;85585376;85513330;72046;
14.02.2019;20:04:06;85585491;85513421;72070;
14.02.2019;20:05:05;85585590;85513498;72092;
14.02.2019;20:06:05;85585718;85513570;72148;
14.02.2019;20:07:05;85585761;85513633;72128;
14.02.2019;20:08:05;85585853;85513658;72195;
14.02.2019;20:09:06;85585859;85513670;72189;
14.02.2019;20:10:05;85585878;85513680;72198;
14.02.2019;20:11:05;85585858;85513684;72174;
14.02.2019;20:12:05;85585979;85513749;72230;
14.02.2019;20:13:05;85585972;85513830;72142;
14.02.2019;20:14:04;85586049;85513904;72145;
14.02.2019;20:15:04;85586112;85513996;72116;
14.02.2019;20:16:05;85586192;85514063;72129;
14.02.2019;20:17:06;85586277;85514144;72133;
14.02.2019;20:18:05;85586355;85514216;72139;
14.02.2019;20:19:05;85586432;85514284;72148;
14.02.2019;20:20:06;85586524;85514376;72148;
14.02.2019;20:21:05;85586573;85514460;72113;
14.02.2019;20:22:04;85586647;85514525;72122;
14.02.2019;20:23:04;85586715;85514593;72122;
14.02.2019;20:24:06;85586807;85514654;72153;
14.02.2019;20:25:05;85586910;85514730;72180;
14.02.2019;20:26:04;85586994;85514786;72208;
14.02.2019;20:27:04;85587081;85514851;72230;
14.02.2019;20:28:05;85587194;85514937;72257;
14.02.2019;20:29:05;85587280;85514997;72283;
14.02.2019;20:30:06;85587370;85515059;72311;
14.02.2019;20:31:05;85587480;85515143;72337;
14.02.2019;20:32:05;85587567;85515201;72366;
14.02.2019;20:33:04;85587711;85515247;72464;
14.02.2019;20:34:05;85587822;85515323;72499;
14.02.2019;20:35:06;85587910;85515366;72544;
14.02.2019;20:36:04;85587996;85515433;72563;
14.02.2019;20:37:05;85588083;85515508;72575;
14.02.2019;20:38:10;85588185;85515593;72592;
14.02.2019;20:39:05;85588268;85515645;72623;
14.02.2019;20:40:05;85588386;85515717;72669;
14.02.2019;20:41:05;85588483;85515771;72712;
14.02.2019;20:42:05;85588578;85515822;72756;
14.02.2019;20:43:04;85588671;85515887;72784;
14.02.2019;20:44:05;85588736;85515955;72781;
14.02.2019;20:45:05;85588835;85516019;72816;
14.02.2019;20:47:05;85589035;85516125;72910;
14.02.2019;20:48:05;85589151;85516180;72971;
14.02.2019;20:49:05;85589243;85516224;73019;
14.02.2019;20:50:05;85589347;85516307;73040;
14.02.2019;20:51:05;85589453;85516358;73095;
14.02.2019;20:52:08;85589559;85516430;73129;
14.02.2019;20:53:05;85589666;85516486;73180;
14.02.2019;20:54:04;85589788;85516555;73233;
14.02.2019;20:55:04;85589870;85516618;73252;
14.02.2019;20:56:04;85589965;85516675;73290;
14.02.2019;20:57:05;85590065;85516742;73323;
14.02.2019;20:58:05;85590175;85516796;73379;
14.02.2019;20:59:05;85590304;85516841;73463;
14.02.2019;21:00:06;85590415;85516894;73521;
14.02.2019;21:01:05;85590472;85516951;73521;
14.02.2019;21:02:05;85590648;85517020;73628;
14.02.2019;21:03:05;85590764;85517074;73690;
14.02.2019;21:04:05;85590869;85517117;73752;
14.02.2019;21:05:05;85590976;85517209;73767;
14.02.2019;21:06:05;85591092;85517256;73836;
14.02.2019;21:07:05;85591216;85517305;73911;
14.02.2019;21:08:05;85591293;85517372;73921;
14.02.2019;21:09:06;85591419;85517427;73992;
14.02.2019;21:10:04;85591542;85517469;74073;
14.02.2019;21:11:05;85591646;85517535;74111;
14.02.2019;21:12:05;85591756;85517582;74174;
14.02.2019;21:13:10;85591867;85517653;74214;
14.02.2019;21:14:05;85591962;85517697;74265;
14.02.2019;21:15:05;85592058;85517754;74304;
14.02.2019;21:16:05;85592141;85517807;74334;
14.02.2019;21:17:05;85592225;85517870;74355;
14.02.2019;21:18:07;85592332;85517934;74398;
14.02.2019;21:19:10;85592442;85517990;74452;
14.02.2019;21:20:05;85592536;85518019;74517;
14.02.2019;21:21:05;85592636;85518057;74579;
14.02.2019;21:22:05;85592734;85518104;74630;
14.02.2019;21:23:05;85592840;85518162;74678;
14.02.2019;21:24:05;85592942;85518220;74722;
14.02.2019;21:25:05;85593046;85518269;74777;
14.02.2019;21:26:05;85593152;85518316;74836;
14.02.2019;21:27:06;85593250;85518357;74893;
14.02.2019;21:28:04;85593345;85518406;74939;
14.02.2019;21:29:05;85593446;85518458;74988;
14.02.2019;21:30:05;85593534;85526606;66928;
14.02.2019;21:31:05;85593636;85526639;66997;
14.02.2019;21:32:07;85593735;85526708;67027;
14.02.2019;21:33:05;85593824;85526746;67078;
14.02.2019;21:34:05;85593944;85526789;67155;
14.02.2019;21:35:05;85594053;85526838;67215;
14.02.2019;21:36:05;85594170;85526884;67286;
14.02.2019;21:37:05;85594296;85526927;67369;
14.02.2019;21:38:04;85594413;85526973;67440;
14.02.2019;21:39:04;85594524;85527015;67509;
14.02.2019;21:40:04;85594582;85526994;67588;
14.02.2019;21:41:05;85594700;85527036;67664;
14.02.2019;21:42:05;85594821;85527076;67745;
14.02.2019;21:43:05;85594923;85527123;67800;
14.02.2019;21:44:05;85595037;85527160;67877;
14.02.2019;21:45:05;85595154;85527207;67947;
14.02.2019;21:46:05;85595260;85527244;68016;
14.02.2019;21:47:05;85595361;85527273;68088;
14.02.2019;21:48:05;85598839;85527324;71515;
14.02.2019;21:49:05;85598963;85527362;71601;
14.02.2019;21:50:05;85599088;85527417;71671;
14.02.2019;21:51:05;85599198;85527450;71748;
14.02.2019;21:52:04;85599292;85527501;71791;
14.02.2019;21:53:05;85599381;85527528;71853;
14.02.2019;21:54:05;85599485;85527597;71888;
14.02.2019;21:55:05;85599603;85527643;71960;
14.02.2019;21:56:05;85599712;85527686;72026;
14.02.2019;21:57:05;85599823;85527726;72097;
14.02.2019;21:58:05;85599944;85527758;72186;
14.02.2019;21:59:05;85600045;85527784;72261;
14.02.2019;22:00:05;85600156;85527826;72330;
14.02.2019;22:01:05;85600255;85527879;72376;
14.02.2019;22:02:04;85600359;85527919;72440;
14.02.2019;22:03:06;85600471;85527963;72508;
14.02.2019;22:04:05;85600615;85528008;72607;
14.02.2019;22:05:04;85600725;85528045;72680;
14.02.2019;22:06:04;85600851;85528077;72774;
14.02.2019;22:07:04;85600952;85528118;72834;
14.02.2019;22:08:05;85601060;85528152;72908;
14.02.2019;22:09:06;85601153;85528191;72962;
14.02.2019;22:10:06;85601227;85528229;72998;
14.02.2019;22:11:05;85601374;85528267;73107;
14.02.2019;22:12:05;85601464;85528296;73168;
14.02.2019;22:13:05;85601568;85528325;73243;
14.02.2019;22:14:05;85601644;85528340;73304;
14.02.2019;22:15:05;85601743;85528372;73371;
14.02.2019;22:16:05;85601836;85528410;73426;
14.02.2019;22:17:05;85601917;85528443;73474;
14.02.2019;22:18:04;85601990;85528474;73516;
14.02.2019;22:19:05;85602062;85528497;73565;
14.02.2019;22:20:04;85602132;85528534;73598;
14.02.2019;22:21:04;85602204;85528541;73663;
14.02.2019;22:22:04;85602261;85528587;73674;
14.02.2019;22:23:04;85602356;85528627;73729;
14.02.2019;22:24:05;85602446;85528651;73795;
14.02.2019;22:25:05;85602520;85528674;73846;
14.02.2019;22:26:05;85602604;85528688;73916;
14.02.2019;22:27:04;85602709;85528714;73995;
14.02.2019;22:28:04;85602808;85528745;74063;
14.02.2019;22:29:05;85602881;85528758;74123;
14.02.2019;22:30:04;85602958;85528794;74164;
14.02.2019;22:31:05;85603043;85528828;74215;
14.02.2019;22:32:04;85603124;85528858;74266;
14.02.2019;22:33:04;85603218;85528881;74337;
14.02.2019;22:34:04;85603313;85528917;74396;
14.02.2019;22:35:05;85603388;85528950;74438;
14.02.2019;22:36:05;85603491;85528972;74519;
14.02.2019;22:37:04;85603573;85528993;74580;
14.02.2019;22:38:04;85603646;85529025;74621;
14.02.2019;22:39:05;85603738;85529041;74697;
14.02.2019;22:40:05;85603824;85529080;74744;
14.02.2019;22:41:05;85603927;85529122;74805;
14.02.2019;22:42:05;85604010;85529153;74857;
14.02.2019;22:43:04;85604109;85529179;74930;
14.02.2019;22:44:04;85604215;85529211;75004;
14.02.2019;22:45:05;85604331;85529244;75087;
14.02.2019;22:46:06;85604428;85529285;75143;
14.02.2019;22:47:05;85604528;85529330;75198;
14.02.2019;22:48:04;85604632;85529371;75261;
14.02.2019;22:49:05;85604729;85529409;75320;
14.02.2019;22:50:04;85604842;85529436;75406;
14.02.2019;22:51:05;85604913;85529478;75435;
14.02.2019;22:52:05;85604992;85529523;75469;
14.02.2019;22:53:05;85605081;85529553;75528;
14.02.2019;22:54:05;85605153;85529579;75574;
14.02.2019;22:55:04;85605250;85529600;75650;
14.02.2019;22:56:05;85605350;85529622;75728;
14.02.2019;22:57:05;85605464;85529652;75812;
14.02.2019;22:58:05;85605556;85529671;75885;
14.02.2019;22:59:05;85605665;85529702;75963;
14.02.2019;23:00:05;85605768;85529737;76031;
14.02.2019;23:01:04;85605872;85529764;76108;
14.02.2019;23:02:04;85605951;85529795;76156;
14.02.2019;23:03:05;85606076;85529820;76256;
14.02.2019;23:04:05;85606170;85529830;76340;
14.02.2019;23:05:05;85606276;85529851;76425;
14.02.2019;23:06:05;85606383;85529872;76511;
14.02.2019;23:07:05;85606483;85529907;76576;
14.02.2019;23:08:05;85606586;85529953;76633;
14.02.2019;23:09:04;85606684;85529974;76710;
14.02.2019;23:10:04;85606806;85530007;76799;
14.02.2019;23:11:05;85606915;85530037;76878;
14.02.2019;23:12:04;85607013;85530063;76950;
14.02.2019;23:13:04;85607104;85530092;77012;
14.02.2019;23:14:05;85607189;85530134;77055;
14.02.2019;23:15:05;85607276;85530161;77115;
14.02.2019;23:16:05;85607372;85530186;77186;
14.02.2019;23:17:04;85607486;85530222;77264;
14.02.2019;23:18:04;85607597;85530258;77339;
14.02.2019;23:19:05;85607668;85530275;77393;
14.02.2019;23:20:04;85607773;85530302;77471;
14.02.2019;23:21:04;85607863;85530337;77526;
14.02.2019;23:22:05;85607944;85530356;77588;
14.02.2019;23:23:05;85608054;85530393;77661;
14.02.2019;23:24:04;85608135;85530408;77727;
14.02.2019;23:25:05;85608239;85530433;77806;
14.02.2019;23:26:05;85608334;85530465;77869;
14.02.2019;23:27:04;85608416;85530495;77921;
14.02.2019;23:28:04;85608509;85530515;77994;
14.02.2019;23:29:10;85608607;85530555;78052;
14.02.2019;23:30:04;85608706;85530576;78130;
14.02.2019;23:31:08;85608792;85530617;78175;
14.02.2019;23:32:04;85608892;85530636;78256;
14.02.2019;23:33:05;85608975;85530664;78311;
14.02.2019;23:34:04;85609068;85530694;78374;
14.02.2019;23:35:05;85609172;85530728;78444;
14.02.2019;23:36:04;85609260;85530752;78508;
14.02.2019;23:37:04;85609373;85530774;78599;
14.02.2019;23:38:05;85609449;85530804;78645;
14.02.2019;23:39:09;85609549;85530828;78721;
14.02.2019;23:40:05;85609634;85530849;78785;
14.02.2019;23:41:05;85609733;85530864;78869;
14.02.2019;23:42:05;85609798;85530892;78906;
14.02.2019;23:43:05;85609851;85530914;78937;
14.02.2019;23:44:10;85609947;85530939;79008;
14.02.2019;23:45:04;85610027;85530953;79074;
14.02.2019;23:46:04;85610122;85530973;79149;
14.02.2019;23:47:05;85610205;85530996;79209;
14.02.2019;23:48:05;85610296;85531015;79281;
14.02.2019;23:49:04;85610401;85531042;79359;
14.02.2019;23:50:05;85610493;85531063;79430;
14.02.2019;23:52:05;85610677;85531105;79572;
14.02.2019;23:53:04;85610767;85531128;79639;
14.02.2019;23:54:04;85610843;85531159;79684;
14.02.2019;23:55:05;85610957;85531197;79760;
14.02.2019;23:56:04;85611045;85531220;79825;
14.02.2019;23:57:04;85611109;85531252;79857;
14.02.2019;23:58:04;85611174;85531278;79896;
14.02.2019;23:59:06;85611290;85531300;79990;
15.02.2019;00:00:08;85611386;85531329;80057;
15.02.2019;00:01:09;85611473;85531359;80114;
15.02.2019;00:02:09;85611552;85531367;80185;
15.02.2019;00:03:07;85611644;85531387;80257;
15.02.2019;00:04:08;85611718;85531405;80313;
15.02.2019;00:05:16;85611806;85531426;80380;
15.02.2019;00:06:10;85611894;85531448;80446;
15.02.2019;00:07:07;85611963;85531478;80485;
15.02.2019;00:08:07;85612063;85531494;80569;
15.02.2019;00:09:08;85612147;85531521;80626;
15.02.2019;00:10:09;85612218;85531548;80670;
15.02.2019;00:11:08;85612281;85531571;80710;
15.02.2019;00:12:08;85612330;85531586;80744;
15.02.2019;00:13:08;85612374;85531607;80767;
15.02.2019;00:14:07;85612438;85531627;80811;
15.02.2019;00:15:07;85612493;85531648;80845;
15.02.2019;00:16:08;85612539;85531662;80877;
15.02.2019;00:17:07;85612615;85531695;80920;
15.02.2019;00:18:08;85612687;85531716;80971;
15.02.2019;00:19:08;85612762;85531732;81030;
15.02.2019;00:20:07;85612836;85531746;81090;
15.02.2019;00:21:07;85612891;85531766;81125;
15.02.2019;00:22:07;85612941;85531776;81165;
15.02.2019;00:23:07;85613019;85531803;81216;
15.02.2019;00:24:07;85613092;85531814;81278;
15.02.2019;00:25:08;85613173;85531855;81318;
15.02.2019;00:26:08;85613247;85531872;81375;
15.02.2019;00:27:08;85613315;85531894;81421;
15.02.2019;00:28:07;85613373;85531918;81455;
15.02.2019;00:29:08;85613430;85531938;81492;
15.02.2019;00:30:08;85613519;85531959;81560;
15.02.2019;00:31:07;85613581;85531970;81611;
15.02.2019;00:32:08;85613656;85532004;81652;
15.02.2019;00:33:08;85613759;85532027;81732;
15.02.2019;00:34:07;85613849;85532046;81803;
15.02.2019;00:35:08;85613931;85532073;81858;
15.02.2019;00:36:12;85614012;85532086;81926;
15.02.2019;00:37:09;85614092;85532117;81975;
15.02.2019;00:38:08;85614165;85532148;82017;
15.02.2019;00:39:08;85614208;85532185;82023;
15.02.2019;00:40:08;85614293;85532206;82087;
15.02.2019;00:41:07;85614369;85532236;82133;
15.02.2019;00:42:07;85614444;85532259;82185;
15.02.2019;00:43:08;85614512;85532283;82229;
15.02.2019;00:44:07;85614598;85532314;82284;
15.02.2019;00:45:07;85614686;85532328;82358;
15.02.2019;00:46:08;85614738;85532302;82436;
15.02.2019;00:47:08;85614803;85532340;82463;
15.02.2019;00:48:08;85614901;85532357;82544;
15.02.2019;00:49:08;85614967;85532387;82580;
15.02.2019;00:50:08;85615035;85532400;82635;
15.02.2019;00:51:07;85615095;85532432;82663;
15.02.2019;00:52:07;85615187;85532455;82732;
15.02.2019;00:53:08;85615281;85532480;82801;
15.02.2019;00:54:08;85615347;85532517;82830;
15.02.2019;00:55:07;85615411;85532543;82868;
15.02.2019;00:56:07;85615493;85532577;82916;
15.02.2019;00:57:08;85615576;85532613;82963;
15.02.2019;00:58:07;85615660;85532633;83027;
15.02.2019;00:59:07;85615742;85532653;83089;
15.02.2019;01:00:05;85615844;85532673;83171;
15.02.2019;01:01:05;85615926;85532694;83232;
15.02.2019;01:02:04;85616004;85532713;83291;
15.02.2019;01:03:04;85616087;85532735;83352;
15.02.2019;01:04:05;85616147;85532762;83385;
15.02.2019;01:05:05;85616228;85532795;83433;
15.02.2019;01:06:04;85616280;85532825;83455;
15.02.2019;01:07:05;85616358;85532860;83498;
15.02.2019;01:08:04;85616434;85532888;83546;
15.02.2019;01:09:04;85616524;85532917;83607;
15.02.2019;01:10:04;85616612;85532955;83657;
15.02.2019;01:11:05;85616700;85532975;83725;
15.02.2019;01:12:04;85616766;85533013;83753;
15.02.2019;01:13:05;85616849;85533043;83806;
15.02.2019;01:14:04;85616932;85533084;83848;
15.02.2019;01:15:05;85617035;85533124;83911;
15.02.2019;01:16:04;85617109;85533165;83944;
15.02.2019;01:17:05;85617201;85533186;84015;
15.02.2019;01:18:04;85617276;85533231;84045;
15.02.2019;01:19:04;85617346;85533262;84084;
15.02.2019;01:20:05;85617449;85533292;84157;
15.02.2019;01:21:04;85617539;85533315;84224;
15.02.2019;01:22:05;85617630;85533345;84285;
15.02.2019;01:23:04;85617697;85533385;84312;
15.02.2019;01:24:05;85617771;85533417;84354;
15.02.2019;01:25:05;85617868;85533455;84413;
15.02.2019;01:26:05;85617948;85533490;84458;
15.02.2019;01:27:05;85618036;85533516;84520;
15.02.2019;01:28:04;85618122;85533533;84589;
15.02.2019;01:29:04;85618197;85533564;84633;
15.02.2019;01:30:05;85618271;85533603;84668;
15.02.2019;01:31:04;85618347;85533645;84702;
15.02.2019;01:32:04;85618424;85533673;84751;
15.02.2019;01:33:05;85618501;85533697;84804;
15.02.2019;01:34:04;85618589;85533749;84840;
15.02.2019;01:35:04;85618675;85533793;84882;
15.02.2019;01:36:05;85618753;85533826;84927;
15.02.2019;01:37:05;85618831;85533857;84974;
15.02.2019;01:38:05;85618923;85533871;85052;
15.02.2019;01:39:05;85618991;85533902;85089;
15.02.2019;01:40:04;85619065;85533956;85109;
15.02.2019;01:41:04;85619178;85534012;85166;
15.02.2019;01:42:05;85619261;85534053;85208;
15.02.2019;01:43:04;85619331;85534090;85241;
15.02.2019;01:44:04;85619408;85534125;85283;
15.02.2019;01:45:05;85619469;85534166;85303;
15.02.2019;01:46:05;85619535;85534202;85333;
15.02.2019;01:47:04;85619631;85534246;85385;
15.02.2019;01:48:05;85619702;85534279;85423;
15.02.2019;01:49:04;85619782;85534318;85464;
15.02.2019;01:50:05;85619850;85534357;85493;
15.02.2019;01:51:04;85619922;85534395;85527;
15.02.2019;01:52:05;85620012;85534439;85573;
15.02.2019;01:53:05;85620095;85534488;85607;
15.02.2019;01:54:04;85620170;85534528;85642;
15.02.2019;01:55:04;85620247;85534576;85671;
15.02.2019;01:56:04;85620347;85534607;85740;
15.02.2019;01:57:04;85620415;85534655;85760;
15.02.2019;01:58:04;85620477;85534713;85764;
15.02.2019;01:59:04;85620558;85534769;85789;
15.02.2019;02:00:04;85620646;85534813;85833;
15.02.2019;02:01:05;85620729;85534855;85874;
15.02.2019;02:02:04;85620802;85534886;85916;
15.02.2019;02:03:04;85620875;85534930;85945;
15.02.2019;02:04:05;85620956;85535003;85953;
15.02.2019;02:05:04;85621060;85535038;86022;
15.02.2019;02:06:04;85621139;85535095;86044;
15.02.2019;02:07:04;85621231;85535143;86088;
15.02.2019;02:08:04;85621303;85535186;86117;
15.02.2019;02:09:05;85621382;85535225;86157;
15.02.2019;02:10:04;85621479;85535270;86209;
15.02.2019;02:11:04;85621519;85535318;86201;
15.02.2019;02:12:05;85621637;85535365;86272;
15.02.2019;02:13:04;85621723;85535428;86295;
15.02.2019;02:14:04;85621803;85535487;86316;
15.02.2019;02:15:05;85621882;85535534;86348;
15.02.2019;02:16:04;85621955;85535587;86368;
15.02.2019;02:17:05;85622000;85535630;86370;
15.02.2019;02:18:05;85622079;85535698;86381;
15.02.2019;02:19:04;85622141;85535762;86379;
15.02.2019;02:20:04;85622191;85535808;86383;
15.02.2019;02:21:04;85622266;85535863;86403;
15.02.2019;02:22:04;85622326;85535914;86412;
15.02.2019;02:23:05;85622406;85535969;86437;
15.02.2019;02:24:04;85622488;85536030;86458;
15.02.2019;02:25:04;85622563;85536094;86469;
15.02.2019;02:26:04;85622632;85536156;86476;
15.02.2019;02:27:04;85622733;85536218;86515;
15.02.2019;02:28:04;85622803;85536284;86519;
15.02.2019;02:29:04;85622883;85536348;86535;
15.02.2019;02:30:05;85622957;85536423;86534;
15.02.2019;02:31:04;85623025;85536495;86530;
15.02.2019;02:32:04;85623086;85536549;86537;
15.02.2019;02:33:04;85623213;85536614;86599;
15.02.2019;02:34:05;85623279;85536687;86592;
15.02.2019;02:35:04;85623375;85536755;86620;
15.02.2019;02:36:05;85623438;85536838;86600;
15.02.2019;02:37:05;85623498;85536915;86583;
15.02.2019;02:38:04;85623615;85536976;86639;
15.02.2019;02:39:04;85623691;85537042;86649;
15.02.2019;02:40:05;85623764;85537115;86649;
15.02.2019;02:41:05;85623854;85537179;86675;
15.02.2019;02:42:05;85623918;85537257;86661;
15.02.2019;02:43:04;85624009;85537318;86691;
15.02.2019;02:44:05;85624084;85537383;86701;
15.02.2019;02:45:04;85624175;85537452;86723;
15.02.2019;02:46:04;85624278;85537528;86750;
15.02.2019;02:47:05;85624359;85537618;86741;
15.02.2019;02:48:05;85624448;85537694;86754;
15.02.2019;02:49:04;85624517;85537781;86736;
15.02.2019;02:50:05;85624607;85537850;86757;
15.02.2019;02:51:04;85624682;85537932;86750;
15.02.2019;02:52:04;85624759;85538010;86749;
15.02.2019;02:53:05;85624850;85538089;86761;
15.02.2019;02:54:04;85624935;85538172;86763;
15.02.2019;02:55:05;85625023;85538242;86781;
15.02.2019;02:56:04;85625117;85538309;86808;
15.02.2019;02:57:04;85625209;85538389;86820;
15.02.2019;02:58:05;85625281;85538476;86805;
15.02.2019;02:59:05;85625375;85538557;86818;
15.02.2019;03:00:04;85625461;85538625;86836;
15.02.2019;03:01:04;85625542;85538710;86832;
15.02.2019;03:02:05;85625627;85538791;86836;
15.02.2019;03:03:05;85625716;85538884;86832;
15.02.2019;03:04:04;85625798;85538967;86831;
15.02.2019;03:05:04;85625850;85539051;86799;
15.02.2019;03:06:05;85625968;85539133;86835;
15.02.2019;03:07:04;85626042;85539230;86812;
15.02.2019;03:08:04;85626117;85539314;86803;
15.02.2019;03:09:05;85626194;85539432;86762;
15.02.2019;03:10:05;85626264;85539512;86752;
15.02.2019;03:11:04;85626338;85539607;86731;
15.02.2019;03:12:05;85626386;85539708;86678;
15.02.2019;03:13:04;85626482;85539811;86671;
15.02.2019;03:14:04;85626553;85539904;86649;
15.02.2019;03:15:05;85626634;85539986;86648;
15.02.2019;03:16:04;85626723;85540075;86648;
15.02.2019;03:17:05;85626818;85540177;86641;
15.02.2019;03:18:05;85626920;85540286;86634;
15.02.2019;03:19:04;85626991;85540379;86612;
15.02.2019;03:20:04;85627056;85540457;86599;
15.02.2019;03:21:05;85627146;85540546;86600;
15.02.2019;03:22:05;85627236;85540622;86614;
15.02.2019;03:23:04;85627319;85540715;86604;
15.02.2019;03:24:05;85627409;85540787;86622;
15.02.2019;03:25:05;85627476;85540876;86600;
15.02.2019;03:26:04;85627563;85540975;86588;
15.02.2019;03:27:05;85627654;85541061;86593;
15.02.2019;03:28:05;85627743;85541170;86573;
15.02.2019;03:29:04;85627828;85541271;86557;
15.02.2019;03:30:04;85627932;85541377;86555;
15.02.2019;03:31:04;85628017;85541473;86544;
15.02.2019;03:32:04;85628106;85541572;86534;
15.02.2019;03:33:04;85628183;85541658;86525;
15.02.2019;03:34:04;85628262;85541758;86504;
15.02.2019;03:35:04;85628343;85541858;86485;
15.02.2019;03:36:04;85628417;85541968;86449;
15.02.2019;03:37:05;85628481;85542066;86415;
15.02.2019;03:38:05;85628560;85542164;86396;
15.02.2019;03:39:06;85628649;85542279;86370;
15.02.2019;03:40:04;85628723;85542361;86362;
15.02.2019;03:41:05;85628807;85542448;86359;
15.02.2019;03:42:04;85628894;85542538;86356;
15.02.2019;03:43:05;85628970;85542647;86323;
15.02.2019;03:44:05;85629053;85542743;86310;
15.02.2019;03:45:04;85629093;85542851;86242;
15.02.2019;03:46:04;85629185;85542945;86240;
15.02.2019;03:47:04;85629265;85543038;86227;
15.02.2019;03:48:05;85629333;85543099;86234;
15.02.2019;03:49:04;85629389;85543170;86219;
15.02.2019;03:50:04;85629451;85543254;86197;
15.02.2019;03:51:05;85629528;85543336;86192;
15.02.2019;03:52:04;85629618;85543444;86174;
15.02.2019;03:53:05;85629711;85543538;86173;
15.02.2019;03:54:05;85629802;85543631;86171;
15.02.2019;03:55:04;85629858;85543726;86132;
15.02.2019;03:56:04;85629925;85543807;86118;
15.02.2019;03:57:05;85630012;85543920;86092;
15.02.2019;03:58:05;85630086;85544028;86058;
15.02.2019;03:59:05;85630149;85544113;86036;
15.02.2019;04:00:04;85630213;85544213;86000;
15.02.2019;04:01:05;85630297;85544325;85972;
15.02.2019;04:02:05;85630394;85544425;85969;
15.02.2019;04:03:04;85630477;85544512;85965;
15.02.2019;04:04:05;85630569;85544618;85951;
15.02.2019;04:05:04;85630642;85544718;85924;
15.02.2019;04:06:04;85630723;85544818;85905;
15.02.2019;04:07:04;85630816;85544925;85891;
15.02.2019;04:08:05;85630883;85545026;85857;
15.02.2019;04:09:05;85630940;85545099;85841;
15.02.2019;04:10:05;85630993;85545178;85815;
15.02.2019;04:11:05;85631046;85545262;85784;
15.02.2019;04:12:04;85631097;85545350;85747;
15.02.2019;04:13:05;85631135;85545456;85679;
15.02.2019;04:14:04;85631210;85545558;85652;
15.02.2019;04:15:05;85631258;85545665;85593;
15.02.2019;04:16:04;85631298;85545751;85547;
15.02.2019;04:17:04;85631359;85545855;85504;
15.02.2019;04:18:05;85631425;85545942;85483;
15.02.2019;04:19:05;85631489;85546035;85454;
15.02.2019;04:20:04;85631558;85546146;85412;
15.02.2019;04:21:04;85631633;85546266;85367;
15.02.2019;04:22:05;85631721;85546367;85354;
15.02.2019;04:23:04;85631779;85546476;85303;
15.02.2019;04:24:04;85631845;85546598;85247;
15.02.2019;04:25:05;85631918;85546691;85227;
15.02.2019;04:26:05;85632010;85546799;85211;
15.02.2019;04:27:04;85632099;85546893;85206;
15.02.2019;04:28:04;85632163;85547000;85163;
15.02.2019;04:29:05;85632263;85547102;85161;
15.02.2019;04:30:05;85632331;85547191;85140;
15.02.2019;04:31:05;85632413;85547269;85144;
15.02.2019;04:32:04;85632492;85547376;85116;
15.02.2019;04:33:05;85632577;85547450;85127;
15.02.2019;04:34:04;85632660;85547543;85117;
15.02.2019;04:35:04;85632736;85547655;85081;
15.02.2019;04:36:05;85632811;85547731;85080;
15.02.2019;04:37:04;85632882;85547825;85057;
15.02.2019;04:38:09;85632972;85547934;85038;
15.02.2019;04:39:07;85633045;85548027;85018;
15.02.2019;04:40:04;85633137;85548122;85015;
15.02.2019;04:41:05;85633212;85548239;84973;
15.02.2019;04:42:05;85633292;85548351;84941;
15.02.2019;04:43:04;85633378;85548456;84922;
15.02.2019;04:44:04;85633460;85548556;84904;
15.02.2019;04:45:05;85633539;85548662;84877;
15.02.2019;04:46:05;85633615;85548753;84862;
15.02.2019;04:47:04;85633717;85548846;84871;
15.02.2019;04:48:04;85633789;85548944;84845;
15.02.2019;04:49:05;85633861;85549076;84785;
15.02.2019;04:50:05;85633938;85549184;84754;
15.02.2019;04:51:05;85634058;85549299;84759;
15.02.2019;04:52:04;85634134;85549410;84724;
15.02.2019;04:53:05;85634204;85549522;84682;
15.02.2019;04:54:05;85634278;85549632;84646;
15.02.2019;04:55:05;85634335;85549739;84596;
15.02.2019;04:56:04;85634409;85549851;84558;
15.02.2019;04:57:04;85634479;85549955;84524;
15.02.2019;04:58:05;85634547;85550066;84481;
15.02.2019;04:59:04;85634620;85550185;84435;
15.02.2019;05:00:05;85634677;85550286;84391;
15.02.2019;05:01:05;85634733;85550383;84350;
15.02.2019;05:02:05;85634803;85550496;84307;
15.02.2019;05:03:04;85634871;85550590;84281;
15.02.2019;05:04:05;85634953;85550728;84225;
15.02.2019;05:05:05;85635048;85550847;84201;
15.02.2019;05:06:04;85635122;85550947;84175;
15.02.2019;05:07:05;85635202;85551046;84156;
15.02.2019;05:08:04;85635281;85551141;84140;
15.02.2019;05:09:04;85635341;85551245;84096;
15.02.2019;05:10:05;85635419;85551347;84072;
15.02.2019;05:11:04;85635484;85551436;84048;
15.02.2019;05:12:04;85635567;85551543;84024;
15.02.2019;05:13:04;85635664;85551662;84002;
15.02.2019;05:14:05;85635761;85551767;83994;
15.02.2019;05:15:05;85635854;85551858;83996;
15.02.2019;05:16:04;85635918;85551974;83944;
15.02.2019;05:17:05;85635999;85552067;83932;
15.02.2019;05:18:04;85636074;85552173;83901;
15.02.2019;05:19:04;85636150;85552278;83872;
15.02.2019;05:20:04;85636215;85552381;83834;
15.02.2019;05:21:04;85636301;85552491;83810;
15.02.2019;05:22:04;85636388;85552603;83785;
15.02.2019;05:23:05;85636475;85552707;83768;
15.02.2019;05:24:04;85636549;85552825;83724;
15.02.2019;05:25:05;85636626;85552919;83707;
15.02.2019;05:26:05;85636716;85553044;83672;
15.02.2019;05:27:05;85636807;85553160;83647;
15.02.2019;05:28:05;85636881;85553291;83590;
15.02.2019;05:29:04;85636936;85553388;83548;
15.02.2019;05:30:04;85637013;85553498;83515;
15.02.2019;05:31:05;85637085;85553615;83470;
15.02.2019;05:32:05;85637165;85553743;83422;
15.02.2019;05:33:04;85637243;85553831;83412;
15.02.2019;05:34:05;85637330;85553954;83376;
15.02.2019;05:35:04;85637403;85554055;83348;
15.02.2019;05:36:04;85637468;85554148;83320;
15.02.2019;05:37:05;85637562;85554269;83293;
15.02.2019;05:38:04;85637663;85554375;83288;
15.02.2019;05:39:06;85637761;85554501;83260;
15.02.2019;05:40:05;85637873;85554610;83263;
15.02.2019;05:41:05;85637956;85554722;83234;
15.02.2019;05:42:05;85638037;85554838;83199;
15.02.2019;05:43:04;85638135;85554981;83154;
15.02.2019;05:44:04;85638214;85555090;83124;
15.02.2019;05:45:05;85638296;85555221;83075;
15.02.2019;05:46:05;85638371;85555299;83072;
15.02.2019;05:47:04;85638463;85555415;83048;
15.02.2019;05:48:04;85638548;85555529;83019;
15.02.2019;05:49:05;85638670;85555647;83023;
15.02.2019;05:50:05;85638776;85555773;83003;
15.02.2019;05:51:04;85638875;85555895;82980;
15.02.2019;05:52:04;85638975;85556019;82956;
15.02.2019;05:53:04;85639079;85556124;82955;
15.02.2019;05:54:04;85639163;85556214;82949;
15.02.2019;05:55:04;85639265;85556349;82916;
15.02.2019;05:56:04;85639352;85556445;82907;
15.02.2019;05:57:04;85639438;85556567;82871;
15.02.2019;05:58:05;85639537;85556686;82851;
15.02.2019;05:59:04;85639616;85556802;82814;
15.02.2019;06:00:05;85639699;85556925;82774;
15.02.2019;06:01:04;85639785;85557032;82753;
15.02.2019;06:02:04;85639878;85557144;82734;
15.02.2019;06:03:05;85639941;85557237;82704;
15.02.2019;06:04:04;85640041;85557332;82709;
15.02.2019;06:05:05;85640120;85557434;82686;
15.02.2019;06:06:04;85640213;85557536;82677;
15.02.2019;06:07:04;85640298;85557646;82652;
15.02.2019;06:08:05;85640358;85557747;82611;
15.02.2019;06:09:06;85640400;85557847;82553;
15.02.2019;06:10:04;85640441;85557975;82466;
15.02.2019;06:11:05;85640460;85558057;82403;
15.02.2019;06:12:04;85640498;85558156;82342;
15.02.2019;06:13:05;85640543;85558240;82303;
15.02.2019;06:14:04;85640582;85558339;82243;
15.02.2019;06:15:05;85640632;85558451;82181;
15.02.2019;06:16:04;85640704;85558559;82145;
15.02.2019;06:17:04;85640777;85558669;82108;
15.02.2019;06:18:05;85640836;85558770;82066;
15.02.2019;06:19:05;85640905;85558891;82014;
15.02.2019;06:20:04;85640988;85559000;81988;
15.02.2019;06:21:04;85641054;85559101;81953;
15.02.2019;06:22:05;85641134;85559190;81944;
15.02.2019;06:23:05;85641209;85559294;81915;
15.02.2019;06:24:04;85641282;85559397;81885;
15.02.2019;06:25:08;85641354;85559509;81845;
15.02.2019;06:26:04;85641432;85559615;81817;
15.02.2019;06:27:04;85641498;85559714;81784;
15.02.2019;06:28:04;85641574;85559839;81735;
15.02.2019;06:29:05;85641658;85559946;81712;
15.02.2019;06:30:04;85641746;85560076;81670;
15.02.2019;06:31:04;85641811;85560209;81602;
15.02.2019;06:32:05;85641902;85560321;81581;
15.02.2019;06:33:04;85641982;85560453;81529;
15.02.2019;06:34:05;85642051;85560556;81495;
15.02.2019;06:35:04;85642130;85560655;81475;
15.02.2019;06:36:04;85642202;85560796;81406;
15.02.2019;06:37:05;85642270;85560906;81364;
15.02.2019;06:38:04;85642340;85561014;81326;
15.02.2019;06:39:04;85642390;85561106;81284;
15.02.2019;06:40:05;85642470;85561216;81254;
15.02.2019;06:41:05;85642550;85561326;81224;
15.02.2019;06:42:04;85642605;85561457;81148;
15.02.2019;06:43:04;85642679;85561550;81129;
15.02.2019;06:44:05;85642742;85561678;81064;
15.02.2019;06:45:05;85642827;85561788;81039;
15.02.2019;06:46:04;85642899;85561916;80983;
15.02.2019;06:47:04;85642963;85562033;80930;
15.02.2019;06:48:05;85643037;85562139;80898;
15.02.2019;06:49:05;85643108;85562254;80854;
15.02.2019;06:50:04;85643168;85562347;80821;
15.02.2019;06:51:05;85643238;85562442;80796;
15.02.2019;06:52:04;85643282;85562503;80779;
15.02.2019;06:53:04;85643336;85562579;80757;
15.02.2019;06:54:04;85643399;85562644;80755;
15.02.2019;06:55:04;85643451;85562745;80706;
15.02.2019;06:56:04;85643512;85562823;80689;
15.02.2019;06:57:05;85643579;85562910;80669;
15.02.2019;06:58:05;85643661;85563020;80641;
15.02.2019;06:59:04;85643739;85563112;80627;
15.02.2019;07:00:05;85643813;85563207;80606;
15.02.2019;07:01:05;85643894;85563307;80587;
15.02.2019;07:02:04;85643969;85563423;80546;
15.02.2019;07:03:04;85644039;85563522;80517;
15.02.2019;07:04:05;85644111;85563630;80481;
15.02.2019;07:05:04;85644200;85563751;80449;
15.02.2019;07:06:04;85644283;85563831;80452;
15.02.2019;07:07:05;85644356;85563953;80403;
15.02.2019;07:08:04;85644423;85564037;80386;
15.02.2019;07:09:04;85644479;85564148;80331;
15.02.2019;07:10:05;85644563;85564269;80294;
15.02.2019;07:11:04;85644623;85564360;80263;
15.02.2019;07:12:04;85644689;85564445;80244;
15.02.2019;07:13:04;85644758;85564549;80209;
15.02.2019;07:14:04;85644833;85564657;80176;
15.02.2019;07:15:05;85644905;85564758;80147;
15.02.2019;07:16:05;85644974;85564892;80082;
15.02.2019;07:17:04;85645050;85564987;80063;
15.02.2019;07:18:04;85645093;85565086;80007;
15.02.2019;07:19:05;85645153;85565193;79960;
15.02.2019;07:20:04;85645256;85565314;79942;
15.02.2019;07:21:04;85645337;85565413;79924;
15.02.2019;07:22:05;85645389;85565517;79872;
15.02.2019;07:23:04;85645458;85565623;79835;
15.02.2019;07:24:04;85645554;85565739;79815;
15.02.2019;07:25:05;85645638;85565844;79794;
15.02.2019;07:26:04;85645717;85565939;79778;
15.02.2019;07:27:04;85645780;85566047;79733;
15.02.2019;07:28:05;85645853;85566132;79721;
15.02.2019;07:29:04;85645927;85566232;79695;
15.02.2019;07:30:04;85645999;85566339;79660;
15.02.2019;07:31:04;85646071;85566464;79607;
15.02.2019;07:32:04;85646124;85566569;79555;
15.02.2019;07:33:05;85646212;85566630;79582;
15.02.2019;07:34:04;85646279;85566787;79492;
15.02.2019;07:35:05;85646341;85566894;79447;
15.02.2019;07:36:05;85646408;85566992;79416;
15.02.2019;07:37:04;85646471;85567092;79379;
15.02.2019;07:38:10;85646552;85567217;79335;
15.02.2019;07:39:04;85646615;85567328;79287;
15.02.2019;07:40:04;85646669;85567421;79248;
15.02.2019;07:41:05;85646712;85567551;79161;
15.02.2019;07:42:04;85646799;85567660;79139;
15.02.2019;07:43:04;85646858;85567776;79082;
15.02.2019;07:44:05;85646927;85567862;79065;
15.02.2019;07:45:04;85646989;85567960;79029;
15.02.2019;07:46:05;85647062;85568069;78993;
15.02.2019;07:47:04;85647123;85568162;78961;
15.02.2019;07:48:04;85647184;85568277;78907;
15.02.2019;07:49:04;85647265;85568408;78857;
15.02.2019;07:50:04;85647329;85568520;78809;
15.02.2019;07:51:04;85647400;85568638;78762;
15.02.2019;07:52:04;85647473;85568757;78716;
15.02.2019;07:53:05;85647533;85568852;78681;
15.02.2019;07:54:04;85647598;85568967;78631;
15.02.2019;07:55:04;85647654;85569080;78574;
15.02.2019;07:56:04;85647720;85569213;78507;
15.02.2019;07:57:04;85647785;85569325;78460;
15.02.2019;07:58:05;85647855;85569429;78426;
15.02.2019;07:59:09;85647945;85569537;78408;
15.02.2019;08:00:05;85648022;85569636;78386;
15.02.2019;08:01:05;85648079;85569756;78323;
15.02.2019;08:02:04;85648148;85569864;78284;
15.02.2019;08:03:05;85648238;85569990;78248;
15.02.2019;08:04:04;85648296;85570101;78195;
15.02.2019;08:05:05;85648341;85570207;78134;
15.02.2019;08:06:04;85648400;85570317;78083;
15.02.2019;08:07:04;85648430;85570405;78025;
15.02.2019;08:08:04;85648489;85570469;78020;
15.02.2019;08:09:04;85648511;85570591;77920;
15.02.2019;08:10:05;85648535;85570666;77869;
15.02.2019;08:11:05;85648570;85570746;77824;
15.02.2019;08:12:04;85648592;85570831;77761;
15.02.2019;08:13:05;85648627;85570933;77694;
15.02.2019;08:14:04;85648665;85571029;77636;
15.02.2019;08:15:04;85648693;85571115;77578;
15.02.2019;08:16:04;85648726;85571210;77516;
15.02.2019;08:17:04;85648770;85571288;77482;
15.02.2019;08:18:05;85648821;85571361;77460;
15.02.2019;08:19:05;85648874;85571479;77395;
15.02.2019;08:20:05;85648932;85571565;77367;
15.02.2019;08:21:04;85648998;85571674;77324;
15.02.2019;08:22:05;85649051;85571784;77267;
15.02.2019;08:23:05;85649116;85571881;77235;
15.02.2019;08:24:04;85649181;85571998;77183;
15.02.2019;08:25:04;85649243;85572097;77146;
15.02.2019;08:26:04;85649307;85572186;77121;
15.02.2019;08:27:04;85649359;85572281;77078;
15.02.2019;08:28:05;85649414;85572371;77043;
15.02.2019;08:29:04;85649468;85572496;76972;
15.02.2019;08:30:04;85649533;85572623;76910;
15.02.2019;08:31:05;85649595;85572749;76846;
15.02.2019;08:32:04;85649669;85572843;76826;
15.02.2019;08:33:04;85649746;85572924;76822;
15.02.2019;08:34:05;85649811;85572985;76826;
15.02.2019;08:35:05;85649877;85573058;76819;
15.02.2019;08:36:05;85649939;85573177;76762;
15.02.2019;08:37:04;85650007;85573267;76740;
15.02.2019;08:38:05;85650075;85573367;76708;
15.02.2019;08:39:05;85650124;85573471;76653;
15.02.2019;08:40:04;85650181;85573543;76638;
15.02.2019;08:41:05;85650241;85573639;76602;
15.02.2019;08:42:04;85650302;85573750;76552;
15.02.2019;08:43:04;85650378;85573857;76521;
15.02.2019;08:44:04;85650434;85573973;76461;
15.02.2019;08:45:04;85650511;85574108;76403;
15.02.2019;08:46:05;85650581;85574210;76371;
15.02.2019;08:47:04;85650623;85574301;76322;
15.02.2019;08:48:04;85650682;85574404;76278;
15.02.2019;08:49:04;85650743;85574506;76237;
15.02.2019;08:50:04;85650796;85574604;76192;
15.02.2019;08:51:05;85650873;85574721;76152;
15.02.2019;08:52:04;85650954;85574805;76149;
15.02.2019;08:53:05;85651013;85574903;76110;
15.02.2019;08:54:05;85651085;85575014;76071;
15.02.2019;08:55:04;85651155;85575127;76028;
15.02.2019;08:56:04;85651209;85575245;75964;
15.02.2019;08:57:04;85651263;85575335;75928;
15.02.2019;08:58:04;85651322;85575431;75891;
15.02.2019;08:59:05;85651383;85575540;75843;
15.02.2019;09:00:04;85651463;85575621;75842;
15.02.2019;09:01:04;85651534;85575722;75812;
15.02.2019;09:02:05;85651609;85575832;75777;
15.02.2019;09:03:05;85651669;85575931;75738;
15.02.2019;09:04:04;85651751;85576015;75736;
15.02.2019;09:05:05;85651807;85576126;75681;
15.02.2019;09:06:04;85651888;85576211;75677;
15.02.2019;09:07:04;85651970;85576310;75660;
15.02.2019;09:08:05;85652024;85576425;75599;
15.02.2019;09:09:05;85652087;85576526;75561;
15.02.2019;09:10:05;85652150;85576644;75506;
15.02.2019;09:11:04;85652202;85576755;75447;
15.02.2019;09:12:04;85652260;85576839;75421;
15.02.2019;09:13:05;85652333;85576933;75400;
15.02.2019;09:14:05;85652401;85577036;75365;
15.02.2019;09:15:04;85652466;85577147;75319;
15.02.2019;09:16:04;85652549;85577240;75309;
15.02.2019;09:17:05;85652614;85577334;75280;
15.02.2019;09:18:04;85652664;85577444;75220;
15.02.2019;09:19:04;85652720;85577540;75180;
15.02.2019;09:20:05;85652785;85577654;75131;
15.02.2019;09:21:05;85652847;85577772;75075;
15.02.2019;09:22:05;85652921;85577867;75054;
15.02.2019;09:23:06;85652986;85577975;75011;
15.02.2019;09:24:04;85653049;85578074;74975;
15.02.2019;09:25:05;85653116;85578192;74924;
15.02.2019;09:26:05;85653179;85578311;74868;
15.02.2019;09:27:05;85653231;85578410;74821;
15.02.2019;09:28:05;85653304;85578517;74787;
15.02.2019;09:29:04;85653372;85578636;74736;
15.02.2019;09:30:04;85653423;85578754;74669;
15.02.2019;09:31:05;85653495;85578847;74648;
15.02.2019;09:32:05;85653538;85578960;74578;
15.02.2019;09:33:05;85653605;85579066;74539;
15.02.2019;09:34:05;85653670;85579187;74483;
15.02.2019;09:35:04;85653733;85579290;74443;
15.02.2019;09:36:05;85653796;85579418;74378;
15.02.2019;09:37:05;85653848;85579524;74324;
15.02.2019;09:38:04;85653903;85579613;74290;
15.02.2019;09:39:04;85653981;85579740;74241;
15.02.2019;09:40:05;85654029;85579841;74188;
15.02.2019;09:41:05;85654091;85579948;74143;
15.02.2019;09:42:05;85654158;85580056;74102;
15.02.2019;09:43:05;85654222;85580155;74067;
15.02.2019;09:44:04;85654281;85580257;74024;
15.02.2019;09:45:05;85654332;85580348;73984;
15.02.2019;09:46:05;85654357;85580403;73954;
15.02.2019;09:47:05;85654404;85580508;73896;
15.02.2019;09:48:06;85654466;85580639;73827;
15.02.2019;09:49:05;85654527;85580729;73798;
15.02.2019;09:50:04;85654594;85580830;73764;
15.02.2019;09:51:12;85654669;85580952;73717;
15.02.2019;09:52:06;85654725;85581053;73672;
15.02.2019;09:53:07;85654774;85581147;73627;
15.02.2019;09:54:05;85654839;85581259;73580;
15.02.2019;09:55:05;85654913;85581394;73519;
15.02.2019;09:56:05;85654985;85581534;73451;
15.02.2019;09:57:05;85655042;85581644;73398;
15.02.2019;09:58:06;85655112;85581766;73346;
15.02.2019;09:59:05;85655176;85581883;73293;
15.02.2019;10:00:05;85655225;85581999;73226;
15.02.2019;10:01:04;85655273;85582102;73171;
15.02.2019;10:02:05;85655335;85582224;73111;
15.02.2019;10:03:05;85655392;85582348;73044;
15.02.2019;10:04:04;85655441;85582481;72960;
15.02.2019;10:05:04;85655503;85582590;72913;
15.02.2019;10:06:05;85655573;85582696;72877;
15.02.2019;10:07:05;85655635;85582819;72816;
15.02.2019;10:08:05;85655691;85582927;72764;
15.02.2019;10:09:04;85655718;85583044;72674;
15.02.2019;10:10:04;85655767;85583139;72628;
15.02.2019;10:11:04;85655821;85583229;72592;
15.02.2019;10:12:04;85655853;85583316;72537;
15.02.2019;10:13:05;85655883;85583429;72454;
15.02.2019;10:14:04;85655925;85583535;72390;
15.02.2019;10:15:04;85655947;85583646;72301;
15.02.2019;10:16:05;85655950;85583745;72205;
15.02.2019;10:17:05;85656006;85583824;72182;
15.02.2019;10:18:05;85656057;85583933;72124;
15.02.2019;10:19:04;85656096;85584073;72023;
15.02.2019;10:20:04;85656161;85584200;71961;
15.02.2019;10:21:05;85656215;85584340;71875;
15.02.2019;10:22:04;85656270;85584477;71793;
15.02.2019;10:23:04;85656324;85584611;71713;
15.02.2019;10:24:05;85656384;85584738;71646;
15.02.2019;10:25:04;85656450;85584863;71587;
15.02.2019;10:26:04;85656507;85584978;71529;
15.02.2019;10:28:04;85656650;85585222;71428;
15.02.2019;10:29:05;85656734;85585336;71398;
15.02.2019;10:30:05;85656791;85585453;71338;
15.02.2019;10:31:04;85656854;85585586;71268;
15.02.2019;10:32:04;85656882;85585709;71173;
15.02.2019;10:33:05;85656971;85585853;71118;
15.02.2019;10:34:04;85657034;85585976;71058;
15.02.2019;10:35:05;85657084;85586091;70993;
15.02.2019;10:36:05;85657140;85586208;70932;
15.02.2019;10:37:05;85657205;85586317;70888;
15.02.2019;10:38:04;85657253;85586449;70804;
15.02.2019;10:39:04;85657312;85586560;70752;
15.02.2019;10:40:04;85657387;85586701;70686;
15.02.2019;10:41:05;85657455;85586807;70648;
15.02.2019;10:42:05;85657515;85586909;70606;
15.02.2019;10:43:04;85657573;85587012;70561;
15.02.2019;10:44:04;85657641;85587152;70489;
15.02.2019;10:45:04;85657703;85587261;70442;
15.02.2019;10:46:04;85657755;85587387;70368;
15.02.2019;10:47:05;85657823;85587497;70326;
15.02.2019;10:48:05;85657878;85587639;70239;
15.02.2019;10:49:07;85657938;85587770;70168;
15.02.2019;10:50:05;85657987;85587865;70122;
15.02.2019;10:51:04;85658059;85587988;70071;
15.02.2019;10:52:06;85658125;85588112;70013;
15.02.2019;10:53:04;85658171;85588225;69946;
15.02.2019;10:54:05;85658236;85588358;69878;
15.02.2019;10:55:04;85658292;85588472;69820;
15.02.2019;10:56:05;85658355;85588623;69732;
15.02.2019;10:57:06;85658404;85588735;69669;
15.02.2019;10:58:05;85658470;85588863;69607;
15.02.2019;10:59:05;85658547;85589010;69537;
15.02.2019;11:00:05;85658605;85589120;69485;
15.02.2019;11:01:05;85658659;85589260;69399;
15.02.2019;11:02:04;85658707;85589367;69340;
15.02.2019;11:03:06;85658764;85589502;69262;
15.02.2019;11:04:05;85658820;85589615;69205;
15.02.2019;11:05:04;85658886;85589740;69146;
15.02.2019;11:06:04;85658954;85589845;69109;
15.02.2019;11:07:05;85659022;85589983;69039;
15.02.2019;11:08:05;85659096;85590104;68992;
15.02.2019;11:09:05;85659153;85590245;68908;
15.02.2019;11:10:04;85659219;85590376;68843;
15.02.2019;11:11:04;85659275;85590497;68778;
15.02.2019;11:12:05;85659348;85590626;68722;
15.02.2019;11:13:04;85659405;85590731;68674;
15.02.2019;11:14:04;85659474;85590867;68607;
15.02.2019;11:15:04;85659543;85590969;68574;
15.02.2019;11:16:05;85659600;85591098;68502;
15.02.2019;11:17:05;85659657;85591198;68459;
15.02.2019;11:18:04;85659732;85591329;68403;
15.02.2019;11:19:05;85659796;85591452;68344;
15.02.2019;11:20:05;85659876;85591557;68319;
15.02.2019;11:21:04;85659944;85591669;68275;
15.02.2019;11:22:04;85660020;85591782;68238;
15.02.2019;11:23:05;85660098;85591893;68205;
15.02.2019;11:24:04;85660146;85592008;68138;
15.02.2019;11:25:04;85660219;85592116;68103;
15.02.2019;11:26:04;85660299;85592222;68077;
15.02.2019;11:27:05;85660368;85592329;68039;
15.02.2019;11:28:05;85660418;85592439;67979;
15.02.2019;11:29:04;85660484;85592568;67916;
15.02.2019;11:30:05;85660543;85592695;67848;
15.02.2019;11:31:05;85660612;85592813;67799;
15.02.2019;11:32:04;85660668;85592939;67729;
15.02.2019;11:33:04;85660739;85593068;67671;
15.02.2019;11:34:05;85660805;85593197;67608;
15.02.2019;11:35:05;85660883;85593319;67564;
15.02.2019;11:36:05;85660953;85593450;67503;
15.02.2019;11:37:04;85661017;85593578;67439;
15.02.2019;11:38:04;85661081;85593674;67407;
15.02.2019;11:39:05;85661156;85593801;67355;
15.02.2019;11:40:04;85661221;85593930;67291;
15.02.2019;11:41:05;85661274;85594048;67226;
15.02.2019;11:42:05;85661320;85594172;67148;
15.02.2019;11:43:11;85661389;85594322;67067;
15.02.2019;11:44:04;85661442;85594424;67018;
15.02.2019;11:45:05;85661497;85594584;66913;
15.02.2019;11:46:05;85661561;85594706;66855;
15.02.2019;11:47:05;85661616;85594836;66780;
15.02.2019;11:48:05;85661686;85594946;66740;
15.02.2019;11:49:04;85661759;85595049;66710;
15.02.2019;11:50:04;85661809;85595144;66665;
15.02.2019;11:51:06;85661884;85595258;66626;
15.02.2019;11:52:05;85661963;85595362;66601;
15.02.2019;11:53:04;85662031;85595502;66529;
15.02.2019;11:54:04;85662091;85595634;66457;
15.02.2019;11:55:05;85662149;85595755;66394;
15.02.2019;11:56:04;85662218;85595871;66347;
15.02.2019;11:57:04;85662281;85595985;66296;
15.02.2019;11:58:05;85662347;85596111;66236;
15.02.2019;11:59:05;85662423;85596229;66194;
15.02.2019;12:00:04;85662475;85596345;66130;
15.02.2019;12:01:05;85662539;85596465;66074;
15.02.2019;12:02:05;85662574;85596548;66026;
15.02.2019;12:03:04;85662591;85596620;65971;
15.02.2019;12:04:05;85662612;85596693;65919;
15.02.2019;12:05:05;85662654;85596784;65870;
15.02.2019;12:06:05;85662698;85596886;65812;
15.02.2019;12:07:04;85662754;85597015;65739;
15.02.2019;12:08:05;85662792;85597134;65658;
15.02.2019;12:09:06;85662854;85597237;65617;
15.02.2019;12:10:05;85662923;85597346;65577;
15.02.2019;12:11:05;85663004;85597470;65534;
15.02.2019;12:12:04;85663075;85597580;65495;
15.02.2019;12:13:05;85663133;85597718;65415;
15.02.2019;12:14:05;85663202;85597840;65362;
15.02.2019;12:15:05;85663272;85597965;65307;
15.02.2019;12:16:05;85663345;85598101;65244;
15.02.2019;12:17:05;85663400;85598209;65191;
15.02.2019;12:18:05;85663455;85598313;65142;
15.02.2019;12:19:05;85663511;85598434;65077;
15.02.2019;12:20:04;85663585;85598579;65006;
15.02.2019;12:21:04;85663665;85598714;64951;
15.02.2019;12:22:05;85663731;85598831;64900;
15.02.2019;12:23:04;85663768;85598969;64799;
15.02.2019;12:24:04;85663826;85599085;64741;
15.02.2019;12:25:05;85663908;85599225;64683;
15.02.2019;12:26:04;85663984;85599347;64637;
15.02.2019;12:27:04;85664048;85599476;64572;
15.02.2019;12:28:05;85664102;85599610;64492;
15.02.2019;12:29:04;85664177;85599716;64461;
15.02.2019;12:30:04;85664250;85599859;64391;
15.02.2019;12:31:05;85664327;85599971;64356;
15.02.2019;12:32:04;85664405;85600113;64292;
15.02.2019;12:33:04;85664488;85600220;64268;
15.02.2019;12:34:05;85664567;85600326;64241;
15.02.2019;12:35:04;85664641;85600460;64181;
15.02.2019;12:36:04;85664718;85600557;64161;
15.02.2019;12:37:05;85664803;85600685;64118;
15.02.2019;12:38:04;85664869;85600790;64079;
15.02.2019;12:39:04;85664939;85600921;64018;
15.02.2019;12:40:04;85665022;85601047;63975;
15.02.2019;12:41:05;85665100;85601186;63914;
15.02.2019;12:42:04;85665182;85601313;63869;
15.02.2019;12:43:04;85665253;85601428;63825;
15.02.2019;12:44:05;85665320;85601558;63762;
15.02.2019;12:45:05;85665396;85601666;63730;
15.02.2019;12:46:04;85665264;85601506;63758;
15.02.2019;12:47:05;85665076;85600849;64227;
15.02.2019;12:48:04;85665149;85600950;64199;
15.02.2019;12:49:04;85665223;85601075;64148;
15.02.2019;12:50:05;85665290;85601207;64083;
15.02.2019;12:51:04;85665363;85601325;64038;
15.02.2019;12:52:04;85665429;85601455;63974;
15.02.2019;12:53:05;85665497;85601591;63906;
15.02.2019;12:54:05;85665573;85601723;63850;
15.02.2019;12:55:04;85665645;85601882;63763;
15.02.2019;12:56:05;85665731;85601990;63741;
15.02.2019;12:57:05;85665829;85602130;63699;
15.02.2019;12:58:04;85665926;85602261;63665;
15.02.2019;12:59:04;85666002;85602389;63613;
15.02.2019;13:00:05;85666103;85602520;63583;
15.02.2019;13:01:06;85666191;85602645;63546;
15.02.2019;13:02:05;85666280;85602753;63527;
15.02.2019;13:04:04;85666426;85603036;63390;
15.02.2019;13:05:05;85666505;85603185;63320;
15.02.2019;13:06:04;85666588;85603305;63283;
15.02.2019;13:07:04;85666672;85603435;63237;
15.02.2019;13:08:05;85666754;85603553;63201;
15.02.2019;13:09:05;85666843;85603659;63184;
15.02.2019;13:10:05;85666933;85603817;63116;
15.02.2019;13:11:05;85667008;85603946;63062;
15.02.2019;13:12:05;85667105;85604050;63055;
15.02.2019;13:13:05;85667201;85604187;63014;
15.02.2019;13:14:05;85667282;85604326;62956;
15.02.2019;13:15:05;85667371;85604441;62930;
15.02.2019;13:16:05;85667444;85604548;62896;
15.02.2019;13:17:05;85667523;85604656;62867;
15.02.2019;13:18:04;85667598;85604801;62797;
15.02.2019;13:19:04;85667673;85604940;62733;
15.02.2019;13:20:05;85667745;85605064;62681;
15.02.2019;13:21:05;85667853;85605206;62647;
15.02.2019;13:22:04;85667946;85605332;62614;
15.02.2019;13:23:04;85668030;85605461;62569;
15.02.2019;13:24:05;85668103;85605578;62525;
15.02.2019;13:25:04;85668185;85605724;62461;
15.02.2019;13:26:08;85668282;85605854;62428;
15.02.2019;13:27:04;85668369;85605982;62387;
15.02.2019;13:28:05;85668462;85606114;62348;
15.02.2019;13:29:04;85668547;85606247;62300;
15.02.2019;13:30:04;85668637;85606386;62251;
15.02.2019;13:31:04;85668714;85606511;62203;
15.02.2019;13:32:05;85668797;85606652;62145;
15.02.2019;13:33:04;85668886;85606761;62125;
15.02.2019;13:34:04;85668989;85606902;62087;
15.02.2019;13:35:05;85669087;85607043;62044;
15.02.2019;13:36:04;85669178;85607167;62011;
15.02.2019;13:37:05;85669287;85607284;62003;
15.02.2019;13:38:05;85669412;85607423;61989;
15.02.2019;13:39:05;85669512;85607570;61942;
15.02.2019;13:40:04;85669604;85607684;61920;
15.02.2019;13:41:04;85669693;85607810;61883;
15.02.2019;13:42:05;85669804;85607949;61855;
15.02.2019;13:43:04;85669884;85608065;61819;
15.02.2019;13:44:05;85670000;85608216;61784;
15.02.2019;13:45:05;85670103;85608330;61773;
15.02.2019;13:46:04;85670184;85608452;61732;
15.02.2019;13:47:04;85670307;85608580;61727;
15.02.2019;13:48:04;85670411;85608710;61701;
15.02.2019;13:49:05;85670512;85608845;61667;
15.02.2019;13:50:05;85670625;85608987;61638;
15.02.2019;13:51:05;85670723;85609127;61596;
15.02.2019;13:52:07;85670814;85609275;61539;
15.02.2019;13:53:05;85670906;85609385;61521;
15.02.2019;13:54:05;85671004;85609529;61475;
15.02.2019;13:55:05;85671083;85609693;61390;
15.02.2019;13:56:05;85671214;85609856;61358;
15.02.2019;13:57:05;85671329;85609978;61351;
15.02.2019;13:58:04;85671425;85610119;61306;
15.02.2019;13:59:05;85671540;85610279;61261;
15.02.2019;14:00:05;85671656;85610418;61238;
15.02.2019;14:01:05;85671746;85610549;61197;
15.02.2019;14:02:04;85671861;85610675;61186;
15.02.2019;14:03:04;85671961;85610820;61141;
15.02.2019;14:04:04;85672063;85610965;61098;
15.02.2019;14:05:05;85672166;85611087;61079;
15.02.2019;14:06:05;85672275;85611232;61043;
15.02.2019;14:07:05;85672373;85611350;61023;
15.02.2019;14:08:05;85672471;85611469;61002;
15.02.2019;14:09:10;85672559;85611639;60920;
15.02.2019;14:10:13;85672655;85611783;60872;
15.02.2019;14:11:04;85672752;85611890;60862;
15.02.2019;14:12:05;85672851;85612035;60816;
15.02.2019;14:13:05;85672918;85612165;60753;
15.02.2019;14:14:05;85673000;85612274;60726;
15.02.2019;14:15:04;85673075;85612413;60662;
15.02.2019;14:16:04;85673158;85612539;60619;
15.02.2019;14:17:04;85673254;85612667;60587;
15.02.2019;14:18:04;85673350;85612790;60560;
15.02.2019;14:19:04;85673448;85612910;60538;
15.02.2019;14:20:05;85673552;85613027;60525;
15.02.2019;14:21:04;85673672;85613140;60532;
15.02.2019;14:22:04;85673756;85613267;60489;
15.02.2019;14:23:04;85673845;85613416;60429;
15.02.2019;14:24:05;85673963;85613551;60412;
15.02.2019;14:25:05;85674070;85613684;60386;
15.02.2019;14:26:04;85674174;85613808;60366;
15.02.2019;14:27:04;85674250;85613926;60324;
15.02.2019;14:28:05;85674347;85614070;60277;
15.02.2019;14:29:04;85674425;85614180;60245;
15.02.2019;14:30:04;85674502;85614306;60196;
15.02.2019;14:31:04;85674606;85614437;60169;
15.02.2019;14:32:05;85674689;85614567;60122;
15.02.2019;14:33:06;85674804;85614681;60123;
15.02.2019;14:34:05;85674905;85614795;60110;
15.02.2019;14:35:05;85675015;85614944;60071;
15.02.2019;14:36:04;85675117;85615090;60027;
15.02.2019;14:37:05;85675210;85615229;59981;
15.02.2019;14:38:05;85675284;85615389;59895;
15.02.2019;14:39:05;85675392;85615536;59856;
15.02.2019;14:40:04;85675496;85615647;59849;
15.02.2019;14:41:05;85675593;85615776;59817;
15.02.2019;14:42:06;85675691;85615938;59753;
15.02.2019;14:43:04;85675771;85616079;59692;
15.02.2019;14:44:09;85675811;85616211;59600;
15.02.2019;14:45:06;85675947;85616339;59608;
15.02.2019;14:46:05;85676026;85616471;59555;
15.02.2019;14:47:05;85676127;85616590;59537;
15.02.2019;14:48:04;85676234;85616734;59500;
15.02.2019;14:49:05;85676342;85616883;59459;
15.02.2019;14:50:05;85676438;85617029;59409;
15.02.2019;14:51:05;85676553;85617181;59372;
15.02.2019;14:52:05;85676653;85617332;59321;
15.02.2019;14:53:04;85676750;85617473;59277;
15.02.2019;14:54:04;85676863;85617619;59244;
15.02.2019;14:55:05;85676964;85617763;59201;
15.02.2019;14:56:05;85677057;85617928;59129;
15.02.2019;14:57:05;85677172;85618090;59082;
15.02.2019;14:58:06;85677293;85618236;59057;
15.02.2019;14:59:05;85677409;85618369;59040;
15.02.2019;15:00:08;85677539;85618512;59027;
15.02.2019;15:01:07;85677631;85618668;58963;
15.02.2019;15:02:08;85677738;85618808;58930;
15.02.2019;15:03:06;85677855;85618941;58914;
15.02.2019;15:04:08;85677960;85619092;58868;
15.02.2019;15:05:07;85678097;85619246;58851;
15.02.2019;15:06:09;85678200;85619403;58797;
15.02.2019;15:07:07;85678304;85619543;58761;
15.02.2019;15:08:06;85678403;85619690;58713;
15.02.2019;15:09:08;85678533;85619876;58657;
15.02.2019;15:10:06;85678640;85620030;58610;
15.02.2019;15:11:08;85678771;85620158;58613;
15.02.2019;15:12:08;85678874;85620297;58577;
15.02.2019;15:13:08;85678991;85620441;58550;
15.02.2019;15:14:23;85679124;85620598;58526;
15.02.2019;15:15:09;85679215;85620717;58498;
15.02.2019;15:16:07;85679307;85620875;58432;
15.02.2019;15:17:08;85679425;85621024;58401;
15.02.2019;15:18:07;85679537;85621158;58379;
15.02.2019;15:19:15;85679676;85621330;58346;
15.02.2019;15:20:12;85679779;85621484;58295;
15.02.2019;15:21:10;85679881;85621637;58244;
15.02.2019;15:22:15;85680012;85621772;58240;
15.02.2019;15:23:10;85680101;85621897;58204;
15.02.2019;15:24:07;85680219;85622068;58151;
15.02.2019;15:25:11;85680345;85622231;58114;
15.02.2019;15:26:07;85680444;85622384;58060;
15.02.2019;15:27:07;85680559;85622540;58019;
15.02.2019;15:28:07;85680644;85622712;57932;
15.02.2019;15:29:07;85680748;85622859;57889;
15.02.2019;15:30:07;85680861;85623043;57818;
15.02.2019;15:31:08;85681009;85623183;57826;
15.02.2019;15:32:13;85681113;85623343;57770;
15.02.2019;15:33:08;85681238;85623492;57746;
15.02.2019;15:34:08;85681332;85623650;57682;
15.02.2019;15:35:08;85681432;85623773;57659;
15.02.2019;15:36:08;85681530;85623935;57595;
15.02.2019;15:37:06;85681630;85624075;57555;
15.02.2019;15:38:08;85681740;85624230;57510;
15.02.2019;15:39:07;85681847;85624340;57507;
15.02.2019;15:40:07;85681960;85624491;57469;
15.02.2019;15:41:08;85682066;85624676;57390;
15.02.2019;15:42:09;85682161;85624823;57338;
15.02.2019;15:43:08;85682273;85624968;57305;
15.02.2019;15:44:07;85682367;85625100;57267;
15.02.2019;15:45:08;85682485;85625224;57261;
15.02.2019;15:46:08;85682599;85625367;57232;
15.02.2019;15:47:07;85682709;85625483;57226;
15.02.2019;15:48:08;85682824;85625629;57195;
15.02.2019;15:49:08;85682942;85625792;57150;
15.02.2019;15:50:14;85683065;85625941;57124;
15.02.2019;15:51:06;85683181;85626044;57137;
15.02.2019;15:52:08;85683292;85626198;57094;
15.02.2019;15:53:08;85683402;85626347;57055;
15.02.2019;15:54:08;85683513;85626486;57027;
15.02.2019;15:55:08;85683635;85626644;56991;
15.02.2019;15:56:07;85683735;85626788;56947;
15.02.2019;15:57:11;85683839;85626929;56910;
15.02.2019;15:58:11;85683953;85627070;56883;
15.02.2019;15:59:13;85684082;85627222;56860;
15.02.2019;16:00:07;85684164;85627348;56816;
15.02.2019;16:01:07;85684285;85627493;56792;
15.02.2019;16:02:05;85684410;85627637;56773;
15.02.2019;16:03:05;85684532;85627798;56734;
15.02.2019;16:04:05;85684651;85627962;56689;
15.02.2019;16:05:05;85684784;85628113;56671;
15.02.2019;16:06:04;85684910;85628270;56640;
15.02.2019;16:07:05;85685021;85628405;56616;
15.02.2019;16:08:05;85685153;85628582;56571;
15.02.2019;16:09:09;85685259;85628755;56504;
15.02.2019;16:10:05;85685357;85628903;56454;
15.02.2019;16:11:05;85685475;85629070;56405;
15.02.2019;16:12:10;85685583;85629219;56364;
15.02.2019;16:13:05;85685678;85629381;56297;
15.02.2019;16:14:05;85685816;85629534;56282;
15.02.2019;16:15:05;85685884;85629652;56232;
15.02.2019;16:16:06;85685904;85629781;56123;
15.02.2019;16:17:05;85685913;85629868;56045;
15.02.2019;16:18:05;85685966;85629961;56005;
15.02.2019;16:19:05;85686029;85630122;55907;
15.02.2019;16:20:07;85686157;85630282;55875;
15.02.2019;16:21:06;85686253;85630456;55797;
15.02.2019;16:22:05;85686361;85630627;55734;
15.02.2019;16:23:05;85686457;85630791;55666;
15.02.2019;16:24:06;85686561;85630953;55608;
15.02.2019;16:25:04;85686681;85631131;55550;
15.02.2019;16:26:05;85686802;85631300;55502;
15.02.2019;16:27:12;85686917;85631490;55427;
15.02.2019;16:28:10;85687016;85631628;55388;
15.02.2019;16:29:05;85687123;85631781;55342;
15.02.2019;16:30:05;85687251;85631944;55307;
15.02.2019;16:31:05;85687362;85632097;55265;
15.02.2019;16:32:05;85687491;85632252;55239;
15.02.2019;16:33:05;85687602;85632431;55171;
15.02.2019;16:34:11;85687734;85632614;55120;
15.02.2019;16:35:05;85687821;85632755;55066;
15.02.2019;16:36:05;85687926;85632914;55012;
15.02.2019;16:37:10;85688065;85633083;54982;
15.02.2019;16:38:06;85688184;85633207;54977;
15.02.2019;16:39:05;85688290;85633342;54948;
15.02.2019;16:40:05;85688393;85633504;54889;
15.02.2019;16:41:05;85688526;85633675;54851;
15.02.2019;16:42:05;85688650;85633822;54828;
15.02.2019;16:43:05;85688772;85633994;54778;
15.02.2019;16:44:04;85688879;85634148;54731;
15.02.2019;16:45:04;85689012;85634309;54703;
15.02.2019;16:46:05;85689128;85634474;54654;
15.02.2019;16:47:04;85689239;85634627;54612;
15.02.2019;16:48:05;85689356;85634771;54585;
15.02.2019;16:49:14;85689455;85634982;54473;
15.02.2019;16:50:05;85689560;85635098;54462;
15.02.2019;16:51:06;85689683;85635239;54444;
15.02.2019;16:52:11;85689803;85635410;54393;
15.02.2019;16:53:05;85689902;85635535;54367;
15.02.2019;16:54:05;85690016;85635692;54324;
15.02.2019;16:55:04;85690135;85635828;54307;
15.02.2019;16:56:04;85690252;85635992;54260;
15.02.2019;16:57:05;85690408;85636144;54264;
15.02.2019;16:58:05;85690504;85636298;54206;
15.02.2019;16:59:05;85690646;85636430;54216;
15.02.2019;17:00:05;85690751;85636582;54169;
15.02.2019;17:01:05;85690845;85636699;54146;
15.02.2019;17:02:05;85690965;85636848;54117;
15.02.2019;17:03:05;85691085;85636998;54087;
15.02.2019;17:04:04;85691211;85637157;54054;
15.02.2019;17:05:05;85691285;85637327;53958;
15.02.2019;17:06:05;85691447;85637514;53933;
15.02.2019;17:07:04;85691561;85637688;53873;
15.02.2019;17:08:05;85691663;85637839;53824;
15.02.2019;17:09:06;85691794;85638013;53781;
15.02.2019;17:10:05;85691906;85638142;53764;
15.02.2019;17:11:06;85692023;85638311;53712;
15.02.2019;17:12:05;85692138;85638476;53662;
15.02.2019;17:13:05;85692276;85638615;53661;
15.02.2019;17:14:04;85692386;85638790;53596;
15.02.2019;17:15:05;85692502;85638964;53538;
15.02.2019;17:16:05;85692626;85639115;53511;
15.02.2019;17:17:05;85692746;85639288;53458;
15.02.2019;17:18:05;85692863;85639453;53410;
15.02.2019;17:19:06;85692972;85639610;53362;
15.02.2019;17:20:05;85693080;85639764;53316;
15.02.2019;17:21:05;85693197;85639929;53268;
15.02.2019;17:22:06;85693295;85640125;53170;
15.02.2019;17:23:05;85693418;85640264;53154;
15.02.2019;17:24:05;85693527;85640417;53110;
15.02.2019;17:25:06;85693641;85640596;53045;
15.02.2019;17:26:05;85693789;85640741;53048;
15.02.2019;17:27:05;85693889;85640898;52991;
15.02.2019;17:28:11;85694010;85641076;52934;
15.02.2019;17:29:05;85694138;85641213;52925;
15.02.2019;17:30:06;85694256;85641381;52875;
15.02.2019;17:32:05;85694534;85641666;52868;
15.02.2019;17:33:05;85694640;85641827;52813;
15.02.2019;17:34:05;85694759;85641968;52791;
15.02.2019;17:35:09;85694878;85642117;52761;
15.02.2019;17:36:05;85695000;85642251;52749;
15.02.2019;17:37:05;85695110;85642387;52723;
15.02.2019;17:38:05;85695261;85642536;52725;
15.02.2019;17:39:05;85695366;85642708;52658;
15.02.2019;17:40:05;85695481;85642843;52638;
15.02.2019;17:41:05;85695581;85642981;52600;
15.02.2019;17:42:04;85695681;85643146;52535;
15.02.2019;17:43:05;85695811;85643312;52499;
15.02.2019;17:44:05;85695918;85643458;52460;
15.02.2019;17:45:05;85696028;85643583;52445;
15.02.2019;17:47:06;85696252;85643906;52346;
15.02.2019;17:48:04;85696367;85644034;52333;
15.02.2019;17:49:04;85696477;85644204;52273;
15.02.2019;17:50:05;85696592;85644354;52238;
15.02.2019;17:51:05;85696734;85644520;52214;
15.02.2019;17:52:05;85696839;85644669;52170;
15.02.2019;17:53:05;85696929;85644831;52098;
15.02.2019;17:54:04;85697040;85644991;52049;
15.02.2019;17:55:09;85697178;85645159;52019;
15.02.2019;17:56:05;85697290;85645305;51985;
15.02.2019;17:57:06;85697419;85645452;51967;
15.02.2019;17:58:05;85697543;85645588;51955;
15.02.2019;17:59:05;85697658;85645718;51940;
15.02.2019;18:00:05;85697776;85645883;51893;
15.02.2019;18:01:05;85697906;85646022;51884;
15.02.2019;18:02:04;85698041;85646188;51853;
15.02.2019;18:03:04;85698135;85646307;51828;
15.02.2019;18:04:05;85698236;85646467;51769;
15.02.2019;18:05:05;85698362;85646625;51737;
15.02.2019;18:06:05;85698496;85646791;51705;
15.02.2019;18:07:05;85698603;85646926;51677;
15.02.2019;18:08:05;85698685;85647071;51614;
15.02.2019;18:09:05;85698800;85647231;51569;
15.02.2019;18:10:09;85698936;85647370;51566;
15.02.2019;18:11:05;85699046;85647506;51540;
15.02.2019;18:12:05;85699153;85647616;51537;
15.02.2019;18:13:05;85699260;85647734;51526;
15.02.2019;18:14:05;85699353;85647872;51481;
15.02.2019;18:15:05;85699470;85648000;51470;
15.02.2019;18:16:05;85699563;85648131;51432;
15.02.2019;18:17:05;85699659;85648236;51423;
15.02.2019;18:18:06;85699776;85648362;51414;
15.02.2019;18:19:06;85699895;85648492;51403;
15.02.2019;18:20:04;85700009;85648595;51414;
15.02.2019;18:21:04;85700121;85648718;51403;
15.02.2019;18:22:05;85700218;85648826;51392;
15.02.2019;18:23:05;85700317;85648951;51366;
15.02.2019;18:24:05;85700414;85649048;51366;
15.02.2019;18:25:05;85700535;85649150;51385;
15.02.2019;18:26:04;85700585;85649265;51320;
15.02.2019;18:27:04;85700721;85649397;51324;
15.02.2019;18:28:05;85700791;85649519;51272;
15.02.2019;18:29:05;85700900;85649651;51249;
15.02.2019;18:30:05;85700984;85649776;51208;
15.02.2019;18:31:04;85701085;85649878;51207;
15.02.2019;18:32:05;85701173;85650001;51172;
15.02.2019;18:33:04;85701267;85650131;51136;
15.02.2019;18:34:04;85701362;85650264;51098;
15.02.2019;18:35:05;85701466;85650405;51061;
15.02.2019;18:36:05;85701585;85650510;51075;
15.02.2019;18:37:04;85701687;85650634;51053;
15.02.2019;18:38:05;85701797;85650753;51044;
15.02.2019;18:39:05;85701917;85650858;51059;
15.02.2019;18:40:04;85702022;85650957;51065;
15.02.2019;18:41:05;85702143;85651107;51036;
15.02.2019;18:42:05;85702258;85651207;51051;
15.02.2019;18:43:05;85702338;85651347;50991;
15.02.2019;18:44:05;85702451;85651485;50966;
15.02.2019;18:45:05;85702559;85651578;50981;
15.02.2019;18:46:05;85702658;85651674;50984;
15.02.2019;18:47:04;85702773;85651794;50979;
15.02.2019;18:48:04;85702894;85651934;50960;
15.02.2019;18:49:04;85702997;85652062;50935;
15.02.2019;18:50:05;85703125;85652166;50959;
15.02.2019;18:51:04;85703266;85652315;50951;
15.02.2019;18:52:05;85703410;85652417;50993;
15.02.2019;18:53:05;85703528;85652529;50999;
15.02.2019;18:54:10;85703659;85652643;51016;
15.02.2019;18:55:04;85703764;85652748;51016;
15.02.2019;18:56:04;85703870;85652890;50980;
15.02.2019;18:57:05;85703973;85653017;50956;
15.02.2019;18:58:18;85704098;85653143;50955;
15.02.2019;18:59:05;85704181;85653245;50936;
15.02.2019;19:00:05;85704305;85653358;50947;
15.02.2019;19:01:05;85704413;85653484;50929;
15.02.2019;19:02:05;85704515;85653588;50927;
15.02.2019;19:03:04;85704618;85653708;50910;
15.02.2019;19:04:05;85704723;85653824;50899;
15.02.2019;19:05:05;85704846;85653946;50900;
15.02.2019;19:06:05;85704959;85654059;50900;
15.02.2019;19:07:06;85705079;85654163;50916;
15.02.2019;19:08:11;85705194;85654285;50909;
15.02.2019;19:09:05;85705294;85654396;50898;
15.02.2019;19:10:05;85705415;85654484;50931;
15.02.2019;19:11:06;85705520;85654591;50929;
15.02.2019;19:12:04;85705647;85654702;50945;
15.02.2019;19:13:13;85705780;85654787;50993;
15.02.2019;19:14:14;85705898;85654908;50990;
15.02.2019;19:15:17;85706037;85655029;51008;
15.02.2019;19:16:12;85706118;85655112;51006;
15.02.2019;19:17:11;85706241;85655236;51005;
15.02.2019;19:18:12;85706345;85655333;51012;
15.02.2019;19:19:18;85706436;85655437;50999;
15.02.2019;19:20:16;85706542;85655535;51007;
15.02.2019;19:21:12;85706624;85655559;51065;
15.02.2019;19:22:10;85706753;85655655;51098;
15.02.2019;19:23:09;85706883;85655767;51116;
15.02.2019;19:24:15;85707010;85655870;51140;
15.02.2019;19:25:10;85707126;85655977;51149;
15.02.2019;19:26:12;85707247;85656098;51149;
15.02.2019;19:27:12;85707384;85656169;51215;
15.02.2019;19:28:11;85707488;85656278;51210;
15.02.2019;19:29:09;85707609;85656369;51240;
15.02.2019;19:30:14;85707724;85656467;51257;
15.02.2019;19:31:12;85707866;85656540;51326;
15.02.2019;19:32:09;85707998;85656635;51363;
15.02.2019;19:33:10;85708108;85656718;51390;
15.02.2019;19:34:17;85708255;85656803;51452;
15.02.2019;19:35:07;85708370;85656879;51491;
15.02.2019;19:36:09;85708509;85656983;51526;
15.02.2019;19:37:12;85708633;85657085;51548;
15.02.2019;19:38:20;85708758;85657169;51589;
15.02.2019;19:39:09;85708865;85657251;51614;
15.02.2019;19:40:13;85708980;85657330;51650;
15.02.2019;19:41:10;85709103;85657418;51685;
15.02.2019;19:42:13;85709201;85657493;51708;
15.02.2019;19:43:09;85709338;85657581;51757;
15.02.2019;19:44:10;85709456;85657665;51791;
15.02.2019;19:45:10;85709575;85657758;51817;
15.02.2019;19:46:13;85709704;85657842;51862;
15.02.2019;19:47:08;85709778;85657918;51860;
15.02.2019;19:49:13;85710006;85658074;51932;
15.02.2019;19:50:12;85710124;85658147;51977;
15.02.2019;19:51:14;85710202;85658233;51969;
15.02.2019;19:52:11;85710221;85658330;51891;
15.02.2019;19:53:04;85710279;85658382;51897;
15.02.2019;19:54:04;85710337;85658463;51874;
15.02.2019;19:55:04;85710411;85658556;51855;
15.02.2019;19:56:08;85710496;85658639;51857;
15.02.2019;19:57:05;85710586;85658749;51837;
15.02.2019;19:58:05;85710682;85658850;51832;
15.02.2019;19:59:08;85710774;85658933;51841;
15.02.2019;20:00:05;85710821;85659000;51821;
15.02.2019;20:01:04;85710932;85659083;51849;
15.02.2019;20:02:05;85710985;85659162;51823;
15.02.2019;20:03:09;85711117;85659239;51878;
15.02.2019;20:04:05;85711187;85659310;51877;
15.02.2019;20:05:04;85711282;85659375;51907;
15.02.2019;20:06:08;85711357;85659447;51910;
15.02.2019;20:07:06;85711442;85659507;51935;
15.02.2019;20:08:07;85711546;85659578;51968;
15.02.2019;20:09:05;85711645;85659674;51971;
15.02.2019;20:11:06;85711850;85659815;52035;
15.02.2019;20:12:05;85711952;85659886;52066;
15.02.2019;20:13:05;85712074;85659970;52104;
15.02.2019;20:14:05;85712224;85660063;52161;
15.02.2019;20:15:06;85712331;85660126;52205;
15.02.2019;20:16:05;85712449;85660208;52241;
15.02.2019;20:17:05;85712560;85660261;52299;
15.02.2019;20:18:05;85712640;85660316;52324;
15.02.2019;20:19:05;85712746;85660363;52383;
15.02.2019;20:20:05;85712834;85660427;52407;
15.02.2019;20:21:05;85712908;85660487;52421;
15.02.2019;20:22:04;85713002;85660520;52482;
15.02.2019;20:23:10;85713073;85660590;52483;
15.02.2019;20:24:06;85713181;85660656;52525;
15.02.2019;20:25:06;85713252;85660718;52534;
15.02.2019;20:26:05;85713322;85660755;52567;
15.02.2019;20:27:07;85713410;85660833;52577;
15.02.2019;20:28:05;85713491;85660893;52598;
15.02.2019;20:29:10;85713587;85660960;52627;
15.02.2019;20:30:06;85713675;85661021;52654;
15.02.2019;20:31:05;85713775;85661061;52714;
15.02.2019;20:32:05;85713811;85661128;52683;
15.02.2019;20:33:05;85713822;85661185;52637;
15.02.2019;20:34:05;85713866;85661242;52624;
15.02.2019;20:35:05;85713937;85661316;52621;
15.02.2019;20:36:11;85713990;85661370;52620;
15.02.2019;20:37:05;85714049;85661420;52629;
15.02.2019;20:38:05;85714116;85661477;52639;
15.02.2019;20:39:05;85714192;85661497;52695;
15.02.2019;20:40:05;85714266;85661564;52702;
15.02.2019;20:41:05;85714314;85661618;52696;
15.02.2019;20:42:06;85714397;85661680;52717;
15.02.2019;20:43:05;85714475;85661733;52742;
15.02.2019;20:44:05;85714549;85661793;52756;
15.02.2019;20:45:05;85714622;85661831;52791;
15.02.2019;20:46:05;85714704;85661908;52796;
15.02.2019;20:47:05;85714797;85661964;52833;
15.02.2019;20:48:05;85714864;85662027;52837;
15.02.2019;20:49:05;85714949;85662088;52861;
15.02.2019;20:50:05;85715048;85662146;52902;
15.02.2019;20:51:05;85715125;85662200;52925;
15.02.2019;20:52:05;85715225;85662262;52963;
15.02.2019;20:53:08;85715301;85662327;52974;
15.02.2019;20:54:05;85715392;85662375;53017;
15.02.2019;20:55:07;85715502;85662445;53057;
15.02.2019;20:56:04;85715571;85662498;53073;
15.02.2019;20:57:08;85715681;85662557;53124;
15.02.2019;20:58:04;85715788;85662612;53176;
15.02.2019;20:59:04;85715904;85662662;53242;
15.02.2019;21:00:06;85716053;85662730;53323;
15.02.2019;21:01:05;85716137;85662771;53366;
15.02.2019;21:02:04;85716246;85662823;53423;
15.02.2019;21:03:05;85716339;85662879;53460;
15.02.2019;21:04:08;85716467;85662940;53527;
15.02.2019;21:05:05;85716579;85662994;53585;
15.02.2019;21:06:05;85716701;85663056;53645;
15.02.2019;21:07:08;85716794;85663126;53668;
15.02.2019;21:08:10;85716916;85663191;53725;
15.02.2019;21:09:07;85717015;85663239;53776;
15.02.2019;21:10:07;85717113;85663303;53810;
15.02.2019;21:11:05;85717220;85663361;53859;
15.02.2019;21:12:08;85717335;85663416;53919;
15.02.2019;21:13:05;85717441;85663477;53964;
15.02.2019;21:14:06;85717548;85663545;54003;
15.02.2019;21:15:07;85717653;85663582;54071;
15.02.2019;21:16:05;85719475;85663642;55833;
15.02.2019;21:17:08;85719570;85663690;55880;
15.02.2019;21:18:06;85719662;85663738;55924;
15.02.2019;21:19:10;85719741;85663793;55948;
15.02.2019;21:20:05;85719837;85663837;56000;
15.02.2019;21:21:05;85719941;85663883;56058;
15.02.2019;21:22:04;85720026;85663907;56119;
15.02.2019;21:23:04;85720144;85663986;56158;
15.02.2019;21:24:04;85720268;85664047;56221;
15.02.2019;21:25:05;85720370;85664088;56282;
15.02.2019;21:26:05;85720475;85664127;56348;
15.02.2019;21:27:07;85720596;85664166;56430;
15.02.2019;21:28:06;85720686;85664215;56471;
15.02.2019;21:29:10;85720825;85664260;56565;
15.02.2019;21:30:05;85720917;85668895;52022;
15.02.2019;21:31:09;85721029;85668950;52079;
15.02.2019;21:32:05;85721163;85669000;52163;
15.02.2019;21:33:05;85721265;85669052;52213;
15.02.2019;21:34:06;85721354;85669088;52266;
15.02.2019;21:35:05;85721472;85669135;52337;
15.02.2019;21:36:05;85721605;85669187;52418;
15.02.2019;21:37:05;85721712;85669234;52478;
15.02.2019;21:38:06;85721800;85669276;52524;
15.02.2019;21:39:10;85721900;85669323;52577;
15.02.2019;21:40:05;85721986;85669355;52631;
15.02.2019;21:41:05;85722093;85669407;52686;
15.02.2019;21:42:05;85722211;85669456;52755;
15.02.2019;21:43:05;85722313;85669504;52809;
15.02.2019;21:44:05;85722446;85669567;52879;
15.02.2019;21:45:05;85722552;85669594;52958;
15.02.2019;21:46:05;85722661;85669639;53022;
15.02.2019;21:47:05;85722754;85669668;53086;
15.02.2019;21:48:05;85722838;85669663;53175;
15.02.2019;21:49:05;85722939;85669714;53225;
15.02.2019;21:51:05;85723153;85669777;53376;
15.02.2019;21:52:04;85723250;85669800;53450;
15.02.2019;21:53:04;85723363;85669831;53532;
15.02.2019;21:54:05;85723475;85669879;53596;
15.02.2019;21:55:05;85723577;85669926;53651;
15.02.2019;21:56:10;85723706;85669971;53735;
15.02.2019;21:57:05;85723778;85670000;53778;
15.02.2019;21:58:05;85723888;85670042;53846;
15.02.2019;21:59:05;85723992;85670082;53910;
15.02.2019;22:00:05;85724103;85670108;53995;
15.02.2019;22:01:10;85724198;85670160;54038;
15.02.2019;22:02:04;85724315;85670198;54117;
15.02.2019;22:03:04;85724411;85670242;54169;
15.02.2019;22:04:05;85724494;85670300;54194;
15.02.2019;22:05:04;85724621;85670335;54286;
15.02.2019;22:06:04;85724727;85670376;54351;
15.02.2019;22:07:05;85724855;85670429;54426;
15.02.2019;22:08:05;85724965;85670459;54506;
15.02.2019;22:09:05;85725090;85670512;54578;
15.02.2019;22:10:05;85725175;85670544;54631;
15.02.2019;22:11:05;85725276;85670582;54694;
15.02.2019;22:12:05;85725366;85670625;54741;
15.02.2019;22:13:05;85725462;85670663;54799;
15.02.2019;22:14:05;85725581;85670696;54885;
15.02.2019;22:15:06;85725695;85670752;54943;
15.02.2019;22:16:05;85725795;85670788;55007;
15.02.2019;22:17:05;85725897;85670821;55076;
15.02.2019;22:18:05;85725986;85670852;55134;
15.02.2019;22:19:10;85726074;85670882;55192;
15.02.2019;22:20:04;85726161;85670895;55266;
15.02.2019;22:21:04;85726246;85670912;55334;
15.02.2019;22:22:05;85726316;85670936;55380;
15.02.2019;22:23:05;85726420;85670964;55456;
15.02.2019;22:24:05;85726492;85670998;55494;
15.02.2019;22:25:04;85726604;85671030;55574;
15.02.2019;22:26:05;85726698;85671059;55639;
15.02.2019;22:27:04;85726761;85671083;55678;
15.02.2019;22:28:04;85726857;85671111;55746;
15.02.2019;22:29:05;85726946;85671144;55802;
15.02.2019;22:30:05;85727045;85671172;55873;
15.02.2019;22:31:05;85727110;85671210;55900;
15.02.2019;22:32:06;85727210;85671231;55979;
15.02.2019;22:33:05;85727317;85671251;56066;
15.02.2019;22:34:05;85727394;85671276;56118;
15.02.2019;22:35:05;85727484;85671314;56170;
15.02.2019;22:36:05;85727579;85671343;56236;
15.02.2019;22:37:05;85727662;85671368;56294;
15.02.2019;22:38:05;85727769;85671401;56368;
15.02.2019;22:39:11;85727864;85671427;56437;
15.02.2019;22:40:05;85727939;85671455;56484;
15.02.2019;22:41:05;85728021;85671503;56518;
15.02.2019;22:42:05;85728094;85671533;56561;
15.02.2019;22:43:05;85728204;85671564;56640;
15.02.2019;22:44:05;85728296;85671601;56695;
15.02.2019;22:45:04;85728410;85671627;56783;
15.02.2019;22:46:10;85728507;85671668;56839;
15.02.2019;22:47:05;85728584;85671703;56881;
15.02.2019;22:48:05;85728652;85671732;56920;
15.02.2019;22:49:05;85728795;85671759;57036;
15.02.2019;22:50:05;85728868;85671793;57075;
15.02.2019;22:51:10;85728950;85671838;57112;
15.02.2019;22:52:04;85729010;85671868;57142;
15.02.2019;22:53:06;85729143;85671902;57241;
15.02.2019;22:54:05;85729240;85671929;57311;
15.02.2019;22:55:05;85729375;85671959;57416;
15.02.2019;22:56:05;85729475;85672000;57475;
15.02.2019;22:57:05;85729579;85672028;57551;
15.02.2019;22:58:05;85729697;85672052;57645;
15.02.2019;22:59:05;85729795;85672085;57710;
15.02.2019;23:00:05;85729908;85672112;57796;
15.02.2019;23:01:05;85730012;85672138;57874;
15.02.2019;23:02:05;85730085;85672163;57922;
15.02.2019;23:03:05;85730184;85672176;58008;
15.02.2019;23:04:05;85730285;85672195;58090;
15.02.2019;23:05:04;85730341;85672222;58119;
15.02.2019;23:06:04;85730440;85672259;58181;
15.02.2019;23:07:04;85730537;85672296;58241;
15.02.2019;23:08:05;85730611;85672325;58286;
15.02.2019;23:09:05;85730723;85672355;58368;
15.02.2019;23:10:04;85730826;85672381;58445;
15.02.2019;23:11:04;85730906;85672420;58486;
15.02.2019;23:12:05;85730987;85672453;58534;
15.02.2019;23:13:05;85731113;85672484;58629;
15.02.2019;23:14:05;85731201;85672520;58681;
15.02.2019;23:15:05;85731408;85672557;58851;
15.02.2019;23:16:05;85731690;85672593;59097;
15.02.2019;23:17:05;85731874;85672626;59248;
15.02.2019;23:18:05;85731990;85672651;59339;
15.02.2019;23:19:05;85732115;85672676;59439;
15.02.2019;23:20:04;85732251;85672701;59550;
15.02.2019;23:21:11;85732364;85672725;59639;
15.02.2019;23:22:05;85732463;85672748;59715;
15.02.2019;23:23:04;85732554;85672764;59790;
15.02.2019;23:24:04;85732670;85672802;59868;
15.02.2019;23:25:04;85732803;85672828;59975;
15.02.2019;23:26:05;85732899;85672857;60042;
15.02.2019;23:27:05;85733006;85672885;60121;
15.02.2019;23:28:05;85733135;85672921;60214;
15.02.2019;23:29:05;85733245;85672954;60291;
15.02.2019;23:30:05;85733379;85672995;60384;
15.02.2019;23:31:05;85733515;85673019;60496;
15.02.2019;23:32:05;85733642;85673047;60595;
15.02.2019;23:33:05;85733782;85673059;60723;
15.02.2019;23:34:05;85733878;85673087;60791;
15.02.2019;23:35:05;85734004;85673117;60887;
15.02.2019;23:36:10;85734139;85673147;60992;
15.02.2019;23:37:05;85734267;85673175;61092;
15.02.2019;23:38:05;85734390;85673200;61190;
15.02.2019;23:39:05;85734499;85673228;61271;
15.02.2019;23:40:04;85734635;85673253;61382;
15.02.2019;23:41:06;85734778;85673287;61491;
15.02.2019;23:42:04;85734932;85673317;61615;
15.02.2019;23:43:04;85735067;85673349;61718;
15.02.2019;23:44:04;85735186;85673383;61803;
15.02.2019;23:45:04;85735319;85673407;61912;
15.02.2019;23:46:05;85735456;85673435;62021;
15.02.2019;23:47:05;85735579;85673466;62113;
15.02.2019;23:48:05;85735728;85673492;62236;
15.02.2019;23:49:04;85735836;85673517;62319;
15.02.2019;23:50:05;85735956;85673538;62418;
15.02.2019;23:51:05;85736100;85673561;62539;
15.02.2019;23:52:05;85736220;85673584;62636;
15.02.2019;23:53:05;85736353;85673615;62738;
15.02.2019;23:54:05;85736468;85673643;62825;
15.02.2019;23:55:05;85736610;85673670;62940;
15.02.2019;23:56:04;85736728;85673701;63027;
15.02.2019;23:57:05;85736855;85673726;63129;
15.02.2019;23:58:04;85736972;85673757;63215;
15.02.2019;23:59:04;85737105;85673782;63323;
16.02.2019;00:00:08;85737261;85673818;63443;
16.02.2019;00:01:08;85737356;85673836;63520;
16.02.2019;00:02:07;85737478;85673853;63625;
16.02.2019;00:03:08;85737594;85673879;63715;
16.02.2019;00:04:07;85737703;85673907;63796;
16.02.2019;00:05:08;85737808;85673945;63863;
16.02.2019;00:06:08;85737934;85673981;63953;
16.02.2019;00:07:08;85738057;85673998;64059;
16.02.2019;00:08:08;85738167;85674018;64149;
16.02.2019;00:09:07;85738287;85674050;64237;
16.02.2019;00:10:09;85738404;85674080;64324;
16.02.2019;00:11:08;85738499;85674099;64400;
16.02.2019;00:12:08;85738606;85674129;64477;
16.02.2019;00:13:07;85738695;85674143;64552;
16.02.2019;00:14:08;85738808;85674169;64639;
16.02.2019;00:15:08;85738883;85674201;64682;
16.02.2019;00:16:07;85738981;85674213;64768;
16.02.2019;00:17:08;85739072;85674250;64822;
16.02.2019;00:18:08;85739161;85674264;64897;
16.02.2019;00:19:08;85739245;85674292;64953;
16.02.2019;00:20:07;85739331;85674308;65023;
16.02.2019;00:21:08;85739440;85674331;65109;
16.02.2019;00:22:07;85739548;85674357;65191;
16.02.2019;00:23:08;85739644;85674357;65287;
16.02.2019;00:24:08;85739714;85674403;65311;
16.02.2019;00:25:08;85739837;85674432;65405;
16.02.2019;00:26:07;85739918;85674467;65451;
16.02.2019;00:27:10;85740015;85674494;65521;
16.02.2019;00:28:07;85740108;85674517;65591;
16.02.2019;00:29:08;85740204;85674544;65660;
16.02.2019;00:30:08;85740296;85674565;65731;
16.02.2019;00:31:07;85740403;85674583;65820;
16.02.2019;00:32:08;85740506;85674612;65894;
16.02.2019;00:33:08;85740627;85674637;65990;
16.02.2019;00:34:08;85740715;85674652;66063;
16.02.2019;00:35:07;85740798;85674677;66121;
16.02.2019;00:36:07;85740903;85674706;66197;
16.02.2019;00:37:08;85740998;85674737;66261;
16.02.2019;00:38:07;85741115;85674749;66366;
16.02.2019;00:39:08;85741224;85674762;66462;
16.02.2019;00:40:07;85741320;85674789;66531;
16.02.2019;00:41:13;85741423;85674817;66606;
16.02.2019;00:42:08;85741541;85674836;66705;
16.02.2019;00:43:07;85741647;85674870;66777;
16.02.2019;00:44:07;85741756;85674892;66864;
16.02.2019;00:45:08;85741873;85674920;66953;
16.02.2019;00:46:07;85741970;85674956;67014;
16.02.2019;00:47:09;85742081;85674989;67092;
16.02.2019;00:48:08;85742195;85675014;67181;
16.02.2019;00:49:07;85742303;85675044;67259;
16.02.2019;00:50:08;85742422;85675063;67359;
16.02.2019;00:51:08;85742546;85675089;67457;
16.02.2019;00:52:07;85742654;85675121;67533;
16.02.2019;00:53:07;85742769;85675138;67631;
16.02.2019;00:54:08;85742869;85675177;67692;
16.02.2019;00:55:08;85742984;85675199;67785;
16.02.2019;00:56:08;85743074;85675214;67860;
16.02.2019;00:57:08;85743147;85675180;67967;
16.02.2019;00:58:09;85743243;85675205;68038;
16.02.2019;00:59:08;85743361;85675250;68111;
16.02.2019;01:00:05;85743471;85675285;68186;
16.02.2019;01:01:05;85743568;85675313;68255;
16.02.2019;01:02:05;85743659;85675349;68310;
16.02.2019;01:03:05;85743748;85675375;68373;
16.02.2019;01:04:05;85743852;85675410;68442;
16.02.2019;01:05:05;85743974;85675428;68546;
16.02.2019;01:06:04;85744099;85675460;68639;
16.02.2019;01:07:04;85744199;85675500;68699;
16.02.2019;01:08:05;85744307;85675526;68781;
16.02.2019;01:09:05;85744422;85675560;68862;
16.02.2019;01:10:05;85744545;85675577;68968;
16.02.2019;01:11:05;85744664;85675597;69067;
16.02.2019;01:12:05;85744759;85675630;69129;
16.02.2019;01:13:04;85744857;85675642;69215;
16.02.2019;01:14:05;85744950;85675675;69275;
16.02.2019;01:15:05;85745032;85675710;69322;
16.02.2019;01:16:05;85745160;85675738;69422;
16.02.2019;01:17:05;85745262;85675770;69492;
16.02.2019;01:18:05;85745361;85675793;69568;
16.02.2019;01:19:05;85745464;85675833;69631;
16.02.2019;01:20:05;85745555;85675865;69690;
16.02.2019;01:21:04;85745653;85675897;69756;
16.02.2019;01:22:04;85745755;85675931;69824;
16.02.2019;01:23:05;85745861;85675958;69903;
16.02.2019;01:24:05;85745971;85675982;69989;
16.02.2019;01:25:06;85746082;85676021;70061;
16.02.2019;01:26:05;85746186;85676047;70139;
16.02.2019;01:27:05;85746307;85676087;70220;
16.02.2019;01:28:05;85746418;85676107;70311;
16.02.2019;01:29:05;85746540;85676150;70390;
16.02.2019;01:30:04;85746651;85676188;70463;
16.02.2019;01:31:05;85746743;85676214;70529;
16.02.2019;01:32:05;85746854;85676246;70608;
16.02.2019;01:33:04;85746968;85676282;70686;
16.02.2019;01:34:04;85747072;85676307;70765;
16.02.2019;01:35:05;85747150;85676331;70819;
16.02.2019;01:36:05;85747247;85676376;70871;
16.02.2019;01:37:04;85747348;85676405;70943;
16.02.2019;01:38:05;85747422;85676432;70990;
16.02.2019;01:39:05;85747540;85676467;71073;
16.02.2019;01:40:05;85747623;85676508;71115;
16.02.2019;01:41:05;85747714;85676549;71165;
16.02.2019;01:42:05;85747803;85676580;71223;
16.02.2019;01:43:05;85747896;85676611;71285;
16.02.2019;01:44:04;85748014;85676643;71371;
16.02.2019;01:45:05;85748119;85676689;71430;
16.02.2019;01:46:05;85748233;85676722;71511;
16.02.2019;01:47:04;85748328;85676763;71565;
16.02.2019;01:48:05;85748413;85676780;71633;
16.02.2019;01:49:05;85748521;85676810;71711;
16.02.2019;01:50:05;85748615;85676865;71750;
16.02.2019;01:51:05;85748720;85676894;71826;
16.02.2019;01:52:04;85748828;85676932;71896;
16.02.2019;01:53:04;85748929;85676978;71951;
16.02.2019;01:54:04;85749023;85677023;72000;
16.02.2019;01:55:05;85749134;85677064;72070;
16.02.2019;01:56:04;85749232;85677104;72128;
16.02.2019;01:57:04;85749330;85677141;72189;
16.02.2019;01:58:05;85749424;85677184;72240;
16.02.2019;01:59:05;85749517;85677231;72286;
16.02.2019;02:00:05;85749604;85677278;72326;
16.02.2019;02:01:04;85749685;85677330;72355;
16.02.2019;02:02:04;85749789;85677383;72406;
16.02.2019;02:03:05;85749882;85677448;72434;
16.02.2019;02:04:04;85750019;85677485;72534;
16.02.2019;02:05:05;85750117;85677532;72585;
16.02.2019;02:06:04;85750217;85677579;72638;
16.02.2019;02:07:04;85750317;85677628;72689;
16.02.2019;02:08:05;85750436;85677682;72754;
16.02.2019;02:09:06;85750558;85677729;72829;
16.02.2019;02:10:05;85750648;85677780;72868;
16.02.2019;02:11:04;85750747;85677837;72910;
16.02.2019;02:13:05;85750904;85677941;72963;
16.02.2019;02:14:05;85751027;85678005;73022;
16.02.2019;02:15:04;85751118;85678058;73060;
16.02.2019;02:16:05;85751175;85678110;73065;
16.02.2019;02:17:05;85751268;85678177;73091;
16.02.2019;02:18:04;85751339;85678249;73090;
16.02.2019;02:19:04;85751422;85678309;73113;
16.02.2019;02:20:05;85751512;85678368;73144;
16.02.2019;02:21:05;85751592;85678423;73169;
16.02.2019;02:22:04;85751679;85678486;73193;
16.02.2019;02:23:04;85751763;85678539;73224;
16.02.2019;02:24:05;85751874;85678592;73282;
16.02.2019;02:25:04;85751959;85678657;73302;
16.02.2019;02:26:04;85752045;85678723;73322;
16.02.2019;02:27:05;85752130;85678770;73360;
16.02.2019;02:28:09;85752236;85678846;73390;
16.02.2019;02:29:04;85752316;85678897;73419;
16.02.2019;02:30:05;85752413;85678944;73469;
16.02.2019;02:31:05;85752522;85679004;73518;
16.02.2019;02:32:05;85752616;85679045;73571;
16.02.2019;02:33:05;85752717;85679100;73617;
16.02.2019;02:34:04;85752803;85679151;73652;
16.02.2019;02:35:05;85752908;85679214;73694;
16.02.2019;02:36:04;85753002;85679268;73734;
16.02.2019;02:37:04;85753117;85679324;73793;
16.02.2019;02:38:10;85753214;85679404;73810;
16.02.2019;02:39:05;85753298;85679470;73828;
16.02.2019;02:40:05;85753429;85679522;73907;
16.02.2019;02:41:04;85753523;85679583;73940;
16.02.2019;02:42:04;85753621;85679642;73979;
16.02.2019;02:43:05;85753742;85679697;74045;
16.02.2019;02:44:04;85753855;85679753;74102;
16.02.2019;02:45:04;85753969;85679821;74148;
16.02.2019;02:46:05;85754062;85679892;74170;
16.02.2019;02:47:05;85754160;85679959;74201;
16.02.2019;02:48:04;85754263;85680047;74216;
16.02.2019;02:49:04;85754353;85680119;74234;
16.02.2019;02:50:05;85754477;85680212;74265;
16.02.2019;02:51:05;85754590;85680293;74297;
16.02.2019;02:52:04;85754698;85680361;74337;
16.02.2019;02:53:05;85754809;85680436;74373;
16.02.2019;02:54:05;85754907;85680502;74405;
16.02.2019;02:55:04;85755000;85680573;74427;
16.02.2019;02:56:04;85755115;85680654;74461;
16.02.2019;02:57:05;85755232;85680748;74484;
16.02.2019;02:58:05;85755358;85680837;74521;
16.02.2019;02:59:05;85755468;85680949;74519;
16.02.2019;03:00:04;85755570;85681042;74528;
16.02.2019;03:01:04;85755682;85681117;74565;
16.02.2019;03:02:05;85755807;85681192;74615;
16.02.2019;03:03:04;85755922;85681261;74661;
16.02.2019;03:05:05;85756127;85681409;74718;
16.02.2019;03:06:04;85756219;85681479;74740;
16.02.2019;03:07:05;85756327;85681571;74756;
16.02.2019;03:08:04;85756436;85681653;74783;
16.02.2019;03:09:05;85756554;85681729;74825;
16.02.2019;03:10:04;85756637;85681830;74807;
16.02.2019;03:11:04;85756749;85681920;74829;
16.02.2019;03:12:05;85756857;85682027;74830;
16.02.2019;03:13:05;85756996;85682121;74875;
16.02.2019;03:14:05;85757127;85682200;74927;
16.02.2019;03:15:05;85757240;85682298;74942;
16.02.2019;03:16:04;85757350;85682377;74973;
16.02.2019;03:17:05;85757469;85682471;74998;
16.02.2019;03:18:05;85757562;85682558;75004;
16.02.2019;03:19:05;85757671;85682644;75027;
16.02.2019;03:20:05;85757772;85682747;75025;
16.02.2019;03:22:05;85757945;85682928;75017;
16.02.2019;03:23:05;85758061;85683016;75045;
16.02.2019;03:24:05;85758167;85683101;75066;
16.02.2019;03:25:05;85758258;85683183;75075;
16.02.2019;03:26:05;85758354;85683266;75088;
16.02.2019;03:27:05;85758470;85683342;75128;
16.02.2019;03:28:04;85758561;85683428;75133;
16.02.2019;03:29:04;85758675;85683518;75157;
16.02.2019;03:30:05;85758792;85683610;75182;
16.02.2019;03:31:05;85758889;85683701;75188;
16.02.2019;03:32:05;85758968;85683789;75179;
16.02.2019;03:33:04;85759069;85683862;75207;
16.02.2019;03:34:04;85759157;85683950;75207;
16.02.2019;03:35:05;85759250;85684046;75204;
16.02.2019;03:36:05;85759356;85684146;75210;
16.02.2019;03:37:05;85759451;85684227;75224;
16.02.2019;03:38:04;85759560;85684312;75248;
16.02.2019;03:39:04;85759671;85684404;75267;
16.02.2019;03:40:05;85759789;85684509;75280;
16.02.2019;03:41:05;85759877;85684592;75285;
16.02.2019;03:42:05;85759979;85684690;75289;
16.02.2019;03:43:04;85760072;85684767;75305;
16.02.2019;03:44:04;85760181;85684879;75302;
16.02.2019;03:45:04;85760291;85684969;75322;
16.02.2019;03:46:05;85760379;85685064;75315;
16.02.2019;03:47:04;85760478;85685161;75317;
16.02.2019;03:48:04;85760561;85685264;75297;
16.02.2019;03:49:05;85760694;85685362;75332;
16.02.2019;03:50:05;85760803;85685479;75324;
16.02.2019;03:51:05;85760910;85685595;75315;
16.02.2019;03:52:05;85761016;85685691;75325;
16.02.2019;03:53:04;85761088;85685740;75348;
16.02.2019;03:54:05;85761175;85685837;75338;
16.02.2019;03:55:04;85761277;85685947;75330;
16.02.2019;03:56:06;85761375;85686044;75331;
16.02.2019;03:57:04;85761483;85686145;75338;
16.02.2019;03:58:04;85761582;85686257;75325;
16.02.2019;03:59:05;85761696;85686365;75331;
16.02.2019;04:00:05;85761794;85686486;75308;
16.02.2019;04:01:04;85761873;85686579;75294;
16.02.2019;04:02:04;85761979;85686695;75284;
16.02.2019;04:03:05;85762084;85686797;75287;
16.02.2019;04:04:05;85762199;85686919;75280;
16.02.2019;04:05:04;85762287;85687024;75263;
16.02.2019;04:06:05;85762369;85687110;75259;
16.02.2019;04:07:05;85762468;85687226;75242;
16.02.2019;04:08:04;85762571;85687327;75244;
16.02.2019;04:10:05;85762770;85687549;75221;
16.02.2019;04:11:05;85762870;85687651;75219;
16.02.2019;04:12:04;85762974;85687754;75220;
16.02.2019;04:13:05;85763053;85687868;75185;
16.02.2019;04:14:04;85763138;85687969;75169;
16.02.2019;04:15:04;85763206;85688048;75158;
16.02.2019;04:17:04;85763360;85688218;75142;
16.02.2019;04:18:05;85763437;85688313;75124;
16.02.2019;04:19:05;85763523;85688414;75109;
16.02.2019;04:20:05;85763615;85688517;75098;
16.02.2019;04:21:05;85763695;85688604;75091;
16.02.2019;04:22:05;85763777;85688696;75081;
16.02.2019;04:23:04;85763859;85688788;75071;
16.02.2019;04:24:04;85763950;85688867;75083;
16.02.2019;04:25:06;85764032;85688976;75056;
16.02.2019;04:26:04;85764094;85689072;75022;
16.02.2019;04:27:05;85764193;85689171;75022;
16.02.2019;04:28:05;85764261;85689275;74986;
16.02.2019;04:29:05;85764352;85689375;74977;
16.02.2019;04:30:04;85764431;85689495;74936;
16.02.2019;04:31:04;85764530;85689596;74934;
16.02.2019;04:32:05;85764623;85689704;74919;
16.02.2019;04:33:04;85764707;85689805;74902;
16.02.2019;04:34:04;85764794;85689902;74892;
16.02.2019;04:35:05;85764905;85690010;74895;
16.02.2019;04:36:05;85764994;85690117;74877;
16.02.2019;04:37:04;85765084;85690224;74860;
16.02.2019;04:39:05;85765243;85690412;74831;
16.02.2019;04:40:04;85765320;85690503;74817;
16.02.2019;04:41:04;85765421;85690601;74820;
16.02.2019;04:42:05;85765502;85690691;74811;
16.02.2019;04:43:05;85765576;85690796;74780;
16.02.2019;04:44:05;85765658;85690908;74750;
16.02.2019;04:45:04;85765768;85691019;74749;
16.02.2019;04:46:04;85765857;85691121;74736;
16.02.2019;04:47:05;85765939;85691233;74706;
16.02.2019;04:48:05;85766020;85691344;74676;
16.02.2019;04:49:04;85766110;85691459;74651;
16.02.2019;04:50:04;85766215;85691580;74635;
16.02.2019;04:51:05;85766303;85691687;74616;
16.02.2019;04:52:05;85766391;85691788;74603;
16.02.2019;04:53:04;85766473;85691912;74561;
16.02.2019;04:54:04;85766574;85692015;74559;
16.02.2019;04:55:05;85766679;85692096;74583;
16.02.2019;04:56:05;85766748;85692198;74550;
16.02.2019;04:57:04;85766810;85692327;74483;
16.02.2019;04:58:04;85766889;85692425;74464;
16.02.2019;04:59:04;85766990;85692529;74461;
16.02.2019;05:00:05;85767084;85692638;74446;
16.02.2019;05:01:05;85767183;85692734;74449;
16.02.2019;05:02:05;85767265;85692810;74455;
16.02.2019;05:03:05;85767353;85692922;74431;
16.02.2019;05:04:04;85767442;85693030;74412;
16.02.2019;05:05:05;85767532;85693141;74391;
16.02.2019;05:06:05;85767622;85693245;74377;
16.02.2019;05:07:04;85767710;85693360;74350;
16.02.2019;05:08:04;85767798;85693482;74316;
16.02.2019;05:09:05;85767895;85693601;74294;
16.02.2019;05:10:04;85767967;85693723;74244;
16.02.2019;05:11:04;85768050;85693826;74224;
16.02.2019;05:12:05;85768132;85693938;74194;
16.02.2019;05:13:05;85768216;85694026;74190;
16.02.2019;05:14:05;85768316;85694126;74190;
16.02.2019;05:15:04;85768404;85694234;74170;
16.02.2019;05:16:05;85768505;85694335;74170;
16.02.2019;05:17:05;85768593;85694433;74160;
16.02.2019;05:18:05;85768671;85694539;74132;
16.02.2019;05:19:04;85768758;85694649;74109;
16.02.2019;05:20:04;85768851;85694775;74076;
16.02.2019;05:21:04;85768947;85694874;74073;
16.02.2019;05:22:05;85769036;85694982;74054;
16.02.2019;05:23:04;85769120;85695094;74026;
16.02.2019;05:24:04;85769190;85695219;73971;
16.02.2019;05:25:05;85769260;85695320;73940;
16.02.2019;05:26:05;85769358;85695419;73939;
16.02.2019;05:27:04;85769428;85695550;73878;
16.02.2019;05:28:04;85769497;85695652;73845;
16.02.2019;05:29:04;85769587;85695778;73809;
16.02.2019;05:30:05;85769666;85695878;73788;
16.02.2019;05:31:05;85769773;85696016;73757;
16.02.2019;05:32:05;85769865;85696132;73733;
16.02.2019;05:33:04;85769958;85696256;73702;
16.02.2019;05:34:05;85770030;85696372;73658;
16.02.2019;05:35:05;85770126;85696496;73630;
16.02.2019;05:36:05;85770205;85696607;73598;
16.02.2019;05:37:05;85770277;85696699;73578;
16.02.2019;05:38:04;85770351;85696799;73552;
16.02.2019;05:39:04;85770407;85696918;73489;
16.02.2019;05:40:05;85770498;85697050;73448;
16.02.2019;05:41:05;85770595;85697180;73415;
16.02.2019;05:42:05;85770665;85697277;73388;
16.02.2019;05:43:04;85770743;85697386;73357;
16.02.2019;05:44:04;85770824;85697486;73338;
16.02.2019;05:45:05;85770905;85697599;73306;
16.02.2019;05:46:04;85770982;85697722;73260;
16.02.2019;05:47:04;85771071;85697837;73234;
16.02.2019;05:48:05;85771150;85697932;73218;
16.02.2019;05:49:04;85771234;85698036;73198;
16.02.2019;05:50:05;85771294;85698168;73126;
16.02.2019;05:51:05;85771385;85698286;73099;
16.02.2019;05:52:04;85771480;85698403;73077;
16.02.2019;05:53:04;85771574;85698516;73058;
16.02.2019;05:54:04;85771660;85698638;73022;
16.02.2019;05:55:05;85771755;85698754;73001;
16.02.2019;05:56:05;85771808;85698851;72957;
16.02.2019;05:57:05;85771888;85698960;72928;
16.02.2019;05:58:04;85771989;85699065;72924;
16.02.2019;05:59:05;85772065;85699180;72885;
16.02.2019;06:00:05;85772157;85699289;72868;
16.02.2019;06:01:05;85772247;85699409;72838;
16.02.2019;06:02:05;85772325;85699515;72810;
16.02.2019;06:03:04;85772417;85699636;72781;
16.02.2019;06:04:04;85772522;85699750;72772;
16.02.2019;06:05:05;85772606;85699884;72722;
16.02.2019;06:06:05;85772686;85700017;72669;
16.02.2019;06:07:05;85772767;85700129;72638;
16.02.2019;06:08:05;85772850;85700245;72605;
16.02.2019;06:09:05;85772939;85700344;72595;
16.02.2019;06:10:04;85773021;85700455;72566;
16.02.2019;06:11:04;85773090;85700547;72543;
16.02.2019;06:12:04;85773144;85700647;72497;
16.02.2019;06:13:05;85773191;85700751;72440;
16.02.2019;06:14:05;85773229;85700843;72386;
16.02.2019;06:15:04;85773267;85700957;72310;
16.02.2019;06:16:04;85773325;85701061;72264;
16.02.2019;06:17:05;85773379;85701153;72226;
16.02.2019;06:18:04;85773435;85701252;72183;
16.02.2019;06:19:05;85773520;85701359;72161;
16.02.2019;06:20:04;85773548;85701461;72087;
16.02.2019;06:21:04;85773643;85701577;72066;
16.02.2019;06:22:05;85773687;85701675;72012;
16.02.2019;06:23:05;85773734;85701782;71952;
16.02.2019;06:24:05;85773789;85701900;71889;
16.02.2019;06:25:07;85773863;85702020;71843;
16.02.2019;06:26:04;85773931;85702111;71820;
16.02.2019;06:27:04;85773997;85702220;71777;
16.02.2019;06:28:05;85774056;85702305;71751;
16.02.2019;06:29:05;85774111;85702415;71696;
16.02.2019;06:30:04;85774153;85702541;71612;
16.02.2019;06:31:05;85774218;85702637;71581;
16.02.2019;06:32:04;85774283;85702734;71549;
16.02.2019;06:33:05;85774353;85702859;71494;
16.02.2019;06:34:04;85774419;85702958;71461;
16.02.2019;06:35:04;85774485;85703057;71428;
16.02.2019;06:36:05;85774566;85703181;71385;
16.02.2019;06:37:04;85774644;85703298;71346;
16.02.2019;06:38:05;85774708;85703412;71296;
16.02.2019;06:39:04;85774763;85703558;71205;
16.02.2019;06:40:04;85774857;85703669;71188;
16.02.2019;06:41:05;85774941;85703791;71150;
16.02.2019;06:42:04;85775022;85703915;71107;
16.02.2019;06:43:04;85775102;85704010;71092;
16.02.2019;06:44:05;85775171;85704145;71026;
16.02.2019;06:45:04;85775249;85704252;70997;
16.02.2019;06:46:04;85775354;85704393;70961;
16.02.2019;06:47:05;85775427;85704509;70918;
16.02.2019;06:48:05;85775490;85704609;70881;
16.02.2019;06:49:04;85775550;85704740;70810;
16.02.2019;06:50:05;85775619;85704845;70774;
16.02.2019;06:51:04;85775683;85704929;70754;
16.02.2019;06:52:04;85775748;85705030;70718;
16.02.2019;06:53:05;85775810;85705077;70733;
16.02.2019;06:54:05;85775870;85705248;70622;
16.02.2019;06:55:04;85775947;85705378;70569;
16.02.2019;06:56:04;85776028;85705511;70517;
16.02.2019;06:57:04;85776113;85705618;70495;
16.02.2019;06:58:05;85776171;85705742;70429;
16.02.2019;06:59:05;85776247;85705860;70387;
16.02.2019;07:00:05;85776305;85705990;70315;
16.02.2019;07:01:04;85776378;85706112;70266;
16.02.2019;07:02:04;85776446;85706222;70224;
16.02.2019;07:03:09;85776521;85706362;70159;
16.02.2019;07:04:05;85776592;85706461;70131;
16.02.2019;07:05:05;85776675;85706573;70102;
16.02.2019;07:06:05;85776760;85706693;70067;
16.02.2019;07:07:04;85776831;85706809;70022;
16.02.2019;07:08:05;85776887;85706916;69971;
16.02.2019;07:09:05;85776973;85707056;69917;
16.02.2019;07:10:04;85777048;85707174;69874;
16.02.2019;07:11:04;85777103;85707302;69801;
16.02.2019;07:12:05;85777176;85707428;69748;
16.02.2019;07:13:05;85777239;85707559;69680;
16.02.2019;07:14:05;85777281;85707663;69618;
16.02.2019;07:15:05;85777336;85707769;69567;
16.02.2019;07:16:04;85777415;85707894;69521;
16.02.2019;07:17:05;85777493;85707994;69499;
16.02.2019;07:18:05;85777560;85708125;69435;
16.02.2019;07:19:04;85777640;85708230;69410;
16.02.2019;07:20:04;85777710;85708341;69369;
16.02.2019;07:21:05;85777797;85708468;69329;
16.02.2019;07:22:04;85777872;85708606;69266;
16.02.2019;07:23:04;85777944;85708725;69219;
16.02.2019;07:24:04;85778014;85708828;69186;
16.02.2019;07:25:04;85778081;85708950;69131;
16.02.2019;07:26:05;85778158;85709076;69082;
16.02.2019;07:27:05;85778216;85709217;68999;
16.02.2019;07:28:05;85778270;85709333;68937;
16.02.2019;07:29:05;85778346;85709451;68895;
16.02.2019;07:30:04;85778420;85709583;68837;
16.02.2019;07:31:05;85778482;85709702;68780;
16.02.2019;07:32:05;85778544;85709816;68728;
16.02.2019;07:33:05;85778607;85709907;68700;
16.02.2019;07:34:04;85778665;85709993;68672;
16.02.2019;07:35:04;85778739;85710085;68654;
16.02.2019;07:36:05;85778807;85710175;68632;
16.02.2019;07:37:05;85778861;85710268;68593;
16.02.2019;07:38:04;85778931;85710372;68559;
16.02.2019;07:39:06;85778994;85710469;68525;
16.02.2019;07:40:04;85779041;85710538;68503;
16.02.2019;07:41:04;85779096;85710643;68453;
16.02.2019;07:42:05;85779158;85710745;68413;
16.02.2019;07:43:05;85779210;85710873;68337;
16.02.2019;07:44:04;85779288;85710943;68345;
16.02.2019;07:45:04;85779368;85711076;68292;
16.02.2019;07:46:05;85779456;85711181;68275;
16.02.2019;07:47:05;85779527;85711295;68232;
16.02.2019;07:48:04;85779603;85711394;68209;
16.02.2019;07:49:05;85779680;85711512;68168;
16.02.2019;07:50:05;85779754;85711614;68140;
16.02.2019;07:51:05;85779840;85711717;68123;
16.02.2019;07:52:04;85779900;85711850;68050;
16.02.2019;07:53:04;85779954;85711943;68011;
16.02.2019;07:54:05;85780051;85712038;68013;
16.02.2019;07:55:05;85780118;85712146;67972;
16.02.2019;07:56:04;85780193;85712255;67938;
16.02.2019;07:57:04;85780279;85712379;67900;
16.02.2019;07:58:06;85780352;85712479;67873;
16.02.2019;07:59:04;85780435;85712581;67854;
16.02.2019;08:00:04;85780499;85712691;67808;
16.02.2019;08:01:05;85780563;85712817;67746;
16.02.2019;08:02:05;85780641;85712921;67720;
16.02.2019;08:03:05;85780696;85713042;67654;
16.02.2019;08:04:05;85780764;85713166;67598;
16.02.2019;08:05:04;85780827;85713277;67550;
16.02.2019;08:06:04;85780886;85713389;67497;
16.02.2019;08:07:05;85780968;85713510;67458;
16.02.2019;08:08:05;85781028;85713600;67428;
16.02.2019;08:09:04;85781098;85713699;67399;
16.02.2019;08:10:05;85781149;85713793;67356;
16.02.2019;08:11:04;85781215;85713901;67314;
16.02.2019;08:12:05;85781268;85714014;67254;
16.02.2019;08:13:04;85781339;85714115;67224;
16.02.2019;08:14:05;85781410;85714221;67189;
16.02.2019;08:15:05;85781464;85714320;67144;
16.02.2019;08:16:04;85781504;85714414;67090;
16.02.2019;08:17:05;85781560;85714515;67045;
16.02.2019;08:18:04;85781612;85714617;66995;
16.02.2019;08:19:04;85781666;85714731;66935;
16.02.2019;08:20:05;85781723;85714838;66885;
16.02.2019;08:21:04;85781776;85714942;66834;
16.02.2019;08:22:04;85781836;85715047;66789;
16.02.2019;08:23:04;85781900;85715162;66738;
16.02.2019;08:24:05;85781961;85715270;66691;
16.02.2019;08:25:05;85782015;85715379;66636;
16.02.2019;08:26:05;85782063;85715490;66573;
16.02.2019;08:27:04;85782145;85715598;66547;
16.02.2019;08:28:04;85782201;85715708;66493;
16.02.2019;08:29:10;85782256;85715807;66449;
16.02.2019;08:30:05;85782305;85715908;66397;
16.02.2019;08:31:05;85782359;85716032;66327;
16.02.2019;08:32:05;85782428;85716126;66302;
16.02.2019;08:33:05;85782492;85716260;66232;
16.02.2019;08:34:04;85782557;85716400;66157;
16.02.2019;08:35:04;85782622;85716503;66119;
16.02.2019;08:36:04;85782681;85716626;66055;
16.02.2019;08:37:05;85782762;85716756;66006;
16.02.2019;08:38:05;85782833;85716866;65967;
16.02.2019;08:39:07;85782912;85716983;65929;
16.02.2019;08:40:05;85782984;85717093;65891;
16.02.2019;08:41:05;85783028;85717219;65809;
16.02.2019;08:42:04;85783094;85717326;65768;
16.02.2019;08:43:05;85783153;85717425;65728;
16.02.2019;08:44:04;85783221;85717541;65680;
16.02.2019;08:45:05;85783282;85717661;65621;
16.02.2019;08:46:05;85783349;85717790;65559;
16.02.2019;08:47:05;85783419;85717927;65492;
16.02.2019;08:48:05;85783479;85718057;65422;
16.02.2019;08:49:04;85783551;85718185;65366;
16.02.2019;08:50:04;85783625;85718349;65276;
16.02.2019;08:51:04;85783680;85718433;65247;
16.02.2019;08:52:05;85783750;85718559;65191;
16.02.2019;08:53:05;85783816;85718658;65158;
16.02.2019;08:54:05;85783887;85718763;65124;
16.02.2019;08:55:05;85783967;85718870;65097;
16.02.2019;08:56:04;85784043;85718988;65055;
16.02.2019;08:57:04;85784130;85719093;65037;
16.02.2019;08:58:05;85784221;85719205;65016;
16.02.2019;08:59:05;85784287;85719311;64976;
16.02.2019;09:00:05;85784372;85719429;64943;
16.02.2019;09:01:05;85784442;85719549;64893;
16.02.2019;09:02:05;85784517;85719672;64845;
16.02.2019;09:03:05;85784592;85719804;64788;
16.02.2019;09:04:05;85784671;85719931;64740;
16.02.2019;09:05:05;85784734;85720055;64679;
16.02.2019;09:06:05;85784797;85720196;64601;
16.02.2019;09:07:05;85784845;85720306;64539;
16.02.2019;09:08:04;85784915;85720418;64497;
16.02.2019;09:09:04;85784987;85720546;64441;
16.02.2019;09:10:04;85785076;85720670;64406;
16.02.2019;09:11:05;85785157;85720772;64385;
16.02.2019;09:12:05;85785235;85720900;64335;
16.02.2019;09:13:05;85785310;85721017;64293;
16.02.2019;09:14:04;85785371;85721119;64252;
16.02.2019;09:15:05;85785446;85721238;64208;
16.02.2019;09:16:05;85785514;85721334;64180;
16.02.2019;09:17:05;85785595;85721448;64147;
16.02.2019;09:18:05;85785672;85721603;64069;
16.02.2019;09:19:05;85785763;85721732;64031;
16.02.2019;09:20:05;85785858;85721846;64012;
16.02.2019;09:21:05;85785927;85721976;63951;
16.02.2019;09:22:04;85785988;85722094;63894;
16.02.2019;09:23:04;85786068;85722240;63828;
16.02.2019;09:24:05;85786143;85722391;63752;
16.02.2019;09:25:05;85786207;85722517;63690;
16.02.2019;09:26:05;85786270;85722633;63637;
16.02.2019;09:27:05;85786329;85722758;63571;
16.02.2019;09:28:04;85786404;85722883;63521;
16.02.2019;09:29:04;85786485;85723017;63468;
16.02.2019;09:30:05;85786553;85723139;63414;
16.02.2019;09:31:04;85786626;85723258;63368;
16.02.2019;09:32:04;85786680;85723390;63290;
16.02.2019;09:33:04;85786765;85723523;63242;
16.02.2019;09:34:05;85786821;85723641;63180;
16.02.2019;09:35:05;85786891;85723758;63133;
16.02.2019;09:36:05;85786953;85723893;63060;
16.02.2019;09:37:04;85787030;85723997;63033;
16.02.2019;09:38:04;85787098;85724096;63002;
16.02.2019;09:39:05;85787194;85724219;62975;
16.02.2019;09:40:04;85787277;85724339;62938;
16.02.2019;09:41:05;85787375;85724450;62925;
16.02.2019;09:42:04;85787439;85724553;62886;
16.02.2019;09:43:04;85787535;85724680;62855;
16.02.2019;09:44:05;85787608;85724812;62796;
16.02.2019;09:45:04;85787672;85724890;62782;
16.02.2019;09:46:04;85787697;85724974;62723;
16.02.2019;09:47:04;85787766;85725082;62684;
16.02.2019;09:48:05;85787829;85725208;62621;
16.02.2019;09:49:04;85787899;85725315;62584;
16.02.2019;09:50:05;85787985;85725461;62524;
16.02.2019;09:51:05;85788072;85725586;62486;
16.02.2019;09:52:05;85788133;85725718;62415;
16.02.2019;09:53:04;85788183;85725837;62346;
16.02.2019;09:54:05;85788254;85725953;62301;
16.02.2019;09:55:05;85788308;85726071;62237;
16.02.2019;09:56:04;85788370;85726198;62172;
16.02.2019;09:57:04;85788439;85726338;62101;
16.02.2019;09:58:05;85788502;85726448;62054;
16.02.2019;09:59:05;85788571;85726572;61999;
16.02.2019;10:00:05;85788632;85726708;61924;
16.02.2019;10:01:05;85788684;85726826;61858;
16.02.2019;10:02:04;85788772;85726924;61848;
16.02.2019;10:03:05;85788849;85727053;61796;
16.02.2019;10:04:05;85788925;85727196;61729;
16.02.2019;10:05:04;85789004;85727322;61682;
16.02.2019;10:06:05;85789089;85727451;61638;
16.02.2019;10:07:04;85789149;85727587;61562;
16.02.2019;10:08:04;85789215;85727680;61535;
16.02.2019;10:09:05;85789272;85727802;61470;
16.02.2019;10:10:05;85789337;85727933;61404;
16.02.2019;10:11:04;85789393;85728060;61333;
16.02.2019;10:12:04;85789450;85728181;61269;
16.02.2019;10:13:05;85789523;85728304;61219;
16.02.2019;10:14:04;85789578;85728417;61161;
16.02.2019;10:15:04;85789633;85728536;61097;
16.02.2019;10:16:05;85789722;85728654;61068;
16.02.2019;10:17:05;85789776;85728764;61012;
16.02.2019;10:18:05;85789842;85728889;60953;
16.02.2019;10:19:04;85789896;85728985;60911;
16.02.2019;10:20:05;85789979;85729122;60857;
16.02.2019;10:21:09;85790049;85729222;60827;
16.02.2019;10:22:04;85790126;85729347;60779;
16.02.2019;10:23:05;85790191;85729467;60724;
16.02.2019;10:24:05;85790264;85729588;60676;
16.02.2019;10:25:04;85790335;85729701;60634;
16.02.2019;10:26:05;85790413;85729837;60576;
16.02.2019;10:27:05;85790484;85729943;60541;
16.02.2019;10:28:05;85790555;85730085;60470;
16.02.2019;10:29:05;85790619;85730198;60421;
16.02.2019;10:30:04;85790719;85730331;60388;
16.02.2019;10:31:05;85790796;85730474;60322;
16.02.2019;10:32:05;85790866;85730584;60282;
16.02.2019;10:33:04;85790931;85730732;60199;
16.02.2019;10:34:04;85790994;85730855;60139;
16.02.2019;10:35:04;85791056;85730973;60083;
16.02.2019;10:36:04;85791123;85731093;60030;
16.02.2019;10:37:05;85791195;85731251;59944;
16.02.2019;10:38:04;85791284;85731387;59897;
16.02.2019;10:39:04;85791369;85731488;59881;
16.02.2019;10:40:05;85791447;85731575;59872;
16.02.2019;10:41:04;85791527;85731716;59811;
16.02.2019;10:42:04;85791630;85731834;59796;
16.02.2019;10:43:05;85791701;85731976;59725;
16.02.2019;10:44:04;85791767;85732083;59684;
16.02.2019;10:45:04;85791855;85732229;59626;
16.02.2019;10:46:05;85791941;85732336;59605;
16.02.2019;10:47:04;85792016;85732451;59565;
16.02.2019;10:48:04;85792104;85732560;59544;
16.02.2019;10:49:05;85792191;85732669;59522;
16.02.2019;10:50:04;85792261;85732798;59463;
16.02.2019;10:51:05;85792338;85732928;59410;
16.02.2019;10:52:04;85792417;85733098;59319;
16.02.2019;10:53:04;85792500;85733218;59282;
16.02.2019;10:54:07;85792561;85733349;59212;
16.02.2019;10:55:05;85792637;85733463;59174;
16.02.2019;10:56:04;85792706;85733591;59115;
16.02.2019;10:57:05;85792790;85733711;59079;
16.02.2019;10:58:07;85792879;85733842;59037;
16.02.2019;10:59:04;85792933;85733962;58971;
16.02.2019;11:00:04;85793029;85734103;58926;
16.02.2019;11:01:05;85793119;85734218;58901;
16.02.2019;11:02:09;85793195;85734364;58831;
16.02.2019;11:03:05;85793275;85734499;58776;
16.02.2019;11:04:07;85793348;85734628;58720;
16.02.2019;11:05:05;85793410;85734744;58666;
16.02.2019;11:06:04;85793488;85734891;58597;
16.02.2019;11:07:08;85793571;85735019;58552;
16.02.2019;11:08:05;85793637;85735145;58492;
16.02.2019;11:09:06;85793720;85735271;58449;
16.02.2019;11:10:08;85793786;85735401;58385;
16.02.2019;11:11:04;85793869;85735523;58346;
16.02.2019;11:12:05;85793960;85735667;58293;
16.02.2019;11:13:08;85794047;85735795;58252;
16.02.2019;11:14:05;85794140;85735910;58230;
16.02.2019;11:15:04;85794236;85736003;58233;
16.02.2019;11:16:05;85794332;85736140;58192;
16.02.2019;11:17:05;85794425;85736255;58170;
16.02.2019;11:18:05;85794512;85736385;58127;
16.02.2019;11:19:05;85794594;85736516;58078;
16.02.2019;11:20:04;85794662;85736629;58033;
16.02.2019;11:21:04;85794742;85736754;57988;
16.02.2019;11:22:05;85794813;85736871;57942;
16.02.2019;11:23:04;85794887;85737017;57870;
16.02.2019;11:24:04;85794953;85737141;57812;
16.02.2019;11:25:07;85795030;85737273;57757;
16.02.2019;11:26:05;85795103;85737392;57711;
16.02.2019;11:27:05;85795173;85737516;57657;
16.02.2019;11:28:04;85795232;85737652;57580;
16.02.2019;11:29:08;85795308;85737781;57527;
16.02.2019;11:30:05;85795398;85737923;57475;
16.02.2019;11:31:04;85795473;85738063;57410;
16.02.2019;11:32:04;85795555;85738177;57378;
16.02.2019;11:33:05;85795655;85738306;57349;
16.02.2019;11:34:05;85795731;85738428;57303;
16.02.2019;11:35:05;85795833;85738541;57292;
16.02.2019;11:36:04;85795920;85738658;57262;
16.02.2019;11:37:05;85795991;85738805;57186;
16.02.2019;11:38:05;85796052;85738921;57131;
16.02.2019;11:39:05;85796144;85739024;57120;
16.02.2019;11:40:05;85796235;85739152;57083;
16.02.2019;11:41:05;85796308;85739278;57030;
16.02.2019;11:42:05;85796381;85739410;56971;
16.02.2019;11:43:04;85796476;85739530;56946;
16.02.2019;11:44:04;85796552;85739655;56897;
16.02.2019;11:45:05;85796647;85739792;56855;
16.02.2019;11:46:05;85796736;85739903;56833;
16.02.2019;11:47:05;85796809;85740046;56763;
16.02.2019;11:48:05;85796886;85740200;56686;
16.02.2019;11:49:05;85796973;85740318;56655;
16.02.2019;11:50:04;85797073;85740420;56653;
16.02.2019;11:51:04;85797165;85740540;56625;
16.02.2019;11:52:04;85797240;85740681;56559;
16.02.2019;11:53:04;85797325;85740803;56522;
16.02.2019;11:54:04;85797392;85740904;56488;
16.02.2019;11:55:05;85797462;85741014;56448;
16.02.2019;11:56:04;85797529;85741145;56384;
16.02.2019;11:57:04;85797616;85741266;56350;
16.02.2019;11:58:05;85797697;85741403;56294;
16.02.2019;11:59:05;85797779;85741535;56244;
16.02.2019;12:00:05;85797860;85741652;56208;
16.02.2019;12:01:05;85797951;85741760;56191;
16.02.2019;12:02:05;85798061;85741900;56161;
16.02.2019;12:03:05;85798134;85742017;56117;
16.02.2019;12:04:04;85798232;85742137;56095;
16.02.2019;12:05:05;85798305;85742275;56030;
16.02.2019;12:06:04;85798379;85742379;56000;
16.02.2019;12:07:04;85798469;85742498;55971;
16.02.2019;12:08:05;85798535;85742603;55932;
16.02.2019;12:09:04;85798621;85742725;55896;
16.02.2019;12:10:04;85798694;85742858;55836;
16.02.2019;12:11:05;85798781;85742976;55805;
16.02.2019;12:12:05;85798862;85743097;55765;
16.02.2019;12:13:04;85798928;85743212;55716;
16.02.2019;12:14:04;85799007;85743334;55673;
16.02.2019;12:15:05;85799065;85743430;55635;
16.02.2019;12:16:04;85799129;85743513;55616;
16.02.2019;12:17:04;85799161;85743619;55542;
16.02.2019;12:18:05;85799211;85743729;55482;
16.02.2019;12:19:05;85799286;85743819;55467;
16.02.2019;12:20:06;85799324;85743923;55401;
16.02.2019;12:21:04;85799379;85744028;55351;
16.02.2019;12:22:05;85799433;85744124;55309;
16.02.2019;12:23:05;85799500;85744240;55260;
16.02.2019;12:24:04;85799569;85744341;55228;
16.02.2019;12:25:04;85799626;85744450;55176;
16.02.2019;12:26:04;85799695;85744555;55140;
16.02.2019;12:27:04;85799773;85744674;55099;
16.02.2019;12:28:05;85799861;85744788;55073;
16.02.2019;12:29:04;85799929;85744915;55014;
16.02.2019;12:30:05;85800021;85745028;54993;
16.02.2019;12:31:05;85800101;85745157;54944;
16.02.2019;12:32:04;85800183;85745285;54898;
16.02.2019;12:33:04;85800276;85745419;54857;
16.02.2019;12:34:05;85800349;85745549;54800;
16.02.2019;12:35:04;85800446;85745681;54765;
16.02.2019;12:36:04;85800510;85745804;54706;
16.02.2019;12:37:05;85800578;85745932;54646;
16.02.2019;12:38:04;85800640;85746056;54584;
16.02.2019;12:39:06;85800750;85746184;54566;
16.02.2019;12:40:04;85800834;85746311;54523;
16.02.2019;12:41:04;85800916;85746446;54470;
16.02.2019;12:42:05;85800976;85746533;54443;
16.02.2019;12:43:04;85800881;85746377;54504;
16.02.2019;12:44:05;85800898;85746399;54499;
16.02.2019;12:45:05;85800989;85746518;54471;
16.02.2019;12:46:04;85801051;85746610;54441;
16.02.2019;12:47:04;85801126;85746741;54385;
16.02.2019;12:48:05;85801206;85746871;54335;
16.02.2019;12:49:04;85801319;85746990;54329;
16.02.2019;12:50:04;85801390;85747124;54266;
16.02.2019;12:51:05;85801405;85747103;54302;
16.02.2019;12:52:05;85801415;85747074;54341;
16.02.2019;12:53:04;85801493;85747184;54309;
16.02.2019;12:54:04;85801570;85747273;54297;
16.02.2019;12:55:05;85801638;85747410;54228;
16.02.2019;12:56:04;85801711;85747516;54195;
16.02.2019;12:57:04;85801818;85747624;54194;
16.02.2019;12:58:05;85801909;85747760;54149;
16.02.2019;12:59:10;85801985;85747898;54087;
16.02.2019;13:00:04;85802070;85748016;54054;
16.02.2019;13:01:04;85802161;85748118;54043;
16.02.2019;13:03:11;85802367;85748375;53992;
16.02.2019;13:04:04;85802442;85748503;53939;
16.02.2019;13:05:05;85802543;85748651;53892;
16.02.2019;13:06:05;85802633;85748774;53859;
16.02.2019;13:07:04;85802703;85748918;53785;
16.02.2019;13:08:04;85802784;85749031;53753;
16.02.2019;13:09:05;85802853;85749145;53708;
16.02.2019;13:10:05;85802943;85749275;53668;
16.02.2019;13:11:05;85803024;85749411;53613;
16.02.2019;13:12:05;85803121;85749532;53589;
16.02.2019;13:13:05;85803218;85749669;53549;
16.02.2019;13:14:05;85803301;85749786;53515;
16.02.2019;13:15:05;85803363;85749919;53444;
16.02.2019;13:16:04;85803448;85750057;53391;
16.02.2019;13:17:04;85803549;85750204;53345;
16.02.2019;13:18:04;85803633;85750312;53321;
16.02.2019;13:19:05;85803724;85750438;53286;
16.02.2019;13:20:05;85803828;85750577;53251;
16.02.2019;13:21:04;85803892;85750680;53212;
16.02.2019;13:22:05;85803967;85750790;53177;
16.02.2019;13:23:04;85804050;85750909;53141;
16.02.2019;13:24:04;85804146;85751028;53118;
16.02.2019;13:25:04;85804231;85751140;53091;
16.02.2019;13:26:05;85804348;85751241;53107;
16.02.2019;13:27:05;85804422;85751378;53044;
16.02.2019;13:28:04;85804513;85751506;53007;
16.02.2019;13:29:05;85804584;85751634;52950;
16.02.2019;13:30:04;85804680;85751729;52951;
16.02.2019;13:31:04;85804777;85751855;52922;
16.02.2019;13:32:04;85804888;85751968;52920;
16.02.2019;13:33:04;85804994;85752086;52908;
16.02.2019;13:34:05;85805084;85752200;52884;
16.02.2019;13:35:05;85805164;85752333;52831;
16.02.2019;13:36:04;85805244;85752470;52774;
16.02.2019;13:37:04;85805338;85752593;52745;
16.02.2019;13:38:05;85805426;85752706;52720;
16.02.2019;13:39:05;85805509;85752845;52664;
16.02.2019;13:40:04;85805584;85752965;52619;
16.02.2019;13:41:04;85805671;85753093;52578;
16.02.2019;13:42:05;85805776;85753212;52564;
16.02.2019;13:43:05;85805879;85753319;52560;
16.02.2019;13:44:04;85805962;85753445;52517;
16.02.2019;13:45:04;85806058;85753565;52493;
16.02.2019;13:46:05;85806138;85753714;52424;
16.02.2019;13:47:05;85806230;85753824;52406;
16.02.2019;13:48:05;85806309;85753962;52347;
16.02.2019;13:49:04;85806394;85754057;52337;
16.02.2019;13:50:05;85806479;85754180;52299;
16.02.2019;13:51:04;85806569;85754295;52274;
16.02.2019;13:52:05;85806666;85754434;52232;
16.02.2019;13:53:05;85806745;85754546;52199;
16.02.2019;13:54:05;85806829;85754685;52144;
16.02.2019;13:55:05;85806914;85754835;52079;
16.02.2019;13:56:05;85806997;85754944;52053;
16.02.2019;13:57:05;85807091;85755074;52017;
16.02.2019;13:58:04;85807168;85755206;51962;
16.02.2019;13:59:04;85807259;85755308;51951;
16.02.2019;14:00:04;85807344;85755444;51900;
16.02.2019;14:01:05;85807438;85755565;51873;
16.02.2019;14:02:05;85807534;85755684;51850;
16.02.2019;14:03:04;85807654;85755813;51841;
16.02.2019;14:04:04;85807735;85755960;51775;
16.02.2019;14:05:05;85807841;85756104;51737;
16.02.2019;14:06:04;85807961;85756244;51717;
16.02.2019;14:07:04;85808057;85756371;51686;
16.02.2019;14:08:04;85808141;85756468;51673;
16.02.2019;14:09:04;85808218;85756622;51596;
16.02.2019;14:10:05;85808320;85756744;51576;
16.02.2019;14:11:04;85808417;85756877;51540;
16.02.2019;14:12:04;85808520;85757023;51497;
16.02.2019;14:13:05;85808600;85757157;51443;
16.02.2019;14:14:04;85808675;85757267;51408;
16.02.2019;14:15:04;85808754;85757419;51335;
16.02.2019;14:16:06;85808823;85757534;51289;
16.02.2019;14:17:05;85808909;85757642;51267;
16.02.2019;14:18:05;85808995;85757788;51207;
16.02.2019;14:19:04;85809083;85757931;51152;
16.02.2019;14:21:04;85809231;85758196;51035;
16.02.2019;14:22:04;85809319;85758309;51010;
16.02.2019;14:23:05;85809383;85758419;50964;
16.02.2019;14:24:04;85809464;85758567;50897;
16.02.2019;14:25:04;85809551;85758672;50879;
16.02.2019;14:26:04;85809623;85758767;50856;
16.02.2019;14:27:05;85809720;85758920;50800;
16.02.2019;14:28:04;85809802;85759046;50756;
16.02.2019;14:29:04;85809862;85759189;50673;
16.02.2019;14:30:04;85809933;85759330;50603;
16.02.2019;14:31:05;85810027;85759470;50557;
16.02.2019;14:32:04;85810108;85759618;50490;
16.02.2019;14:33:04;85810217;85759743;50474;
16.02.2019;14:34:05;85810289;85759873;50416;
16.02.2019;14:35:04;85810388;85759981;50407;
16.02.2019;14:36:04;85810462;85760114;50348;
16.02.2019;14:37:05;85810540;85760232;50308;
16.02.2019;14:38:04;85810623;85760362;50261;
16.02.2019;14:39:07;85810702;85760502;50200;
16.02.2019;14:40:09;85810797;85760610;50187;
16.02.2019;14:41:05;85810899;85760761;50138;
16.02.2019;14:42:05;85811000;85760850;50150;
16.02.2019;14:43:04;85811089;85760981;50108;
16.02.2019;14:44:04;85811194;85761119;50075;
16.02.2019;14:45:05;85811277;85761252;50025;
16.02.2019;14:46:04;85811374;85761379;49995;
16.02.2019;14:47:04;85811476;85761543;49933;
16.02.2019;14:48:05;85811566;85761695;49871;
16.02.2019;14:49:04;85811658;85761827;49831;
16.02.2019;14:50:04;85811729;85761968;49761;
16.02.2019;14:51:04;85811804;85762112;49692;
16.02.2019;14:52:04;85811883;85762257;49626;
16.02.2019;14:53:04;85811984;85762391;49593;
16.02.2019;14:54:05;85812088;85762535;49553;
16.02.2019;14:55:04;85812203;85762691;49512;
16.02.2019;14:56:05;85812293;85762836;49457;
16.02.2019;14:57:04;85812392;85762958;49434;
16.02.2019;14:58:04;85812497;85763095;49402;
16.02.2019;14:59:05;85812597;85763247;49350;
16.02.2019;15:00:07;85812717;85763416;49301;
16.02.2019;15:01:07;85812831;85763524;49307;
16.02.2019;15:02:07;85812922;85763661;49261;
16.02.2019;15:03:08;85813049;85763787;49262;
16.02.2019;15:04:08;85813172;85763912;49260;
16.02.2019;15:05:07;85813258;85764034;49224;
16.02.2019;15:06:07;85813349;85764184;49165;
16.02.2019;15:07:07;85813439;85764325;49114;
16.02.2019;15:08:08;85813555;85764471;49084;
16.02.2019;15:09:07;85813669;85764623;49046;
16.02.2019;15:10:08;85813769;85764754;49015;
16.02.2019;15:11:07;85813879;85764854;49025;
16.02.2019;15:12:07;85813988;85765019;48969;
16.02.2019;15:13:08;85814099;85765143;48956;
16.02.2019;15:14:07;85814183;85765275;48908;
16.02.2019;15:15:09;85814303;85765422;48881;
16.02.2019;15:16:08;85814397;85765550;48847;
16.02.2019;15:17:08;85814511;85765701;48810;
16.02.2019;15:18:08;85814606;85765843;48763;
16.02.2019;15:19:07;85814707;85765959;48748;
16.02.2019;15:20:08;85814820;85766093;48727;
16.02.2019;15:21:07;85814915;85766232;48683;
16.02.2019;15:22:07;85815030;85766383;48647;
16.02.2019;15:23:07;85815132;85766524;48608;
16.02.2019;15:24:08;85815236;85766663;48573;
16.02.2019;15:25:07;85815334;85766795;48539;
16.02.2019;15:26:07;85815469;85766929;48540;
16.02.2019;15:27:08;85815601;85767057;48544;
16.02.2019;15:28:08;85815700;85767204;48496;
16.02.2019;15:29:08;85815819;85767341;48478;
16.02.2019;15:30:07;85815920;85767486;48434;
16.02.2019;15:31:15;85816039;85767650;48389;
16.02.2019;15:32:10;85816148;85767793;48355;
16.02.2019;15:33:08;85816246;85767935;48311;
16.02.2019;15:34:07;85816356;85768065;48291;
16.02.2019;15:35:07;85816447;85768166;48281;
16.02.2019;15:36:08;85816552;85768323;48229;
16.02.2019;15:37:08;85816656;85768471;48185;
16.02.2019;15:38:07;85816743;85768600;48143;
16.02.2019;15:39:08;85816854;85768769;48085;
16.02.2019;15:40:07;85816942;85768910;48032;
16.02.2019;15:41:08;85817068;85769058;48010;
16.02.2019;15:42:07;85817160;85769189;47971;
16.02.2019;15:43:08;85817263;85769297;47966;
16.02.2019;15:44:07;85817373;85769432;47941;
16.02.2019;15:45:07;85817484;85769566;47918;
16.02.2019;15:46:07;85817602;85769697;47905;
16.02.2019;15:47:07;85817682;85769820;47862;
16.02.2019;15:48:07;85817805;85769960;47845;
16.02.2019;15:49:07;85817942;85770076;47866;
16.02.2019;15:50:08;85818067;85770213;47854;
16.02.2019;15:51:07;85818178;85770347;47831;
16.02.2019;15:52:08;85818305;85770493;47812;
16.02.2019;15:53:08;85818426;85770613;47813;
16.02.2019;15:54:06;85818538;85770746;47792;
16.02.2019;15:55:07;85818662;85770913;47749;
16.02.2019;15:56:08;85818775;85771064;47711;
16.02.2019;15:57:08;85818890;85771212;47678;
16.02.2019;15:58:07;85818996;85771339;47657;
16.02.2019;15:59:10;85819112;85771478;47634;
16.02.2019;16:00:05;85819233;85771596;47637;
16.02.2019;16:01:04;85819354;85771736;47618;
16.02.2019;16:02:04;85819455;85771890;47565;
16.02.2019;16:03:05;85819556;85772008;47548;
16.02.2019;16:04:05;85819648;85772114;47534;
16.02.2019;16:05:04;85819752;85772242;47510;
16.02.2019;16:06:05;85819870;85772367;47503;
16.02.2019;16:07:04;85819999;85772517;47482;
16.02.2019;16:08:04;85820109;85772655;47454;
16.02.2019;16:09:05;85820227;85772786;47441;
16.02.2019;16:10:05;85820338;85772925;47413;
16.02.2019;16:11:05;85820458;85773093;47365;
16.02.2019;16:12:04;85820566;85773231;47335;
16.02.2019;16:13:04;85820661;85773385;47276;
16.02.2019;16:14:05;85820755;85773535;47220;
16.02.2019;16:15:04;85820880;85773683;47197;
16.02.2019;16:16:04;85820984;85773828;47156;
16.02.2019;16:17:05;85821073;85773961;47112;
16.02.2019;16:18:05;85821175;85774070;47105;
16.02.2019;16:19:04;85821290;85774214;47076;
16.02.2019;16:20:05;85821395;85774343;47052;
16.02.2019;16:21:05;85821507;85774500;47007;
16.02.2019;16:22:04;85821596;85774647;46949;
16.02.2019;16:23:05;85821692;85774812;46880;
16.02.2019;16:24:04;85821782;85774959;46823;
16.02.2019;16:25:04;85821883;85775114;46769;
16.02.2019;16:26:05;85821982;85775264;46718;
16.02.2019;16:27:04;85822115;85775383;46732;
16.02.2019;16:28:04;85822209;85775516;46693;
16.02.2019;16:29:05;85822295;85775642;46653;
16.02.2019;16:30:04;85822392;85775779;46613;
16.02.2019;16:31:04;85822506;85775921;46585;
16.02.2019;16:32:05;85822608;85776047;46561;
16.02.2019;16:33:04;85822700;85776183;46517;
16.02.2019;16:34:04;85822788;85776336;46452;
16.02.2019;16:35:04;85822892;85776472;46420;
16.02.2019;16:36:05;85822993;85776618;46375;
16.02.2019;16:37:04;85823095;85776781;46314;
16.02.2019;16:38:05;85823217;85776940;46277;
16.02.2019;16:39:04;85823316;85777061;46255;
16.02.2019;16:40:04;85823410;85777181;46229;
16.02.2019;16:41:04;85823545;85777316;46229;
16.02.2019;16:42:05;85823654;85777459;46195;
16.02.2019;16:43:05;85823770;85777616;46154;
16.02.2019;16:44:05;85823910;85777723;46187;
16.02.2019;16:45:04;85824010;85777841;46169;
16.02.2019;16:46:04;85824135;85777978;46157;
16.02.2019;16:47:05;85824247;85778135;46112;
16.02.2019;16:48:05;85824345;85778285;46060;
16.02.2019;16:49:04;85824459;85778433;46026;
16.02.2019;16:50:05;85824559;85778573;45986;
16.02.2019;16:51:05;85824674;85778728;45946;
16.02.2019;16:52:05;85824789;85778877;45912;
16.02.2019;16:53:05;85824928;85779033;45895;
16.02.2019;16:54:05;85825047;85779180;45867;
16.02.2019;16:55:04;85825146;85779310;45836;
16.02.2019;16:56:05;85825275;85779442;45833;
16.02.2019;16:57:04;85825392;85779588;45804;
16.02.2019;16:58:05;85825485;85779748;45737;
16.02.2019;16:59:05;85825594;85779902;45692;
16.02.2019;17:00:08;85825719;85780043;45676;
16.02.2019;17:01:04;85825814;85780168;45646;
16.02.2019;17:02:05;85825946;85780317;45629;
16.02.2019;17:03:05;85826049;85780466;45583;
16.02.2019;17:04:05;85826161;85780596;45565;
16.02.2019;17:05:04;85826259;85780762;45497;
16.02.2019;17:06:05;85826348;85780912;45436;
16.02.2019;17:07:05;85826457;85781055;45402;
16.02.2019;17:08:05;85826570;85781207;45363;
16.02.2019;17:09:04;85826702;85781351;45351;
16.02.2019;17:10:04;85826795;85781503;45292;
16.02.2019;17:11:04;85826915;85781644;45271;
16.02.2019;17:12:08;85827054;85781812;45242;
16.02.2019;17:13:05;85827174;85781946;45228;
16.02.2019;17:14:05;85827289;85782075;45214;
16.02.2019;17:15:05;85827397;85782205;45192;
16.02.2019;17:16:06;85827525;85782367;45158;
16.02.2019;17:17:04;85827638;85782520;45118;
16.02.2019;17:18:08;85827777;85782648;45129;
16.02.2019;17:19:06;85827874;85782792;45082;
16.02.2019;17:20:07;85827998;85782909;45089;
16.02.2019;17:21:04;85828104;85783047;45057;
16.02.2019;17:22:06;85828230;85783195;45035;
16.02.2019;17:23:05;85828342;85783351;44991;
16.02.2019;17:24:05;85828461;85783501;44960;
16.02.2019;17:25:10;85828595;85783665;44930;
16.02.2019;17:26:05;85828686;85783804;44882;
16.02.2019;17:27:10;85828815;85783968;44847;
16.02.2019;17:28:05;85828927;85784113;44814;
16.02.2019;17:29:11;85829043;85784261;44782;
16.02.2019;17:30:13;85829158;85784426;44732;
16.02.2019;17:31:06;85829267;85784572;44695;
16.02.2019;17:32:05;85829386;85784694;44692;
16.02.2019;17:33:05;85829505;85784829;44676;
16.02.2019;17:34:05;85829609;85784977;44632;
16.02.2019;17:35:05;85829751;85785109;44642;
16.02.2019;17:36:04;85829861;85785221;44640;
16.02.2019;17:37:04;85829969;85785358;44611;
16.02.2019;17:38:15;85830093;85785499;44594;
16.02.2019;17:39:06;85830193;85785637;44556;
16.02.2019;17:40:10;85830319;85785758;44561;
16.02.2019;17:41:04;85830430;85785892;44538;
16.02.2019;17:42:04;85830560;85786013;44547;
16.02.2019;17:43:04;85830698;85786146;44552;
16.02.2019;17:44:04;85830804;85786268;44536;
16.02.2019;17:45:05;85830948;85786415;44533;
16.02.2019;17:46:04;85831054;85786568;44486;
16.02.2019;17:47:05;85831149;85786700;44449;
16.02.2019;17:48:04;85831267;85786857;44410;
16.02.2019;17:49:05;85831394;85787003;44391;
16.02.2019;17:50:05;85831505;85787131;44374;
16.02.2019;17:51:05;85831613;85787272;44341;
16.02.2019;17:52:05;85831720;85787392;44328;
16.02.2019;17:53:05;85831855;85787521;44334;
16.02.2019;17:54:04;85831962;85787655;44307;
16.02.2019;17:55:05;85832068;85787814;44254;
16.02.2019;17:56:05;85832174;85787964;44210;
16.02.2019;17:57:04;85832283;85788101;44182;
16.02.2019;17:58:13;85832422;85788253;44169;
16.02.2019;17:59:04;85832537;85788366;44171;
16.02.2019;18:00:05;85832644;85788508;44136;
16.02.2019;18:01:05;85832749;85788627;44122;
16.02.2019;18:02:05;85832869;85788753;44116;
16.02.2019;18:03:15;85833002;85788907;44095;
16.02.2019;18:04:07;85833092;85789041;44051;
16.02.2019;18:05:08;85833196;85789182;44014;
16.02.2019;18:06:07;85833297;85789320;43977;
16.02.2019;18:07:07;85833417;85789449;43968;
16.02.2019;18:08:06;85833514;85789574;43940;
16.02.2019;18:09:06;85833638;85789702;43936;
16.02.2019;18:10:07;85833760;85789840;43920;
16.02.2019;18:11:08;85833856;85789975;43881;
16.02.2019;18:12:07;85833975;85790096;43879;
16.02.2019;18:13:07;85834070;85790220;43850;
16.02.2019;18:14:08;85834151;85790334;43817;
16.02.2019;18:15:07;85834240;85790457;43783;
16.02.2019;18:16:08;85834335;85790594;43741;
16.02.2019;18:17:07;85834431;85790706;43725;
16.02.2019;18:18:05;85834542;85790837;43705;
16.02.2019;18:19:07;85834648;85790991;43657;
16.02.2019;18:20:06;85834761;85791087;43674;
16.02.2019;18:21:11;85834862;85791194;43668;
16.02.2019;18:22:09;85834942;85791302;43640;
16.02.2019;18:23:18;85835035;85791420;43615;
16.02.2019;18:24:11;85835138;85791527;43611;
16.02.2019;18:25:10;85835215;85791649;43566;
16.02.2019;18:26:12;85835343;85791759;43584;
16.02.2019;18:27:14;85835446;85791867;43579;
16.02.2019;18:28:11;85835549;85791984;43565;
16.02.2019;18:29:19;85835651;85792095;43556;
16.02.2019;18:30:11;85835732;85792220;43512;
16.02.2019;18:31:08;85835824;85792335;43489;
16.02.2019;18:32:07;85835916;85792455;43461;
16.02.2019;18:33:21;85836047;85792578;43469;
16.02.2019;18:34:11;85836112;85792665;43447;
16.02.2019;18:35:09;85836207;85792761;43446;
16.02.2019;18:36:06;85836310;85792863;43447;
16.02.2019;18:37:08;85836434;85792979;43455;
16.02.2019;18:38:07;85836554;85793107;43447;
16.02.2019;18:39:06;85836646;85793216;43430;
16.02.2019;18:40:05;85836749;85793327;43422;
16.02.2019;18:41:06;85836834;85793450;43384;
16.02.2019;18:42:06;85836946;85793573;43373;
16.02.2019;18:43:10;85837011;85793625;43386;
16.02.2019;18:44:10;85837119;85793750;43369;
16.02.2019;18:45:12;85837206;85793865;43341;
16.02.2019;18:46:10;85837321;85793976;43345;
16.02.2019;18:47:09;85837445;85794109;43336;
16.02.2019;18:48:08;85837564;85794204;43360;
16.02.2019;18:49:10;85837688;85794295;43393;
16.02.2019;18:50:09;85837792;85794414;43378;
16.02.2019;18:51:11;85837917;85794526;43391;
16.02.2019;18:52:25;85838047;85794663;43384;
16.02.2019;18:53:16;85838142;85794762;43380;
16.02.2019;18:54:09;85838247;85794871;43376;
16.02.2019;18:55:09;85838356;85794959;43397;
16.02.2019;18:56:11;85838473;85795069;43404;
16.02.2019;18:57:09;85838585;85795178;43407;
16.02.2019;18:58:08;85838695;85795315;43380;
16.02.2019;18:59:09;85838800;85795451;43349;
16.02.2019;19:00:12;85838902;85795575;43327;
16.02.2019;19:01:10;85839011;85795677;43334;
16.02.2019;19:02:09;85839126;85795773;43353;
16.02.2019;19:03:10;85839252;85795871;43381;
16.02.2019;19:04:08;85839357;85795972;43385;
16.02.2019;19:05:14;85839474;85796064;43410;
16.02.2019;19:06:07;85839586;85796177;43409;
16.02.2019;19:07:08;85839691;85796294;43397;
16.02.2019;19:08:13;85839807;85796397;43410;
16.02.2019;19:09:07;85839912;85796486;43426;
16.02.2019;19:10:05;85840022;85796584;43438;
16.02.2019;19:11:05;85840124;85796696;43428;
16.02.2019;19:12:08;85840240;85796813;43427;
16.02.2019;19:13:09;85840339;85796911;43428;
16.02.2019;19:14:06;85840460;85797011;43449;
16.02.2019;19:15:07;85840562;85797123;43439;
16.02.2019;19:16:05;85840658;85797243;43415;
16.02.2019;19:17:12;85840795;85797364;43431;
16.02.2019;19:18:08;85840878;85797445;43433;
16.02.2019;19:19:11;85840989;85797548;43441;
16.02.2019;19:20:04;85841086;85797637;43449;
16.02.2019;19:21:04;85841181;85797749;43432;
16.02.2019;19:22:05;85841292;85797844;43448;
16.02.2019;19:23:04;85841389;85797919;43470;
16.02.2019;19:24:04;85841503;85798006;43497;
16.02.2019;19:25:09;85841619;85798093;43526;
16.02.2019;19:26:05;85841704;85798188;43516;
16.02.2019;19:27:05;85841816;85798289;43527;
16.02.2019;19:28:04;85841923;85798382;43541;
16.02.2019;19:29:05;85842024;85798459;43565;
16.02.2019;19:30:09;85842148;85798571;43577;
16.02.2019;19:31:04;85842253;85798649;43604;
16.02.2019;19:32:05;85842372;85798748;43624;
16.02.2019;19:33:08;85842507;85798851;43656;
16.02.2019;19:34:05;85842620;85798925;43695;
16.02.2019;19:35:04;85842699;85799006;43693;
16.02.2019;19:36:05;85842830;85799112;43718;
16.02.2019;19:37:05;85842935;85799159;43776;
16.02.2019;19:38:05;85843046;85799259;43787;
16.02.2019;19:39:05;85843136;85799352;43784;
16.02.2019;19:40:05;85843247;85799439;43808;
16.02.2019;19:41:04;85843353;85799512;43841;
16.02.2019;19:42:05;85843446;85799591;43855;
16.02.2019;19:43:05;85843546;85799675;43871;
16.02.2019;19:44:05;85843663;85799762;43901;
16.02.2019;19:45:04;85843749;85799832;43917;
16.02.2019;19:46:04;85843876;85799918;43958;
16.02.2019;19:47:04;85843992;85799993;43999;
16.02.2019;19:48:04;85844124;85800075;44049;
16.02.2019;19:49:04;85844227;85800155;44072;
16.02.2019;19:50:05;85844351;85800223;44128;
16.02.2019;19:51:05;85844455;85800305;44150;
16.02.2019;19:52:05;85844583;85800411;44172;
16.02.2019;19:53:04;85844691;85800495;44196;
16.02.2019;19:54:09;85844791;85800577;44214;
16.02.2019;19:55:06;85844891;85800645;44246;
16.02.2019;19:56:05;85845018;85800733;44285;
16.02.2019;19:57:05;85845087;85800801;44286;
16.02.2019;19:58:04;85845254;85800860;44394;
16.02.2019;19:59:04;85845381;85800930;44451;
16.02.2019;20:00:10;85845517;85801018;44499;
16.02.2019;20:01:05;85845629;85801089;44540;
16.02.2019;20:02:05;85845752;85801171;44581;
16.02.2019;20:03:05;85845861;85801255;44606;
16.02.2019;20:04:05;85845963;85801342;44621;
16.02.2019;20:05:05;85846076;85801414;44662;
16.02.2019;20:06:05;85846183;85801480;44703;
16.02.2019;20:07:05;85846309;85801583;44726;
16.02.2019;20:08:05;85846418;85801636;44782;
16.02.2019;20:09:05;85846494;85801722;44772;
16.02.2019;20:10:05;85846593;85801813;44780;
16.02.2019;20:11:05;85846695;85801890;44805;
16.02.2019;20:12:04;85846818;85801954;44864;
16.02.2019;20:13:05;85846930;85802022;44908;
16.02.2019;20:14:04;85847044;85802083;44961;
16.02.2019;20:15:05;85847126;85802162;44964;
16.02.2019;20:16:05;85847253;85802211;45042;
16.02.2019;20:17:05;85847369;85802261;45108;
16.02.2019;20:18:05;85847413;85802270;45143;
16.02.2019;20:19:05;85847429;85802293;45136;
16.02.2019;20:20:05;85847426;85802309;45117;
16.02.2019;20:21:05;85847495;85802337;45158;
16.02.2019;20:22:05;85847581;85802387;45194;
16.02.2019;20:23:05;85847685;85802465;45220;
16.02.2019;20:24:05;85847794;85802526;45268;
16.02.2019;20:25:04;85847876;85802572;45304;
16.02.2019;20:26:04;85847967;85802636;45331;
16.02.2019;20:27:05;85848061;85802702;45359;
16.02.2019;20:28:05;85848174;85802750;45424;
16.02.2019;20:29:06;85848272;85802813;45459;
16.02.2019;20:30:04;85848359;85802884;45475;
16.02.2019;20:31:04;85848447;85802930;45517;
16.02.2019;20:32:06;85848546;85802999;45547;
16.02.2019;20:33:05;85848644;85803060;45584;
16.02.2019;20:34:05;85848757;85803125;45632;
16.02.2019;20:35:05;85848842;85803177;45665;
16.02.2019;20:36:06;85848951;85803229;45722;
16.02.2019;20:37:04;85849065;85803296;45769;
16.02.2019;20:38:05;85849162;85803345;45817;
16.02.2019;20:39:05;85849251;85803416;45835;
16.02.2019;20:40:05;85849345;85803467;45878;
16.02.2019;20:41:05;85849452;85803514;45938;
16.02.2019;20:42:05;85849547;85803574;45973;
16.02.2019;20:43:05;85849606;85803624;45982;
16.02.2019;20:44:05;85849610;85803696;45914;
16.02.2019;20:45:05;85849666;85803744;45922;
16.02.2019;20:46:04;85849716;85803802;45914;
16.02.2019;20:47:05;85849771;85803861;45910;
16.02.2019;20:48:16;85849845;85803930;45915;
16.02.2019;20:49:05;85849895;85803984;45911;
16.02.2019;20:50:05;85849986;85804069;45917;
16.02.2019;20:51:04;85850065;85804120;45945;
16.02.2019;20:52:04;85850155;85804165;45990;
16.02.2019;20:53:06;85850226;85804214;46012;
16.02.2019;20:54:04;85850317;85804265;46052;
16.02.2019;20:55:09;85850400;85804324;46076;
16.02.2019;20:56:05;85850460;85804374;46086;
16.02.2019;20:57:05;85850538;85804409;46129;
16.02.2019;20:58:04;85850647;85804464;46183;
16.02.2019;20:59:04;85850733;85804532;46201;
16.02.2019;21:00:10;85850800;85804597;46203;
16.02.2019;21:01:04;85850882;85804641;46241;
16.02.2019;21:02:04;85850942;85804700;46242;
16.02.2019;21:03:05;85851047;85804758;46289;
16.02.2019;21:04:05;85851160;85804804;46356;
16.02.2019;21:05:05;85851254;85804862;46392;
16.02.2019;21:06:05;85851347;85804927;46420;
16.02.2019;21:07:05;85851444;85804974;46470;
16.02.2019;21:08:05;85851535;85805026;46509;
16.02.2019;21:09:05;85851640;85805082;46558;
16.02.2019;21:10:06;85851728;85805133;46595;
16.02.2019;21:11:10;85851810;85805195;46615;
16.02.2019;21:12:05;85851890;85805246;46644;
16.02.2019;21:13:05;85851984;85805295;46689;
16.02.2019;21:14:05;85852063;85805345;46718;
16.02.2019;21:15:04;85852142;85805389;46753;
16.02.2019;21:16:05;85852244;85805451;46793;
16.02.2019;21:17:06;85852349;85805502;46847;
16.02.2019;21:18:05;85852419;85805541;46878;
16.02.2019;21:19:05;85852512;85805581;46931;
16.02.2019;21:20:05;85852607;85805633;46974;
16.02.2019;21:21:05;85852696;85805677;47019;
16.02.2019;21:22:04;85852780;85805712;47068;
16.02.2019;21:23:09;85852870;85805765;47105;
16.02.2019;21:24:05;85852948;85805798;47150;
16.02.2019;21:25:05;85853037;85805853;47184;
16.02.2019;21:26:05;85853133;85805905;47228;
16.02.2019;21:27:04;85853195;85805947;47248;
16.02.2019;21:28:04;85853293;85806006;47287;
16.02.2019;21:29:06;85853366;85806052;47314;
16.02.2019;21:30:04;85853458;85806099;47359;
16.02.2019;21:31:04;85853551;85806143;47408;
16.02.2019;21:32:05;85853666;85806204;47462;
16.02.2019;21:33:04;85853746;85806246;47500;
16.02.2019;21:34:04;85853813;85806299;47514;
16.02.2019;21:35:05;85853895;85806357;47538;
16.02.2019;21:36:05;85853992;85806400;47592;
16.02.2019;21:37:04;85854078;85806440;47638;
16.02.2019;21:38:04;85854179;85806478;47701;
16.02.2019;21:39:05;85854278;85806512;47766;
16.02.2019;21:40:05;85854382;85806530;47852;
16.02.2019;21:41:04;85854474;85806577;47897;
16.02.2019;21:42:05;85854563;85806619;47944;
16.02.2019;21:43:05;85854636;85806681;47955;
16.02.2019;21:44:05;85854748;85806714;48034;
16.02.2019;21:45:05;85854841;85806752;48089;
16.02.2019;21:46:04;85854893;85806729;48164;
16.02.2019;21:47:05;85854979;85806774;48205;
16.02.2019;21:48:05;85855064;85806813;48251;
16.02.2019;21:49:05;85855170;85806857;48313;
16.02.2019;21:50:06;85855253;85806896;48357;
16.02.2019;21:51:05;85855344;85806940;48404;
16.02.2019;21:52:06;85855451;85806982;48469;
16.02.2019;21:53:09;85855547;85807032;48515;
16.02.2019;21:54:04;85855623;85807083;48540;
16.02.2019;21:55:05;85855721;85807139;48582;
16.02.2019;21:56:05;85855823;85807164;48659;
16.02.2019;21:57:05;85855924;85807198;48726;
16.02.2019;21:58:06;85856020;85807250;48770;
16.02.2019;21:59:09;85856136;85807280;48856;
16.02.2019;22:00:04;85856226;85807320;48906;
16.02.2019;22:01:05;85856328;85807357;48971;
16.02.2019;22:02:05;85856416;85807391;49025;
16.02.2019;22:03:05;85856506;85807410;49096;
16.02.2019;22:04:05;85856599;85807440;49159;
16.02.2019;22:05:05;85856695;85807474;49221;
16.02.2019;22:06:05;85856782;85807521;49261;
16.02.2019;22:07:05;85856898;85807553;49345;
16.02.2019;22:08:04;85857015;85813748;43267;
16.02.2019;22:09:04;85857110;85813778;43332;
16.02.2019;22:10:05;85857194;85813822;43372;
16.02.2019;22:11:05;85857298;85813855;43443;
16.02.2019;22:12:05;85857370;85813895;43475;
16.02.2019;22:13:05;85857489;85813934;43555;
16.02.2019;22:14:05;85857580;85813970;43610;
16.02.2019;22:15:04;85855917;85814016;41901;
16.02.2019;22:16:04;85856020;85814049;41971;
16.02.2019;22:17:05;85856127;85814078;42049;
16.02.2019;22:18:05;85856221;85814113;42108;
16.02.2019;22:19:05;85856304;85814139;42165;
16.02.2019;22:20:05;85856379;85814144;42235;
16.02.2019;22:21:05;85856450;85814174;42276;
16.02.2019;22:22:05;85856531;85814226;42305;
16.02.2019;22:23:05;85856623;85814244;42379;
16.02.2019;22:24:05;85856715;85814274;42441;
16.02.2019;22:25:05;85856787;85814307;42480;
16.02.2019;22:26:05;85856851;85814335;42516;
16.02.2019;22:27:04;85856952;85814355;42597;
16.02.2019;22:28:04;85857042;85814381;42661;
16.02.2019;22:29:06;85857127;85814397;42730;
16.02.2019;22:30:05;85857227;85814442;42785;
16.02.2019;22:31:04;85857298;85814462;42836;
16.02.2019;22:32:05;85857391;85814503;42888;
16.02.2019;22:33:05;85857485;85814535;42950;
16.02.2019;22:34:05;85857544;85814559;42985;
16.02.2019;22:35:05;85857624;85814581;43043;
16.02.2019;22:36:05;85857703;85814605;43098;
16.02.2019;22:37:05;85857806;85814629;43177;
16.02.2019;22:38:05;85857889;85814649;43240;
16.02.2019;22:39:07;85857985;85814672;43313;
16.02.2019;22:40:04;85858052;85814700;43352;
16.02.2019;22:41:05;85858148;85814728;43420;
16.02.2019;22:42:06;85858230;85814751;43479;
16.02.2019;22:43:05;85858309;85814783;43526;
16.02.2019;22:44:05;85858388;85814812;43576;
16.02.2019;22:45:05;85858491;85814846;43645;
16.02.2019;22:46:05;85858590;85814871;43719;
16.02.2019;22:47:04;85858675;85814892;43783;
16.02.2019;22:48:04;85858769;85814920;43849;
16.02.2019;22:49:05;85858857;85814955;43902;
16.02.2019;22:50:05;85858933;85814988;43945;
16.02.2019;22:51:04;85859044;85815010;44034;
16.02.2019;22:52:04;85859146;85815043;44103;
16.02.2019;22:53:05;85859217;85815064;44153;
16.02.2019;22:54:05;85859306;85815098;44208;
16.02.2019;22:55:07;85859400;85815135;44265;
16.02.2019;22:56:06;85859500;85815178;44322;
16.02.2019;22:57:09;85859588;85815207;44381;
16.02.2019;22:58:06;85859672;85815229;44443;
16.02.2019;22:59:06;85859757;85815269;44488;
16.02.2019;23:00:07;85859854;85815290;44564;
16.02.2019;23:01:05;85859936;85815317;44619;
16.02.2019;23:02:07;85860047;85815342;44705;
16.02.2019;23:03:22;85860153;85815372;44781;
16.02.2019;23:04:08;85860222;85815388;44834;
16.02.2019;23:06:06;85860419;85815440;44979;
16.02.2019;23:07:08;85860510;85815478;45032;
16.02.2019;23:08:05;85860606;85815494;45112;
16.02.2019;23:09:07;85860689;85815521;45168;
16.02.2019;23:10:06;85860777;85815546;45231;
16.02.2019;23:11:06;85860854;85815576;45278;
16.02.2019;23:12:07;85860952;85815610;45342;
16.02.2019;23:13:08;85861046;85815645;45401;
16.02.2019;23:14:06;85861128;85815665;45463;
16.02.2019;23:15:04;85861194;85815685;45509;
16.02.2019;23:16:05;85861264;85815706;45558;
16.02.2019;23:17:06;85861335;85815739;45596;
16.02.2019;23:18:11;85861426;85815768;45658;
16.02.2019;23:19:06;85861509;85815794;45715;
16.02.2019;23:20:06;85861595;85815825;45770;
16.02.2019;23:21:07;85861680;85815851;45829;
16.02.2019;23:22:05;85861772;85815868;45904;
16.02.2019;23:23:11;85861845;85815920;45925;
16.02.2019;23:24:05;85861928;85815948;45980;
16.02.2019;23:25:06;85862025;85815991;46034;
16.02.2019;23:26:06;85862094;85816010;46084;
16.02.2019;23:27:05;85862181;85816042;46139;
16.02.2019;23:28:08;85862292;85816075;46217;
16.02.2019;23:29:08;85862369;85816095;46274;
16.02.2019;23:30:06;85862447;85816131;46316;
16.02.2019;23:31:05;85862550;85816150;46400;
16.02.2019;23:32:08;85862622;85816178;46444;
16.02.2019;23:33:07;85862692;85816207;46485;
16.02.2019;23:34:13;85862792;85816234;46558;
16.02.2019;23:35:05;85862862;85816259;46603;
16.02.2019;23:36:11;85862956;85816287;46669;
16.02.2019;23:37:11;85863040;85816301;46739;
16.02.2019;23:38:07;85863123;85816329;46794;
16.02.2019;23:39:13;85863190;85816362;46828;
16.02.2019;23:40:07;85863291;85816401;46890;
16.02.2019;23:41:09;85863395;85816421;46974;
16.02.2019;23:42:04;85863491;85816449;47042;
16.02.2019;23:43:11;85863592;85816475;47117;
16.02.2019;23:44:05;85863701;85816496;47205;
16.02.2019;23:45:15;85863766;85816518;47248;
16.02.2019;23:46:10;85863865;85816546;47319;
16.02.2019;23:47:10;85863941;85816574;47367;
16.02.2019;23:48:11;85864004;85816607;47397;
16.02.2019;23:49:11;85864111;85816623;47488;
16.02.2019;23:50:09;85864180;85816658;47522;
16.02.2019;23:51:11;85864250;85816680;47570;
16.02.2019;23:52:10;85864327;85816692;47635;
16.02.2019;23:53:07;85864398;85816732;47666;
16.02.2019;23:54:05;85864494;85816755;47739;
16.02.2019;23:55:05;85864578;85816779;47799;
16.02.2019;23:56:05;85864692;85816792;47900;
16.02.2019;23:57:10;85864805;85816830;47975;
16.02.2019;23:58:12;85864878;85816849;48029;
16.02.2019;23:59:14;85864959;85816882;48077;
17.02.2019;00:00:21;85865081;85816900;48181;
17.02.2019;00:01:12;85865162;85816932;48230;
17.02.2019;00:02:17;85865258;85816954;48304;
17.02.2019;00:03:17;85865380;85816970;48410;
17.02.2019;00:04:21;85865473;85816996;48477;
17.02.2019;00:05:18;85865574;85817019;48555;
17.02.2019;00:06:22;85865671;85817040;48631;
17.02.2019;00:07:19;85865751;85817064;48687;
17.02.2019;00:08:20;85865853;85817104;48749;
17.02.2019;00:09:23;85865945;85817136;48809;
17.02.2019;00:10:19;85866029;85817163;48866;
17.02.2019;00:11:20;85866128;85817185;48943;
17.02.2019;00:12:21;85866197;85817212;48985;
17.02.2019;00:13:18;85866262;85817233;49029;
17.02.2019;00:14:26;85866364;85817257;49107;
17.02.2019;00:15:18;85866422;85817277;49145;
17.02.2019;00:16:16;85866489;85817303;49186;
17.02.2019;00:17:14;85866560;85817316;49244;
17.02.2019;00:18:13;85866592;85817331;49261;
17.02.2019;00:19:09;85866650;85817345;49305;
17.02.2019;00:20:11;85866694;85817367;49327;
17.02.2019;00:21:09;85866763;85817379;49384;
17.02.2019;00:22:07;85866829;85817394;49435;
17.02.2019;00:23:08;85866901;85817409;49492;
17.02.2019;00:24:07;85866978;85817420;49558;
17.02.2019;00:25:07;85867051;85817429;49622;
17.02.2019;00:26:08;85867108;85817450;49658;
17.02.2019;00:27:06;85867156;85817468;49688;
17.02.2019;00:28:08;85867238;85817492;49746;
17.02.2019;00:29:07;85867303;85817523;49780;
17.02.2019;00:30:07;85867384;85817545;49839;
17.02.2019;00:31:08;85867439;85817571;49868;
17.02.2019;00:32:08;85867501;85817586;49915;
17.02.2019;00:33:07;85867559;85817607;49952;
17.02.2019;00:34:08;85867634;85817632;50002;
17.02.2019;00:35:07;85867710;85817655;50055;
17.02.2019;00:36:08;85867780;85817667;50113;
17.02.2019;00:37:08;85867878;85817693;50185;
17.02.2019;00:38:07;85867969;85817719;50250;
17.02.2019;00:39:08;85868056;85817743;50313;
17.02.2019;00:40:08;85868127;85817762;50365;
17.02.2019;00:41:07;85868220;85817796;50424;
17.02.2019;00:42:08;85868307;85817832;50475;
17.02.2019;00:43:08;85868388;85817854;50534;
17.02.2019;00:44:08;85868480;85817877;50603;
17.02.2019;00:45:07;85868592;85817896;50696;
17.02.2019;00:46:08;85868658;85817925;50733;
17.02.2019;00:47:07;85868736;85817955;50781;
17.02.2019;00:48:07;85868813;85817961;50852;
17.02.2019;00:49:07;85868892;85817949;50943;
17.02.2019;00:50:07;85868982;85817972;51010;
17.02.2019;00:51:07;85869062;85817997;51065;
17.02.2019;00:52:08;85869141;85818024;51117;
17.02.2019;00:53:07;85869228;85818061;51167;
17.02.2019;00:54:08;85869326;85818082;51244;
17.02.2019;00:55:08;85869411;85818108;51303;
17.02.2019;00:56:08;85869523;85818132;51391;
17.02.2019;00:57:07;85869615;85818159;51456;
17.02.2019;00:58:07;85869703;85818184;51519;
17.02.2019;00:59:08;85869809;85818203;51606;
17.02.2019;01:00:04;85869886;85818237;51649;
17.02.2019;01:01:04;85869968;85818267;51701;
17.02.2019;01:02:04;85870052;85818289;51763;
17.02.2019;01:03:05;85870122;85818310;51812;
17.02.2019;01:04:05;85870186;85818337;51849;
17.02.2019;01:05:05;85870273;85818369;51904;
17.02.2019;01:06:04;85870375;85818384;51991;
17.02.2019;01:07:04;85870434;85818413;52021;
17.02.2019;01:08:06;85870537;85818438;52099;
17.02.2019;01:09:05;85870620;85818465;52155;
17.02.2019;01:10:05;85870727;85818492;52235;
17.02.2019;01:11:04;85870821;85818528;52293;
17.02.2019;01:12:04;85870874;85818549;52325;
17.02.2019;01:13:05;85870948;85818573;52375;
17.02.2019;01:14:04;85871046;85818598;52448;
17.02.2019;01:15:04;85871122;85818627;52495;
17.02.2019;01:16:04;85871208;85818656;52552;
17.02.2019;01:17:05;85871281;85818677;52604;
17.02.2019;01:18:04;85871376;85818709;52667;
17.02.2019;01:19:04;85871452;85818732;52720;
17.02.2019;01:20:05;85871531;85818768;52763;
17.02.2019;01:21:05;85871604;85818794;52810;
17.02.2019;01:22:05;85871691;85818816;52875;
17.02.2019;01:23:05;85871791;85818841;52950;
17.02.2019;01:24:05;85871876;85818864;53012;
17.02.2019;01:25:04;85871937;85818898;53039;
17.02.2019;01:26:05;85872038;85818937;53101;
17.02.2019;01:27:05;85872120;85818974;53146;
17.02.2019;01:28:05;85872196;85819008;53188;
17.02.2019;01:29:05;85872283;85819033;53250;
17.02.2019;01:30:04;85872383;85819053;53330;
17.02.2019;01:31:04;85872470;85819078;53392;
17.02.2019;01:32:05;85872539;85819123;53416;
17.02.2019;01:33:05;85872629;85819162;53467;
17.02.2019;01:34:05;85872712;85819183;53529;
17.02.2019;01:35:04;85872795;85819210;53585;
17.02.2019;01:36:05;85872877;85819238;53639;
17.02.2019;01:37:04;85872961;85819284;53677;
17.02.2019;01:38:04;85873033;85819315;53718;
17.02.2019;01:39:05;85873109;85819344;53765;
17.02.2019;01:40:04;85873192;85819381;53811;
17.02.2019;01:41:04;85873280;85819417;53863;
17.02.2019;01:42:04;85873363;85819457;53906;
17.02.2019;01:43:05;85873441;85819484;53957;
17.02.2019;01:44:05;85873526;85819531;53995;
17.02.2019;01:45:05;85873612;85819566;54046;
17.02.2019;01:46:05;85873704;85819604;54100;
17.02.2019;01:47:04;85873785;85819635;54150;
17.02.2019;01:48:05;85873860;85819667;54193;
17.02.2019;01:49:05;85873952;85819708;54244;
17.02.2019;01:50:04;85874053;85819738;54315;
17.02.2019;01:51:04;85874148;85819777;54371;
17.02.2019;01:52:04;85874245;85819814;54431;
17.02.2019;01:53:05;85874338;85819850;54488;
17.02.2019;01:54:05;85874409;85819890;54519;
17.02.2019;01:55:05;85874509;85819940;54569;
17.02.2019;01:56:04;85874597;85819970;54627;
17.02.2019;01:57:04;85874688;85820011;54677;
17.02.2019;01:58:04;85874770;85820054;54716;
17.02.2019;01:59:05;85874844;85820088;54756;
17.02.2019;02:00:05;85874917;85820138;54779;
17.02.2019;02:01:05;85874986;85820190;54796;
17.02.2019;02:02:05;85875081;85820237;54844;
17.02.2019;02:03:05;85875151;85820283;54868;
17.02.2019;02:04:05;85875200;85820321;54879;
17.02.2019;02:05:05;85875303;85820373;54930;
17.02.2019;02:06:04;85875377;85820414;54963;
17.02.2019;02:07:04;85875464;85820474;54990;
17.02.2019;02:08:05;85875574;85820523;55051;
17.02.2019;02:09:05;85875671;85820572;55099;
17.02.2019;02:10:05;85875752;85820621;55131;
17.02.2019;02:11:05;85875822;85820684;55138;
17.02.2019;02:12:05;85875889;85820722;55167;
17.02.2019;02:13:05;85875947;85820764;55183;
17.02.2019;02:14:04;85876001;85820770;55231;
17.02.2019;02:15:04;85876052;85820826;55226;
17.02.2019;02:16:05;85876116;85820875;55241;
17.02.2019;02:17:05;85876193;85820926;55267;
17.02.2019;02:18:04;85876256;85820984;55272;
17.02.2019;02:19:05;85876309;85821013;55296;
17.02.2019;02:20:05;85876384;85821056;55328;
17.02.2019;02:21:05;85876446;85821124;55322;
17.02.2019;02:22:06;85876522;85821156;55366;
17.02.2019;02:23:04;85876597;85821208;55389;
17.02.2019;02:24:05;85876663;85821256;55407;
17.02.2019;02:25:05;85876739;85821301;55438;
17.02.2019;02:26:04;85876816;85821341;55475;
17.02.2019;02:27:05;85876906;85821391;55515;
17.02.2019;02:28:05;85876991;85821444;55547;
17.02.2019;02:29:04;85877067;85821487;55580;
17.02.2019;02:30:05;85877148;85821542;55606;
17.02.2019;02:31:05;85877230;85821612;55618;
17.02.2019;02:32:04;85877298;85821674;55624;
17.02.2019;02:33:04;85877390;85821725;55665;
17.02.2019;02:34:04;85877465;85821761;55704;
17.02.2019;02:35:05;85877557;85821815;55742;
17.02.2019;02:36:05;85877651;85821881;55770;
17.02.2019;02:37:04;85877728;85821939;55789;
17.02.2019;02:38:04;85877802;85822020;55782;
17.02.2019;02:39:04;85877882;85822085;55797;
17.02.2019;02:40:06;85877950;85822148;55802;
17.02.2019;02:41:04;85878031;85822219;55812;
17.02.2019;02:42:04;85878123;85822281;55842;
17.02.2019;02:43:06;85878208;85822348;55860;
17.02.2019;02:44:04;85878275;85822417;55858;
17.02.2019;02:45:05;85878355;85822494;55861;
17.02.2019;02:46:05;85878436;85822573;55863;
17.02.2019;02:47:04;85878539;85822645;55894;
17.02.2019;02:48:04;85878613;85822713;55900;
17.02.2019;02:49:04;85878702;85822793;55909;
17.02.2019;02:50:05;85878779;85822863;55916;
17.02.2019;02:51:04;85878864;85822938;55926;
17.02.2019;02:52:04;85878952;85823027;55925;
17.02.2019;02:53:05;85879032;85823096;55936;
17.02.2019;02:54:05;85879114;85823180;55934;
17.02.2019;02:55:05;85879193;85823254;55939;
17.02.2019;02:56:05;85879291;85823334;55957;
17.02.2019;02:57:05;85879359;85823403;55956;
17.02.2019;02:58:05;85879461;85823465;55996;
17.02.2019;02:59:05;85879542;85823549;55993;
17.02.2019;03:00:04;85879632;85823635;55997;
17.02.2019;03:01:04;85879687;85823724;55963;
17.02.2019;03:02:05;85879823;85823802;56021;
17.02.2019;03:03:05;85879909;85823865;56044;
17.02.2019;03:04:04;85879999;85823959;56040;
17.02.2019;03:05:06;85880078;85824051;56027;
17.02.2019;03:06:05;85880149;85824124;56025;
17.02.2019;03:07:04;85880245;85824200;56045;
17.02.2019;03:08:04;85880325;85824296;56029;
17.02.2019;03:09:05;85880413;85824384;56029;
17.02.2019;03:10:05;85880503;85824466;56037;
17.02.2019;03:11:04;85880601;85824538;56063;
17.02.2019;03:12:04;85880695;85824633;56062;
17.02.2019;03:13:05;85880795;85824718;56077;
17.02.2019;03:14:05;85880870;85824805;56065;
17.02.2019;03:15:05;85880962;85824894;56068;
17.02.2019;03:16:04;85881048;85824984;56064;
17.02.2019;03:18:04;85881235;85825160;56075;
17.02.2019;03:19:05;85881322;85825227;56095;
17.02.2019;03:20:05;85881402;85825329;56073;
17.02.2019;03:21:05;85881480;85825412;56068;
17.02.2019;03:22:04;85881571;85825492;56079;
17.02.2019;03:23:04;85881655;85825575;56080;
17.02.2019;03:24:04;85881728;85825686;56042;
17.02.2019;03:25:05;85881810;85825773;56037;
17.02.2019;03:26:05;85881906;85825867;56039;
17.02.2019;03:27:04;85882001;85825953;56048;
17.02.2019;03:28:04;85882086;85826029;56057;
17.02.2019;03:29:05;85882162;85826121;56041;
17.02.2019;03:30:04;85882230;85826215;56015;
17.02.2019;03:31:04;85882300;85826290;56010;
17.02.2019;03:32:05;85882382;85826385;55997;
17.02.2019;03:33:05;85882477;85826471;56006;
17.02.2019;03:34:04;85882556;85826558;55998;
17.02.2019;03:35:04;85882651;85826638;56013;
17.02.2019;03:36:05;85882739;85826738;56001;
17.02.2019;03:37:04;85882819;85826823;55996;
17.02.2019;03:38:05;85882906;85826932;55974;
17.02.2019;03:39:05;85882992;85827027;55965;
17.02.2019;03:40:05;85883081;85827134;55947;
17.02.2019;03:41:04;85883159;85827225;55934;
17.02.2019;03:42:04;85883235;85827327;55908;
17.02.2019;03:43:05;85883345;85827431;55914;
17.02.2019;03:44:04;85883427;85827529;55898;
17.02.2019;03:45:05;85883514;85827620;55894;
17.02.2019;03:46:04;85883629;85827708;55921;
17.02.2019;03:47:04;85883712;85827824;55888;
17.02.2019;03:48:05;85883806;85827935;55871;
17.02.2019;03:49:04;85883902;85828047;55855;
17.02.2019;03:50:04;85883996;85828156;55840;
17.02.2019;03:51:05;85884087;85828258;55829;
17.02.2019;03:52:05;85884183;85828350;55833;
17.02.2019;03:53:04;85884271;85828446;55825;
17.02.2019;03:54:04;85884324;85828509;55815;
17.02.2019;03:55:04;85884380;85828582;55798;
17.02.2019;03:56:05;85884468;85828677;55791;
17.02.2019;03:57:05;85884557;85828773;55784;
17.02.2019;03:58:04;85884663;85828879;55784;
17.02.2019;03:59:05;85884747;85829009;55738;
17.02.2019;04:00:05;85884824;85829127;55697;
17.02.2019;04:01:05;85884892;85829226;55666;
17.02.2019;04:02:05;85884986;85829320;55666;
17.02.2019;04:03:05;85885068;85829431;55637;
17.02.2019;04:04:04;85885175;85829547;55628;
17.02.2019;04:05:04;85885269;85829657;55612;
17.02.2019;04:06:05;85885329;85829773;55556;
17.02.2019;04:07:05;85885386;85829891;55495;
17.02.2019;04:08:05;85885453;85830000;55453;
17.02.2019;04:09:05;85885535;85830104;55431;
17.02.2019;04:10:05;85885605;85830219;55386;
17.02.2019;04:11:05;85885685;85830314;55371;
17.02.2019;04:12:05;85885753;85830423;55330;
17.02.2019;04:13:05;85885834;85830526;55308;
17.02.2019;04:14:04;85885912;85830630;55282;
17.02.2019;04:15:04;85885956;85830714;55242;
17.02.2019;04:16:05;85886024;85830833;55191;
17.02.2019;04:17:05;85886091;85830931;55160;
17.02.2019;04:18:04;85886183;85831051;55132;
17.02.2019;04:19:05;85886263;85831133;55130;
17.02.2019;04:20:05;85886348;85831247;55101;
17.02.2019;04:21:05;85886446;85831374;55072;
17.02.2019;04:22:04;85886511;85831481;55030;
17.02.2019;04:23:04;85886571;85831576;54995;
17.02.2019;04:24:05;85886633;85831680;54953;
17.02.2019;04:25:04;85886697;85831798;54899;
17.02.2019;04:26:04;85886773;85831902;54871;
17.02.2019;04:27:05;85886818;85832014;54804;
17.02.2019;04:28:05;85886879;85832134;54745;
17.02.2019;04:29:04;85886957;85832236;54721;
17.02.2019;04:30:04;85887038;85832348;54690;
17.02.2019;04:31:05;85887114;85832466;54648;
17.02.2019;04:32:05;85887216;85832573;54643;
17.02.2019;04:33:04;85887292;85832676;54616;
17.02.2019;04:34:04;85887368;85832771;54597;
17.02.2019;04:35:05;85887434;85832890;54544;
17.02.2019;04:36:05;85887525;85833008;54517;
17.02.2019;04:37:05;85887586;85833134;54452;
17.02.2019;04:38:05;85887658;85833250;54408;
17.02.2019;04:39:04;85887737;85833360;54377;
17.02.2019;04:40:04;85887815;85833477;54338;
17.02.2019;04:41:04;85887885;85833603;54282;
17.02.2019;04:42:05;85887968;85833686;54282;
17.02.2019;04:43:05;85888069;85833843;54226;
17.02.2019;04:44:05;85888161;85833980;54181;
17.02.2019;04:45:04;85888241;85834110;54131;
17.02.2019;04:46:04;85888329;85834239;54090;
17.02.2019;04:47:05;85888432;85834364;54068;
17.02.2019;04:48:04;85888509;85834464;54045;
17.02.2019;04:49:05;85888613;85834575;54038;
17.02.2019;04:50:05;85888699;85834673;54026;
17.02.2019;04:51:04;85888776;85834813;53963;
17.02.2019;04:52:05;85888852;85834931;53921;
17.02.2019;04:53:05;85888945;85835041;53904;
17.02.2019;04:54:04;85889028;85835150;53878;
17.02.2019;04:55:04;85889119;85835230;53889;
17.02.2019;04:56:04;85889206;85835417;53789;
17.02.2019;04:57:05;85889283;85835546;53737;
17.02.2019;04:58:04;85889369;85835655;53714;
17.02.2019;04:59:04;85889458;85835766;53692;
17.02.2019;05:00:05;85889561;85835895;53666;
17.02.2019;05:01:05;85889624;85836018;53606;
17.02.2019;05:02:04;85889718;85836128;53590;
17.02.2019;05:03:04;85889796;85836260;53536;
17.02.2019;05:04:04;85889860;85836373;53487;
17.02.2019;05:05:04;85889966;85836476;53490;
17.02.2019;05:06:05;85890051;85836601;53450;
17.02.2019;05:07:05;85890135;85836726;53409;
17.02.2019;05:08:04;85890233;85836827;53406;
17.02.2019;05:09:05;85890288;85836954;53334;
17.02.2019;05:10:04;85890383;85837082;53301;
17.02.2019;05:11:04;85890450;85837220;53230;
17.02.2019;05:12:05;85890547;85837333;53214;
17.02.2019;05:13:04;85890629;85837449;53180;
17.02.2019;05:14:04;85890713;85837579;53134;
17.02.2019;05:15:05;85890776;85837723;53053;
17.02.2019;05:16:04;85890846;85837832;53014;
17.02.2019;05:17:05;85890929;85837976;52953;
17.02.2019;05:18:05;85890993;85838091;52902;
17.02.2019;05:19:04;85891079;85838203;52876;
17.02.2019;05:20:05;85891163;85838334;52829;
17.02.2019;05:21:05;85891244;85838453;52791;
17.02.2019;05:22:04;85891347;85838578;52769;
17.02.2019;05:23:05;85891427;85838692;52735;
17.02.2019;05:24:05;85891525;85838800;52725;
17.02.2019;05:25:04;85891589;85838905;52684;
17.02.2019;05:26:05;85891706;85838998;52708;
17.02.2019;05:27:05;85891792;85839133;52659;
17.02.2019;05:28:04;85891878;85839258;52620;
17.02.2019;05:29:05;85891953;85839388;52565;
17.02.2019;05:30:04;85892029;85839506;52523;
17.02.2019;05:31:04;85892101;85839638;52463;
17.02.2019;05:32:05;85892178;85839759;52419;
17.02.2019;05:33:04;85892254;85839891;52363;
17.02.2019;05:34:05;85892339;85840016;52323;
17.02.2019;05:35:04;85892401;85840154;52247;
17.02.2019;05:36:04;85892490;85840286;52204;
17.02.2019;05:37:05;85892581;85840416;52165;
17.02.2019;05:38:04;85892659;85840540;52119;
17.02.2019;05:39:05;85892733;85840684;52049;
17.02.2019;05:40:05;85892801;85840819;51982;
17.02.2019;05:41:04;85892850;85840960;51890;
17.02.2019;05:42:04;85892923;85841093;51830;
17.02.2019;05:43:05;85893005;85841232;51773;
17.02.2019;05:44:05;85893076;85841346;51730;
17.02.2019;05:45:04;85893151;85841473;51678;
17.02.2019;05:46:04;85893238;85841589;51649;
17.02.2019;05:47:05;85893326;85841723;51603;
17.02.2019;05:48:05;85893406;85841839;51567;
17.02.2019;05:49:04;85893490;85841994;51496;
17.02.2019;05:50:05;85893571;85842109;51462;
17.02.2019;05:51:05;85893650;85842267;51383;
17.02.2019;05:52:04;85893732;85842378;51354;
17.02.2019;05:53:04;85893802;85842520;51282;
17.02.2019;05:54:05;85893863;85842671;51192;
17.02.2019;05:55:05;85893925;85842794;51131;
17.02.2019;05:56:04;85893992;85842917;51075;
17.02.2019;05:57:04;85894052;85843043;51009;
17.02.2019;05:58:05;85894123;85843188;50935;
17.02.2019;05:59:05;85894198;85843313;50885;
17.02.2019;06:00:04;85894275;85843427;50848;
17.02.2019;06:01:04;85894361;85843560;50801;
17.02.2019;06:02:06;85894440;85843709;50731;
17.02.2019;06:03:04;85894501;85843849;50652;
17.02.2019;06:04:05;85894570;85843962;50608;
17.02.2019;06:05:04;85894621;85844088;50533;
17.02.2019;06:06:05;85894684;85844232;50452;
17.02.2019;06:07:04;85894744;85844347;50397;
17.02.2019;06:08:05;85894807;85844474;50333;
17.02.2019;06:09:05;85894859;85844594;50265;
17.02.2019;06:10:04;85894923;85844725;50198;
17.02.2019;06:11:05;85894997;85844856;50141;
17.02.2019;06:12:05;85895041;85844980;50061;
17.02.2019;06:13:05;85895116;85845106;50010;
17.02.2019;06:14:05;85895176;85845226;49950;
17.02.2019;06:15:04;85895227;85845354;49873;
17.02.2019;06:16:04;85895271;85845445;49826;
17.02.2019;06:17:05;85895333;85845611;49722;
17.02.2019;06:18:05;85895402;85845719;49683;
17.02.2019;06:19:05;85895468;85845883;49585;
17.02.2019;06:20:04;85895539;85845995;49544;
17.02.2019;06:21:04;85895588;85846122;49466;
17.02.2019;06:22:05;85895665;85846260;49405;
17.02.2019;06:23:04;85895724;85846399;49325;
17.02.2019;06:24:04;85895788;85846536;49252;
17.02.2019;06:25:08;85895844;85846671;49173;
17.02.2019;06:26:04;85895905;85846801;49104;
17.02.2019;06:27:04;85895949;85846969;48980;
17.02.2019;06:28:05;85896030;85847119;48911;
17.02.2019;06:29:04;85896086;85847250;48836;
17.02.2019;06:30:04;85896162;85847360;48802;
17.02.2019;06:31:04;85896226;85847500;48726;
17.02.2019;06:32:05;85896285;85847626;48659;
17.02.2019;06:33:05;85896363;85847725;48638;
17.02.2019;06:34:04;85896410;85847834;48576;
17.02.2019;06:35:04;85896479;85847938;48541;
17.02.2019;06:36:05;85896546;85848080;48466;
17.02.2019;06:37:04;85896616;85848193;48423;
17.02.2019;06:38:05;85896672;85848311;48361;
17.02.2019;06:39:05;85896753;85848430;48323;
17.02.2019;06:40:04;85896824;85848537;48287;
17.02.2019;06:41:05;85896911;85848646;48265;
17.02.2019;06:42:04;85896973;85848754;48219;
17.02.2019;06:43:04;85897050;85848887;48163;
17.02.2019;06:44:05;85897133;85848997;48136;
17.02.2019;06:45:04;85897194;85849130;48064;
17.02.2019;06:46:04;85897278;85849264;48014;
17.02.2019;06:47:07;85897360;85849403;47957;
17.02.2019;06:48:05;85897449;85849511;47938;
17.02.2019;06:49:05;85897519;85849589;47930;
17.02.2019;06:50:04;85897561;85849669;47892;
17.02.2019;06:51:04;85897645;85849792;47853;
17.02.2019;06:52:05;85897720;85849896;47824;
17.02.2019;06:53:05;85897780;85850001;47779;
17.02.2019;06:54:04;85897846;85850129;47717;
17.02.2019;06:55:04;85897900;85850254;47646;
17.02.2019;06:56:05;85897979;85850383;47596;
17.02.2019;06:57:04;85898049;85850498;47551;
17.02.2019;06:58:04;85898120;85850638;47482;
17.02.2019;06:59:05;85898174;85850757;47417;
17.02.2019;07:00:04;85898229;85850902;47327;
17.02.2019;07:01:05;85898287;85851012;47275;
17.02.2019;07:02:04;85898341;85851158;47183;
17.02.2019;07:03:04;85898401;85851278;47123;
17.02.2019;07:04:05;85898478;85851400;47078;
17.02.2019;07:05:04;85898566;85851516;47050;
17.02.2019;07:06:04;85898638;85851658;46980;
17.02.2019;07:07:05;85898702;85851784;46918;
17.02.2019;07:08:05;85898758;85851897;46861;
17.02.2019;07:09:06;85898822;85852017;46805;
17.02.2019;07:10:05;85898893;85852142;46751;
17.02.2019;07:11:09;85898957;85852285;46672;
17.02.2019;07:12:04;85899010;85852403;46607;
17.02.2019;07:13:05;85899081;85852552;46529;
17.02.2019;07:14:05;85899129;85852672;46457;
17.02.2019;07:15:04;85899190;85852820;46370;
17.02.2019;07:16:04;85899257;85852950;46307;
17.02.2019;07:17:05;85899311;85853092;46219;
17.02.2019;07:18:05;85899400;85853232;46168;
17.02.2019;07:19:05;85899458;85853362;46096;
17.02.2019;07:20:05;85899529;85853491;46038;
17.02.2019;07:21:04;85899581;85853600;45981;
17.02.2019;07:22:05;85899631;85853732;45899;
17.02.2019;07:23:04;85899695;85853874;45821;
17.02.2019;07:24:05;85899779;85854024;45755;
17.02.2019;07:25:05;85899845;85854156;45689;
17.02.2019;07:26:05;85899925;85854286;45639;
17.02.2019;07:27:04;85899998;85854408;45590;
17.02.2019;07:28:05;85900065;85854550;45515;
17.02.2019;07:29:05;85900167;85854661;45506;
17.02.2019;07:30:05;85900238;85854803;45435;
17.02.2019;07:31:04;85900300;85854913;45387;
17.02.2019;07:32:04;85900376;85855061;45315;
17.02.2019;07:33:05;85900452;85855183;45269;
17.02.2019;07:34:05;85900517;85855294;45223;
17.02.2019;07:35:05;85900587;85855431;45156;
17.02.2019;07:36:04;85900653;85855560;45093;
17.02.2019;07:37:04;85900723;85855684;45039;
17.02.2019;07:38:04;85900772;85855858;44914;
17.02.2019;07:39:05;85900845;85855982;44863;
17.02.2019;07:40:05;85900902;85856135;44767;
17.02.2019;07:41:05;85900983;85856281;44702;
17.02.2019;07:42:04;85901041;85856413;44628;
17.02.2019;07:43:04;85901083;85856581;44502;
17.02.2019;07:44:05;85901147;85856726;44421;
17.02.2019;07:45:05;85901197;85856876;44321;
17.02.2019;07:46:04;85901281;85857006;44275;
17.02.2019;07:47:04;85901349;85857119;44230;
17.02.2019;07:48:05;85901422;85857249;44173;
17.02.2019;07:49:04;85901470;85857393;44077;
17.02.2019;07:50:04;85901546;85857518;44028;
17.02.2019;07:51:05;85901598;85857648;43950;
17.02.2019;07:52:04;85901671;85857794;43877;
17.02.2019;07:53:04;85901744;85857936;43808;
17.02.2019;07:54:05;85901810;85858081;43729;
17.02.2019;07:55:04;85901879;85858218;43661;
17.02.2019;07:56:05;85901966;85858364;43602;
17.02.2019;07:57:04;85902030;85858507;43523;
17.02.2019;07:58:05;85902106;85858639;43467;
17.02.2019;07:59:04;85902137;85858763;43374;
17.02.2019;08:00:04;85902241;85858909;43332;
17.02.2019;08:01:05;85902324;85859063;43261;
17.02.2019;08:02:05;85902387;85859230;43157;
17.02.2019;08:03:04;85902453;85859339;43114;
17.02.2019;08:04:05;85902492;85859477;43015;
17.02.2019;08:05:05;85902558;85859565;42993;
17.02.2019;08:06:04;85902623;85859675;42948;
17.02.2019;08:07:05;85902687;85859800;42887;
17.02.2019;08:08:05;85902767;85859923;42844;
17.02.2019;08:09:04;85902829;85860043;42786;
17.02.2019;08:10:05;85902870;85860191;42679;
17.02.2019;08:11:05;85902941;85860300;42641;
17.02.2019;08:12:04;85902964;85860414;42550;
17.02.2019;08:13:05;85902993;85860536;42457;
17.02.2019;08:14:05;85903074;85860669;42405;
17.02.2019;08:15:04;85903138;85860781;42357;
17.02.2019;08:16:04;85903180;85860881;42299;
17.02.2019;08:17:05;85903223;85860989;42234;
17.02.2019;08:18:05;85903282;85861116;42166;
17.02.2019;08:19:04;85903328;85861235;42093;
17.02.2019;08:20:04;85903363;85861346;42017;
17.02.2019;08:21:05;85903426;85861438;41988;
17.02.2019;08:22:05;85903456;85861556;41900;
17.02.2019;08:23:05;85903520;85861673;41847;
17.02.2019;08:24:05;85903566;85861797;41769;
17.02.2019;08:25:05;85903623;85861925;41698;
17.02.2019;08:26:04;85903692;85862068;41624;
17.02.2019;08:27:04;85903749;85862208;41541;
17.02.2019;08:28:04;85903803;85862346;41457;
17.02.2019;08:29:05;85903878;85862470;41408;
17.02.2019;08:30:05;85903930;85862567;41363;
17.02.2019;08:31:05;85904001;85862656;41345;
17.02.2019;08:32:04;85904063;85862722;41341;
17.02.2019;08:33:04;85904118;85862787;41331;
17.02.2019;08:34:05;85904180;85862902;41278;
17.02.2019;08:35:04;85904222;85862975;41247;
17.02.2019;08:36:04;85904284;85863070;41214;
17.02.2019;08:37:05;85904344;85863185;41159;
17.02.2019;08:38:04;85904402;85863300;41102;
17.02.2019;08:39:04;85904466;85863418;41048;
17.02.2019;08:40:04;85904541;85863541;41000;
17.02.2019;08:41:05;85904608;85863641;40967;
17.02.2019;08:42:05;85904662;85863757;40905;
17.02.2019;08:43:05;85904716;85863861;40855;
17.02.2019;08:44:04;85904770;85863987;40783;
17.02.2019;08:45:04;85904827;85864103;40724;
17.02.2019;08:46:05;85904883;85864224;40659;
17.02.2019;08:47:05;85904959;85864362;40597;
17.02.2019;08:48:05;85905027;85864474;40553;
17.02.2019;08:49:05;85905094;85864606;40488;
17.02.2019;08:50:04;85905155;85864727;40428;
17.02.2019;08:51:05;85905239;85864843;40396;
17.02.2019;08:52:05;85905281;85864926;40355;
17.02.2019;08:53:04;85905352;85865061;40291;
17.02.2019;08:54:04;85905414;85865180;40234;
17.02.2019;08:55:05;85905484;85865319;40165;
17.02.2019;08:56:04;85905530;85865440;40090;
17.02.2019;08:57:04;85905595;85865550;40045;
17.02.2019;08:58:05;85905670;85865682;39988;
17.02.2019;08:59:04;85905729;85865792;39937;
17.02.2019;09:00:04;85905805;85865910;39895;
17.02.2019;09:01:05;85905881;85866027;39854;
17.02.2019;09:02:04;85905943;85866136;39807;
17.02.2019;09:03:04;85906006;85866250;39756;
17.02.2019;09:04:05;85906066;85866357;39709;
17.02.2019;09:05:05;85906107;85866469;39638;
17.02.2019;09:06:05;85906172;85866587;39585;
17.02.2019;09:07:04;85906232;85866712;39520;
17.02.2019;09:08:05;85906287;85866827;39460;
17.02.2019;09:09:05;85906365;85866921;39444;
17.02.2019;09:10:04;85906416;85867037;39379;
17.02.2019;09:11:04;85906465;85867180;39285;
17.02.2019;09:12:05;85906528;85867291;39237;
17.02.2019;09:13:05;85906586;85867437;39149;
17.02.2019;09:14:04;85906660;85867581;39079;
17.02.2019;09:15:04;85906705;85867724;38981;
17.02.2019;09:16:04;85906759;85867842;38917;
17.02.2019;09:17:05;85906816;85867984;38832;
17.02.2019;09:18:05;85906867;85868137;38730;
17.02.2019;09:19:05;85906918;85868240;38678;
17.02.2019;09:20:04;85906992;85868351;38641;
17.02.2019;09:21:04;85907032;85868498;38534;
17.02.2019;09:22:05;85907099;85868629;38470;
17.02.2019;09:23:05;85907158;85868743;38415;
17.02.2019;09:24:04;85907230;85868858;38372;
17.02.2019;09:25:04;85907288;85868978;38310;
17.02.2019;09:26:05;85907358;85869100;38258;
17.02.2019;09:27:04;85907423;85869228;38195;
17.02.2019;09:28:04;85907467;85869340;38127;
17.02.2019;09:29:05;85907545;85869493;38052;
17.02.2019;09:30:04;85907615;85869658;37957;
17.02.2019;09:31:05;85907672;85869788;37884;
17.02.2019;09:32:05;85907744;85869909;37835;
17.02.2019;09:33:04;85907822;85870011;37811;
17.02.2019;09:34:04;85907875;85870093;37782;
17.02.2019;09:35:05;85907930;85870182;37748;
17.02.2019;09:36:04;85907985;85870260;37725;
17.02.2019;09:37:04;85908063;85870348;37715;
17.02.2019;09:38:05;85908109;85870468;37641;
17.02.2019;09:39:05;85908166;85870548;37618;
17.02.2019;09:40:04;85908229;85870642;37587;
17.02.2019;09:41:04;85908287;85870774;37513;
17.02.2019;09:42:05;85908369;85870891;37478;
17.02.2019;09:43:05;85908431;85870987;37444;
17.02.2019;09:44:05;85908509;85871104;37405;
17.02.2019;09:45:04;85908594;85871221;37373;
17.02.2019;09:46:05;85908663;85871373;37290;
17.02.2019;09:47:05;85908755;85871501;37254;
17.02.2019;09:48:04;85908813;85871637;37176;
17.02.2019;09:49:05;85908877;85871757;37120;
17.02.2019;09:50:05;85908880;85871784;37096;
17.02.2019;09:51:05;85908947;85871904;37043;
17.02.2019;09:52:05;85909018;85872038;36980;
17.02.2019;09:53:04;85909080;85872160;36920;
17.02.2019;09:54:04;85909136;85872268;36868;
17.02.2019;09:55:04;85909220;85872415;36805;
17.02.2019;09:56:05;85909303;85872522;36781;
17.02.2019;09:57:05;85909374;85872663;36711;
17.02.2019;09:58:04;85909437;85872767;36670;
17.02.2019;09:59:04;85909475;85872876;36599;
17.02.2019;10:00:05;85909546;85873015;36531;
17.02.2019;10:01:05;85909607;85873129;36478;
17.02.2019;10:02:05;85909668;85873265;36403;
17.02.2019;10:03:05;85909728;85873417;36311;
17.02.2019;10:04:04;85909791;85873574;36217;
17.02.2019;10:05:04;85909833;85873708;36125;
17.02.2019;10:06:05;85909885;85873858;36027;
17.02.2019;10:07:05;85909951;85873991;35960;
17.02.2019;10:08:04;85910032;85874132;35900;
17.02.2019;10:09:04;85910104;85874238;35866;
17.02.2019;10:10:05;85910160;85874368;35792;
17.02.2019;10:11:05;85910213;85874465;35748;
17.02.2019;10:12:04;85910257;85874567;35690;
17.02.2019;10:13:04;85910311;85874691;35620;
17.02.2019;10:14:05;85910351;85874831;35520;
17.02.2019;10:15:05;85910412;85874933;35479;
17.02.2019;10:16:04;85910469;85875064;35405;
17.02.2019;10:17:04;85910528;85875173;35355;
17.02.2019;10:18:04;85910588;85875297;35291;
17.02.2019;10:19:05;85910631;85875423;35208;
17.02.2019;10:20:04;85910686;85875558;35128;
17.02.2019;10:21:04;85910751;85875677;35074;
17.02.2019;10:22:05;85910794;85875807;34987;
17.02.2019;10:23:05;85910825;85875899;34926;
17.02.2019;10:24:04;85910841;85876024;34817;
17.02.2019;10:25:04;85910878;85876114;34764;
17.02.2019;10:26:05;85910929;85876224;34705;
17.02.2019;10:27:04;85910984;85876327;34657;
17.02.2019;10:28:04;85911016;85876463;34553;
17.02.2019;10:29:05;85911071;85876602;34469;
17.02.2019;10:30:05;85911129;85876708;34421;
17.02.2019;10:31:05;85911197;85876823;34374;
17.02.2019;10:32:05;85911253;85876954;34299;
17.02.2019;10:33:05;85911314;85877049;34265;
17.02.2019;10:34:05;85911383;85877183;34200;
17.02.2019;10:35:05;85911443;85877300;34143;
17.02.2019;10:36:05;85911500;85877417;34083;
17.02.2019;10:37:04;85911564;85877529;34035;
17.02.2019;10:38:05;85911623;85877651;33972;
17.02.2019;10:39:05;85911673;85877764;33909;
17.02.2019;10:40:05;85911736;85877907;33829;
17.02.2019;10:41:05;85911805;85878050;33755;
17.02.2019;10:42:05;85911869;85878161;33708;
17.02.2019;10:43:04;85911936;85878327;33609;
17.02.2019;10:44:04;85911993;85878459;33534;
17.02.2019;10:45:05;85912041;85878612;33429;
17.02.2019;10:46:10;85912127;85878747;33380;
17.02.2019;10:47:04;85912185;85878865;33320;
17.02.2019;10:48:04;85912256;85879003;33253;
17.02.2019;10:49:05;85912305;85879135;33170;
17.02.2019;10:50:04;85912358;85879287;33071;
17.02.2019;10:51:05;85912424;85879461;32963;
17.02.2019;10:52:04;85912479;85879580;32899;
17.02.2019;10:53:04;85912559;85879726;32833;
17.02.2019;10:54:05;85912628;85879864;32764;
17.02.2019;10:55:05;85912694;85879989;32705;
17.02.2019;10:56:04;85912749;85880116;32633;
17.02.2019;10:57:04;85912802;85880255;32547;
17.02.2019;10:58:05;85912877;85880399;32478;
17.02.2019;10:59:05;85912942;85880525;32417;
17.02.2019;11:00:04;85913022;85880638;32384;
17.02.2019;11:01:05;85913090;85880787;32303;
17.02.2019;11:02:04;85913152;85880929;32223;
17.02.2019;11:03:04;85913205;85881050;32155;
17.02.2019;11:04:05;85913275;85881181;32094;
17.02.2019;11:05:04;85913352;85881335;32017;
17.02.2019;11:06:04;85913429;85881465;31964;
17.02.2019;11:07:05;85913498;85881594;31904;
17.02.2019;11:08:04;85913577;85881722;31855;
17.02.2019;11:09:04;85913665;85881846;31819;
17.02.2019;11:10:04;85913722;85881977;31745;
17.02.2019;11:11:05;85913782;85882134;31648;
17.02.2019;11:12:05;85913833;85882293;31540;
17.02.2019;11:13:05;85913908;85882432;31476;
17.02.2019;11:14:05;85913968;85882580;31388;
17.02.2019;11:15:05;85914043;85882695;31348;
17.02.2019;11:16:05;85914111;85882846;31265;
17.02.2019;11:17:05;85914174;85882984;31190;
17.02.2019;11:18:05;85914246;85883098;31148;
17.02.2019;11:19:04;85914313;85883248;31065;
17.02.2019;11:20:04;85914382;85883406;30976;
17.02.2019;11:21:05;85914448;85883528;30920;
17.02.2019;11:22:05;85914511;85883670;30841;
17.02.2019;11:23:04;85914578;85883767;30811;
17.02.2019;11:24:04;85914639;85883900;30739;
17.02.2019;11:25:04;85914711;85884026;30685;
17.02.2019;11:26:05;85914770;85884166;30604;
17.02.2019;11:27:04;85914836;85884280;30556;
17.02.2019;11:28:04;85914918;85884398;30520;
17.02.2019;11:29:05;85914973;85884526;30447;
17.02.2019;11:30:04;85915039;85884659;30380;
17.02.2019;11:31:04;85915095;85884810;30285;
17.02.2019;11:32:05;85915152;85884933;30219;
17.02.2019;11:33:04;85915208;85885059;30149;
17.02.2019;11:34:04;85915266;85885165;30101;
17.02.2019;11:35:05;85915325;85885308;30017;
17.02.2019;11:36:05;85915394;85885437;29957;
17.02.2019;11:37:04;85915450;85885536;29914;
17.02.2019;11:38:05;85915527;85885667;29860;
17.02.2019;11:39:05;85915587;85885803;29784;
17.02.2019;11:40:05;85915639;85885941;29698;
17.02.2019;11:41:04;85915708;85886097;29611;
17.02.2019;11:42:04;85915781;85886217;29564;
17.02.2019;11:43:05;85915841;85886341;29500;
17.02.2019;11:44:04;85915901;85886472;29429;
17.02.2019;11:45:04;85915962;85886600;29362;
17.02.2019;11:46:05;85916022;85886717;29305;
17.02.2019;11:47:05;85916076;85886845;29231;
17.02.2019;11:48:05;85916148;85886955;29193;
17.02.2019;11:49:05;85916225;85887081;29144;
17.02.2019;11:50:04;85916285;85887225;29060;
17.02.2019;11:51:04;85916350;85887361;28989;
17.02.2019;11:52:05;85916411;85887516;28895;
17.02.2019;11:53:05;85916471;85887645;28826;
17.02.2019;11:54:05;85916548;85887789;28759;
17.02.2019;11:55:05;85916604;85887909;28695;
17.02.2019;11:56:05;85916671;85888022;28649;
17.02.2019;11:57:05;85916728;85888146;28582;
17.02.2019;11:58:05;85916781;85888251;28530;
17.02.2019;11:59:05;85916844;85888397;28447;
17.02.2019;12:00:05;85916901;85888534;28367;
17.02.2019;12:01:05;85916965;85888672;28293;
17.02.2019;12:02:04;85917046;85888826;28220;
17.02.2019;12:03:04;85917113;85888943;28170;
17.02.2019;12:04:05;85917188;85889072;28116;
17.02.2019;12:05:04;85917227;85889192;28035;
17.02.2019;12:06:05;85917255;85889278;27977;
17.02.2019;12:07:05;85917282;85889366;27916;
17.02.2019;12:08:05;85917316;85889475;27841;
17.02.2019;12:09:05;85917353;85889556;27797;
17.02.2019;12:10:04;85917368;85889638;27730;
17.02.2019;12:11:04;85917460;85889764;27696;
17.02.2019;12:12:04;85917526;85889890;27636;
17.02.2019;12:13:05;85917578;85890018;27560;
17.02.2019;12:14:05;85917639;85890140;27499;
17.02.2019;12:15:04;85917692;85890244;27448;
17.02.2019;12:16:04;85917756;85890379;27377;
17.02.2019;12:17:05;85917831;85890518;27313;
17.02.2019;12:18:05;85917902;85890655;27247;
17.02.2019;12:19:05;85917969;85890790;27179;
17.02.2019;12:20:04;85918032;85890904;27128;
17.02.2019;12:21:04;85918096;85891038;27058;
17.02.2019;12:22:05;85918154;85891160;26994;
17.02.2019;12:23:04;85918212;85891242;26970;
17.02.2019;12:24:05;85918281;85891404;26877;
17.02.2019;12:25:04;85918334;85891518;26816;
17.02.2019;12:26:04;85918393;85891634;26759;
17.02.2019;12:27:05;85918476;85891746;26730;
17.02.2019;12:28:05;85918544;85891862;26682;
17.02.2019;12:29:05;85918607;85891985;26622;
17.02.2019;12:30:05;85918664;85892089;26575;
17.02.2019;12:31:04;85918739;85892237;26502;
17.02.2019;12:32:04;85918809;85892360;26449;
17.02.2019;12:33:05;85918871;85892482;26389;
17.02.2019;12:34:05;85918937;85892588;26349;
17.02.2019;12:35:05;85919001;85892703;26298;
17.02.2019;12:36:05;85919086;85892827;26259;
17.02.2019;12:37:05;85919171;85892943;26228;
17.02.2019;12:38:05;85919262;85893055;26207;
17.02.2019;12:39:07;85919332;85893204;26128;
17.02.2019;12:40:04;85919371;85893355;26016;
17.02.2019;12:41:04;85919440;85893474;25966;
17.02.2019;12:42:05;85919506;85893603;25903;
17.02.2019;12:43:05;85919565;85893718;25847;
17.02.2019;12:44:10;85919649;85893848;25801;
17.02.2019;12:45:05;85919731;85894009;25722;
17.02.2019;12:46:05;85919785;85894123;25662;
17.02.2019;12:47:04;85919838;85894244;25594;
17.02.2019;12:48:05;85919911;85894357;25554;
17.02.2019;12:49:05;85919978;85894478;25500;
17.02.2019;12:50:05;85920065;85894616;25449;
17.02.2019;12:51:05;85920158;85894747;25411;
17.02.2019;12:52:05;85920242;85894884;25358;
17.02.2019;12:53:05;85920330;85895019;25311;
17.02.2019;12:54:05;85920411;85895145;25266;
17.02.2019;12:55:05;85920488;85895265;25223;
17.02.2019;12:56:05;85920547;85895401;25146;
17.02.2019;12:57:10;85920636;85895524;25112;
17.02.2019;12:58:05;85920698;85895640;25058;
17.02.2019;12:59:05;85920772;85895756;25016;
17.02.2019;13:00:04;85920846;85895871;24975;
17.02.2019;13:01:04;85920937;85895982;24955;
17.02.2019;13:02:05;85921013;85896114;24899;
17.02.2019;13:03:04;85921090;85896234;24856;
17.02.2019;13:04:05;85921159;85896347;24812;
17.02.2019;13:05:13;85921235;85896524;24711;
17.02.2019;13:06:04;85921291;85896620;24671;
17.02.2019;13:07:05;85921359;85896740;24619;
17.02.2019;13:08:04;85921429;85896864;24565;
17.02.2019;13:09:04;85921486;85896993;24493;
17.02.2019;13:10:05;85921547;85897148;24399;
17.02.2019;13:11:05;85921624;85897280;24344;
17.02.2019;13:12:05;85921704;85897399;24305;
17.02.2019;13:13:04;85921792;85897533;24259;
17.02.2019;13:14:04;85921871;85897654;24217;
17.02.2019;13:15:04;85921933;85897771;24162;
17.02.2019;13:16:05;85922025;85897911;24114;
17.02.2019;13:17:05;85922085;85898058;24027;
17.02.2019;13:18:05;85922178;85898177;24001;
17.02.2019;13:19:04;85922239;85898284;23955;
17.02.2019;13:20:04;85922322;85898418;23904;
17.02.2019;13:21:05;85922398;85898545;23853;
17.02.2019;13:22:04;85922497;85898662;23835;
17.02.2019;13:23:04;85922569;85898792;23777;
17.02.2019;13:24:04;85922637;85898922;23715;
17.02.2019;13:25:05;85922721;85899054;23667;
17.02.2019;13:26:05;85922795;85899184;23611;
17.02.2019;13:27:04;85922877;85899284;23593;
17.02.2019;13:28:04;85922936;85899397;23539;
17.02.2019;13:29:04;85923003;85899529;23474;
17.02.2019;13:30:04;85923069;85899664;23405;
17.02.2019;13:31:04;85923133;85899779;23354;
17.02.2019;13:32:04;85923197;85899884;23313;
17.02.2019;13:33:05;85923289;85899983;23306;
17.02.2019;13:34:04;85923372;85900126;23246;
17.02.2019;13:35:05;85923439;85900257;23182;
17.02.2019;13:36:04;85923518;85900383;23135;
17.02.2019;13:37:04;85923585;85900507;23078;
17.02.2019;13:38:05;85923655;85900628;23027;
17.02.2019;13:39:06;85923722;85900735;22987;
17.02.2019;13:40:04;85923789;85900835;22954;
17.02.2019;13:41:04;85923866;85900957;22909;
17.02.2019;13:42:05;85923962;85901103;22859;
17.02.2019;13:43:05;85924037;85901217;22820;
17.02.2019;13:44:04;85924101;85901345;22756;
17.02.2019;13:45:05;85924176;85901465;22711;
17.02.2019;13:46:04;85924237;85901593;22644;
17.02.2019;13:47:04;85924308;85901719;22589;
17.02.2019;13:48:05;85924387;85901841;22546;
17.02.2019;13:49:05;85924453;85901984;22469;
17.02.2019;13:50:05;85924524;85902121;22403;
17.02.2019;13:51:04;85924588;85902240;22348;
17.02.2019;13:52:04;85924661;85902369;22292;
17.02.2019;13:53:04;85924746;85902494;22252;
17.02.2019;13:54:05;85924813;85902607;22206;
17.02.2019;13:55:04;85924883;85902724;22159;
17.02.2019;13:56:04;85924939;85902869;22070;
17.02.2019;13:57:05;85925032;85902977;22055;
17.02.2019;13:58:04;85925102;85903108;21994;
17.02.2019;13:59:04;85925218;85903255;21963;
17.02.2019;14:00:05;85925287;85903370;21917;
17.02.2019;14:01:04;85925380;85903497;21883;
17.02.2019;14:02:05;85925484;85903604;21880;
17.02.2019;14:03:04;85925561;85903728;21833;
17.02.2019;14:04:04;85925629;85903876;21753;
17.02.2019;14:05:05;85925718;85904005;21713;
17.02.2019;14:06:04;85925773;85904127;21646;
17.02.2019;14:07:04;85925858;85904246;21612;
17.02.2019;14:08:05;85925933;85904379;21554;
17.02.2019;14:09:05;85926039;85904531;21508;
17.02.2019;14:10:04;85926118;85904644;21474;
17.02.2019;14:11:04;85926194;85904778;21416;
17.02.2019;14:12:05;85926290;85904911;21379;
17.02.2019;14:13:05;85926362;85905041;21321;
17.02.2019;14:14:04;85926461;85905164;21297;
17.02.2019;14:15:05;85926527;85905306;21221;
17.02.2019;14:16:04;85926627;85905446;21181;
17.02.2019;14:17:05;85926710;85905571;21139;
17.02.2019;14:18:05;85926781;85905715;21066;
17.02.2019;14:19:04;85926848;85905802;21046;
17.02.2019;14:20:04;85926915;85905903;21012;
17.02.2019;14:21:05;85926965;85906018;20947;
17.02.2019;14:22:04;85927031;85906116;20915;
17.02.2019;14:23:04;85927101;85906229;20872;
17.02.2019;14:24:05;85927169;85906351;20818;
17.02.2019;14:25:05;85927239;85906498;20741;
17.02.2019;14:26:05;85927327;85906598;20729;
17.02.2019;14:27:05;85927412;85906740;20672;
17.02.2019;14:28:04;85927488;85906841;20647;
17.02.2019;14:29:04;85927572;85906969;20603;
17.02.2019;14:30:04;85927651;85907116;20535;
17.02.2019;14:31:05;85927738;85907197;20541;
17.02.2019;14:32:04;85927815;85907358;20457;
17.02.2019;14:33:04;85927905;85907493;20412;
17.02.2019;14:34:05;85928001;85907608;20393;
17.02.2019;14:35:05;85928074;85907758;20316;
17.02.2019;14:36:05;85928169;85907882;20287;
17.02.2019;14:37:04;85928248;85908020;20228;
17.02.2019;14:38:05;85928330;85908147;20183;
17.02.2019;14:39:06;85928420;85908314;20106;
17.02.2019;14:40:04;85928493;85908456;20037;
17.02.2019;14:41:04;85928585;85908584;20001;
17.02.2019;14:42:05;85928668;85908745;19923;
17.02.2019;14:43:04;85928759;85908871;19888;
17.02.2019;14:44:04;85928855;85909014;19841;
17.02.2019;14:45:04;85928923;85909154;19769;
17.02.2019;14:46:05;85928989;85909295;19694;
17.02.2019;14:47:05;85929074;85909446;19628;
17.02.2019;14:48:04;85929168;85909602;19566;
17.02.2019;14:49:04;85929277;85909740;19537;
17.02.2019;14:50:04;85929362;85909895;19467;
17.02.2019;14:51:04;85929467;85910025;19442;
17.02.2019;14:52:05;85929562;85910162;19400;
17.02.2019;14:53:04;85929654;85910321;19333;
17.02.2019;14:54:08;85929751;85910463;19288;
17.02.2019;14:55:06;85929846;85910611;19235;
17.02.2019;14:56:05;85929934;85910731;19203;
17.02.2019;14:57:04;85930013;85910868;19145;
17.02.2019;14:58:05;85930140;85911027;19113;
17.02.2019;14:59:04;85930248;85911173;19075;
17.02.2019;15:00:07;85930340;85911320;19020;
17.02.2019;15:01:08;85930428;85911455;18973;
17.02.2019;15:02:09;85930620;85911617;19003;
17.02.2019;15:03:06;85930843;85911860;18983;
17.02.2019;15:04:08;85931253;85912100;19153;
17.02.2019;15:05:07;85931679;85912298;19381;
17.02.2019;15:06:08;85931934;85912473;19461;
17.02.2019;15:07:08;85932118;85912655;19463;
17.02.2019;15:08:07;85932269;85912789;19480;
17.02.2019;15:09:08;85932432;85912925;19507;
17.02.2019;15:10:08;85932573;85913055;19518;
17.02.2019;15:11:07;85932709;85913215;19494;
17.02.2019;15:12:08;85932836;85913369;19467;
17.02.2019;15:13:08;85932934;85913521;19413;
17.02.2019;15:14:08;85933049;85913650;19399;
17.02.2019;15:15:09;85933147;85913798;19349;
17.02.2019;15:16:07;85933241;85913936;19305;
17.02.2019;15:17:07;85933346;85914072;19274;
17.02.2019;15:18:08;85933442;85914194;19248;
17.02.2019;15:19:07;85933560;85914340;19220;
17.02.2019;15:20:07;85933669;85914514;19155;
17.02.2019;15:21:08;85933804;85914663;19141;
17.02.2019;15:22:07;85933906;85914840;19066;
17.02.2019;15:23:08;85934001;85914977;19024;
17.02.2019;15:24:07;85934091;85915137;18954;
17.02.2019;15:25:08;85934200;85915286;18914;
17.02.2019;15:26:08;85934290;85915427;18863;
17.02.2019;15:27:08;85934406;85915606;18800;
17.02.2019;15:28:08;85934497;85915765;18732;
17.02.2019;15:29:07;85934585;85915932;18653;
17.02.2019;15:30:08;85934695;85916084;18611;
17.02.2019;15:31:08;85934792;85916236;18556;
17.02.2019;15:32:07;85934890;85916366;18524;
17.02.2019;15:33:07;85934980;85916496;18484;
17.02.2019;15:34:07;85935070;85916644;18426;
17.02.2019;15:35:08;85935166;85916766;18400;
17.02.2019;15:36:08;85935273;85916902;18371;
17.02.2019;15:37:08;85935368;85917014;18354;
17.02.2019;15:38:07;85935490;85917175;18315;
17.02.2019;15:39:08;85935586;85917327;18259;
17.02.2019;15:40:07;85935679;85917466;18213;
17.02.2019;15:41:08;85935783;85917601;18182;
17.02.2019;15:42:07;85935862;85917750;18112;
17.02.2019;15:43:08;85935979;85917875;18104;
17.02.2019;15:44:07;85936077;85918036;18041;
17.02.2019;15:45:07;85936190;85918177;18013;
17.02.2019;15:46:07;85936289;85918332;17957;
17.02.2019;15:47:08;85936385;85918484;17901;
17.02.2019;15:48:07;85936478;85918646;17832;
17.02.2019;15:49:08;85936591;85918808;17783;
17.02.2019;15:50:07;85936704;85918976;17728;
17.02.2019;15:51:07;85936800;85919133;17667;
17.02.2019;15:52:08;85936891;85919306;17585;
17.02.2019;15:53:08;85936988;85919384;17604;
17.02.2019;15:54:08;85937116;85919591;17525;
17.02.2019;15:55:07;85937222;85919735;17487;
17.02.2019;15:56:08;85937322;85919879;17443;
17.02.2019;15:57:08;85937420;85920043;17377;
17.02.2019;15:58:10;85937530;85920191;17339;
17.02.2019;15:59:11;85937633;85920336;17297;
17.02.2019;16:00:05;85937722;85920484;17238;
17.02.2019;16:01:05;85937833;85920603;17230;
17.02.2019;16:02:05;85937949;85920727;17222;
17.02.2019;16:03:05;85938070;85920871;17199;
17.02.2019;16:04:05;85938176;85921020;17156;
17.02.2019;16:05:05;85938266;85921159;17107;
17.02.2019;16:06:05;85938368;85921314;17054;
17.02.2019;16:07:06;85938466;85921441;17025;
17.02.2019;16:08:05;85938567;85921574;16993;
17.02.2019;16:09:06;85938688;85921733;16955;
17.02.2019;16:10:05;85938816;85921888;16928;
17.02.2019;16:11:04;85938935;85922012;16923;
17.02.2019;16:12:05;85939047;85922165;16882;
17.02.2019;16:13:05;85939164;85922323;16841;
17.02.2019;16:14:09;85939286;85922477;16809;
17.02.2019;16:15:04;85939395;85922618;16777;
17.02.2019;16:16:04;85939391;85922701;16690;
17.02.2019;16:17:06;85939397;85922795;16602;
17.02.2019;16:18:04;85939480;85922929;16551;
17.02.2019;16:19:04;85939566;85923100;16466;
17.02.2019;16:20:04;85939648;85923244;16404;
17.02.2019;16:21:05;85939754;85923417;16337;
17.02.2019;16:22:05;85939824;85923563;16261;
17.02.2019;16:23:05;85939914;85923716;16198;
17.02.2019;16:24:05;85939997;85923868;16129;
17.02.2019;16:25:12;85940097;85924014;16083;
17.02.2019;16:26:05;85940205;85924136;16069;
17.02.2019;16:27:05;85940320;85924289;16031;
17.02.2019;16:28:05;85940439;85924456;15983;
17.02.2019;16:29:05;85940552;85924621;15931;
17.02.2019;16:30:05;85940665;85924770;15895;
17.02.2019;16:31:06;85940762;85924923;15839;
17.02.2019;16:32:04;85940862;85925085;15777;
17.02.2019;16:33:04;85940963;85925228;15735;
17.02.2019;16:34:04;85941112;85925371;15741;
17.02.2019;16:35:05;85941215;85925516;15699;
17.02.2019;16:36:04;85941331;85925655;15676;
17.02.2019;16:37:04;85941460;85925816;15644;
17.02.2019;16:38:08;85941583;85925967;15616;
17.02.2019;16:39:05;85941711;85926109;15602;
17.02.2019;16:40:05;85941851;85926264;15587;
17.02.2019;16:41:04;85941961;85926394;15567;
17.02.2019;16:42:05;85942070;85926546;15524;
17.02.2019;16:43:05;85942179;85926710;15469;
17.02.2019;16:44:05;85942265;85926866;15399;
17.02.2019;16:45:10;85942376;85927010;15366;
17.02.2019;16:46:05;85942494;85927147;15347;
17.02.2019;16:47:04;85942595;85927282;15313;
17.02.2019;16:48:05;85942712;85927429;15283;
17.02.2019;16:49:05;85942819;85927581;15238;
17.02.2019;16:50:05;85942927;85927659;15268;
17.02.2019;16:51:06;85943046;85927858;15188;
17.02.2019;16:52:05;85943164;85927999;15165;
17.02.2019;16:53:05;85943302;85928168;15134;
17.02.2019;16:54:04;85943412;85928314;15098;
17.02.2019;16:55:19;85943543;85928501;15042;
17.02.2019;16:56:04;85943645;85928627;15018;
17.02.2019;16:57:05;85943751;85928808;14943;
17.02.2019;16:58:04;85943913;85928953;14960;
17.02.2019;16:59:04;85944011;85929107;14904;
17.02.2019;17:00:05;85944138;85929233;14905;
17.02.2019;17:01:05;85944231;85929388;14843;
17.02.2019;17:02:05;85944340;85929520;14820;
17.02.2019;17:03:05;85944445;85929655;14790;
17.02.2019;17:04:05;85944540;85929792;14748;
17.02.2019;17:05:05;85944661;85929951;14710;
17.02.2019;17:06:05;85944768;85930123;14645;
17.02.2019;17:07:05;85944880;85930291;14589;
17.02.2019;17:08:05;85945024;85930466;14558;
17.02.2019;17:09:05;85945163;85930625;14538;
17.02.2019;17:10:04;85945285;85930786;14499;
17.02.2019;17:11:05;85945433;85930944;14489;
17.02.2019;17:12:05;85945568;85931119;14449;
17.02.2019;17:13:04;85945701;85931266;14435;
17.02.2019;17:14:05;85945833;85931405;14428;
17.02.2019;17:15:05;85945952;85931561;14391;
17.02.2019;17:16:05;85946092;85931697;14395;
17.02.2019;17:17:05;85946231;85931839;14392;
17.02.2019;17:18:05;85946363;85931990;14373;
17.02.2019;17:19:04;85946480;85932124;14356;
17.02.2019;17:20:04;85946604;85932259;14345;
17.02.2019;17:21:05;85946730;85932381;14349;
17.02.2019;17:22:05;85946862;85932540;14322;
17.02.2019;17:23:06;85946984;85932675;14309;
17.02.2019;17:24:04;85947099;85932825;14274;
17.02.2019;17:25:04;85947217;85932972;14245;
17.02.2019;17:26:05;85947325;85933110;14215;
17.02.2019;17:27:10;85947439;85933244;14195;
17.02.2019;17:28:05;85947571;85933380;14191;
17.02.2019;17:29:05;85947705;85933527;14178;
17.02.2019;17:30:05;85947835;85933683;14152;
17.02.2019;17:31:05;85947990;85933830;14160;
17.02.2019;17:32:05;85948093;85933956;14137;
17.02.2019;17:33:05;85948215;85934098;14117;
17.02.2019;17:34:04;85948355;85934264;14091;
17.02.2019;17:35:04;85948491;85934399;14092;
17.02.2019;17:36:05;85948632;85934530;14102;
17.02.2019;17:37:10;85948783;85934686;14097;
17.02.2019;17:38:04;85948923;85934844;14079;
17.02.2019;17:39:04;85949068;85934977;14091;
17.02.2019;17:40:05;85949211;85935161;14050;
17.02.2019;17:41:04;85949321;85935324;13997;
17.02.2019;17:42:05;85949426;85935465;13961;
17.02.2019;17:43:05;85949574;85935591;13983;
17.02.2019;17:44:05;85949716;85935736;13980;
17.02.2019;17:45:05;85949823;85935880;13943;
17.02.2019;17:46:05;85949957;85936038;13919;
17.02.2019;17:47:05;85950081;85936203;13878;
17.02.2019;17:48:05;85950231;85936357;13874;
17.02.2019;17:49:05;85950362;85936500;13862;
17.02.2019;17:50:05;85950496;85936634;13862;
17.02.2019;17:51:04;85950620;85936778;13842;
17.02.2019;17:52:05;85950757;85936908;13849;
17.02.2019;17:53:05;85950871;85937056;13815;
17.02.2019;17:54:05;85950959;85937192;13767;
17.02.2019;17:55:10;85951089;85937324;13765;
17.02.2019;17:56:05;85951215;85937462;13753;
17.02.2019;17:57:05;85951358;85937612;13746;
17.02.2019;17:58:05;85951473;85937742;13731;
17.02.2019;17:59:05;85951586;85937874;13712;
17.02.2019;18:00:05;85951735;85938035;13700;
17.02.2019;18:01:05;85951875;85938170;13705;
17.02.2019;18:02:05;85951996;85938305;13691;
17.02.2019;18:03:04;85952114;85938436;13678;
17.02.2019;18:04:05;85952244;85938570;13674;
17.02.2019;18:05:05;85952378;85938699;13679;
17.02.2019;18:06:05;85952551;85938826;13725;
17.02.2019;18:07:10;85952671;85938970;13701;
17.02.2019;18:08:05;85952798;85939116;13682;
17.02.2019;18:09:04;85952901;85939260;13641;
17.02.2019;18:10:04;85953021;85939382;13639;
17.02.2019;18:11:05;85953151;85939519;13632;
17.02.2019;18:12:04;85953261;85939690;13571;
17.02.2019;18:13:05;85953362;85939846;13516;
17.02.2019;18:14:06;85953552;85940019;13533;
17.02.2019;18:15:04;85953681;85940135;13546;
17.02.2019;18:16:04;85953783;85940289;13494;
17.02.2019;18:17:10;85953883;85940424;13459;
17.02.2019;18:18:05;85953996;85940525;13471;
17.02.2019;18:19:06;85954113;85940630;13483;
17.02.2019;18:20:05;85954199;85940719;13480;
17.02.2019;18:21:05;85954411;85940787;13624;
17.02.2019;18:22:04;85954634;85940884;13750;
17.02.2019;18:23:04;85954854;85941013;13841;
17.02.2019;18:24:05;85955251;85941130;14121;
17.02.2019;18:25:05;85955547;85941243;14304;
17.02.2019;18:26:05;85955812;85941368;14444;
17.02.2019;18:27:05;85956061;85941474;14587;
17.02.2019;18:28:05;85956300;85941627;14673;
17.02.2019;18:29:05;85956502;85941765;14737;
17.02.2019;18:30:04;85956699;85941905;14794;
17.02.2019;18:31:04;85956935;85942053;14882;
17.02.2019;18:32:05;85957144;85942179;14965;
17.02.2019;18:33:10;85957391;85942304;15087;
17.02.2019;18:34:05;85957594;85942423;15171;
17.02.2019;18:35:05;85957794;85942551;15243;
17.02.2019;18:36:05;85957980;85942713;15267;
17.02.2019;18:37:05;85958249;85942879;15370;
17.02.2019;18:38:05;85958525;85942997;15528;
17.02.2019;18:39:05;85958810;85943116;15694;
17.02.2019;18:40:04;85959081;85943243;15838;
17.02.2019;18:41:04;85959272;85943361;15911;
17.02.2019;18:42:05;85959504;85943522;15982;
17.02.2019;18:43:04;85959643;85943522;16121;
17.02.2019;18:44:04;85959862;85943659;16203;
17.02.2019;18:45:05;85960091;85943793;16298;
17.02.2019;18:46:04;85960331;85943925;16406;
17.02.2019;18:47:04;85960565;85944061;16504;
17.02.2019;18:48:10;85960805;85944194;16611;
17.02.2019;18:49:05;85960966;85944321;16645;
17.02.2019;18:50:04;85961171;85944444;16727;
17.02.2019;18:51:04;85961402;85944573;16829;
17.02.2019;18:52:05;85961618;85944721;16897;
17.02.2019;18:53:05;85961850;85944843;17007;
17.02.2019;18:54:04;85962100;85944941;17159;
17.02.2019;18:55:05;85962349;85945066;17283;
17.02.2019;18:56:05;85962559;85945223;17336;
17.02.2019;18:57:05;85962791;85945357;17434;
17.02.2019;18:58:05;85962996;85945470;17526;
17.02.2019;18:59:06;85963208;85945568;17640;
17.02.2019;19:00:04;85963544;85945674;17870;
17.02.2019;19:01:05;85963856;85945765;18091;
17.02.2019;19:02:05;85964074;85945872;18202;
17.02.2019;19:03:05;85964295;85945987;18308;
17.02.2019;19:04:05;85964514;85946109;18405;
17.02.2019;19:05:05;85964680;85946210;18470;
17.02.2019;19:06:05;85964818;85946301;18517;
17.02.2019;19:07:05;85964987;85946410;18577;
17.02.2019;19:08:05;85965144;85946540;18604;
17.02.2019;19:09:05;85965338;85946659;18679;
17.02.2019;19:10:05;85965486;85946755;18731;
17.02.2019;19:11:05;85965722;85946851;18871;
17.02.2019;19:12:05;85965978;85946974;19004;
17.02.2019;19:13:04;85966273;85947062;19211;
17.02.2019;19:14:06;85966486;85947157;19329;
17.02.2019;19:15:04;85966709;85947252;19457;
17.02.2019;19:16:04;85966913;85947344;19569;
17.02.2019;19:17:05;85967119;85947453;19666;
17.02.2019;19:18:05;85967308;85947539;19769;
17.02.2019;19:19:06;85967518;85947645;19873;
17.02.2019;19:20:04;85967676;85947756;19920;
17.02.2019;19:21:04;85967787;85947853;19934;
17.02.2019;19:22:04;85967962;85947959;20003;
17.02.2019;19:23:04;85968139;85948077;20062;
17.02.2019;19:24:04;85968279;85948177;20102;
17.02.2019;19:25:04;85968473;85948266;20207;
17.02.2019;19:26:05;85968634;85948368;20266;
17.02.2019;19:27:06;85968835;85948458;20377;
17.02.2019;19:28:04;85969012;85948554;20458;
17.02.2019;19:29:05;85969201;85948631;20570;
17.02.2019;19:30:05;85969376;85948707;20669;
17.02.2019;19:31:05;85969535;85948806;20729;
17.02.2019;19:32:05;85969662;85948892;20770;
17.02.2019;19:33:05;85969831;85948975;20856;
17.02.2019;19:34:05;85969982;85949067;20915;
17.02.2019;19:35:06;85970175;85949163;21012;
17.02.2019;19:36:05;85970331;85949241;21090;
17.02.2019;19:37:05;85970562;85949345;21217;
17.02.2019;19:38:06;85970890;85949406;21484;
17.02.2019;19:39:05;85971095;85949504;21591;
17.02.2019;19:40:05;85971310;85949578;21732;
17.02.2019;19:41:05;85971455;85949658;21797;
17.02.2019;19:42:05;85971627;85949739;21888;
17.02.2019;19:43:05;85971765;85949824;21941;
17.02.2019;19:44:05;85971917;85949938;21979;
17.02.2019;19:45:05;85972076;85950020;22056;
17.02.2019;19:46:05;85972250;85950109;22141;
17.02.2019;19:47:05;85972428;85950196;22232;
17.02.2019;19:48:05;85972574;85950285;22289;
17.02.2019;19:49:04;85972733;85950368;22365;
17.02.2019;19:50:05;85972908;85950450;22458;
17.02.2019;19:51:05;85973048;85950535;22513;
17.02.2019;19:52:06;85973302;85950647;22655;
17.02.2019;19:53:05;85973539;85950723;22816;
17.02.2019;19:54:06;85973784;85950816;22968;
17.02.2019;19:55:05;85973956;85950897;23059;
17.02.2019;19:56:05;85974080;85950976;23104;
17.02.2019;19:57:04;85974265;85951033;23232;
17.02.2019;19:58:04;85974372;85951092;23280;
17.02.2019;19:59:05;85974533;85951179;23354;
17.02.2019;20:00:05;85974687;85951259;23428;
17.02.2019;20:01:05;85974841;85951335;23506;
17.02.2019;20:02:05;85974950;85951411;23539;
17.02.2019;20:03:04;85975077;85951481;23596;
17.02.2019;20:04:05;85975225;85951555;23670;
17.02.2019;20:05:04;85975432;85951649;23783;
17.02.2019;20:06:04;85975600;85951721;23879;
17.02.2019;20:07:05;85975751;85951789;23962;
17.02.2019;20:08:05;85975651;85951795;23856;
17.02.2019;20:09:05;85975357;85951764;23593;
17.02.2019;20:10:05;85975352;85951796;23556;
17.02.2019;20:11:06;85975415;85951861;23554;
17.02.2019;20:12:05;85975447;85951942;23505;
17.02.2019;20:13:05;85975501;85951991;23510;
17.02.2019;20:14:05;85975551;85952046;23505;
17.02.2019;20:15:05;85975616;85952115;23501;
17.02.2019;20:16:05;85975660;85952165;23495;
17.02.2019;20:17:06;85975701;85952229;23472;
17.02.2019;20:18:05;85975755;85952290;23465;
17.02.2019;20:19:04;85975808;85952354;23454;
17.02.2019;20:20:04;85975884;85952399;23485;
17.02.2019;20:21:05;85975947;85952453;23494;
17.02.2019;20:22:05;85976070;85952527;23543;
17.02.2019;20:23:25;85976206;85952606;23600;
17.02.2019;20:24:06;85976260;85952653;23607;
17.02.2019;20:25:05;85976345;85952726;23619;
17.02.2019;20:26:07;85976459;85952806;23653;
17.02.2019;20:27:04;85976557;85952868;23689;
17.02.2019;20:28:05;85976688;85952935;23753;
17.02.2019;20:29:06;85976803;85952999;23804;
17.02.2019;20:30:05;85976935;85953055;23880;
17.02.2019;20:31:05;85977022;85953133;23889;
17.02.2019;20:32:08;85977112;85953193;23919;
17.02.2019;20:33:05;85977216;85953275;23941;
17.02.2019;20:34:05;85977323;85953336;23987;
17.02.2019;20:35:05;85977416;85953425;23991;
17.02.2019;20:36:04;85977508;85953487;24021;
17.02.2019;20:37:05;85977606;85953539;24067;
17.02.2019;20:38:05;85977726;85953608;24118;
17.02.2019;20:39:07;85977826;85953662;24164;
17.02.2019;20:40:11;85977944;85953725;24219;
17.02.2019;20:41:05;85978070;85953786;24284;
17.02.2019;20:42:04;85978164;85953848;24316;
17.02.2019;20:43:06;85978295;85953905;24390;
17.02.2019;20:44:06;85978430;85953955;24475;
17.02.2019;20:45:05;85978532;85954004;24528;
17.02.2019;20:46:05;85978614;85954068;24546;
17.02.2019;20:47:05;85978746;85954131;24615;
17.02.2019;20:48:06;85978836;85954197;24639;
17.02.2019;20:49:04;85978935;85954254;24681;
17.02.2019;20:50:05;85979064;85954323;24741;
17.02.2019;20:51:05;85979178;85954390;24788;
17.02.2019;20:52:05;85979272;85954427;24845;
17.02.2019;20:53:04;85979391;85954496;24895;
17.02.2019;20:54:05;85979504;85954550;24954;
17.02.2019;20:55:05;85979632;85954607;25025;
17.02.2019;20:56:05;85979731;85954641;25090;
17.02.2019;20:57:05;85979822;85954698;25124;
17.02.2019;20:58:05;85979934;85954760;25174;
17.02.2019;20:59:05;85980041;85954809;25232;
17.02.2019;21:00:05;85980181;85954859;25322;
17.02.2019;21:01:05;85980306;85954917;25389;
17.02.2019;21:02:05;85980414;85954964;25450;
17.02.2019;21:03:04;85980521;85955017;25504;
17.02.2019;21:04:05;85980638;85955071;25567;
17.02.2019;21:05:05;85980734;85955125;25609;
17.02.2019;21:06:06;85980858;85955173;25685;
17.02.2019;21:07:05;85980979;85955221;25758;
17.02.2019;21:08:05;85981113;85955270;25843;
17.02.2019;21:09:05;85981209;85955299;25910;
17.02.2019;21:10:04;85981326;85955364;25962;
17.02.2019;21:11:05;85981450;85955420;26030;
17.02.2019;21:12:05;85981558;85955456;26102;
17.02.2019;21:13:05;85981690;85955510;26180;
17.02.2019;21:14:05;85981794;85955554;26240;
17.02.2019;21:15:05;85981921;85955595;26326;
17.02.2019;21:16:06;85982024;85955665;26359;
17.02.2019;21:17:05;85982136;85955701;26435;
17.02.2019;21:18:05;85982240;85955740;26500;
17.02.2019;21:19:05;85982340;85955776;26564;
17.02.2019;21:20:05;85982433;85955832;26601;
17.02.2019;21:21:06;85982543;85955869;26674;
17.02.2019;21:22:05;85982658;85955920;26738;
17.02.2019;21:23:04;85982751;85955954;26797;
17.02.2019;21:24:05;85982865;85956006;26859;
17.02.2019;21:25:04;85982956;85956052;26904;
17.02.2019;21:26:04;85983044;85956098;26946;
17.02.2019;21:27:05;85983136;85956140;26996;
17.02.2019;21:28:05;85983243;85956179;27064;
17.02.2019;21:29:04;85983338;85956213;27125;
17.02.2019;21:30:05;85983454;85956262;27192;
17.02.2019;21:31:05;85983589;85956318;27271;
17.02.2019;21:32:05;85983690;85956349;27341;
17.02.2019;21:33:05;85983808;85956401;27407;
17.02.2019;21:34:05;85983925;85956438;27487;
17.02.2019;21:35:05;85984051;85956477;27574;
17.02.2019;21:36:05;85984172;85956508;27664;
17.02.2019;21:37:05;85984255;85956550;27705;
17.02.2019;21:38:05;85984346;85956577;27769;
17.02.2019;21:39:04;85984440;85956606;27834;
17.02.2019;21:40:05;85984519;85956664;27855;
17.02.2019;21:41:05;85984621;85956699;27922;
17.02.2019;21:42:05;85984719;85956738;27981;
17.02.2019;21:43:05;85984816;85956777;28039;
17.02.2019;21:44:06;85984905;85956760;28145;
17.02.2019;21:45:05;85984991;85956790;28201;
17.02.2019;21:46:05;85985103;85956825;28278;
17.02.2019;21:47:05;85985214;85956859;28355;
17.02.2019;21:48:05;85985318;85956901;28417;
17.02.2019;21:49:04;85985430;85956947;28483;
17.02.2019;21:51:09;85985669;85956980;28689;
17.02.2019;21:52:04;85985749;85957020;28729;
17.02.2019;21:54:05;85985969;85957086;28883;
17.02.2019;21:55:05;85986087;85957122;28965;
17.02.2019;21:56:05;85986218;85957166;29052;
17.02.2019;21:57:04;85986312;85957200;29112;
17.02.2019;21:58:10;85986434;85957236;29198;
17.02.2019;21:59:10;85986559;85957269;29290;
17.02.2019;22:00:04;85986673;85957293;29380;
17.02.2019;22:01:10;85986782;85957316;29466;
17.02.2019;22:02:05;85986853;85957367;29486;
17.02.2019;22:03:05;85986943;85957401;29542;
17.02.2019;22:04:05;85987062;85957435;29627;
17.02.2019;22:05:05;85987158;85957464;29694;
17.02.2019;22:06:05;85987228;85965641;21587;
17.02.2019;22:07:04;85987314;85965686;21628;
17.02.2019;22:08:05;85990671;85965709;24962;
17.02.2019;22:09:06;85990762;85965736;25026;
17.02.2019;22:10:05;85990814;85965762;25052;
17.02.2019;22:11:05;85990907;85965785;25122;
17.02.2019;22:12:04;85991014;85965819;25195;
17.02.2019;22:13:05;85991098;85965850;25248;
17.02.2019;22:14:05;85991170;85965896;25274;
17.02.2019;22:15:05;85991255;85965919;25336;
17.02.2019;22:16:05;85991279;85965926;25353;
17.02.2019;22:17:05;85991323;85965947;25376;
17.02.2019;22:18:05;85991346;85965962;25384;
17.02.2019;22:19:10;85991365;85965983;25382;
17.02.2019;22:20:05;85991406;85966011;25395;
17.02.2019;22:21:05;85991452;85966041;25411;
17.02.2019;22:22:05;85991460;85966062;25398;
17.02.2019;22:23:04;85991518;85966082;25436;
17.02.2019;22:24:04;85991580;85966110;25470;
17.02.2019;22:25:04;85991637;85966136;25501;
17.02.2019;22:26:09;85991685;85966161;25524;
17.02.2019;22:27:05;85991762;85966184;25578;
17.02.2019;22:28:04;85991815;85966216;25599;
17.02.2019;22:29:04;85991860;85966235;25625;
17.02.2019;22:30:04;85991951;85966245;25706;
17.02.2019;22:31:04;85992031;85966281;25750;
17.02.2019;22:32:04;85992091;85966310;25781;
17.02.2019;22:33:05;85992142;85966322;25820;
17.02.2019;22:34:05;85992210;85966359;25851;
17.02.2019;22:35:05;85992288;85966380;25908;
17.02.2019;22:36:05;85992381;85966408;25973;
17.02.2019;22:37:05;85992455;85966422;26033;
17.02.2019;22:38:05;85992514;85966468;26046;
17.02.2019;22:39:04;85992579;85966492;26087;
17.02.2019;22:40:05;85992628;85966521;26107;
17.02.2019;22:41:05;85992726;85966551;26175;
17.02.2019;22:42:05;85992814;85966573;26241;
17.02.2019;22:43:05;85992898;85966591;26307;
17.02.2019;22:44:05;85992967;85966607;26360;
17.02.2019;22:45:05;85993048;85966634;26414;
17.02.2019;22:46:04;85993134;85966667;26467;
17.02.2019;22:47:04;85993221;85966691;26530;
17.02.2019;22:48:05;85993315;85966719;26596;
17.02.2019;22:49:04;85993415;85966744;26671;
17.02.2019;22:50:05;85993490;85966780;26710;
17.02.2019;22:51:05;85993584;85966813;26771;
17.02.2019;22:52:04;85993698;85966841;26857;
17.02.2019;22:53:05;85993786;85966869;26917;
17.02.2019;22:54:04;85993883;85966881;27002;
17.02.2019;22:55:04;85993972;85966911;27061;
17.02.2019;22:56:05;85994098;85966951;27147;
17.02.2019;22:57:06;85994181;85966975;27206;
17.02.2019;22:58:04;85994290;85967004;27286;
17.02.2019;22:59:04;85994391;85967024;27367;
17.02.2019;23:00:04;85994480;85967040;27440;
17.02.2019;23:01:05;85994594;85967071;27523;
17.02.2019;23:02:05;85994671;85967106;27565;
17.02.2019;23:03:05;85994764;85967127;27637;
17.02.2019;23:04:15;85994839;85967153;27686;
17.02.2019;23:05:04;85994899;85967181;27718;
17.02.2019;23:06:04;85994959;85967210;27749;
17.02.2019;23:07:04;85995053;85967240;27813;
17.02.2019;23:08:04;85995126;85967262;27864;
17.02.2019;23:09:04;85995224;85967294;27930;
17.02.2019;23:10:05;85995317;85967320;27997;
17.02.2019;23:11:06;85995425;85967350;28075;
17.02.2019;23:12:05;85995500;85967377;28123;
17.02.2019;23:13:05;85995591;85967413;28178;
17.02.2019;23:14:06;85995678;85967434;28244;
17.02.2019;23:15:04;85995769;85967454;28315;
17.02.2019;23:16:05;85995852;85967482;28370;
17.02.2019;23:17:05;85995957;85967510;28447;
17.02.2019;23:18:05;85996086;85967531;28555;
17.02.2019;23:19:05;85996202;85967553;28649;
17.02.2019;23:20:05;85996299;85967567;28732;
17.02.2019;23:21:05;85996393;85967584;28809;
17.02.2019;23:22:05;85996478;85967604;28874;
17.02.2019;23:23:05;85996569;85967624;28945;
17.02.2019;23:24:05;85996662;85967650;29012;
17.02.2019;23:25:05;85996765;85967679;29086;
17.02.2019;23:26:04;85996845;85967700;29145;
17.02.2019;23:27:04;85996946;85967723;29223;
17.02.2019;23:28:04;85997016;85967754;29262;
17.02.2019;23:29:04;85997133;85967770;29363;
17.02.2019;23:30:05;85997225;85967802;29423;
17.02.2019;23:31:05;85997298;85967831;29467;
17.02.2019;23:32:05;85997373;85967855;29518;
17.02.2019;23:33:05;85997474;85967883;29591;
17.02.2019;23:34:04;85997554;85967900;29654;
17.02.2019;23:35:04;85997656;85967926;29730;
17.02.2019;23:36:04;85997743;85967944;29799;
17.02.2019;23:37:05;85997839;85967969;29870;
17.02.2019;23:38:04;85997945;85967989;29956;
17.02.2019;23:39:07;85998065;85968005;30060;
17.02.2019;23:40:04;85998160;85968017;30143;
17.02.2019;23:41:05;85998254;85968048;30206;
17.02.2019;23:42:05;85998361;85968058;30303;
17.02.2019;23:43:05;85998461;85968075;30386;
17.02.2019;23:44:05;85998549;85968105;30444;
17.02.2019;23:45:04;85998620;85968133;30487;
17.02.2019;23:46:04;85998714;85968163;30551;
17.02.2019;23:47:05;85998783;85968174;30609;
17.02.2019;23:48:07;85998886;85968195;30691;
17.02.2019;23:49:05;85998956;85968218;30738;
17.02.2019;23:50:05;85999064;85968241;30823;
17.02.2019;23:51:05;85999182;85968266;30916;
17.02.2019;23:52:05;85999246;85968300;30946;
17.02.2019;23:53:05;85999363;85968313;31050;
17.02.2019;23:54:05;85999473;85968351;31122;
17.02.2019;23:55:04;85999546;85968358;31188;
17.02.2019;23:56:04;85999635;85968382;31253;
17.02.2019;23:57:04;85999736;85968395;31341;
17.02.2019;23:58:04;85999826;85968414;31412;
17.02.2019;23:59:05;85999906;85968427;31479;
18.02.2019;00:00:07;86000096;85968456;31640;
18.02.2019;00:01:07;86000201;85968471;31730;
18.02.2019;00:02:08;86000294;85968492;31802;
18.02.2019;00:03:07;86000377;85968509;31868;
18.02.2019;00:04:08;86000482;85968540;31942;
18.02.2019;00:05:07;86000583;85968566;32017;
18.02.2019;00:06:07;86000653;85968585;32068;
18.02.2019;00:07:08;86000748;85968594;32154;
18.02.2019;00:08:08;86000844;85968622;32222;
18.02.2019;00:09:09;86000941;85968642;32299;
18.02.2019;00:10:08;86000996;85968654;32342;
18.02.2019;00:11:08;86001002;85968645;32357;
18.02.2019;00:12:08;86001035;85968650;32385;
18.02.2019;00:14:08;86001150;85968663;32487;
18.02.2019;00:15:08;86001215;85968677;32538;
18.02.2019;00:16:08;86001265;85968710;32555;
18.02.2019;00:17:07;86001325;85968713;32612;
18.02.2019;00:18:08;86001372;85968736;32636;
18.02.2019;00:19:07;86001416;85968752;32664;
18.02.2019;00:20:08;86001480;85968762;32718;
18.02.2019;00:21:08;86001529;85968789;32740;
18.02.2019;00:22:07;86001598;85968810;32788;
18.02.2019;00:23:07;86001659;85968812;32847;
18.02.2019;00:24:08;86001706;85968828;32878;
18.02.2019;00:25:08;86001769;85968848;32921;
18.02.2019;00:26:07;86001845;85968879;32966;
18.02.2019;00:27:07;86001901;85968883;33018;
18.02.2019;00:28:09;86001979;85968913;33066;
18.02.2019;00:29:08;86002036;85968932;33104;
18.02.2019;00:30:08;86002139;85968949;33190;
18.02.2019;00:31:08;86002212;85968954;33258;
18.02.2019;00:32:11;86002274;85968975;33299;
18.02.2019;00:33:07;86002339;85968975;33364;
18.02.2019;00:34:07;86002404;85968977;33427;
18.02.2019;00:35:07;86002481;85969003;33478;
18.02.2019;00:36:07;86002525;85969030;33495;
18.02.2019;00:37:07;86002601;85969044;33557;
18.02.2019;00:38:08;86002678;85969071;33607;
18.02.2019;00:39:07;86002732;85969096;33636;
18.02.2019;00:40:07;86002829;85969109;33720;
18.02.2019;00:41:08;86002922;85969135;33787;
18.02.2019;00:42:07;86002965;85969104;33861;
18.02.2019;00:43:08;86003040;85969129;33911;
18.02.2019;00:44:09;86003123;85969149;33974;
18.02.2019;00:45:08;86003192;85969170;34022;
18.02.2019;00:46:07;86003280;85969191;34089;
18.02.2019;00:47:07;86003344;85969213;34131;
18.02.2019;00:48:08;86003422;85969227;34195;
18.02.2019;00:49:08;86003519;85969253;34266;
18.02.2019;00:50:07;86003596;85969274;34322;
18.02.2019;00:51:08;86003661;85969295;34366;
18.02.2019;00:52:08;86003740;85969312;34428;
18.02.2019;00:53:07;86003803;85969340;34463;
18.02.2019;00:54:07;86003880;85969362;34518;
18.02.2019;00:55:08;86003932;85969394;34538;
18.02.2019;00:56:08;86003998;85969432;34566;
18.02.2019;00:57:08;86004073;85969457;34616;
18.02.2019;00:58:07;86004134;85969485;34649;
18.02.2019;00:59:08;86004240;85969517;34723;
18.02.2019;01:00:04;86004304;85969536;34768;
18.02.2019;01:01:05;86004403;85969562;34841;
18.02.2019;01:02:05;86004478;85969596;34882;
18.02.2019;01:03:05;86004545;85969613;34932;
18.02.2019;01:04:04;86004643;85969626;35017;
18.02.2019;01:05:04;86004708;85969639;35069;
18.02.2019;01:06:05;86004782;85969669;35113;
18.02.2019;01:07:04;86004850;85969691;35159;
18.02.2019;01:08:04;86004940;85969719;35221;
18.02.2019;01:09:05;86005022;85969739;35283;
18.02.2019;01:10:04;86005086;85969765;35321;
18.02.2019;01:11:04;86005160;85969786;35374;
18.02.2019;01:12:05;86005250;85969813;35437;
18.02.2019;01:13:05;86005313;85969840;35473;
18.02.2019;01:14:04;86005390;85969874;35516;
18.02.2019;01:15:04;86005487;85969906;35581;
18.02.2019;01:16:04;86005553;85969928;35625;
18.02.2019;01:17:05;86005606;85969972;35634;
18.02.2019;01:18:05;86005670;85969992;35678;
18.02.2019;01:19:04;86005729;85970020;35709;
18.02.2019;01:20:04;86005810;85970047;35763;
18.02.2019;01:21:05;86005883;85970059;35824;
18.02.2019;01:22:05;86005942;85970092;35850;
18.02.2019;01:23:05;86006007;85970109;35898;
18.02.2019;01:24:05;86006082;85970141;35941;
18.02.2019;01:25:04;86006154;85970170;35984;
18.02.2019;01:26:05;86006236;85970195;36041;
18.02.2019;01:27:04;86006287;85970218;36069;
18.02.2019;01:28:04;86006340;85970248;36092;
18.02.2019;01:29:05;86006424;85970271;36153;
18.02.2019;01:30:04;86006486;85970302;36184;
18.02.2019;01:31:04;86006569;85970350;36219;
18.02.2019;01:32:05;86006654;85970372;36282;
18.02.2019;01:33:05;86006729;85970401;36328;
18.02.2019;01:34:04;86006811;85970413;36398;
18.02.2019;01:35:04;86006890;85970426;36464;
18.02.2019;01:36:05;86006967;85970464;36503;
18.02.2019;01:37:05;86007019;85970501;36518;
18.02.2019;01:38:05;86007106;85970529;36577;
18.02.2019;01:39:05;86007169;85970556;36613;
18.02.2019;01:40:05;86007241;85970590;36651;
18.02.2019;01:41:04;86007292;85970622;36670;
18.02.2019;01:42:04;86007371;85970648;36723;
18.02.2019;01:43:05;86007456;85970678;36778;
18.02.2019;01:44:05;86007533;85970726;36807;
18.02.2019;01:45:05;86007606;85970766;36840;
18.02.2019;01:46:04;86007687;85970801;36886;
18.02.2019;01:47:04;86007758;85970832;36926;
18.02.2019;01:48:04;86007805;85970863;36942;
18.02.2019;01:49:04;86007895;85970902;36993;
18.02.2019;01:50:04;86007953;85970958;36995;
18.02.2019;01:51:05;86008050;85970997;37053;
18.02.2019;01:52:05;86008117;85971033;37084;
18.02.2019;01:53:04;86008174;85971060;37114;
18.02.2019;01:54:05;86008284;85971100;37184;
18.02.2019;01:55:05;86008358;85971144;37214;
18.02.2019;01:56:04;86008438;85971182;37256;
18.02.2019;01:57:04;86008505;85971224;37281;
18.02.2019;01:58:05;86008564;85971271;37293;
18.02.2019;01:59:05;86008620;85971303;37317;
18.02.2019;02:00:04;86008685;85971359;37326;
18.02.2019;02:01:04;86008762;85971399;37363;
18.02.2019;02:02:04;86008820;85971418;37402;
18.02.2019;02:03:05;86008885;85971465;37420;
18.02.2019;02:04:04;86008954;85971507;37447;
18.02.2019;02:05:04;86009019;85971563;37456;
18.02.2019;02:06:05;86009088;85971613;37475;
18.02.2019;02:07:04;86009131;85971658;37473;
18.02.2019;02:08:04;86009198;85971699;37499;
18.02.2019;02:09:05;86009272;85971739;37533;
18.02.2019;02:10:04;86009331;85971794;37537;
18.02.2019;02:11:04;86009382;85971819;37563;
18.02.2019;02:12:04;86009429;85971855;37574;
18.02.2019;02:13:04;86009457;85971897;37560;
18.02.2019;02:14:04;86009491;85971948;37543;
18.02.2019;02:15:05;86009535;85971985;37550;
18.02.2019;02:16:05;86009598;85972038;37560;
18.02.2019;02:17:05;86009636;85972096;37540;
18.02.2019;02:18:04;86009685;85972136;37549;
18.02.2019;02:19:05;86009756;85972185;37571;
18.02.2019;02:20:05;86009817;85972225;37592;
18.02.2019;02:21:05;86009888;85972265;37623;
18.02.2019;02:22:05;86009930;85972323;37607;
18.02.2019;02:23:04;86009980;85972367;37613;
18.02.2019;02:24:04;86010062;85972415;37647;
18.02.2019;02:25:06;86010118;85972478;37640;
18.02.2019;02:26:05;86010176;85972518;37658;
18.02.2019;02:27:04;86010246;85972568;37678;
18.02.2019;02:28:05;86010307;85972634;37673;
18.02.2019;02:29:04;86010368;85972688;37680;
18.02.2019;02:30:04;86010398;85972760;37638;
18.02.2019;02:31:05;86010479;85972804;37675;
18.02.2019;02:32:04;86010565;85972857;37708;
18.02.2019;02:33:04;86010615;85972918;37697;
18.02.2019;02:34:05;86010702;85972958;37744;
18.02.2019;02:35:04;86010773;85973015;37758;
18.02.2019;02:36:04;86010832;85973091;37741;
18.02.2019;02:37:05;86010906;85973149;37757;
18.02.2019;02:38:04;86010977;85973195;37782;
18.02.2019;02:39:05;86011055;85973276;37779;
18.02.2019;02:40:05;86011144;85973327;37817;
18.02.2019;02:41:04;86011202;85973396;37806;
18.02.2019;02:42:05;86011283;85973463;37820;
18.02.2019;02:43:04;86011325;85973521;37804;
18.02.2019;02:44:04;86011396;85973568;37828;
18.02.2019;02:45:04;86011473;85973624;37849;
18.02.2019;02:46:05;86011560;85973687;37873;
18.02.2019;02:47:04;86011621;85973768;37853;
18.02.2019;02:48:04;86011689;85973845;37844;
18.02.2019;02:49:05;86011757;85973921;37836;
18.02.2019;02:50:05;86011826;85973986;37840;
18.02.2019;02:51:04;86011909;85974045;37864;
18.02.2019;02:52:04;86011989;85974107;37882;
18.02.2019;02:53:05;86012052;85974158;37894;
18.02.2019;02:54:04;86012111;85974247;37864;
18.02.2019;02:55:04;86012176;85974321;37855;
18.02.2019;02:56:05;86012258;85974380;37878;
18.02.2019;02:57:04;86012342;85974452;37890;
18.02.2019;02:58:04;86012417;85974544;37873;
18.02.2019;02:59:05;86012483;85974615;37868;
18.02.2019;03:00:05;86012567;85974694;37873;
18.02.2019;03:01:05;86012649;85974771;37878;
18.02.2019;03:02:04;86012701;85974843;37858;
18.02.2019;03:03:05;86012780;85974922;37858;
18.02.2019;03:04:04;86012847;85975009;37838;
18.02.2019;03:05:04;86012897;85975076;37821;
18.02.2019;03:06:05;86012974;85975157;37817;
18.02.2019;03:07:04;86013040;85975237;37803;
18.02.2019;03:08:04;86013122;85975305;37817;
18.02.2019;03:09:05;86013193;85975387;37806;
18.02.2019;03:10:05;86013272;85975471;37801;
18.02.2019;03:11:04;86013327;85975570;37757;
18.02.2019;03:12:05;86013410;85975646;37764;
18.02.2019;03:13:05;86013489;85975727;37762;
18.02.2019;03:14:05;86013592;85975809;37783;
18.02.2019;03:15:04;86013662;85975896;37766;
18.02.2019;03:16:05;86013733;85975982;37751;
18.02.2019;03:17:05;86013805;85976059;37746;
18.02.2019;03:18:04;86013857;85976131;37726;
18.02.2019;03:19:05;86013933;85976211;37722;
18.02.2019;03:20:05;86014003;85976279;37724;
18.02.2019;03:21:05;86014068;85976362;37706;
18.02.2019;03:22:04;86014136;85976444;37692;
18.02.2019;03:23:05;86014206;85976525;37681;
18.02.2019;03:24:05;86014288;85976608;37680;
18.02.2019;03:25:05;86014376;85976681;37695;
18.02.2019;03:26:04;86014454;85976789;37665;
18.02.2019;03:27:05;86014522;85976865;37657;
18.02.2019;03:28:04;86014596;85976932;37664;
18.02.2019;03:29:04;86014658;85977012;37646;
18.02.2019;03:30:05;86014716;85977108;37608;
18.02.2019;03:31:04;86014773;85977198;37575;
18.02.2019;03:32:04;86014841;85977287;37554;
18.02.2019;03:33:05;86014916;85977370;37546;
18.02.2019;03:34:04;86014995;85977454;37541;
18.02.2019;03:35:04;86015062;85977514;37548;
18.02.2019;03:36:05;86015138;85977600;37538;
18.02.2019;03:37:04;86015203;85977671;37532;
18.02.2019;03:38:05;86015269;85977776;37493;
18.02.2019;03:39:05;86015347;85977873;37474;
18.02.2019;03:40:04;86015406;85977961;37445;
18.02.2019;03:41:04;86015468;85978055;37413;
18.02.2019;03:42:05;86015548;85978135;37413;
18.02.2019;03:43:05;86015619;85978217;37402;
18.02.2019;03:44:04;86015687;85978285;37402;
18.02.2019;03:45:04;86015777;85978362;37415;
18.02.2019;03:46:05;86015848;85978446;37402;
18.02.2019;03:47:05;86015916;85978519;37397;
18.02.2019;03:48:04;86015981;85978618;37363;
18.02.2019;03:49:04;86016047;85978693;37354;
18.02.2019;03:50:05;86016073;85978743;37330;
18.02.2019;03:51:04;86016135;85978806;37329;
18.02.2019;03:52:05;86016216;85978884;37332;
18.02.2019;03:53:05;86016306;85978992;37314;
18.02.2019;03:54:04;86016377;85979082;37295;
18.02.2019;03:55:04;86016446;85979156;37290;
18.02.2019;03:56:05;86016507;85979242;37265;
18.02.2019;03:57:04;86016577;85979326;37251;
18.02.2019;03:58:04;86016648;85979444;37204;
18.02.2019;03:59:05;86016748;85979540;37208;
18.02.2019;04:00:05;86016806;85979641;37165;
18.02.2019;04:02:05;86016965;85979808;37157;
18.02.2019;04:03:05;86017036;85979885;37151;
18.02.2019;04:04:04;86017121;85979974;37147;
18.02.2019;04:05:04;86017220;85980076;37144;
18.02.2019;04:06:05;86017284;85980158;37126;
18.02.2019;04:07:05;86017350;85980253;37097;
18.02.2019;04:08:05;86017412;85980340;37072;
18.02.2019;04:09:04;86017480;85980414;37066;
18.02.2019;04:10:04;86017551;85980482;37069;
18.02.2019;04:11:05;86017604;85980565;37039;
18.02.2019;04:12:05;86017619;85980639;36980;
18.02.2019;04:13:04;86017663;85980715;36948;
18.02.2019;04:14:05;86017718;85980820;36898;
18.02.2019;04:15:05;86017799;85980924;36875;
18.02.2019;04:16:04;86017872;85981010;36862;
18.02.2019;04:17:04;86017945;85981118;36827;
18.02.2019;04:18:05;86018014;85981222;36792;
18.02.2019;04:19:05;86018077;85981322;36755;
18.02.2019;04:20:10;86018166;85981430;36736;
18.02.2019;04:21:04;86018230;85981520;36710;
18.02.2019;04:22:04;86018310;85981603;36707;
18.02.2019;04:23:05;86018373;85981713;36660;
18.02.2019;04:24:04;86018437;85981808;36629;
18.02.2019;04:25:05;86018516;85981899;36617;
18.02.2019;04:26:04;86018580;85981984;36596;
18.02.2019;04:27:04;86018644;85982092;36552;
18.02.2019;04:28:05;86018731;85982198;36533;
18.02.2019;04:29:04;86018802;85982291;36511;
18.02.2019;04:30:04;86018862;85982393;36469;
18.02.2019;04:31:04;86018915;85982495;36420;
18.02.2019;04:32:05;86019018;85982602;36416;
18.02.2019;04:33:05;86019085;85982685;36400;
18.02.2019;04:34:04;86019163;85982785;36378;
18.02.2019;04:35:04;86019219;85982871;36348;
18.02.2019;04:36:05;86019341;85982957;36384;
18.02.2019;04:37:05;86019433;85983076;36357;
18.02.2019;04:38:04;86019492;85983170;36322;
18.02.2019;04:39:04;86019590;85983251;36339;
18.02.2019;04:40:04;86019659;85983340;36319;
18.02.2019;04:41:05;86019742;85983426;36316;
18.02.2019;04:42:04;86019805;85983514;36291;
18.02.2019;04:43:04;86019877;85983622;36255;
18.02.2019;04:44:04;86019947;85983734;36213;
18.02.2019;04:45:05;86020049;85983810;36239;
18.02.2019;04:46:04;86020128;85983888;36240;
18.02.2019;04:47:04;86020202;85984008;36194;
18.02.2019;04:48:05;86020283;85984109;36174;
18.02.2019;04:49:05;86020380;85984201;36179;
18.02.2019;04:50:04;86020466;85984290;36176;
18.02.2019;04:51:05;86020543;85984390;36153;
18.02.2019;04:52:04;86020604;85984500;36104;
18.02.2019;04:53:04;86020670;85984597;36073;
18.02.2019;04:54:05;86020748;85984718;36030;
18.02.2019;04:55:05;86020825;85984824;36001;
18.02.2019;04:56:04;86020911;85984925;35986;
18.02.2019;04:57:04;86020995;85984997;35998;
18.02.2019;04:58:05;86021065;85985107;35958;
18.02.2019;04:59:04;86021143;85985201;35942;
18.02.2019;05:00:04;86021233;85985321;35912;
18.02.2019;05:01:04;86021327;85985403;35924;
18.02.2019;05:02:05;86021423;85985519;35904;
18.02.2019;05:03:04;86021523;85985618;35905;
18.02.2019;05:04:05;86021603;85985703;35900;
18.02.2019;05:05:04;86021702;85985772;35930;
18.02.2019;05:06:04;86021799;85985890;35909;
18.02.2019;05:07:10;86021906;85985992;35914;
18.02.2019;05:08:04;86021985;85986090;35895;
18.02.2019;05:09:04;86022069;85986183;35886;
18.02.2019;05:10:05;86022165;85986292;35873;
18.02.2019;05:11:05;86022266;85986383;35883;
18.02.2019;05:12:04;86022379;85986485;35894;
18.02.2019;05:13:05;86022494;85986589;35905;
18.02.2019;05:14:05;86022582;85986704;35878;
18.02.2019;05:15:04;86022686;85986819;35867;
18.02.2019;05:16:04;86022792;85986922;35870;
18.02.2019;05:17:05;86022892;85987015;35877;
18.02.2019;05:18:05;86022998;85987108;35890;
18.02.2019;05:19:04;86023111;85987218;35893;
18.02.2019;05:20:05;86023198;85987322;35876;
18.02.2019;05:21:04;86023308;85987419;35889;
18.02.2019;05:22:04;86023388;85987520;35868;
18.02.2019;05:23:05;86023484;85987618;35866;
18.02.2019;05:24:04;86023575;85987701;35874;
18.02.2019;05:25:04;86023683;85987812;35871;
18.02.2019;05:26:05;86023789;85987915;35874;
18.02.2019;05:27:04;86023886;85988040;35846;
18.02.2019;05:28:04;86023971;85988156;35815;
18.02.2019;05:29:05;86024048;85988236;35812;
18.02.2019;05:30:04;86024193;85988353;35840;
18.02.2019;05:31:04;86024283;85988442;35841;
18.02.2019;05:32:05;86024385;85988545;35840;
18.02.2019;05:33:05;86024482;85988641;35841;
18.02.2019;05:34:04;86024567;85988735;35832;
18.02.2019;05:35:09;86024686;85988827;35859;
18.02.2019;05:36:05;86024789;85988930;35859;
18.02.2019;05:37:04;86024861;85989037;35824;
18.02.2019;05:38:05;86024945;85989128;35817;
18.02.2019;05:39:05;86025056;85989215;35841;
18.02.2019;05:40:05;86025134;85989317;35817;
18.02.2019;05:41:04;86025202;85989426;35776;
18.02.2019;05:42:04;86025286;85989525;35761;
18.02.2019;05:43:05;86025377;85989645;35732;
18.02.2019;05:44:09;86025455;85989751;35704;
18.02.2019;05:45:04;86025534;85989833;35701;
18.02.2019;05:46:05;86025605;85989930;35675;
18.02.2019;05:47:04;86025701;85990039;35662;
18.02.2019;05:48:04;86025785;85990114;35671;
18.02.2019;05:49:04;86025888;85990206;35682;
18.02.2019;05:50:04;86025971;85990299;35672;
18.02.2019;05:51:05;86026063;85990407;35656;
18.02.2019;05:52:04;86026135;85990499;35636;
18.02.2019;05:53:04;86026214;85990595;35619;
18.02.2019;05:54:05;86026286;85990700;35586;
18.02.2019;05:55:04;86026358;85990817;35541;
18.02.2019;05:56:05;86026448;85990912;35536;
18.02.2019;05:57:05;86026541;85990995;35546;
18.02.2019;05:58:04;86026624;85991111;35513;
18.02.2019;05:59:05;86026715;85991206;35509;
18.02.2019;06:00:05;86026821;85991312;35509;
18.02.2019;06:01:04;86026920;85991389;35531;
18.02.2019;06:02:05;86027006;85991482;35524;
18.02.2019;06:03:04;86027098;85991564;35534;
18.02.2019;06:04:04;86027185;85991663;35522;
18.02.2019;06:05:05;86027280;85991757;35523;
18.02.2019;06:06:04;86027362;85991842;35520;
18.02.2019;06:07:04;86027452;85991932;35520;
18.02.2019;06:08:05;86027509;85992045;35464;
18.02.2019;06:09:04;86027562;85992129;35433;
18.02.2019;06:10:04;86027591;85992206;35385;
18.02.2019;06:11:05;86027624;85992312;35312;
18.02.2019;06:12:04;86027655;85992382;35273;
18.02.2019;06:13:05;86027688;85992458;35230;
18.02.2019;06:14:05;86027734;85992527;35207;
18.02.2019;06:15:04;86027819;85992612;35207;
18.02.2019;06:16:04;86027887;85992699;35188;
18.02.2019;06:17:05;86027945;85992784;35161;
18.02.2019;06:18:04;86028032;85992890;35142;
18.02.2019;06:19:05;86028104;85992990;35114;
18.02.2019;06:20:04;86028179;85993076;35103;
18.02.2019;06:21:04;86028267;85993169;35098;
18.02.2019;06:22:05;86028322;85993261;35061;
18.02.2019;06:23:04;86028391;85993349;35042;
18.02.2019;06:24:05;86028453;85993440;35013;
18.02.2019;06:25:07;86028548;85993546;35002;
18.02.2019;06:26:04;86028628;85993617;35011;
18.02.2019;06:27:05;86028687;85993710;34977;
18.02.2019;06:28:04;86028721;85993794;34927;
18.02.2019;06:29:04;86028817;85993901;34916;
18.02.2019;06:30:05;86028893;85993988;34905;
18.02.2019;06:31:04;86028946;85994092;34854;
18.02.2019;06:32:04;86029059;85994156;34903;
18.02.2019;06:33:05;86029135;85994276;34859;
18.02.2019;06:34:04;86029190;85994359;34831;
18.02.2019;06:35:04;86029267;85994456;34811;
18.02.2019;06:36:05;86029343;85994553;34790;
18.02.2019;06:37:04;86029421;85994644;34777;
18.02.2019;06:38:04;86029509;85994728;34781;
18.02.2019;06:39:05;86029581;85994852;34729;
18.02.2019;06:40:05;86029641;85994925;34716;
18.02.2019;06:41:04;86029719;85994999;34720;
18.02.2019;06:42:04;86029783;85995068;34715;
18.02.2019;06:43:05;86029875;85995163;34712;
18.02.2019;06:44:04;86029943;85995256;34687;
18.02.2019;06:45:04;86030019;85995356;34663;
18.02.2019;06:46:05;86030078;85995444;34634;
18.02.2019;06:47:04;86030153;85995534;34619;
18.02.2019;06:48:04;86030205;85995594;34611;
18.02.2019;06:49:05;86030260;85995694;34566;
18.02.2019;06:50:05;86030331;85995778;34553;
18.02.2019;06:51:04;86030398;85995868;34530;
18.02.2019;06:52:04;86030462;85995966;34496;
18.02.2019;06:53:04;86030512;85996070;34442;
18.02.2019;06:54:05;86030582;85996181;34401;
18.02.2019;06:55:04;86030646;85996263;34383;
18.02.2019;06:56:04;86030712;85996369;34343;
18.02.2019;06:57:05;86030774;85996459;34315;
18.02.2019;06:58:05;86030848;85996535;34313;
18.02.2019;06:59:04;86030926;85996616;34310;
18.02.2019;07:00:04;86030996;85996733;34263;
18.02.2019;07:01:05;86031066;85996845;34221;
18.02.2019;07:02:04;86031133;85996930;34203;
18.02.2019;07:03:04;86031187;85997027;34160;
18.02.2019;07:04:05;86031264;85997124;34140;
18.02.2019;07:05:04;86031334;85997218;34116;
18.02.2019;07:06:05;86031403;85997304;34099;
18.02.2019;07:07:05;86031465;85997402;34063;
18.02.2019;07:08:05;86031536;85997498;34038;
18.02.2019;07:09:05;86031599;85997591;34008;
18.02.2019;07:10:05;86031668;85997683;33985;
18.02.2019;07:11:04;86031755;85997766;33989;
18.02.2019;07:12:04;86031818;85997875;33943;
18.02.2019;07:13:05;86031873;85997961;33912;
18.02.2019;07:14:04;86031934;85998079;33855;
18.02.2019;07:15:04;86032004;85998178;33826;
18.02.2019;07:16:04;86032061;85998282;33779;
18.02.2019;07:17:05;86032140;85998382;33758;
18.02.2019;07:18:05;86032207;85998489;33718;
18.02.2019;07:19:05;86032278;85998596;33682;
18.02.2019;07:20:05;86032343;85998708;33635;
18.02.2019;07:21:05;86032411;85998818;33593;
18.02.2019;07:22:04;86032471;85998927;33544;
18.02.2019;07:23:04;86032535;85999037;33498;
18.02.2019;07:24:05;86032580;85999153;33427;
18.02.2019;07:25:05;86032647;85999273;33374;
18.02.2019;07:26:04;86032704;85999363;33341;
18.02.2019;07:27:04;86032763;85999497;33266;
18.02.2019;07:28:04;86032809;85999609;33200;
18.02.2019;07:29:05;86032864;85999708;33156;
18.02.2019;07:30:05;86032915;85999807;33108;
18.02.2019;07:31:04;86032977;85999914;33063;
18.02.2019;07:32:04;86033035;86000036;32999;
18.02.2019;07:33:04;86033131;86000125;33006;
18.02.2019;07:34:05;86033205;86000249;32956;
18.02.2019;07:35:04;86033273;86000346;32927;
18.02.2019;07:36:05;86033319;86000482;32837;
18.02.2019;07:37:04;86033385;86000587;32798;
18.02.2019;07:38:04;86033448;86000687;32761;
18.02.2019;07:39:05;86033511;86000802;32709;
18.02.2019;07:40:05;86033581;86000895;32686;
18.02.2019;07:41:05;86033642;86001005;32637;
18.02.2019;07:42:05;86033709;86001097;32612;
18.02.2019;07:43:04;86033765;86001194;32571;
18.02.2019;07:44:04;86033825;86001296;32529;
18.02.2019;07:45:05;86033895;86001428;32467;
18.02.2019;07:46:04;86033959;86001535;32424;
18.02.2019;07:47:04;86034018;86001639;32379;
18.02.2019;07:48:05;86034073;86001738;32335;
18.02.2019;07:49:05;86034125;86001829;32296;
18.02.2019;07:50:05;86034179;86001919;32260;
18.02.2019;07:51:04;86034246;86002016;32230;
18.02.2019;07:52:04;86034301;86002095;32206;
18.02.2019;07:53:05;86034337;86002172;32165;
18.02.2019;07:54:04;86034417;86002302;32115;
18.02.2019;07:55:04;86034473;86002391;32082;
18.02.2019;07:56:05;86034541;86002483;32058;
18.02.2019;07:57:07;86034610;86002586;32024;
18.02.2019;07:58:08;86034657;86002688;31969;
18.02.2019;07:59:04;86034727;86002817;31910;
18.02.2019;08:00:04;86034802;86002915;31887;
18.02.2019;08:01:05;86034868;86003024;31844;
18.02.2019;08:02:05;86034923;86003125;31798;
18.02.2019;08:03:05;86034992;86003242;31750;
18.02.2019;08:04:05;86035055;86003346;31709;
18.02.2019;08:05:04;86035116;86003448;31668;
18.02.2019;08:06:04;86035180;86003556;31624;
18.02.2019;08:07:06;86035240;86003664;31576;
18.02.2019;08:08:04;86035290;86003758;31532;
18.02.2019;08:09:07;86035344;86003847;31497;
18.02.2019;08:10:04;86035382;86003927;31455;
18.02.2019;08:11:04;86035430;86004020;31410;
18.02.2019;08:12:05;86035468;86004133;31335;
18.02.2019;08:13:04;86035504;86004212;31292;
18.02.2019;08:14:04;86035531;86004236;31295;
18.02.2019;08:15:10;86035541;86004394;31147;
18.02.2019;08:16:04;86035563;86004481;31082;
18.02.2019;08:17:05;86035594;86004584;31010;
18.02.2019;08:18:05;86035652;86004704;30948;
18.02.2019;08:19:04;86035711;86004803;30908;
18.02.2019;08:20:05;86035751;86004903;30848;
18.02.2019;08:21:05;86035808;86005001;30807;
18.02.2019;08:22:05;86035846;86005114;30732;
18.02.2019;08:23:05;86035913;86005224;30689;
18.02.2019;08:24:04;86035985;86005349;30636;
18.02.2019;08:25:05;86036044;86005467;30577;
18.02.2019;08:26:04;86036090;86005558;30532;
18.02.2019;08:27:04;86036144;86005640;30504;
18.02.2019;08:28:05;86036191;86005756;30435;
18.02.2019;08:29:04;86036242;86005866;30376;
18.02.2019;08:30:04;86036286;86005978;30308;
18.02.2019;08:31:05;86036338;86006082;30256;
18.02.2019;08:32:04;86036403;86006186;30217;
18.02.2019;08:33:04;86036469;86006279;30190;
18.02.2019;08:34:05;86036506;86006373;30133;
18.02.2019;08:35:04;86036564;86006480;30084;
18.02.2019;08:36:04;86036626;86006579;30047;
18.02.2019;08:37:05;86036687;86006681;30006;
18.02.2019;08:38:04;86036752;86006779;29973;
18.02.2019;08:39:04;86036813;86006894;29919;
18.02.2019;08:40:04;86036873;86006991;29882;
18.02.2019;08:41:05;86036929;86007122;29807;
18.02.2019;08:42:04;86036981;86007232;29749;
18.02.2019;08:43:04;86037057;86007352;29705;
18.02.2019;08:44:05;86037121;86007465;29656;
18.02.2019;08:45:04;86037188;86007566;29622;
18.02.2019;08:46:04;86037246;86007650;29596;
18.02.2019;08:47:05;86037310;86007754;29556;
18.02.2019;08:48:04;86037378;86007856;29522;
18.02.2019;08:49:04;86037428;86007947;29481;
18.02.2019;08:50:05;86037481;86008069;29412;
18.02.2019;08:51:04;86037536;86008163;29373;
18.02.2019;08:52:04;86037600;86008222;29378;
18.02.2019;08:53:05;86037679;86008272;29407;
18.02.2019;08:54:04;86037741;86008359;29382;
18.02.2019;08:55:10;86037793;86008443;29350;
18.02.2019;08:56:05;86037863;86008492;29371;
18.02.2019;08:57:04;86037915;86008603;29312;
18.02.2019;08:58:05;86037971;86008644;29327;
18.02.2019;08:59:04;86038040;86008730;29310;
18.02.2019;09:00:04;86038106;86008814;29292;
18.02.2019;09:01:05;86038158;86008917;29241;
18.02.2019;09:02:04;86038208;86009025;29183;
18.02.2019;09:03:04;86038269;86009123;29146;
18.02.2019;09:04:05;86038325;86009218;29107;
18.02.2019;09:05:04;86038383;86009318;29065;
18.02.2019;09:06:04;86038441;86009430;29011;
18.02.2019;09:07:05;86038507;86009531;28976;
18.02.2019;09:08:04;86038586;86009655;28931;
18.02.2019;09:09:05;86038650;86009743;28907;
18.02.2019;09:10:04;86038713;86009818;28895;
18.02.2019;09:11:05;86038788;86009896;28892;
18.02.2019;09:12:04;86038843;86009963;28880;
18.02.2019;09:13:04;86038880;86010053;28827;
18.02.2019;09:14:05;86038950;86010134;28816;
18.02.2019;09:15:04;86039020;86010253;28767;
18.02.2019;09:16:04;86039074;86010346;28728;
18.02.2019;09:17:05;86039138;86010470;28668;
18.02.2019;09:18:05;86039212;86010562;28650;
18.02.2019;09:19:04;86039269;86010668;28601;
18.02.2019;09:20:04;86039337;86010774;28563;
18.02.2019;09:21:05;86039399;86010852;28547;
18.02.2019;09:22:04;86039455;86010947;28508;
18.02.2019;09:23:04;86039504;86011037;28467;
18.02.2019;09:24:05;86039566;86011124;28442;
18.02.2019;09:25:04;86039623;86011217;28406;
18.02.2019;09:26:04;86039669;86011322;28347;
18.02.2019;09:27:05;86039720;86011429;28291;
18.02.2019;09:28:04;86039768;86011536;28232;
18.02.2019;09:29:05;86039830;86011625;28205;
18.02.2019;09:30:05;86039895;86011724;28171;
18.02.2019;09:31:05;86039936;86011824;28112;
18.02.2019;09:32:04;86040003;86011924;28079;
18.02.2019;09:33:05;86040068;86012041;28027;
18.02.2019;09:34:04;86040116;86012150;27966;
18.02.2019;09:35:04;86040183;86012252;27931;
18.02.2019;09:36:05;86040243;86012343;27900;
18.02.2019;09:37:04;86040304;86012459;27845;
18.02.2019;09:38:04;86040369;86012553;27816;
18.02.2019;09:39:05;86040419;86012633;27786;
18.02.2019;09:40:05;86040487;86012726;27761;
18.02.2019;09:41:04;86040555;86012828;27727;
18.02.2019;09:42:05;86040620;86012929;27691;
18.02.2019;09:43:05;86040681;86013019;27662;
18.02.2019;09:44:04;86040764;86013117;27647;
18.02.2019;09:45:04;86040829;86013225;27604;
18.02.2019;09:46:05;86040895;86013300;27595;
18.02.2019;09:47:04;86040957;86013393;27564;
18.02.2019;09:48:04;86041031;86013498;27533;
18.02.2019;09:49:05;86041092;86013602;27490;
18.02.2019;09:50:05;86041157;86013712;27445;
18.02.2019;09:51:04;86041209;86013817;27392;
18.02.2019;09:52:04;86041284;86013941;27343;
18.02.2019;09:53:05;86041354;86014048;27306;
18.02.2019;09:54:04;86041405;86014150;27255;
18.02.2019;09:55:06;86041466;86014254;27212;
18.02.2019;09:56:04;86041514;86014361;27153;
18.02.2019;09:57:05;86041586;86014460;27126;
18.02.2019;09:58:05;86041670;86014557;27113;
18.02.2019;09:59:04;86041727;86014622;27105;
18.02.2019;10:00:05;86041760;86014706;27054;
18.02.2019;10:01:05;86041822;86014815;27007;
18.02.2019;10:02:05;86041898;86014930;26968;
18.02.2019;10:03:04;86041970;86015049;26921;
18.02.2019;10:04:04;86042025;86015161;26864;
18.02.2019;10:05:05;86042093;86015272;26821;
18.02.2019;10:06:04;86042158;86015381;26777;
18.02.2019;10:07:04;86042244;86015488;26756;
18.02.2019;10:08:05;86042305;86015565;26740;
18.02.2019;10:09:04;86042361;86015666;26695;
18.02.2019;10:10:04;86042413;86015753;26660;
18.02.2019;10:11:04;86042446;86015873;26573;
18.02.2019;10:12:04;86042471;86015954;26517;
18.02.2019;10:13:05;86042533;86016062;26471;
18.02.2019;10:14:04;86042578;86016147;26431;
18.02.2019;10:15:04;86042604;86016214;26390;
18.02.2019;10:16:05;86042639;86016318;26321;
18.02.2019;10:17:05;86042677;86016412;26265;
18.02.2019;10:18:04;86042743;86016503;26240;
18.02.2019;10:19:05;86042784;86016606;26178;
18.02.2019;10:20:05;86042817;86016715;26102;
18.02.2019;10:21:04;86042855;86016814;26041;
18.02.2019;10:22:05;86042909;86016910;25999;
18.02.2019;10:23:04;86042972;86017012;25960;
18.02.2019;10:24:04;86043017;86017108;25909;
18.02.2019;10:25:05;86043088;86017202;25886;
18.02.2019;10:26:05;86043166;86017305;25861;
18.02.2019;10:27:04;86043217;86017418;25799;
18.02.2019;10:28:05;86043287;86017539;25748;
18.02.2019;10:29:05;86043351;86017644;25707;
18.02.2019;10:30:04;86043422;86017757;25665;
18.02.2019;10:31:05;86043481;86017857;25624;
18.02.2019;10:32:05;86043550;86017962;25588;
18.02.2019;10:33:04;86043609;86018082;25527;
18.02.2019;10:34:05;86043665;86018190;25475;
18.02.2019;10:35:10;86043733;86018305;25428;
18.02.2019;10:36:04;86043782;86018408;25374;
18.02.2019;10:37:05;86043845;86018533;25312;
18.02.2019;10:38:05;86043918;86018630;25288;
18.02.2019;10:39:05;86043974;86018740;25234;
18.02.2019;10:40:04;86044028;86018840;25188;
18.02.2019;10:41:05;86044080;86018931;25149;
18.02.2019;10:42:04;86044154;86019042;25112;
18.02.2019;10:43:04;86044217;86019165;25052;
18.02.2019;10:44:05;86044283;86019287;24996;
18.02.2019;10:45:04;86044325;86019391;24934;
18.02.2019;10:46:04;86044390;86019498;24892;
18.02.2019;10:47:04;86044475;86019615;24860;
18.02.2019;10:48:05;86044564;86019718;24846;
18.02.2019;10:49:04;86044624;86019808;24816;
18.02.2019;10:50:04;86044680;86019938;24742;
18.02.2019;10:51:05;86044748;86020037;24711;
18.02.2019;10:52:05;86044808;86020145;24663;
18.02.2019;10:53:05;86044891;86020252;24639;
18.02.2019;10:54:05;86044970;86020352;24618;
18.02.2019;10:55:04;86045029;86020457;24572;
18.02.2019;10:56:04;86045104;86020577;24527;
18.02.2019;10:57:05;86045174;86020676;24498;
18.02.2019;10:58:05;86045259;86020788;24471;
18.02.2019;10:59:04;86045334;86020907;24427;
18.02.2019;11:00:05;86045390;86021032;24358;
18.02.2019;11:01:05;86045479;86021127;24352;
18.02.2019;11:02:05;86045533;86021236;24297;
18.02.2019;11:03:04;86045596;86021353;24243;
18.02.2019;11:04:04;86045649;86021471;24178;
18.02.2019;11:05:05;86045718;86021549;24169;
18.02.2019;11:06:05;86045778;86021660;24118;
18.02.2019;11:07:04;86045836;86021774;24062;
18.02.2019;11:08:04;86045891;86021886;24005;
18.02.2019;11:09:05;86045949;86021980;23969;
18.02.2019;11:10:04;86046019;86022120;23899;
18.02.2019;11:11:04;86046071;86022227;23844;
18.02.2019;11:12:04;86046135;86022342;23793;
18.02.2019;11:13:05;86046205;86022464;23741;
18.02.2019;11:14:04;86046288;86022578;23710;
18.02.2019;11:15:04;86046362;86022673;23689;
18.02.2019;11:16:05;86046429;86022754;23675;
18.02.2019;11:17:05;86046502;86022877;23625;
18.02.2019;11:18:04;86046553;86022983;23570;
18.02.2019;11:19:04;86046610;86023097;23513;
18.02.2019;11:20:05;86046683;86023213;23470;
18.02.2019;11:21:05;86046752;86023335;23417;
18.02.2019;11:22:04;86046831;86023466;23365;
18.02.2019;11:23:04;86046906;86023583;23323;
18.02.2019;11:24:05;86046964;86023706;23258;
18.02.2019;11:25:05;86047038;86023832;23206;
18.02.2019;11:26:04;86047095;86023925;23170;
18.02.2019;11:27:04;86047163;86024043;23120;
18.02.2019;11:28:20;86047241;86024193;23048;
18.02.2019;11:29:04;86047284;86024286;22998;
18.02.2019;11:30:04;86047358;86024420;22938;
18.02.2019;11:31:05;86047431;86024541;22890;
18.02.2019;11:32:05;86047499;86024663;22836;
18.02.2019;11:33:04;86047561;86024770;22791;
18.02.2019;11:34:04;86047644;86024882;22762;
18.02.2019;11:35:05;86047735;86025005;22730;
18.02.2019;11:36:04;86047802;86025107;22695;
18.02.2019;11:37:04;86047869;86025208;22661;
18.02.2019;11:38:05;86047936;86025321;22615;
18.02.2019;11:39:04;86048010;86025405;22605;
18.02.2019;11:40:04;86048089;86025511;22578;
18.02.2019;11:41:05;86048159;86025637;22522;
18.02.2019;11:42:04;86048217;86025753;22464;
18.02.2019;11:43:04;86048281;86025869;22412;
18.02.2019;11:44:05;86048350;86025979;22371;
18.02.2019;11:45:04;86048425;86026082;22343;
18.02.2019;11:46:04;86048508;86026195;22313;
18.02.2019;11:47:05;86048601;86026308;22293;
18.02.2019;11:48:05;86048660;86026424;22236;
18.02.2019;11:49:04;86048724;86026548;22176;
18.02.2019;11:50:04;86048813;86026665;22148;
18.02.2019;11:51:05;86048900;86026784;22116;
18.02.2019;11:52:05;86048957;86026902;22055;
18.02.2019;11:53:04;86049018;86027000;22018;
18.02.2019;11:54:04;86049096;86027138;21958;
18.02.2019;11:55:05;86049159;86027265;21894;
18.02.2019;11:56:04;86049228;86027401;21827;
18.02.2019;11:57:04;86049284;86027504;21780;
18.02.2019;11:58:05;86049349;86027616;21733;
18.02.2019;11:59:05;86049439;86027732;21707;
18.02.2019;12:00:04;86049516;86027863;21653;
18.02.2019;12:01:05;86049561;86027997;21564;
18.02.2019;12:02:05;86049632;86028096;21536;
18.02.2019;12:03:04;86049701;86028204;21497;
18.02.2019;12:04:04;86049779;86028312;21467;
18.02.2019;12:05:05;86049862;86028448;21414;
18.02.2019;12:06:05;86049949;86028573;21376;
18.02.2019;12:07:04;86050027;86028668;21359;
18.02.2019;12:08:04;86050059;86028754;21305;
18.02.2019;12:09:10;86050089;86028857;21232;
18.02.2019;12:10:04;86050137;86028942;21195;
18.02.2019;12:11:04;86050164;86029025;21139;
18.02.2019;12:12:05;86050211;86029108;21103;
18.02.2019;12:13:05;86050250;86029203;21047;
18.02.2019;12:14:05;86050288;86029309;20979;
18.02.2019;12:15:05;86050333;86029396;20937;
18.02.2019;12:16:04;86050397;86029507;20890;
18.02.2019;12:17:04;86050461;86029630;20831;
18.02.2019;12:18:05;86050527;86029729;20798;
18.02.2019;12:19:05;86050614;86029851;20763;
18.02.2019;12:20:04;86050687;86029977;20710;
18.02.2019;12:21:04;86050760;86030070;20690;
18.02.2019;12:22:05;86050828;86030181;20647;
18.02.2019;12:23:04;86050912;86030304;20608;
18.02.2019;12:24:04;86050997;86030397;20600;
18.02.2019;12:25:05;86051076;86030510;20566;
18.02.2019;12:26:04;86051157;86030620;20537;
18.02.2019;12:27:04;86051238;86030737;20501;
18.02.2019;12:28:05;86051300;86030841;20459;
18.02.2019;12:29:05;86051386;86030927;20459;
18.02.2019;12:30:05;86051478;86031043;20435;
18.02.2019;12:31:05;86051554;86031152;20402;
18.02.2019;12:32:04;86051627;86031267;20360;
18.02.2019;12:33:05;86051709;86031375;20334;
18.02.2019;12:34:04;86051778;86031480;20298;
18.02.2019;12:35:04;86051872;86031583;20289;
18.02.2019;12:36:05;86051937;86031716;20221;
18.02.2019;12:37:05;86052034;86031824;20210;
18.02.2019;12:38:04;86052101;86031921;20180;
18.02.2019;12:39:04;86052163;86032015;20148;
18.02.2019;12:40:05;86052262;86032147;20115;
18.02.2019;12:41:04;86052338;86032255;20083;
18.02.2019;12:42:04;86052418;86032375;20043;
18.02.2019;12:43:05;86052494;86032518;19976;
18.02.2019;12:44:04;86052593;86032618;19975;
18.02.2019;12:45:04;86052690;86032732;19958;
18.02.2019;12:46:05;86052534;86032636;19898;
18.02.2019;12:47:04;86052367;86032135;20232;
18.02.2019;12:48:04;86052448;86032242;20206;
18.02.2019;12:49:05;86052541;86032360;20181;
18.02.2019;12:50:05;86052639;86032498;20141;
18.02.2019;12:51:04;86052717;86032624;20093;
18.02.2019;12:52:04;86052805;86032762;20043;
18.02.2019;12:53:05;86052899;86032884;20015;
18.02.2019;12:54:05;86053017;86033000;20017;
18.02.2019;12:55:04;86053132;86033111;20021;
18.02.2019;12:56:04;86053244;86033236;20008;
18.02.2019;12:57:04;86053335;86033358;19977;
18.02.2019;12:58:05;86053434;86033469;19965;
18.02.2019;12:59:05;86053546;86033575;19971;
18.02.2019;13:00:05;86053636;86033709;19927;
18.02.2019;13:01:05;86053718;86033806;19912;
18.02.2019;13:02:05;86053825;86033942;19883;
18.02.2019;13:03:04;86053926;86034063;19863;
18.02.2019;13:04:04;86053987;86034207;19780;
18.02.2019;13:05:05;86054080;86034342;19738;
18.02.2019;13:06:04;86054159;86034453;19706;
18.02.2019;13:07:04;86054242;86034571;19671;
18.02.2019;13:08:05;86054346;86034687;19659;
18.02.2019;13:09:05;86054445;86034807;19638;
18.02.2019;13:10:04;86054553;86034937;19616;
18.02.2019;13:11:04;86054670;86035047;19623;
18.02.2019;13:12:05;86054772;86035189;19583;
18.02.2019;13:13:05;86054861;86035309;19552;
18.02.2019;13:14:05;86054966;86035418;19548;
18.02.2019;13:15:04;86055052;86035530;19522;
18.02.2019;13:16:04;86055149;86035634;19515;
18.02.2019;13:17:05;86055246;86035733;19513;
18.02.2019;13:18:05;86055346;86035864;19482;
18.02.2019;13:19:05;86055448;86035978;19470;
18.02.2019;13:20:04;86055538;86036093;19445;
18.02.2019;13:21:04;86055638;86036215;19423;
18.02.2019;13:22:05;86055740;86036337;19403;
18.02.2019;13:23:04;86055835;86036464;19371;
18.02.2019;13:24:04;86055927;86036581;19346;
18.02.2019;13:25:04;86056016;86036706;19310;
18.02.2019;13:26:05;86056122;86036829;19293;
18.02.2019;13:27:05;86056202;86036956;19246;
18.02.2019;13:28:05;86056292;86037069;19223;
18.02.2019;13:29:05;86056393;86037222;19171;
18.02.2019;13:30:05;86056493;86037332;19161;
18.02.2019;13:31:05;86056591;86037455;19136;
18.02.2019;13:32:04;86056681;86037560;19121;
18.02.2019;13:33:04;86056774;86037663;19111;
18.02.2019;13:34:05;86056864;86037779;19085;
18.02.2019;13:35:04;86056961;86037919;19042;
18.02.2019;13:36:05;86057051;86038059;18992;
18.02.2019;13:37:05;86057170;86038185;18985;
18.02.2019;13:38:05;86057285;86038310;18975;
18.02.2019;13:39:05;86057361;86038430;18931;
18.02.2019;13:40:05;86057463;86038551;18912;
18.02.2019;13:41:05;86057552;86038682;18870;
18.02.2019;13:42:04;86057669;86038787;18882;
18.02.2019;13:43:04;86057772;86038910;18862;
18.02.2019;13:44:05;86057874;86039019;18855;
18.02.2019;13:45:04;86057961;86039120;18841;
18.02.2019;13:46:04;86058073;86039241;18832;
18.02.2019;13:47:05;86058165;86039381;18784;
18.02.2019;13:48:05;86058264;86039475;18789;
18.02.2019;13:49:05;86058356;86039601;18755;
18.02.2019;13:50:04;86058456;86039713;18743;
18.02.2019;13:51:04;86058556;86039850;18706;
18.02.2019;13:52:06;86058650;86039985;18665;
18.02.2019;13:53:04;86058738;86040148;18590;
18.02.2019;13:54:04;86058839;86040269;18570;
18.02.2019;13:55:05;86058946;86040419;18527;
18.02.2019;13:56:05;86059044;86040548;18496;
18.02.2019;13:57:05;86059157;86040692;18465;
18.02.2019;13:58:05;86059255;86040799;18456;
18.02.2019;13:59:04;86059353;86040907;18446;
18.02.2019;14:00:05;86059462;86041023;18439;
18.02.2019;14:01:04;86059591;86041146;18445;
18.02.2019;14:02:04;86059691;86041290;18401;
18.02.2019;14:03:05;86059805;86041417;18388;
18.02.2019;14:04:05;86059923;86041532;18391;
18.02.2019;14:05:04;86060046;86041631;18415;
18.02.2019;14:06:05;86060158;86041707;18451;
18.02.2019;14:07:05;86060275;86041712;18563;
18.02.2019;14:08:05;86060406;86041746;18660;
18.02.2019;14:09:05;86060495;86041782;18713;
18.02.2019;14:10:05;86060609;86041859;18750;
18.02.2019;14:11:05;86060740;86041902;18838;
18.02.2019;14:12:05;86060866;86041981;18885;
18.02.2019;14:13:05;86060978;86042054;18924;
18.02.2019;14:14:05;86061073;86042129;18944;
18.02.2019;14:15:05;86061159;86042199;18960;
18.02.2019;14:16:05;86061293;86042276;19017;
18.02.2019;14:17:04;86061399;86042348;19051;
18.02.2019;14:18:04;86061492;86042428;19064;
18.02.2019;14:19:05;86061598;86042498;19100;
18.02.2019;14:20:05;86061687;86042556;19131;
18.02.2019;14:21:04;86061800;86042663;19137;
18.02.2019;14:22:05;86061925;86042754;19171;
18.02.2019;14:23:05;86062047;86042869;19178;
18.02.2019;14:24:04;86062187;86042942;19245;
18.02.2019;14:25:04;86062287;86043028;19259;
18.02.2019;14:26:05;86062387;86043124;19263;
18.02.2019;14:27:05;86062485;86043232;19253;
18.02.2019;14:28:05;86062609;86043322;19287;
18.02.2019;14:29:05;86062733;86043431;19302;
18.02.2019;14:30:05;86062864;86043566;19298;
18.02.2019;14:31:04;86063001;86043685;19316;
18.02.2019;14:32:05;86063142;86043802;19340;
18.02.2019;14:33:04;86063284;86043887;19397;
18.02.2019;14:34:05;86063408;86043990;19418;
18.02.2019;14:35:05;86063535;86044104;19431;
18.02.2019;14:36:04;86063676;86044194;19482;
18.02.2019;14:37:04;86063806;86044327;19479;
18.02.2019;14:38:05;86063920;86044416;19504;
18.02.2019;14:39:05;86064060;86044506;19554;
18.02.2019;14:40:05;86064162;86044611;19551;
18.02.2019;14:41:05;86064279;86044709;19570;
18.02.2019;14:42:04;86064401;86044825;19576;
18.02.2019;14:43:05;86064530;86044930;19600;
18.02.2019;14:44:05;86064657;86045046;19611;
18.02.2019;14:45:04;86064787;86045183;19604;
18.02.2019;14:46:04;86064904;86045287;19617;
18.02.2019;14:47:05;86065029;86045411;19618;
18.02.2019;14:48:04;86065167;86045542;19625;
18.02.2019;14:49:05;86065289;86045666;19623;
18.02.2019;14:50:05;86065423;86045741;19682;
18.02.2019;14:51:04;86065550;86045846;19704;
18.02.2019;14:52:04;86065665;86045935;19730;
18.02.2019;14:53:05;86065810;86046055;19755;
18.02.2019;14:54:04;86065947;86046166;19781;
18.02.2019;14:55:04;86066066;86046280;19786;
18.02.2019;14:56:05;86066191;86046401;19790;
18.02.2019;14:57:04;86066332;86046519;19813;
18.02.2019;14:58:04;86066473;86046655;19818;
18.02.2019;14:59:04;86066608;86046751;19857;
18.02.2019;15:00:07;86066744;86046850;19894;
18.02.2019;15:01:07;86066843;86046982;19861;
18.02.2019;15:02:08;86066967;86047104;19863;
18.02.2019;15:03:08;86067103;86047211;19892;
18.02.2019;15:04:08;86067216;86047319;19897;
18.02.2019;15:05:08;86067356;86047429;19927;
18.02.2019;15:06:08;86067460;86047559;19901;
18.02.2019;15:07:08;86067585;86047684;19901;
18.02.2019;15:08:07;86067708;86047774;19934;
18.02.2019;15:09:09;86067803;86047884;19919;
18.02.2019;15:10:07;86067922;86047981;19941;
18.02.2019;15:11:07;86068059;86048126;19933;
18.02.2019;15:12:07;86068168;86048240;19928;
18.02.2019;15:13:08;86068277;86048362;19915;
18.02.2019;15:14:08;86068402;86048457;19945;
18.02.2019;15:15:07;86068532;86048589;19943;
18.02.2019;15:16:08;86068671;86048738;19933;
18.02.2019;15:17:08;86068804;86048871;19933;
18.02.2019;15:18:08;86068944;86048982;19962;
18.02.2019;15:19:07;86069094;86049125;19969;
18.02.2019;15:20:07;86069219;86049249;19970;
18.02.2019;15:21:08;86069333;86049369;19964;
18.02.2019;15:22:08;86069488;86049487;20001;
18.02.2019;15:23:08;86069600;86049596;20004;
18.02.2019;15:24:12;86069753;86049732;20021;
18.02.2019;15:25:08;86069872;86049846;20026;
18.02.2019;15:26:13;86069997;86049985;20012;
18.02.2019;15:27:06;86070111;86050107;20004;
18.02.2019;15:28:07;86070273;86050223;20050;
18.02.2019;15:29:08;86070407;86050374;20033;
18.02.2019;15:30:07;86070508;86050520;19988;
18.02.2019;15:31:07;86070623;86050640;19983;
18.02.2019;15:32:07;86070741;86050749;19992;
18.02.2019;15:33:08;86070857;86050870;19987;
18.02.2019;15:34:07;86070976;86050988;19988;
18.02.2019;15:35:07;86071121;86051121;20000;
18.02.2019;15:36:07;86071244;86051243;20001;
18.02.2019;15:37:08;86071374;86051369;20005;
18.02.2019;15:38:07;86071484;86051507;19977;
18.02.2019;15:39:07;86071637;86051639;19998;
18.02.2019;15:40:07;86071777;86051788;19989;
18.02.2019;15:41:07;86071891;86051910;19981;
18.02.2019;15:42:07;86072028;86052027;20001;
18.02.2019;15:43:08;86072173;86052159;20014;
18.02.2019;15:44:07;86072319;86052274;20045;
18.02.2019;15:45:07;86072441;86052407;20034;
18.02.2019;15:46:08;86072575;86052521;20054;
18.02.2019;15:47:08;86072719;86052651;20068;
18.02.2019;15:48:08;86072863;86052792;20071;
18.02.2019;15:49:08;86072984;86052894;20090;
18.02.2019;15:50:08;86073137;86053047;20090;
18.02.2019;15:51:07;86073277;86053181;20096;
18.02.2019;15:52:08;86073392;86053300;20092;
18.02.2019;15:53:08;86073531;86053449;20082;
18.02.2019;15:54:08;86073661;86053588;20073;
18.02.2019;15:55:07;86073771;86053732;20039;
18.02.2019;15:56:07;86073868;86053859;20009;
18.02.2019;15:57:08;86074011;86054019;19992;
18.02.2019;15:58:07;86074157;86054147;20010;
18.02.2019;15:59:08;86074290;86054313;19977;
18.02.2019;16:00:04;86074420;86054429;19991;
18.02.2019;16:01:04;86074550;86054559;19991;
18.02.2019;16:02:05;86074691;86054698;19993;
18.02.2019;16:03:05;86074829;86054840;19989;
18.02.2019;16:04:05;86074984;86054984;20000;
18.02.2019;16:05:05;86075112;86055141;19971;
18.02.2019;16:06:05;86075256;86055285;19971;
18.02.2019;16:07:05;86075387;86055411;19976;
18.02.2019;16:08:04;86075506;86055545;19961;
18.02.2019;16:09:04;86075636;86055669;19967;
18.02.2019;16:10:04;86075757;86055821;19936;
18.02.2019;16:11:04;86075878;86055962;19916;
18.02.2019;16:12:05;86075983;86056102;19881;
18.02.2019;16:13:04;86076099;86056216;19883;
18.02.2019;16:14:04;86076240;86056352;19888;
18.02.2019;16:15:05;86076359;86056538;19821;
18.02.2019;16:16:04;86076471;86056665;19806;
18.02.2019;16:17:05;86076561;86056802;19759;
18.02.2019;16:18:05;86076682;86056920;19762;
18.02.2019;16:19:08;86076756;86057029;19727;
18.02.2019;16:20:05;86076854;86057144;19710;
18.02.2019;16:21:05;86076975;86057275;19700;
18.02.2019;16:22:08;86077103;86057386;19717;
18.02.2019;16:23:04;86077178;86057501;19677;
18.02.2019;16:24:04;86077284;86057669;19615;
18.02.2019;16:25:05;86077392;86057799;19593;
18.02.2019;16:26:06;86077521;86057949;19572;
18.02.2019;16:27:05;86077624;86058068;19556;
18.02.2019;16:28:05;86077710;86058208;19502;
18.02.2019;16:29:08;86077825;86058320;19505;
18.02.2019;16:30:06;86077937;86058425;19512;
18.02.2019;16:31:05;86078089;86058539;19550;
18.02.2019;16:32:08;86078196;86058698;19498;
18.02.2019;16:33:05;86078298;86058807;19491;
18.02.2019;16:34:04;86078408;86058914;19494;
18.02.2019;16:35:07;86078534;86059063;19471;
18.02.2019;16:36:04;86078662;86059185;19477;
18.02.2019;16:37:05;86078783;86059317;19466;
18.02.2019;16:38:07;86078918;86059472;19446;
18.02.2019;16:39:04;86079017;86059588;19429;
18.02.2019;16:40:04;86079167;86059721;19446;
18.02.2019;16:41:08;86079304;86059881;19423;
18.02.2019;16:42:05;86079423;86060017;19406;
18.02.2019;16:43:10;86079562;86060160;19402;
18.02.2019;16:44:07;86079697;86060255;19442;
18.02.2019;16:45:04;86079822;86060397;19425;
18.02.2019;16:46:05;86079965;86060549;19416;
18.02.2019;16:47:05;86080101;86060662;19439;
18.02.2019;16:48:05;86080218;86060815;19403;
18.02.2019;16:49:07;86080391;86060966;19425;
18.02.2019;16:50:05;86080516;86061097;19419;
18.02.2019;16:51:04;86080641;86061259;19382;
18.02.2019;16:52:08;86080767;86061412;19355;
18.02.2019;16:53:05;86080879;86061566;19313;
18.02.2019;16:54:05;86081015;86061689;19326;
18.02.2019;16:55:07;86081175;86061837;19338;
18.02.2019;16:56:05;86081321;86061965;19356;
18.02.2019;16:57:05;86081452;86062098;19354;
18.02.2019;16:58:07;86081618;86062269;19349;
18.02.2019;16:59:04;86081767;86062414;19353;
18.02.2019;17:00:05;86081896;86062572;19324;
18.02.2019;17:01:08;86082034;86062703;19331;
18.02.2019;17:02:04;86082180;86062832;19348;
18.02.2019;17:03:04;86082326;86062962;19364;
18.02.2019;17:04:05;86082467;86063098;19369;
18.02.2019;17:05:05;86082610;86063264;19346;
18.02.2019;17:06:05;86082735;86063409;19326;
18.02.2019;17:07:04;86082877;86063543;19334;
18.02.2019;17:08:06;86083006;86063659;19347;
18.02.2019;17:09:09;86083158;86063801;19357;
18.02.2019;17:10:04;86083288;86063929;19359;
18.02.2019;17:11:06;86083441;86064078;19363;
18.02.2019;17:12:04;86083572;86064196;19376;
18.02.2019;17:13:05;86083706;86064329;19377;
18.02.2019;17:14:08;86083823;86064466;19357;
18.02.2019;17:15:05;86083955;86064602;19353;
18.02.2019;17:16:05;86084110;86064745;19365;
18.02.2019;17:17:08;86084254;86064877;19377;
18.02.2019;17:18:05;86084386;86065006;19380;
18.02.2019;17:19:04;86084506;86065155;19351;
18.02.2019;17:20:08;86084645;86065326;19319;
18.02.2019;17:21:05;86084761;86065481;19280;
18.02.2019;17:22:05;86084883;86065599;19284;
18.02.2019;17:23:08;86085022;86065734;19288;
18.02.2019;17:24:05;86085167;86065869;19298;
18.02.2019;17:25:04;86085283;86065997;19286;
18.02.2019;17:26:08;86085446;86066123;19323;
18.02.2019;17:27:05;86085573;86066236;19337;
18.02.2019;17:28:04;86085732;86066371;19361;
18.02.2019;17:29:08;86085865;86066519;19346;
18.02.2019;17:30:05;86086024;86066650;19374;
18.02.2019;17:31:05;86086170;86066757;19413;
18.02.2019;17:32:08;86086313;86066906;19407;
18.02.2019;17:33:05;86086450;86067042;19408;
18.02.2019;17:34:05;86086616;86067165;19451;
18.02.2019;17:35:09;86086753;86067322;19431;
18.02.2019;17:36:05;86086887;86067445;19442;
18.02.2019;17:37:05;86087010;86067565;19445;
18.02.2019;17:38:08;86087181;86067684;19497;
18.02.2019;17:39:07;86087319;86067810;19509;
18.02.2019;17:40:04;86087461;86067950;19511;
18.02.2019;17:41:09;86087621;86068097;19524;
18.02.2019;17:42:05;86087748;86068238;19510;
18.02.2019;17:43:05;86087909;86068368;19541;
18.02.2019;17:44:05;86088081;86068497;19584;
18.02.2019;17:45:05;86088171;86068623;19548;
18.02.2019;17:46:04;86088363;86068740;19623;
18.02.2019;17:47:09;86088505;86068898;19607;
18.02.2019;17:48:05;86088632;86069021;19611;
18.02.2019;17:49:04;86088776;86069137;19639;
18.02.2019;17:50:09;86088928;86069275;19653;
18.02.2019;17:51:05;86089085;86069398;19687;
18.02.2019;17:52:05;86089194;86069519;19675;
18.02.2019;17:53:04;86089328;86069630;19698;
18.02.2019;17:54:04;86089442;86069752;19690;
18.02.2019;17:55:05;86089590;86069855;19735;
18.02.2019;17:56:05;86089741;86069961;19780;
18.02.2019;17:57:05;86089879;86070083;19796;
18.02.2019;17:58:05;86090058;86070212;19846;
18.02.2019;17:59:04;86090186;86070324;19862;
18.02.2019;18:00:05;86090322;86070459;19863;
18.02.2019;18:01:05;86090468;86070623;19845;
18.02.2019;18:02:04;86090586;86070771;19815;
18.02.2019;18:03:05;86090741;86070894;19847;
18.02.2019;18:04:05;86090863;86071023;19840;
18.02.2019;18:05:05;86091005;86071137;19868;
18.02.2019;18:06:05;86091151;86071284;19867;
18.02.2019;18:07:05;86091313;86071380;19933;
18.02.2019;18:08:04;86091451;86071506;19945;
18.02.2019;18:09:04;86091604;86071622;19982;
18.02.2019;18:10:05;86091740;86071725;20015;
18.02.2019;18:11:05;86091890;86071805;20085;
18.02.2019;18:12:04;86092034;86071965;20069;
18.02.2019;18:13:04;86092178;86072122;20056;
18.02.2019;18:14:05;86092315;86072350;19965;
18.02.2019;18:15:05;86092467;86072524;19943;
18.02.2019;18:16:05;86092593;86072676;19917;
18.02.2019;18:17:05;86092734;86072786;19948;
18.02.2019;18:18:05;86092857;86072910;19947;
18.02.2019;18:19:05;86092982;86073046;19936;
18.02.2019;18:20:05;86093145;86073202;19943;
18.02.2019;18:21:04;86093285;86073373;19912;
18.02.2019;18:22:04;86093403;86073699;19704;
18.02.2019;18:23:05;86093524;86073933;19591;
18.02.2019;18:24:04;86093624;86074123;19501;
18.02.2019;18:25:05;86093730;86074283;19447;
18.02.2019;18:26:04;86093857;86074415;19442;
18.02.2019;18:27:05;86093964;86074541;19423;
18.02.2019;18:28:05;86094060;86074683;19377;
18.02.2019;18:29:05;86094170;86074802;19368;
18.02.2019;18:30:05;86094266;86074940;19326;
18.02.2019;18:31:04;86094342;86075126;19216;
18.02.2019;18:32:04;86094477;86075297;19180;
18.02.2019;18:33:05;86094569;86075432;19137;
18.02.2019;18:34:05;86094687;86075549;19138;
18.02.2019;18:35:05;86094819;86075663;19156;
18.02.2019;18:36:05;86094947;86075748;19199;
18.02.2019;18:37:05;86095076;86075861;19215;
18.02.2019;18:38:05;86095190;86075975;19215;
18.02.2019;18:39:04;86095302;86076091;19211;
18.02.2019;18:40:04;86095429;86076236;19193;
18.02.2019;18:41:04;86095561;86076352;19209;
18.02.2019;18:42:05;86095692;86076481;19211;
18.02.2019;18:43:05;86095808;86076600;19208;
18.02.2019;18:44:05;86095918;86076717;19201;
18.02.2019;18:45:05;86096004;86076781;19223;
18.02.2019;18:46:05;86096119;86076916;19203;
18.02.2019;18:47:04;86096247;86077048;19199;
18.02.2019;18:48:05;86096353;86077132;19221;
18.02.2019;18:49:04;86096464;86077286;19178;
18.02.2019;18:50:04;86096608;86077379;19229;
18.02.2019;18:51:05;86096754;86077498;19256;
18.02.2019;18:52:05;86096907;86077613;19294;
18.02.2019;18:53:05;86097060;86077745;19315;
18.02.2019;18:54:04;86097194;86077852;19342;
18.02.2019;18:55:04;86097318;86077949;19369;
18.02.2019;18:56:05;86097480;86078046;19434;
18.02.2019;18:57:05;86097607;86078198;19409;
18.02.2019;18:58:05;86097732;86078322;19410;
18.02.2019;18:59:05;86097853;86078417;19436;
18.02.2019;19:00:04;86098005;86078507;19498;
18.02.2019;19:01:04;86098108;86078610;19498;
18.02.2019;19:02:04;86098224;86078705;19519;
18.02.2019;19:03:05;86098378;86078812;19566;
18.02.2019;19:04:04;86098526;86078899;19627;
18.02.2019;19:05:04;86098683;86079013;19670;
18.02.2019;19:06:05;86098814;86079130;19684;
18.02.2019;19:07:04;86098974;86079233;19741;
18.02.2019;19:08:04;86099160;86079317;19843;
18.02.2019;19:09:05;86099294;86079413;19881;
18.02.2019;19:10:05;86099426;86079525;19901;
18.02.2019;19:11:05;86099532;86079616;19916;
18.02.2019;19:12:05;86099661;86079694;19967;
18.02.2019;19:13:04;86099792;86079785;20007;
18.02.2019;19:14:04;86099940;86079888;20052;
18.02.2019;19:15:04;86100067;86079970;20097;
18.02.2019;19:16:04;86100159;86080044;20115;
18.02.2019;19:17:05;86100160;86080134;20026;
18.02.2019;19:18:05;86100224;86080233;19991;
18.02.2019;19:19:05;86100311;86080340;19971;
18.02.2019;19:20:04;86100406;86080432;19974;
18.02.2019;19:21:04;86100508;86080523;19985;
18.02.2019;19:22:05;86100582;86080621;19961;
18.02.2019;19:23:05;86100672;86080743;19929;
18.02.2019;19:24:05;86100782;86080842;19940;
18.02.2019;19:25:05;86100900;86080937;19963;
18.02.2019;19:26:05;86100993;86081031;19962;
18.02.2019;19:27:05;86101114;86081120;19994;
18.02.2019;19:28:05;86101214;86081194;20020;
18.02.2019;19:29:05;86101330;86081303;20027;
18.02.2019;19:30:04;86101454;86081390;20064;
18.02.2019;19:31:04;86101564;86081470;20094;
18.02.2019;19:32:05;86101701;86081553;20148;
18.02.2019;19:33:04;86101828;86081645;20183;
18.02.2019;19:34:05;86101912;86081761;20151;
18.02.2019;19:35:05;86102017;86081833;20184;
18.02.2019;19:36:04;86102145;86081924;20221;
18.02.2019;19:37:04;86102266;86082012;20254;
18.02.2019;19:38:04;86102372;86082078;20294;
18.02.2019;19:39:04;86102471;86082148;20323;
18.02.2019;19:40:04;86102564;86082204;20360;
18.02.2019;19:41:05;86102650;86082258;20392;
18.02.2019;19:42:05;86102737;86082335;20402;
18.02.2019;19:43:05;86102826;86082361;20465;
18.02.2019;19:44:04;86102922;86082452;20470;
18.02.2019;19:45:04;86103005;86082540;20465;
18.02.2019;19:46:05;86103127;86082591;20536;
18.02.2019;19:47:05;86103259;86082656;20603;
18.02.2019;19:48:06;86103388;86082733;20655;
18.02.2019;19:49:04;86103489;86082785;20704;
18.02.2019;19:50:05;86103617;86082886;20731;
18.02.2019;19:51:04;86103752;86082935;20817;
18.02.2019;19:52:05;86103871;86083005;20866;
18.02.2019;19:53:04;86104000;86083070;20930;
18.02.2019;19:54:05;86104113;86083131;20982;
18.02.2019;19:55:05;86104241;86083195;21046;
18.02.2019;19:56:05;86104364;86083271;21093;
18.02.2019;19:57:05;86104462;86083339;21123;
18.02.2019;19:58:05;86104586;86083406;21180;
18.02.2019;19:59:09;86104688;86083469;21219;
18.02.2019;20:00:05;86104809;86083525;21284;
18.02.2019;20:01:05;86104903;86083576;21327;
18.02.2019;20:02:05;86105021;86083668;21353;
18.02.2019;20:03:05;86105147;86083754;21393;
18.02.2019;20:04:04;86105228;86083803;21425;
18.02.2019;20:05:04;86105357;86083879;21478;
18.02.2019;20:06:05;86105474;86083949;21525;
18.02.2019;20:07:05;86105594;86084004;21590;
18.02.2019;20:08:05;86105713;86084088;21625;
18.02.2019;20:09:06;86105853;86084144;21709;
18.02.2019;20:10:04;86105956;86084206;21750;
18.02.2019;20:11:04;86106063;86084271;21792;
18.02.2019;20:12:06;86106165;86084335;21830;
18.02.2019;20:13:04;86106256;86084365;21891;
18.02.2019;20:14:04;86106366;86084408;21958;
18.02.2019;20:15:04;86106468;86084460;22008;
18.02.2019;20:16:04;86106562;86084501;22061;
18.02.2019;20:17:05;86106674;86084553;22121;
18.02.2019;20:18:04;86106763;86084572;22191;
18.02.2019;20:19:04;86106877;86084623;22254;
18.02.2019;20:20:05;86106940;86084647;22293;
18.02.2019;20:21:05;86107043;86084643;22400;
18.02.2019;20:22:04;86107120;86084693;22427;
18.02.2019;20:23:04;86107198;86084730;22468;
18.02.2019;20:24:05;86107255;86084753;22502;
18.02.2019;20:25:05;86107350;86084791;22559;
18.02.2019;20:26:05;86107436;86084799;22637;
18.02.2019;20:27:05;86107469;86084852;22617;
18.02.2019;20:28:05;86107554;86084886;22668;
18.02.2019;20:29:05;86107643;86084949;22694;
18.02.2019;20:30:05;86107766;86084991;22775;
18.02.2019;20:31:05;86107856;86085041;22815;
18.02.2019;20:32:05;86108059;86085109;22950;
18.02.2019;20:33:05;86108230;86085160;23070;
18.02.2019;20:34:04;86108320;86085218;23102;
18.02.2019;20:35:05;86108449;86085273;23176;
18.02.2019;20:36:05;86108594;86085306;23288;
18.02.2019;20:37:05;86108716;86085374;23342;
18.02.2019;20:38:05;86108825;86085407;23418;
18.02.2019;20:39:05;86108902;86085446;23456;
18.02.2019;20:40:05;86109007;86085492;23515;
18.02.2019;20:41:05;86109125;86085559;23566;
18.02.2019;20:42:05;86109234;86085588;23646;
18.02.2019;20:43:05;86109361;86085621;23740;
18.02.2019;20:44:05;86109432;86085661;23771;
18.02.2019;20:45:05;86109562;86085711;23851;
18.02.2019;20:46:05;86109664;86085749;23915;
18.02.2019;20:47:05;86109792;86085804;23988;
18.02.2019;20:48:05;86109910;86085848;24062;
18.02.2019;20:49:05;86110035;86085888;24147;
18.02.2019;20:50:04;86110120;86085931;24189;
18.02.2019;20:51:05;86110222;86085967;24255;
18.02.2019;20:52:05;86110345;86086020;24325;
18.02.2019;20:53:05;86110473;86086084;24389;
18.02.2019;20:54:04;86110583;86086122;24461;
18.02.2019;20:55:04;86110691;86086154;24537;
18.02.2019;20:56:04;86110795;86086190;24605;
18.02.2019;20:57:05;86110904;86086226;24678;
18.02.2019;20:58:05;86111031;86086263;24768;
18.02.2019;20:59:05;86111133;86086307;24826;
18.02.2019;21:00:05;86111258;86086354;24904;
18.02.2019;21:01:05;86111345;86086384;24961;
18.02.2019;21:02:04;86111424;86086409;25015;
18.02.2019;21:03:05;86111528;86086444;25084;
18.02.2019;21:04:04;86111645;86086485;25160;
18.02.2019;21:05:04;86111742;86086516;25226;
18.02.2019;21:06:05;86111846;86086548;25298;
18.02.2019;21:07:05;86111958;86086586;25372;
18.02.2019;21:08:05;86112061;86086630;25431;
18.02.2019;21:09:05;86112174;86086645;25529;
18.02.2019;21:10:05;86112281;86086680;25601;
18.02.2019;21:11:04;86112366;86086718;25648;
18.02.2019;21:12:06;86112469;86086750;25719;
18.02.2019;21:13:04;86112569;86086787;25782;
18.02.2019;21:14:05;86112666;86086819;25847;
18.02.2019;21:15:06;86112761;86086864;25897;
18.02.2019;21:16:04;86112868;86086883;25985;
18.02.2019;21:17:04;86112940;86086919;26021;
18.02.2019;21:18:04;86113053;86086955;26098;
18.02.2019;21:19:05;86113166;86086996;26170;
18.02.2019;21:20:05;86113263;86087033;26230;
18.02.2019;21:21:05;86113378;86087069;26309;
18.02.2019;21:22:05;86113479;86087101;26378;
18.02.2019;21:23:05;86113596;86087142;26454;
18.02.2019;21:24:04;86113695;86087185;26510;
18.02.2019;21:25:04;86113825;86087235;26590;
18.02.2019;21:26:04;86113930;86087258;26672;
18.02.2019;21:27:05;86114051;86087296;26755;
18.02.2019;21:28:05;86114157;86087341;26816;
18.02.2019;21:29:05;86114277;86087366;26911;
18.02.2019;21:30:05;86114391;86087413;26978;
18.02.2019;21:31:05;86114533;86087445;27088;
18.02.2019;21:32:04;86114636;86087493;27143;
18.02.2019;21:33:06;86114736;86087522;27214;
18.02.2019;21:34:05;86114839;86087559;27280;
18.02.2019;21:35:04;86114940;86087582;27358;
18.02.2019;21:36:04;86115048;86087610;27438;
18.02.2019;21:37:05;86115171;86087638;27533;
18.02.2019;21:38:04;86115263;86087661;27602;
18.02.2019;21:39:04;86115374;86087693;27681;
18.02.2019;21:40:04;86115472;86087726;27746;
18.02.2019;21:41:05;86115573;86087764;27809;
18.02.2019;21:42:06;86115664;86087789;27875;
18.02.2019;21:43:06;86115786;86087814;27972;
18.02.2019;21:44:05;86115887;86087845;28042;
18.02.2019;21:45:05;86116018;86087884;28134;
18.02.2019;21:46:05;86116131;86087923;28208;
18.02.2019;21:47:05;86116255;86087955;28300;
18.02.2019;21:48:05;86116343;86087984;28359;
18.02.2019;21:49:05;86116440;86088025;28415;
18.02.2019;21:50:05;86116568;86088052;28516;
18.02.2019;21:51:05;86116681;86088082;28599;
18.02.2019;21:52:05;86116753;86088029;28724;
18.02.2019;21:54:05;86116961;86088077;28884;
18.02.2019;21:55:06;86117060;86088119;28941;
18.02.2019;21:56:05;86117174;86088171;29003;
18.02.2019;21:57:06;86117271;86088203;29068;
18.02.2019;21:58:05;86117344;86088230;29114;
18.02.2019;21:59:05;86117458;86088266;29192;
18.02.2019;22:00:05;86117533;86088289;29244;
18.02.2019;22:01:07;86117619;86088320;29299;
18.02.2019;22:02:04;86117753;86088344;29409;
18.02.2019;22:03:05;86117849;86088371;29478;
18.02.2019;22:04:05;86117959;86088392;29567;
18.02.2019;22:05:05;86118063;86088428;29635;
18.02.2019;22:06:05;86118166;86088451;29715;
18.02.2019;22:07:05;86118276;86088460;29816;
18.02.2019;22:08:07;86118383;86088501;29882;
18.02.2019;22:09:05;86118474;86088531;29943;
18.02.2019;22:10:05;86118571;86088556;30015;
18.02.2019;22:11:06;86118676;86088586;30090;
18.02.2019;22:12:05;86118765;86088617;30148;
18.02.2019;22:13:06;86118848;86088620;30228;
18.02.2019;22:14:05;86118916;86088630;30286;
18.02.2019;22:15:05;86118991;86088635;30356;
18.02.2019;22:16:05;86119072;86088633;30439;
18.02.2019;22:17:05;86119119;86094200;24919;
18.02.2019;22:18:04;86119220;86094209;25011;
18.02.2019;22:19:05;86119284;86094220;25064;
18.02.2019;22:20:15;86119362;86094228;25134;
18.02.2019;22:21:05;86119451;86094245;25206;
18.02.2019;22:22:06;86119531;86094259;25272;
18.02.2019;22:23:05;86119601;86094268;25333;
18.02.2019;22:24:05;86119659;86094289;25370;
18.02.2019;22:25:05;86118033;86094313;23720;
18.02.2019;22:26:05;86118119;86094315;23804;
18.02.2019;22:27:04;86118191;86094335;23856;
18.02.2019;22:28:05;86118271;86094361;23910;
18.02.2019;22:29:05;86118369;86094366;24003;
18.02.2019;22:30:05;86118453;86094386;24067;
18.02.2019;22:31:10;86118540;86094385;24155;
18.02.2019;22:32:05;86118582;86094392;24190;
18.02.2019;22:33:05;86118658;86094410;24248;
18.02.2019;22:34:06;86118722;86094431;24291;
18.02.2019;22:35:05;86118804;86094458;24346;
18.02.2019;22:36:07;86118883;86094459;24424;
18.02.2019;22:37:06;86118961;86094473;24488;
18.02.2019;22:38:05;86119034;86094485;24549;
18.02.2019;22:39:06;86119095;86094500;24595;
18.02.2019;22:40:05;86119169;86094518;24651;
18.02.2019;22:41:05;86119262;86094531;24731;
18.02.2019;22:42:06;86119363;86094544;24819;
18.02.2019;22:43:06;86119460;86094553;24907;
18.02.2019;22:44:05;86119538;86094570;24968;
18.02.2019;22:46:06;86119710;86094596;25114;
18.02.2019;22:47:20;86119822;86094640;25182;
18.02.2019;22:48:05;86119912;86094655;25257;
18.02.2019;22:49:05;86120006;86094678;25328;
18.02.2019;22:50:05;86120110;86094703;25407;
18.02.2019;22:51:05;86120213;86094717;25496;
18.02.2019;22:52:05;86120301;86094735;25566;
18.02.2019;22:53:04;86120408;86094765;25643;
18.02.2019;22:54:05;86120498;86094788;25710;
18.02.2019;22:55:04;86120595;86094806;25789;
18.02.2019;22:56:05;86120676;86094829;25847;
18.02.2019;22:57:04;86120769;86094851;25918;
18.02.2019;22:58:06;86120864;86094877;25987;
18.02.2019;22:59:05;86120935;86094887;26048;
18.02.2019;23:00:05;86121027;86094901;26126;
18.02.2019;23:01:05;86121113;86094913;26200;
18.02.2019;23:02:05;86121206;86094931;26275;
18.02.2019;23:03:05;86121287;86094957;26330;
18.02.2019;23:04:05;86121366;86094983;26383;
18.02.2019;23:05:04;86121454;86095013;26441;
18.02.2019;23:06:06;86121549;86095028;26521;
18.02.2019;23:09:06;86121799;86095079;26720;
18.02.2019;23:10:06;86121898;86095107;26791;
18.02.2019;23:11:05;86121991;86095112;26879;
18.02.2019;23:12:04;86122068;86095142;26926;
18.02.2019;23:13:05;86122161;86095150;27011;
18.02.2019;23:14:04;86122254;86095174;27080;
18.02.2019;23:15:04;86122342;86095199;27143;
18.02.2019;23:16:04;86122418;86095214;27204;
18.02.2019;23:17:04;86122505;86095215;27290;
18.02.2019;23:18:04;86122591;86095243;27348;
18.02.2019;23:19:05;86122690;86095260;27430;
18.02.2019;23:20:14;86122799;86095288;27511;
18.02.2019;23:21:04;86122886;86095301;27585;
18.02.2019;23:22:04;86122999;86095323;27676;
18.02.2019;23:23:05;86123087;86095358;27729;
18.02.2019;23:24:10;86123182;86095385;27797;
18.02.2019;23:25:17;86123266;86095402;27864;
18.02.2019;23:23:18;86127575;86096291;31284;
19.02.2019;00:14:31;86127585;86096293;31292;
19.02.2019;00:15:12;86127634;86096301;31333;
19.02.2019;00:16:17;86127693;86096312;31381;
19.02.2019;00:17:19;86127739;86096314;31425;
19.02.2019;00:18:19;86127777;86096313;31464;
19.02.2019;00:19:19;86127808;86096310;31498;
19.02.2019;00:20:19;86127868;86096327;31541;
19.02.2019;00:21:22;86127968;86096329;31639;
19.02.2019;00:22:23;86128052;86096343;31709;
19.02.2019;00:23:22;86128121;86096352;31769;
19.02.2019;00:24:22;86128205;86096364;31841;
19.02.2019;00:25:21;86128263;86096372;31891;
19.02.2019;00:26:22;86128346;86096407;31939;
19.02.2019;00:27:25;86128440;86096427;32013;
19.02.2019;00:28:21;86128520;86096427;32093;
19.02.2019;00:29:21;86128584;86096441;32143;
19.02.2019;00:30:20;86128657;86096463;32194;
19.02.2019;00:31:18;86128707;86096485;32222;
19.02.2019;00:32:19;86128791;86096512;32279;
19.02.2019;00:33:19;86128865;86096523;32342;
19.02.2019;00:34:19;86128945;86096539;32406;
19.02.2019;00:35:16;86129011;86096547;32464;
19.02.2019;00:36:16;86129067;86096561;32506;
19.02.2019;00:37:16;86129161;86096590;32571;
19.02.2019;00:38:16;86129230;86096597;32633;
19.02.2019;00:39:16;86129302;86096611;32691;
19.02.2019;00:40:17;86129379;86096625;32754;
19.02.2019;00:41:13;86129427;86096645;32782;
19.02.2019;00:42:14;86129503;86096654;32849;
19.02.2019;00:43:14;86129572;86096671;32901;
19.02.2019;00:44:13;86129676;86096697;32979;
19.02.2019;00:45:13;86129754;86096720;33034;
19.02.2019;00:46:12;86129829;86096730;33099;
19.02.2019;00:47:10;86129908;86096758;33150;
19.02.2019;00:48:10;86130006;86096780;33226;
19.02.2019;00:49:11;86130074;86096773;33301;
19.02.2019;00:50:11;86130138;86096749;33389;
19.02.2019;00:51:10;86130221;86096773;33448;
19.02.2019;00:52:11;86130311;86096792;33519;
19.02.2019;00:53:09;86130376;86096825;33551;
19.02.2019;00:54:07;86130452;86096845;33607;
19.02.2019;00:55:07;86130533;86096862;33671;
19.02.2019;00:56:08;86130599;86096885;33714;
19.02.2019;00:57:07;86130677;86096906;33771;
19.02.2019;00:58:08;86130759;86096928;33831;
19.02.2019;00:59:07;86130845;86096943;33902;
19.02.2019;01:00:04;86130906;86096970;33936;
19.02.2019;01:01:05;86131003;86096981;34022;
19.02.2019;01:02:04;86131097;86097008;34089;
19.02.2019;01:03:04;86131168;86097036;34132;
19.02.2019;01:04:05;86131268;86097054;34214;
19.02.2019;01:05:05;86131340;86097084;34256;
19.02.2019;01:06:04;86131417;86097102;34315;
19.02.2019;01:07:05;86131491;86097134;34357;
19.02.2019;01:08:05;86131552;86097155;34397;
19.02.2019;01:09:04;86131651;86097186;34465;
19.02.2019;01:10:04;86131710;86097214;34496;
19.02.2019;01:11:05;86131774;86097244;34530;
19.02.2019;01:12:04;86131857;86097275;34582;
19.02.2019;01:13:04;86131930;86097297;34633;
19.02.2019;01:14:05;86132013;86097318;34695;
19.02.2019;01:15:04;86132099;86097340;34759;
19.02.2019;01:16:04;86132188;86097351;34837;
19.02.2019;01:17:05;86132261;86097373;34888;
19.02.2019;01:18:05;86132339;86097405;34934;
19.02.2019;01:19:05;86132421;86097435;34986;
19.02.2019;01:20:04;86132501;86097469;35032;
19.02.2019;01:21:05;86132582;86097476;35106;
19.02.2019;01:22:05;86132678;86097507;35171;
19.02.2019;01:23:05;86132763;86097539;35224;
19.02.2019;01:24:05;86132858;86097567;35291;
19.02.2019;01:25:05;86132936;86097597;35339;
19.02.2019;01:26:05;86133017;86097634;35383;
19.02.2019;01:27:04;86133091;86097679;35412;
19.02.2019;01:28:04;86133177;86097702;35475;
19.02.2019;01:29:05;86133272;86097729;35543;
19.02.2019;01:30:04;86133366;86097761;35605;
19.02.2019;01:31:04;86133449;86097791;35658;
19.02.2019;01:32:05;86133530;86097811;35719;
19.02.2019;01:33:05;86133609;86097852;35757;
19.02.2019;01:34:04;86133685;86097892;35793;
19.02.2019;01:35:04;86133764;86097926;35838;
19.02.2019;01:36:05;86133843;86097954;35889;
19.02.2019;01:37:04;86133904;86097991;35913;
19.02.2019;01:38:05;86133970;86098018;35952;
19.02.2019;01:39:05;86134040;86098044;35996;
19.02.2019;01:40:05;86134103;86098072;36031;
19.02.2019;01:41:05;86134184;86098095;36089;
19.02.2019;01:42:04;86134272;86098132;36140;
19.02.2019;01:43:04;86134352;86098168;36184;
19.02.2019;01:44:05;86134443;86098196;36247;
19.02.2019;01:45:05;86134515;86098228;36287;
19.02.2019;01:46:04;86134597;86098271;36326;
19.02.2019;01:47:04;86134672;86098315;36357;
19.02.2019;01:48:05;86134768;86098353;36415;
19.02.2019;01:49:05;86134825;86098378;36447;
19.02.2019;01:50:04;86134895;86098411;36484;
19.02.2019;01:51:04;86134973;86098442;36531;
19.02.2019;01:52:05;86135043;86098479;36564;
19.02.2019;01:53:04;86135127;86098516;36611;
19.02.2019;01:54:05;86135209;86098559;36650;
19.02.2019;01:55:05;86135288;86098589;36699;
19.02.2019;01:56:04;86135354;86098634;36720;
19.02.2019;01:57:04;86135427;86098672;36755;
19.02.2019;01:58:05;86135515;86098688;36827;
19.02.2019;01:59:04;86135608;86098753;36855;
19.02.2019;02:00:04;86135681;86098780;36901;
19.02.2019;02:01:05;86135755;86098821;36934;
19.02.2019;02:02:05;86135851;86098861;36990;
19.02.2019;02:03:05;86135927;86098908;37019;
19.02.2019;02:04:05;86135989;86098960;37029;
19.02.2019;02:05:04;86136061;86099003;37058;
19.02.2019;02:06:05;86136138;86099037;37101;
19.02.2019;02:07:05;86136241;86099079;37162;
19.02.2019;02:08:04;86136333;86099099;37234;
19.02.2019;02:09:06;86136409;86099181;37228;
19.02.2019;02:10:05;86136495;86099225;37270;
19.02.2019;02:11:04;86136556;86099269;37287;
19.02.2019;02:12:04;86136620;86099298;37322;
19.02.2019;02:13:04;86136687;86099357;37330;
19.02.2019;02:14:05;86136738;86099402;37336;
19.02.2019;02:15:05;86136815;86099455;37360;
19.02.2019;02:16:04;86136875;86099507;37368;
19.02.2019;02:17:04;86136911;86099554;37357;
19.02.2019;02:18:04;86136974;86099589;37385;
19.02.2019;02:19:04;86137017;86099622;37395;
19.02.2019;02:20:05;86137060;86099663;37397;
19.02.2019;02:21:05;86137107;86099699;37408;
19.02.2019;02:22:05;86137166;86099750;37416;
19.02.2019;02:23:05;86137219;86099809;37410;
19.02.2019;02:24:04;86137284;86099860;37424;
19.02.2019;02:25:04;86137343;86099902;37441;
19.02.2019;02:26:05;86137417;86099950;37467;
19.02.2019;02:27:04;86137469;86099994;37475;
19.02.2019;02:28:04;86137536;86100038;37498;
19.02.2019;02:29:05;86137593;86100075;37518;
19.02.2019;02:30:04;86137659;86100144;37515;
19.02.2019;02:31:05;86137737;86100198;37539;
19.02.2019;02:32:05;86137789;86100260;37529;
19.02.2019;02:33:05;86137856;86100309;37547;
19.02.2019;02:34:04;86137926;86100366;37560;
19.02.2019;02:35:05;86138010;86100424;37586;
19.02.2019;02:36:04;86138078;86100495;37583;
19.02.2019;02:37:04;86138161;86100555;37606;
19.02.2019;02:38:05;86138249;86100604;37645;
19.02.2019;02:39:05;86138322;86100673;37649;
19.02.2019;02:40:04;86138403;86100759;37644;
19.02.2019;02:41:04;86138474;86100829;37645;
19.02.2019;02:42:05;86138541;86100884;37657;
19.02.2019;02:43:04;86138621;86100924;37697;
19.02.2019;02:44:04;86138702;86101019;37683;
19.02.2019;02:45:05;86138795;86101086;37709;
19.02.2019;02:46:05;86138885;86101158;37727;
19.02.2019;02:47:05;86138954;86101213;37741;
19.02.2019;02:48:05;86139045;86101268;37777;
19.02.2019;02:49:04;86139134;86101344;37790;
19.02.2019;02:50:04;86139208;86101426;37782;
19.02.2019;02:51:05;86139290;86101505;37785;
19.02.2019;02:52:04;86139392;86101588;37804;
19.02.2019;02:53:05;86139475;86101672;37803;
19.02.2019;02:54:04;86139562;86101738;37824;
19.02.2019;02:55:04;86139643;86101818;37825;
19.02.2019;02:56:05;86139717;86101896;37821;
19.02.2019;02:57:04;86139793;86101975;37818;
19.02.2019;02:58:05;86139891;86102050;37841;
19.02.2019;02:59:04;86139969;86102119;37850;
19.02.2019;03:00:05;86140059;86102185;37874;
19.02.2019;03:01:05;86140131;86102273;37858;
19.02.2019;03:02:04;86140222;86102325;37897;
19.02.2019;03:03:05;86140296;86102390;37906;
19.02.2019;03:04:04;86140381;86102474;37907;
19.02.2019;03:05:04;86140464;86102555;37909;
19.02.2019;03:06:05;86140538;86102626;37912;
19.02.2019;03:07:04;86140638;86102666;37972;
19.02.2019;03:08:04;86140699;86102782;37917;
19.02.2019;03:09:04;86140804;86102842;37962;
19.02.2019;03:10:05;86140890;86102912;37978;
19.02.2019;03:11:04;86140966;86102987;37979;
19.02.2019;03:12:04;86141065;86103086;37979;
19.02.2019;03:13:05;86141161;86103152;38009;
19.02.2019;03:14:05;86141248;86103219;38029;
19.02.2019;03:15:05;86141324;86103278;38046;
19.02.2019;03:16:04;86141398;86103359;38039;
19.02.2019;03:17:06;86141468;86103441;38027;
19.02.2019;03:18:04;86141557;86103539;38018;
19.02.2019;03:19:04;86141649;86103622;38027;
19.02.2019;03:20:04;86141704;86103698;38006;
19.02.2019;03:21:05;86141765;86103790;37975;
19.02.2019;03:22:04;86141839;86103880;37959;
19.02.2019;03:23:04;86141914;86103961;37953;
19.02.2019;03:24:05;86141991;86104031;37960;
19.02.2019;03:25:05;86142074;86104131;37943;
19.02.2019;03:26:04;86142159;86104231;37928;
19.02.2019;03:27:05;86142245;86104297;37948;
19.02.2019;03:28:04;86142331;86104375;37956;
19.02.2019;03:29:04;86142423;86104455;37968;
19.02.2019;03:30:05;86142502;86104481;38021;
19.02.2019;03:31:04;86142597;86104633;37964;
19.02.2019;03:32:04;86142676;86104709;37967;
19.02.2019;03:33:04;86142769;86104798;37971;
19.02.2019;03:34:04;86142850;86104890;37960;
19.02.2019;03:35:05;86142943;86104997;37946;
19.02.2019;03:36:04;86143012;86105077;37935;
19.02.2019;03:37:04;86143095;86105167;37928;
19.02.2019;03:38:10;86143169;86105251;37918;
19.02.2019;03:39:05;86143251;86105325;37926;
19.02.2019;03:40:04;86143343;86105413;37930;
19.02.2019;03:41:04;86143408;86105500;37908;
19.02.2019;03:42:05;86143483;86105578;37905;
19.02.2019;03:43:05;86143558;86105688;37870;
19.02.2019;03:44:04;86143630;86105778;37852;
19.02.2019;03:45:04;86143738;86105866;37872;
19.02.2019;03:46:05;86143806;86105962;37844;
19.02.2019;03:47:04;86143886;86106064;37822;
19.02.2019;03:48:04;86143951;86106141;37810;
19.02.2019;03:49:10;86144028;86106247;37781;
19.02.2019;03:50:05;86144100;86106338;37762;
19.02.2019;03:51:04;86144172;86106424;37748;
19.02.2019;03:52:05;86144240;86106521;37719;
19.02.2019;03:53:04;86144284;86106553;37731;
19.02.2019;03:54:04;86144357;86106654;37703;
19.02.2019;03:55:05;86144424;86106751;37673;
19.02.2019;03:56:04;86144493;86106836;37657;
19.02.2019;03:57:05;86144567;86106941;37626;
19.02.2019;03:58:04;86144643;86107022;37621;
19.02.2019;03:59:05;86144727;86107109;37618;
19.02.2019;04:00:04;86144813;86107190;37623;
19.02.2019;04:01:05;86144890;86107282;37608;
19.02.2019;04:02:04;86144958;86107367;37591;
19.02.2019;04:03:04;86145042;86107454;37588;
19.02.2019;04:04:04;86145109;86107547;37562;
19.02.2019;04:05:05;86145160;86107634;37526;
19.02.2019;04:06:04;86145217;86107722;37495;
19.02.2019;04:07:04;86145294;86107815;37479;
19.02.2019;04:08:05;86145370;86107913;37457;
19.02.2019;04:09:05;86145422;86108016;37406;
19.02.2019;04:10:04;86145491;86108111;37380;
19.02.2019;04:11:04;86145551;86108199;37352;
19.02.2019;04:12:04;86145620;86108300;37320;
19.02.2019;04:13:05;86145689;86108374;37315;
19.02.2019;04:14:05;86145750;86108471;37279;
19.02.2019;04:15:04;86145808;86108562;37246;
19.02.2019;04:16:05;86145864;86108658;37206;
19.02.2019;04:17:05;86145917;86108748;37169;
19.02.2019;04:18:05;86145963;86108832;37131;
19.02.2019;04:19:04;86146024;86108927;37097;
19.02.2019;04:20:05;86146088;86109003;37085;
19.02.2019;04:21:05;86146132;86109091;37041;
19.02.2019;04:22:04;86146184;86109179;37005;
19.02.2019;04:23:05;86146243;86109265;36978;
19.02.2019;04:24:05;86146300;86109349;36951;
19.02.2019;04:25:04;86146343;86109466;36877;
19.02.2019;04:26:04;86146406;86109562;36844;
19.02.2019;04:27:05;86146479;86109654;36825;
19.02.2019;04:28:05;86146553;86109774;36779;
19.02.2019;04:29:05;86146614;86109870;36744;
19.02.2019;04:30:04;86146676;86109962;36714;
19.02.2019;04:31:04;86146744;86110070;36674;
19.02.2019;04:32:05;86146809;86110161;36648;
19.02.2019;04:33:04;86146894;86110277;36617;
19.02.2019;04:34:05;86146985;86110377;36608;
19.02.2019;04:35:05;86147057;86110453;36604;
19.02.2019;04:36:04;86147121;86110563;36558;
19.02.2019;04:37:04;86147196;86110649;36547;
19.02.2019;04:38:05;86147262;86110785;36477;
19.02.2019;04:39:06;86147352;86110894;36458;
19.02.2019;04:40:05;86147409;86111006;36403;
19.02.2019;04:41:04;86147472;86111113;36359;
19.02.2019;04:42:04;86147532;86111222;36310;
19.02.2019;04:43:04;86147604;86111311;36293;
19.02.2019;04:44:05;86147690;86111412;36278;
19.02.2019;04:45:05;86147758;86111518;36240;
19.02.2019;04:46:05;86147823;86111606;36217;
19.02.2019;04:47:04;86147888;86111711;36177;
19.02.2019;04:48:05;86147961;86111824;36137;
19.02.2019;04:49:05;86148023;86111947;36076;
19.02.2019;04:50:04;86148086;86112033;36053;
19.02.2019;04:51:04;86148156;86112126;36030;
19.02.2019;04:52:05;86148223;86112211;36012;
19.02.2019;04:53:04;86148296;86112297;35999;
19.02.2019;04:54:04;86148356;86112381;35975;
19.02.2019;04:55:05;86148429;86112500;35929;
19.02.2019;04:56:04;86148501;86112605;35896;
19.02.2019;04:57:04;86148557;86112715;35842;
19.02.2019;04:58:04;86148614;86112815;35799;
19.02.2019;04:59:04;86148682;86112917;35765;
19.02.2019;05:00:05;86148726;86113000;35726;
19.02.2019;05:01:05;86148798;86113080;35718;
19.02.2019;05:02:04;86148860;86113165;35695;
19.02.2019;05:03:04;86148929;86113249;35680;
19.02.2019;05:04:05;86149001;86113361;35640;
19.02.2019;05:05:04;86149085;86113491;35594;
19.02.2019;05:06:04;86149169;86113591;35578;
19.02.2019;05:07:05;86149256;86113709;35547;
19.02.2019;05:08:05;86149325;86113816;35509;
19.02.2019;05:09:05;86149391;86113912;35479;
19.02.2019;05:10:05;86149467;86114029;35438;
19.02.2019;05:11:04;86149532;86114123;35409;
19.02.2019;05:12:05;86149590;86114234;35356;
19.02.2019;05:13:05;86149646;86114360;35286;
19.02.2019;05:14:04;86149717;86114461;35256;
19.02.2019;05:15:05;86149769;86114572;35197;
19.02.2019;05:16:05;86149838;86114676;35162;
19.02.2019;05:17:05;86149913;86114772;35141;
19.02.2019;05:18:04;86149969;86114861;35108;
19.02.2019;05:19:05;86150037;86114973;35064;
19.02.2019;05:20:04;86150096;86115087;35009;
19.02.2019;05:21:04;86150145;86115212;34933;
19.02.2019;05:22:05;86150228;86115327;34901;
19.02.2019;05:23:05;86150297;86115458;34839;
19.02.2019;05:24:05;86150369;86115581;34788;
19.02.2019;05:25:04;86150445;86115685;34760;
19.02.2019;05:26:04;86150525;86115785;34740;
19.02.2019;05:27:05;86150588;86115891;34697;
19.02.2019;05:28:05;86150645;86115989;34656;
19.02.2019;05:29:05;86150704;86116106;34598;
19.02.2019;05:30:05;86150777;86116224;34553;
19.02.2019;05:31:04;86150840;86116295;34545;
19.02.2019;05:32:05;86150902;86116402;34500;
19.02.2019;05:33:05;86150946;86116507;34439;
19.02.2019;05:34:05;86151009;86116624;34385;
19.02.2019;05:35:04;86151093;86116734;34359;
19.02.2019;05:36:04;86151146;86116840;34306;
19.02.2019;05:37:05;86151205;86116939;34266;
19.02.2019;05:38:05;86151273;86117057;34216;
19.02.2019;05:39:05;86151353;86117161;34192;
19.02.2019;05:40:04;86151412;86117261;34151;
19.02.2019;05:41:04;86151460;86117370;34090;
19.02.2019;05:42:04;86151515;86117489;34026;
19.02.2019;05:43:05;86151584;86117589;33995;
19.02.2019;05:44:04;86151655;86117673;33982;
19.02.2019;05:45:04;86151716;86117765;33951;
19.02.2019;05:46:04;86151777;86117908;33869;
19.02.2019;05:47:04;86151828;86118028;33800;
19.02.2019;05:48:05;86151896;86118133;33763;
19.02.2019;05:49:04;86151961;86118225;33736;
19.02.2019;05:50:05;86152030;86118355;33675;
19.02.2019;05:51:04;86152096;86118464;33632;
19.02.2019;05:52:04;86152155;86118564;33591;
19.02.2019;05:53:05;86152208;86118671;33537;
19.02.2019;05:54:05;86152289;86118780;33509;
19.02.2019;05:55:05;86152371;86118895;33476;
19.02.2019;05:56:04;86152436;86119005;33431;
19.02.2019;05:57:05;86152493;86119115;33378;
19.02.2019;05:58:05;86152564;86119221;33343;
19.02.2019;05:59:04;86152627;86119332;33295;
19.02.2019;06:00:05;86152690;86119446;33244;
19.02.2019;06:01:04;86152739;86119575;33164;
19.02.2019;06:02:04;86152806;86119682;33124;
19.02.2019;06:03:05;86152867;86119774;33093;
19.02.2019;06:04:04;86152933;86119864;33069;
19.02.2019;06:05:04;86153002;86119968;33034;
19.02.2019;06:06:05;86153073;86120085;32988;
19.02.2019;06:07:05;86153148;86120186;32962;
19.02.2019;06:08:04;86153196;86120276;32920;
19.02.2019;06:09:04;86153239;86120384;32855;
19.02.2019;06:10:05;86153295;86120473;32822;
19.02.2019;06:11:04;86153350;86120578;32772;
19.02.2019;06:12:04;86153392;86120702;32690;
19.02.2019;06:13:05;86153430;86120768;32662;
19.02.2019;06:14:04;86153436;86120850;32586;
19.02.2019;06:15:04;86153491;86120951;32540;
19.02.2019;06:16:05;86153527;86121046;32481;
19.02.2019;06:17:05;86153572;86121151;32421;
19.02.2019;06:18:05;86153614;86121246;32368;
19.02.2019;06:19:04;86153669;86121363;32306;
19.02.2019;06:20:04;86153725;86121466;32259;
19.02.2019;06:21:04;86153767;86121581;32186;
19.02.2019;06:22:04;86153813;86121679;32134;
19.02.2019;06:23:05;86153860;86121779;32081;
19.02.2019;06:24:04;86153901;86121875;32026;
19.02.2019;06:25:07;86153940;86121977;31963;
19.02.2019;06:26:04;86153988;86122073;31915;
19.02.2019;06:27:05;86154057;86122197;31860;
19.02.2019;06:28:04;86154106;86122332;31774;
19.02.2019;06:29:04;86154159;86122434;31725;
19.02.2019;06:30:05;86154231;86122551;31680;
19.02.2019;06:31:04;86154288;86122660;31628;
19.02.2019;06:32:04;86154356;86122784;31572;
19.02.2019;06:33:05;86154416;86122907;31509;
19.02.2019;06:34:04;86154481;86123022;31459;
19.02.2019;06:35:04;86154543;86123147;31396;
19.02.2019;06:36:05;86154584;86123270;31314;
19.02.2019;06:37:04;86154643;86123385;31258;
19.02.2019;06:38:04;86154705;86123480;31225;
19.02.2019;06:39:05;86154775;86123582;31193;
19.02.2019;06:40:05;86154832;86123712;31120;
19.02.2019;06:41:04;86154883;86123838;31045;
19.02.2019;06:42:04;86154927;86123964;30963;
19.02.2019;06:43:05;86154978;86124089;30889;
19.02.2019;06:44:05;86155025;86124220;30805;
19.02.2019;06:45:04;86155073;86124349;30724;
19.02.2019;06:46:04;86155125;86124471;30654;
19.02.2019;06:47:05;86155172;86124588;30584;
19.02.2019;06:48:05;86155220;86124695;30525;
19.02.2019;06:49:04;86155257;86124770;30487;
19.02.2019;06:50:04;86155317;86124869;30448;
19.02.2019;06:51:05;86155391;86124967;30424;
19.02.2019;06:52:05;86155442;86125082;30360;
19.02.2019;06:53:04;86155508;86125194;30314;
19.02.2019;06:54:05;86155568;86125324;30244;
19.02.2019;06:55:05;86155606;86125428;30178;
19.02.2019;06:56:05;86155649;86125554;30095;
19.02.2019;06:57:04;86155704;86125662;30042;
19.02.2019;06:58:05;86155749;86125788;29961;
19.02.2019;06:59:05;86155808;86125883;29925;
19.02.2019;07:00:04;86155875;86125997;29878;
19.02.2019;07:01:04;86155938;86126110;29828;
19.02.2019;07:02:05;86155993;86126222;29771;
19.02.2019;07:03:05;86156060;86126329;29731;
19.02.2019;07:04:05;86156104;86126455;29649;
19.02.2019;07:05:05;86156164;86126573;29591;
19.02.2019;07:06:05;86156222;86126677;29545;
19.02.2019;07:07:04;86156281;86126806;29475;
19.02.2019;07:08:04;86156335;86126934;29401;
19.02.2019;07:09:04;86156380;86127065;29315;
19.02.2019;07:10:04;86156434;86127190;29244;
19.02.2019;07:11:05;86156488;86127319;29169;
19.02.2019;07:12:05;86156537;86127431;29106;
19.02.2019;07:13:05;86156582;86127554;29028;
19.02.2019;07:14:05;86156647;86127656;28991;
19.02.2019;07:15:04;86156722;86127764;28958;
19.02.2019;07:16:04;86156780;86127883;28897;
19.02.2019;07:17:05;86156848;86127997;28851;
19.02.2019;07:18:04;86156885;86128102;28783;
19.02.2019;07:19:05;86156950;86128219;28731;
19.02.2019;07:20:05;86156999;86128343;28656;
19.02.2019;07:21:05;86157054;86128447;28607;
19.02.2019;07:22:05;86157109;86128552;28557;
19.02.2019;07:23:05;86157166;86128676;28490;
19.02.2019;07:24:05;86157232;86128795;28437;
19.02.2019;07:25:04;86157306;86128896;28410;
19.02.2019;07:26:05;86157363;86129014;28349;
19.02.2019;07:27:05;86157412;86129132;28280;
19.02.2019;07:28:04;86157496;86129257;28239;
19.02.2019;07:29:04;86157550;86129413;28137;
19.02.2019;07:30:05;86157614;86129526;28088;
19.02.2019;07:31:10;86157665;86129645;28020;
19.02.2019;07:32:04;86157706;86129758;27948;
19.02.2019;07:33:04;86157754;86129882;27872;
19.02.2019;07:34:04;86157809;86130005;27804;
19.02.2019;07:35:04;86157869;86130126;27743;
19.02.2019;07:36:05;86157930;86130235;27695;
19.02.2019;07:37:04;86157977;86130329;27648;
19.02.2019;07:38:04;86158030;86130437;27593;
19.02.2019;07:39:05;86158090;86130552;27538;
19.02.2019;07:40:05;86158145;86130652;27493;
19.02.2019;07:41:04;86158204;86130772;27432;
19.02.2019;07:42:05;86158259;86130901;27358;
19.02.2019;07:43:05;86158299;86131004;27295;
19.02.2019;07:44:05;86158363;86131127;27236;
19.02.2019;07:45:05;86158407;86131274;27133;
19.02.2019;07:46:05;86158469;86131381;27088;
19.02.2019;07:47:05;86158510;86131499;27011;
19.02.2019;07:48:05;86158578;86131611;26967;
19.02.2019;07:49:05;86158636;86131727;26909;
19.02.2019;07:50:04;86158690;86131828;26862;
19.02.2019;07:51:04;86158737;86131939;26798;
19.02.2019;07:52:05;86158780;86132057;26723;
19.02.2019;07:53:04;86158836;86132176;26660;
19.02.2019;07:54:04;86158908;86132285;26623;
19.02.2019;07:55:05;86158988;86132410;26578;
19.02.2019;07:56:05;86159057;86132537;26520;
19.02.2019;07:57:04;86159115;86132659;26456;
19.02.2019;07:58:05;86159168;86132763;26405;
19.02.2019;07:59:04;86159229;86132878;26351;
19.02.2019;08:00:04;86159277;86132974;26303;
19.02.2019;08:01:05;86159341;86133100;26241;
19.02.2019;08:02:05;86159395;86133219;26176;
19.02.2019;08:03:04;86159456;86133356;26100;
19.02.2019;08:04:04;86159500;86133450;26050;
19.02.2019;08:05:05;86159557;86133578;25979;
19.02.2019;08:06:05;86159589;86133677;25912;
19.02.2019;08:07:04;86159615;86133757;25858;
19.02.2019;08:08:04;86159658;86133859;25799;
19.02.2019;08:09:06;86159712;86133952;25760;
19.02.2019;08:10:04;86159762;86134025;25737;
19.02.2019;08:11:04;86159808;86134131;25677;
19.02.2019;08:12:05;86159844;86134179;25665;
19.02.2019;08:13:04;86159898;86134365;25533;
19.02.2019;08:14:04;86159933;86134463;25470;
19.02.2019;08:15:04;86159956;86134566;25390;
19.02.2019;08:16:05;86159997;86134653;25344;
19.02.2019;08:17:05;86160031;86134753;25278;
19.02.2019;08:18:05;86160051;86134839;25212;
19.02.2019;08:19:05;86160085;86134936;25149;
19.02.2019;08:20:04;86160110;86135048;25062;
19.02.2019;08:21:05;86160161;86135161;25000;
19.02.2019;08:22:04;86160200;86135259;24941;
19.02.2019;08:23:05;86160242;86135385;24857;
19.02.2019;08:24:05;86160267;86135513;24754;
19.02.2019;08:25:04;86160312;86135633;24679;
19.02.2019;08:26:04;86160363;86135735;24628;
19.02.2019;08:27:05;86160412;86135846;24566;
19.02.2019;08:28:05;86160462;86135969;24493;
19.02.2019;08:29:05;86160513;86136062;24451;
19.02.2019;08:30:05;86160575;86136165;24410;
19.02.2019;08:31:05;86160618;86136261;24357;
19.02.2019;08:32:04;86160660;86136379;24281;
19.02.2019;08:33:05;86160723;86136497;24226;
19.02.2019;08:34:05;86160774;86136643;24131;
19.02.2019;08:35:04;86160834;86136766;24068;
19.02.2019;08:36:04;86160881;86136903;23978;
19.02.2019;08:37:04;86160951;86137038;23913;
19.02.2019;08:38:05;86161019;86137131;23888;
19.02.2019;08:39:05;86161074;86137222;23852;
19.02.2019;08:40:05;86161124;86137356;23768;
19.02.2019;08:41:05;86161184;86137463;23721;
19.02.2019;08:42:05;86161236;86137560;23676;
19.02.2019;08:43:04;86161288;86137671;23617;
19.02.2019;08:44:04;86161339;86137793;23546;
19.02.2019;08:45:05;86161399;86137905;23494;
19.02.2019;08:46:05;86161449;86138035;23414;
19.02.2019;08:47:05;86161506;86138135;23371;
19.02.2019;08:48:05;86161550;86138254;23296;
19.02.2019;08:49:05;86161618;86138374;23244;
19.02.2019;08:50:05;86161670;86138493;23177;
19.02.2019;08:51:05;86161718;86138611;23107;
19.02.2019;08:52:04;86161788;86138740;23048;
19.02.2019;08:53:04;86161854;86138859;22995;
19.02.2019;08:54:05;86161925;86138968;22957;
19.02.2019;08:55:05;86161969;86139070;22899;
19.02.2019;08:56:05;86162016;86139171;22845;
19.02.2019;08:57:04;86162073;86139294;22779;
19.02.2019;08:58:05;86162141;86139415;22726;
19.02.2019;08:59:05;86162189;86139552;22637;
19.02.2019;09:00:04;86162254;86139701;22553;
19.02.2019;09:01:05;86162310;86139828;22482;
19.02.2019;09:02:05;86162364;86139929;22435;
19.02.2019;09:03:05;86162416;86140066;22350;
19.02.2019;09:04:05;86162476;86140192;22284;
19.02.2019;09:05:05;86162526;86140298;22228;
19.02.2019;09:06:05;86162580;86140447;22133;
19.02.2019;09:07:04;86162644;86140552;22092;
19.02.2019;09:08:04;86162706;86140682;22024;
19.02.2019;09:09:05;86162768;86140778;21990;
19.02.2019;09:10:05;86162829;86140891;21938;
19.02.2019;09:11:04;86162882;86141014;21868;
19.02.2019;09:12:05;86162936;86141139;21797;
19.02.2019;09:13:05;86162991;86141265;21726;
19.02.2019;09:14:04;86163046;86141407;21639;
19.02.2019;09:15:05;86163111;86141541;21570;
19.02.2019;09:16:05;86163170;86141663;21507;
19.02.2019;09:17:06;86163229;86141797;21432;
19.02.2019;09:18:05;86163281;86141904;21377;
19.02.2019;09:19:05;86163353;86142011;21342;
19.02.2019;09:20:05;86163395;86142148;21247;
19.02.2019;09:21:10;86163449;86142271;21178;
19.02.2019;09:22:05;86163507;86142376;21131;
19.02.2019;09:23:05;86163564;86142481;21083;
19.02.2019;09:24:04;86163602;86142593;21009;
19.02.2019;09:25:05;86163652;86142728;20924;
19.02.2019;09:26:05;86163706;86142846;20860;
19.02.2019;09:27:10;86163778;86142995;20783;
19.02.2019;09:28:06;86163822;86143121;20701;
19.02.2019;09:29:05;86163866;86143234;20632;
19.02.2019;09:30:04;86163916;86143360;20556;
19.02.2019;09:31:04;86163962;86143473;20489;
19.02.2019;09:32:04;86164027;86143565;20462;
19.02.2019;09:33:05;86164102;86143662;20440;
19.02.2019;09:34:05;86164159;86143777;20382;
19.02.2019;09:35:05;86164200;86143909;20291;
19.02.2019;09:36:05;86164257;86144022;20235;
19.02.2019;09:37:04;86164312;86144144;20168;
19.02.2019;09:38:07;86164391;86144270;20121;
19.02.2019;09:39:05;86164448;86144368;20080;
19.02.2019;09:40:05;86164516;86144489;20027;
19.02.2019;09:41:04;86164571;86144601;19970;
19.02.2019;09:42:05;86164631;86144724;19907;
19.02.2019;09:43:05;86164683;86144854;19829;
19.02.2019;09:44:05;86164727;86144979;19748;
19.02.2019;09:45:04;86164769;86145052;19717;
19.02.2019;09:46:04;86164785;86145070;19715;
19.02.2019;09:47:05;86164843;86145165;19678;
19.02.2019;09:48:04;86164903;86145272;19631;
19.02.2019;09:49:05;86164963;86145393;19570;
19.02.2019;09:50:05;86165027;86145511;19516;
19.02.2019;09:51:05;86165095;86145645;19450;
19.02.2019;09:52:05;86165169;86145771;19398;
19.02.2019;09:53:05;86165230;86145902;19328;
19.02.2019;09:54:05;86165288;86146022;19266;
19.02.2019;09:55:05;86165342;86146115;19227;
19.02.2019;09:56:05;86165394;86146240;19154;
19.02.2019;09:57:05;86165455;86146358;19097;
19.02.2019;09:58:05;86165509;86146482;19027;
19.02.2019;09:59:05;86165567;86146610;18957;
19.02.2019;10:00:05;86165634;86146753;18881;
19.02.2019;10:01:04;86165709;86146868;18841;
19.02.2019;10:02:04;86165771;86146994;18777;
19.02.2019;10:03:05;86165834;86147125;18709;
19.02.2019;10:04:05;86165874;86147254;18620;
19.02.2019;10:05:05;86165935;86147368;18567;
19.02.2019;10:06:04;86165994;86147494;18500;
19.02.2019;10:07:04;86166051;86147626;18425;
19.02.2019;10:08:05;86166098;86147750;18348;
19.02.2019;10:09:07;86166168;86147882;18286;
19.02.2019;10:10:05;86166229;86147985;18244;
19.02.2019;10:11:05;86166272;86148102;18170;
19.02.2019;10:12:07;86166316;86148210;18106;
19.02.2019;10:13:04;86166354;86148331;18023;
19.02.2019;10:14:05;86166416;86148462;17954;
19.02.2019;10:15:05;86166451;86148568;17883;
19.02.2019;10:16:04;86166492;86148683;17809;
19.02.2019;10:17:05;86166547;86148761;17786;
19.02.2019;10:18:05;86166561;86148897;17664;
19.02.2019;10:19:05;86166604;86148985;17619;
19.02.2019;10:20:05;86166683;86149092;17591;
19.02.2019;10:21:04;86166722;86149198;17524;
19.02.2019;10:22:04;86166792;86149307;17485;
19.02.2019;10:23:05;86166861;86149425;17436;
19.02.2019;10:24:05;86166919;86149541;17378;
19.02.2019;10:25:05;86166960;86149632;17328;
19.02.2019;10:26:04;86167024;86149767;17257;
19.02.2019;10:27:04;86167094;86149899;17195;
19.02.2019;10:28:05;86167159;86150024;17135;
19.02.2019;10:29:05;86167227;86150161;17066;
19.02.2019;10:30:05;86167298;86150295;17003;
19.02.2019;10:31:04;86167375;86150417;16958;
19.02.2019;10:32:04;86167449;86150531;16918;
19.02.2019;10:33:05;86167518;86150635;16883;
19.02.2019;10:34:05;86167589;86150767;16822;
19.02.2019;10:35:05;86167665;86150878;16787;
19.02.2019;10:36:05;86167748;86151024;16724;
19.02.2019;10:37:04;86167797;86151138;16659;
19.02.2019;10:38:05;86167873;86151265;16608;
19.02.2019;10:39:04;86167939;86151348;16591;
19.02.2019;10:40:05;86167998;86151471;16527;
19.02.2019;10:41:05;86168049;86151608;16441;
19.02.2019;10:42:04;86168113;86151723;16390;
19.02.2019;10:43:05;86168176;86151824;16352;
19.02.2019;10:44:04;86168259;86151950;16309;
19.02.2019;10:45:04;86168333;86152081;16252;
19.02.2019;10:46:06;86168412;86152200;16212;
19.02.2019;10:47:04;86168472;86152332;16140;
19.02.2019;10:48:04;86168546;86152438;16108;
19.02.2019;10:49:04;86168595;86152551;16044;
19.02.2019;10:50:05;86168653;86152691;15962;
19.02.2019;10:51:05;86168727;86152810;15917;
19.02.2019;10:52:05;86168799;86152966;15833;
19.02.2019;10:53:05;86168859;86153098;15761;
19.02.2019;10:54:04;86168932;86153224;15708;
19.02.2019;10:55:05;86169003;86153340;15663;
19.02.2019;10:56:04;86169097;86153448;15649;
19.02.2019;10:57:05;86169163;86153556;15607;
19.02.2019;10:58:05;86169223;86153696;15527;
19.02.2019;10:59:05;86169300;86153818;15482;
19.02.2019;11:00:04;86169343;86153955;15388;
19.02.2019;11:01:04;86169416;86154077;15339;
19.02.2019;11:02:05;86169488;86154203;15285;
19.02.2019;11:03:05;86169562;86154364;15198;
19.02.2019;11:04:04;86169635;86154520;15115;
19.02.2019;11:05:04;86169702;86154656;15046;
19.02.2019;11:06:05;86169757;86154768;14989;
19.02.2019;11:07:05;86169832;86154907;14925;
19.02.2019;11:08:05;86169907;86155040;14867;
19.02.2019;11:09:05;86169967;86155178;14789;
19.02.2019;11:10:04;86170040;86155335;14705;
19.02.2019;11:11:04;86170097;86155473;14624;
19.02.2019;11:12:04;86170174;86155591;14583;
19.02.2019;11:13:05;86170244;86155762;14482;
19.02.2019;11:14:05;86170310;86155887;14423;
19.02.2019;11:15:05;86170364;86156018;14346;
19.02.2019;11:16:05;86170435;86156162;14273;
19.02.2019;11:17:05;86170518;86156267;14251;
19.02.2019;11:18:05;86170563;86156399;14164;
19.02.2019;11:19:05;86170652;86156532;14120;
19.02.2019;11:20:05;86170729;86156671;14058;
19.02.2019;11:21:05;86170801;86156794;14007;
19.02.2019;11:22:05;86170859;86156981;13878;
19.02.2019;11:23:05;86170939;86157116;13823;
19.02.2019;11:24:04;86171014;86157298;13716;
19.02.2019;11:25:05;86171097;86157436;13661;
19.02.2019;11:26:05;86171162;86157568;13594;
19.02.2019;11:27:04;86171236;86157725;13511;
19.02.2019;11:28:04;86171308;86157880;13428;
19.02.2019;11:29:04;86171368;86157996;13372;
19.02.2019;11:30:05;86171447;86158129;13318;
19.02.2019;11:31:04;86171500;86158268;13232;
19.02.2019;11:32:04;86171561;86158398;13163;
19.02.2019;11:33:05;86171615;86158577;13038;
19.02.2019;11:34:05;86171702;86158739;12963;
19.02.2019;11:35:04;86171781;86158880;12901;
19.02.2019;11:36:04;86171850;86159021;12829;
19.02.2019;11:37:05;86171931;86159181;12750;
19.02.2019;11:38:05;86172013;86159310;12703;
19.02.2019;11:39:05;86172092;86159635;12457;
19.02.2019;11:40:05;86172160;86159927;12233;
19.02.2019;11:41:05;86172243;86160119;12124;
19.02.2019;11:42:05;86172359;86160320;12039;
19.02.2019;11:43:04;86172435;86160510;11925;
19.02.2019;11:44:04;86172518;86160824;11694;
19.02.2019;11:45:05;86172609;86161058;11551;
19.02.2019;11:46:04;86172700;86161281;11419;
19.02.2019;11:47:04;86172788;86161487;11301;
19.02.2019;11:48:05;86172885;86161655;11230;
19.02.2019;11:49:04;86172978;86161835;11143;
19.02.2019;11:50:04;86173084;86161987;11097;
19.02.2019;11:51:05;86173166;86162150;11016;
19.02.2019;11:52:04;86173252;86162321;10931;
19.02.2019;11:53:05;86173356;86162496;10860;
19.02.2019;11:54:04;86173430;86162659;10771;
19.02.2019;11:55:04;86173510;86162814;10696;
19.02.2019;11:56:05;86173597;86162988;10609;
19.02.2019;11:57:04;86173706;86163132;10574;
19.02.2019;11:58:04;86173807;86163304;10503;
19.02.2019;11:59:05;86173882;86163455;10427;
19.02.2019;12:00:05;86173980;86163583;10397;
19.02.2019;12:01:04;86174048;86163745;10303;
19.02.2019;12:02:04;86174142;86163867;10275;
19.02.2019;12:03:05;86174194;86163996;10198;
19.02.2019;12:04:04;86174221;86164041;10180;
19.02.2019;12:05:04;86174248;86164169;10079;
19.02.2019;12:06:05;86174244;86164252;9992;
19.02.2019;12:07:04;86174291;86164330;9961;
19.02.2019;12:08:05;86174372;86164446;9926;
19.02.2019;12:09:05;86174480;86164556;9924;
19.02.2019;12:10:05;86174567;86164724;9843;
19.02.2019;12:11:04;86174667;86164917;9750;
19.02.2019;12:12:04;86174776;86165077;9699;
19.02.2019;12:13:05;86174901;86165228;9673;
19.02.2019;12:14:04;86175012;86165408;9604;
19.02.2019;12:15:04;86175126;86165574;9552;
19.02.2019;12:16:05;86175231;86165729;9502;
19.02.2019;12:17:05;86175336;86165849;9487;
19.02.2019;12:18:04;86175454;86166013;9441;
19.02.2019;12:19:04;86175572;86166142;9430;
19.02.2019;12:20:04;86175711;86166322;9389;
19.02.2019;12:21:05;86175825;86166472;9353;
19.02.2019;12:22:05;86175940;86166644;9296;
19.02.2019;12:23:04;86176059;86166788;9271;
19.02.2019;12:24:04;86176173;86166956;9217;
19.02.2019;12:25:05;86176304;86167124;9180;
19.02.2019;12:26:04;86176422;86167287;9135;
19.02.2019;12:27:04;86176548;86167451;9097;
19.02.2019;12:28:10;86176679;86167615;9064;
19.02.2019;12:29:04;86176797;86167770;9027;
19.02.2019;12:30:04;86176923;86167933;8990;
19.02.2019;12:31:05;86177034;86168116;8918;
19.02.2019;12:32:05;86177168;86168267;8901;
19.02.2019;12:33:04;86177325;86168450;8875;
19.02.2019;12:34:04;86177458;86168630;8828;
19.02.2019;12:35:04;86177582;86168786;8796;
19.02.2019;12:36:05;86177729;86168941;8788;
19.02.2019;12:37:04;86177855;86169088;8767;
19.02.2019;12:38:04;86177996;86169256;8740;
19.02.2019;12:39:05;86178167;86169421;8746;
19.02.2019;12:40:05;86178300;86169608;8692;
19.02.2019;12:41:04;86178440;86169743;8697;
19.02.2019;12:42:04;86178573;86169893;8680;
19.02.2019;12:43:05;86178724;86170055;8669;
19.02.2019;12:44:04;86178865;86170216;8649;
19.02.2019;12:45:04;86179016;86170384;8632;
19.02.2019;12:46:10;86179170;86170563;8607;
19.02.2019;12:47:04;86179289;86170674;8615;
19.02.2019;12:48:04;86179445;86170834;8611;
19.02.2019;12:49:05;86179593;86171004;8589;
19.02.2019;12:50:04;86179732;86171156;8576;
19.02.2019;12:51:04;86179878;86171313;8565;
19.02.2019;12:52:04;86179749;86170904;8845;
19.02.2019;12:53:05;86179640;86170532;9108;
19.02.2019;12:54:04;86179765;86170670;9095;
19.02.2019;12:55:04;86179902;86170820;9082;
19.02.2019;12:56:05;86180045;86170963;9082;
19.02.2019;12:57:04;86180198;86171112;9086;
19.02.2019;12:58:04;86180362;86171284;9078;
19.02.2019;12:59:05;86180522;86171450;9072;
19.02.2019;13:00:05;86180670;86171619;9051;
19.02.2019;13:01:04;86180825;86171748;9077;
19.02.2019;13:02:05;86180974;86171886;9088;
19.02.2019;13:03:05;86181134;86172044;9090;
19.02.2019;13:04:04;86181309;86172201;9108;
19.02.2019;13:05:04;86181475;86172362;9113;
19.02.2019;13:06:04;86181622;86172527;9095;
19.02.2019;13:07:05;86181762;86172687;9075;
19.02.2019;13:08:05;86181942;86172834;9108;
19.02.2019;13:09:05;86182104;86172985;9119;
19.02.2019;13:10:04;86182260;86173119;9141;
19.02.2019;13:11:04;86182418;86173264;9154;
19.02.2019;13:12:05;86182582;86173420;9162;
19.02.2019;13:13:04;86182734;86173571;9163;
19.02.2019;13:14:04;86182893;86173720;9173;
19.02.2019;13:15:05;86183043;86173889;9154;
19.02.2019;13:16:04;86183219;86174049;9170;
19.02.2019;13:17:04;86183350;86174211;9139;
19.02.2019;13:18:05;86183498;86174368;9130;
19.02.2019;13:19:05;86183639;86174506;9133;
19.02.2019;13:20:05;86183812;86174640;9172;
19.02.2019;13:21:04;86183973;86174782;9191;
19.02.2019;13:22:05;86184134;86174944;9190;
19.02.2019;13:23:04;86184304;86175095;9209;
19.02.2019;13:24:10;86184479;86175264;9215;
19.02.2019;13:25:05;86184616;86175433;9183;
19.02.2019;13:26:05;86184780;86175587;9193;
19.02.2019;13:27:05;86184923;86175767;9156;
19.02.2019;13:28:04;86185089;86175929;9160;
19.02.2019;13:29:05;86185242;86176081;9161;
19.02.2019;13:30:05;86185392;86176216;9176;
19.02.2019;13:31:04;86185569;86176364;9205;
19.02.2019;13:32:04;86185690;86176520;9170;
19.02.2019;13:33:05;86185828;86176673;9155;
19.02.2019;13:34:04;86185959;86176789;9170;
19.02.2019;13:35:04;86186126;86176867;9259;
19.02.2019;13:36:05;86186262;86176967;9295;
19.02.2019;13:37:05;86186419;86177101;9318;
19.02.2019;13:38:04;86186556;86177217;9339;
19.02.2019;13:39:05;86186718;86177331;9387;
19.02.2019;13:40:04;86186897;86177480;9417;
19.02.2019;13:41:05;86187076;86177638;9438;
19.02.2019;13:42:05;86187253;86177792;9461;
19.02.2019;13:43:04;86187388;86177873;9515;
19.02.2019;13:44:05;86187548;86178002;9546;
19.02.2019;13:45:05;86187690;86178157;9533;
19.02.2019;13:46:05;86187842;86178322;9520;
19.02.2019;13:47:05;86187996;86178469;9527;
19.02.2019;13:48:05;86188114;86178586;9528;
19.02.2019;13:49:04;86188267;86178732;9535;
19.02.2019;13:50:05;86188409;86178873;9536;
19.02.2019;13:51:05;86188580;86179019;9561;
19.02.2019;13:52:05;86188732;86179151;9581;
19.02.2019;13:53:05;86188887;86179318;9569;
19.02.2019;13:54:05;86189043;86179481;9562;
19.02.2019;13:55:05;86189227;86179595;9632;
19.02.2019;13:56:05;86189385;86179771;9614;
19.02.2019;13:57:05;86189547;86179924;9623;
19.02.2019;13:58:05;86189701;86180087;9614;
19.02.2019;13:59:05;86189859;86180239;9620;
19.02.2019;14:11:54;86191418;86181705;9713;
19.02.2019;14:12:10;86191442;86181730;9712;
19.02.2019;14:12:15;86191454;86181752;9702;
19.02.2019;14:13:24;86191586;86181870;9716;
19.02.2019;14:14:12;86191642;86181950;9692;
19.02.2019;14:15:12;86191752;86182021;9731;
19.02.2019;14:16:20;86191911;86182169;9742;
19.02.2019;14:17:20;86192031;86182300;9731;
19.02.2019;14:18:26;86192196;86182438;9758;
19.02.2019;14:19:20;86192305;86182531;9774;
19.02.2019;14:20:08;86192454;86182621;9833;
19.02.2019;14:21:08;86192564;86182751;9813;
19.02.2019;14:23:10;86192806;86183026;9780;
19.02.2019;14:24:08;86192988;86183152;9836;
19.02.2019;14:25:11;86193168;86183278;9890;
19.02.2019;14:26:05;86193344;86183403;9941;
19.02.2019;14:27:05;86193512;86183567;9945;
19.02.2019;14:28:04;86193682;86183676;10006;
19.02.2019;14:29:04;86193842;86183795;10047;
19.02.2019;14:31:05;86194157;86184070;10087;
19.02.2019;14:32:04;86194334;86184185;10149;
19.02.2019;14:33:05;86194479;86184337;10142;
19.02.2019;14:34:06;86194640;86184419;10221;
19.02.2019;15:38:02;86204050;86193807;10243;
19.02.2019;15:38:25;86204123;86193869;10254;
19.02.2019;17:18:29;86221333;86212687;8646;
19.02.2019;18:15:02;86233804;86223760;10044;
19.02.2019;18:16:06;86233983;86223917;10066;
19.02.2019;18:17:17;86234157;86224097;10060;
19.02.2019;18:18:02;86234327;86224221;10106;
19.02.2019;18:19:02;86234499;86224355;10144;
19.02.2019;18:20:02;86234666;86224519;10147;
19.02.2019;18:21:02;86234850;86224686;10164;
19.02.2019;18:22:02;86234956;86224803;10153;
19.02.2019;18:23:02;86235062;86224905;10157;
19.02.2019;18:24:02;86235199;86225003;10196;
19.02.2019;18:25:02;86235341;86225140;10201;
19.02.2019;18:26:07;86235448;86225295;10153;
19.02.2019;18:27:02;86235558;86225382;10176;
19.02.2019;18:28:02;86235730;86225521;10209;
19.02.2019;18:29:02;86235858;86225633;10225;
19.02.2019;18:30:02;86235970;86225753;10217;
19.02.2019;18:31:02;86236096;86225862;10234;
19.02.2019;18:32:02;86236252;86226019;10233;
19.02.2019;18:33:01;86236396;86226183;10213;
19.02.2019;18:34:02;86236557;86226313;10244;
19.02.2019;18:35:02;86236696;86226461;10235;
19.02.2019;18:36:02;86236835;86226600;10235;
19.02.2019;18:38:02;86237154;86226880;10274;
19.02.2019;18:39:02;86237333;86227001;10332;
19.02.2019;18:40:02;86237452;86227098;10354;
19.02.2019;18:41:01;86237575;86227238;10337;
19.02.2019;18:42:02;86237642;86227274;10368;
19.02.2019;18:43:02;86237790;86227390;10400;
19.02.2019;18:44:02;86237930;86227514;10416;
19.02.2019;18:45:02;86238089;86227641;10448;
19.02.2019;18:46:01;86238265;86227786;10479;
19.02.2019;18:47:02;86238434;86227933;10501;
19.02.2019;18:48:02;86238588;86228046;10542;
19.02.2019;18:49:02;86238753;86228182;10571;
19.02.2019;18:50:02;86238927;86228284;10643;
19.02.2019;18:51:01;86239106;86228405;10701;
19.02.2019;18:52:02;86239293;86228524;10769;
19.02.2019;18:53:07;86239492;86228645;10847;
19.02.2019;18:54:02;86239654;86228749;10905;
19.02.2019;18:55:02;86239805;86228893;10912;
19.02.2019;18:56:02;86239952;86229024;10928;
19.02.2019;18:57:01;86240130;86229148;10982;
19.02.2019;18:58:02;86240304;86229272;11032;
19.02.2019;18:59:02;86240473;86229374;11099;
19.02.2019;19:00:02;86240624;86229498;11126;
19.02.2019;19:01:02;86240807;86229630;11177;
19.02.2019;19:02:02;86240974;86229773;11201;
19.02.2019;19:03:02;86241160;86229927;11233;
19.02.2019;19:04:02;86241362;86230016;11346;
19.02.2019;19:05:01;86241552;86230112;11440;
19.02.2019;19:06:02;86241754;86230256;11498;
19.02.2019;19:07:02;86241897;86230382;11515;
19.02.2019;19:08:02;86242051;86230504;11547;
19.02.2019;19:09:01;86242189;86230635;11554;
19.02.2019;19:10:02;86242292;86230763;11529;
19.02.2019;20:03:02;86250925;86235648;15277;
19.02.2019;20:04:02;86251123;86235726;15397;
19.02.2019;20:05:02;86251306;86235802;15504;
19.02.2019;20:06:02;86251459;86235860;15599;
19.02.2019;20:07:02;86251587;86235893;15694;
19.02.2019;20:08:01;86251525;86235823;15702;
19.02.2019;20:09:02;86251384;86235705;15679;
19.02.2019;20:10:02;86251329;86235652;15677;
19.02.2019;20:11:03;86251401;86235680;15721;
19.02.2019;20:12:02;86251495;86235716;15779;
19.02.2019;20:13:02;86251619;86235791;15828;
19.02.2019;20:14:02;86251721;86235816;15905;
19.02.2019;20:15:02;86251802;86235823;15979;
19.02.2019;20:16:02;86251910;86235847;16063;
19.02.2019;20:18:02;86252179;86235970;16209;
19.02.2019;20:19:02;86252320;86236019;16301;
19.02.2019;20:20:02;86252435;86236063;16372;
19.02.2019;20:23:02;86252799;86236230;16569;
19.02.2019;20:24:02;86252946;86236274;16672;
19.02.2019;20:25:02;86253063;86236321;16742;
19.02.2019;20:26:02;86253211;86236359;16852;
19.02.2019;20:27:02;86253346;86236407;16939;
19.02.2019;20:28:02;86253509;86236467;17042;
19.02.2019;20:29:02;86253627;86236535;17092;
19.02.2019;20:30:02;86253667;86236588;17079;
19.02.2019;20:31:02;86253779;86236647;17132;
19.02.2019;20:32:02;86253889;86236710;17179;
19.02.2019;20:33:03;86253992;86236787;17205;
19.02.2019;20:34:02;86254096;86236831;17265;
19.02.2019;20:35:02;86254208;86236883;17325;
19.02.2019;20:36:02;86254307;86236958;17349;
19.02.2019;20:37:02;86254424;86237039;17385;
19.02.2019;20:38:02;86254540;86237070;17470;
19.02.2019;20:39:01;86254679;86237124;17555;
19.02.2019;20:40:02;86254779;86237183;17596;
19.02.2019;20:41:02;86254894;86237241;17653;
19.02.2019;20:42:02;86255003;86237297;17706;
19.02.2019;20:43:02;86255117;86237356;17761;
19.02.2019;20:44:02;86255207;86237411;17796;
19.02.2019;20:45:02;86255314;86237461;17853;
19.02.2019;20:46:02;86255431;86237515;17916;
19.02.2019;20:47:01;86255569;86237576;17993;
19.02.2019;20:48:03;86255684;86237629;18055;
19.02.2019;20:49:02;86255804;86237669;18135;
19.02.2019;20:50:02;86255905;86237720;18185;
19.02.2019;20:51:02;86256034;86237768;18266;
19.02.2019;20:52:02;86256165;86237836;18329;
19.02.2019;20:53:02;86256304;86237863;18441;
19.02.2019;20:54:02;86256441;86237923;18518;
19.02.2019;20:55:02;86256556;86237973;18583;
19.02.2019;20:56:03;86256702;86238023;18679;
19.02.2019;20:57:01;86256838;86238079;18759;
19.02.2019;20:58:03;86256946;86238107;18839;
19.02.2019;20:59:02;86257061;86238166;18895;
19.02.2019;21:00:02;86257209;86238211;18998;
19.02.2019;21:01:02;86257352;86238270;19082;
19.02.2019;21:02:02;86257485;86238329;19156;
19.02.2019;21:03:02;86257597;86238370;19227;
19.02.2019;21:04:02;86257720;86238412;19308;
19.02.2019;21:05:02;86257847;86238472;19375;
19.02.2019;21:06:02;86257968;86238522;19446;
19.02.2019;21:07:02;86258092;86238554;19538;
19.02.2019;21:08:02;86258216;86238625;19591;
19.02.2019;21:09:02;86258368;86238674;19694;
19.02.2019;21:10:02;86258509;86238709;19800;
19.02.2019;21:11:02;86258640;86238760;19880;
19.02.2019;21:12:02;86258753;86238811;19942;
19.02.2019;21:13:02;86258852;86238851;20001;
19.02.2019;21:14:01;86258999;86238900;20099;
19.02.2019;21:15:02;86259128;86238949;20179;
19.02.2019;21:16:02;86259258;86238988;20270;
19.02.2019;21:17:02;86259376;86239023;20353;
19.02.2019;21:18:02;86259517;86239079;20438;
19.02.2019;21:19:02;86259635;86239121;20514;
19.02.2019;21:20:02;86259761;86239169;20592;
19.02.2019;21:21:03;86259899;86239210;20689;
19.02.2019;21:22:02;86260031;86239258;20773;
19.02.2019;21:23:01;86260170;86239294;20876;
19.02.2019;21:24:02;86260296;86239325;20971;
19.02.2019;21:25:02;86260441;86239376;21065;
19.02.2019;21:26:03;86260572;86239422;21150;
19.02.2019;21:27:02;86260721;86239462;21259;
19.02.2019;21:28:02;86260850;86239486;21364;
19.02.2019;21:29:02;86260979;86239527;21452;
19.02.2019;21:30:02;86261125;86239559;21566;
19.02.2019;21:31:02;86261269;86239605;21664;
19.02.2019;21:32:01;86261429;86239639;21790;
19.02.2019;21:33:02;86261567;86239679;21888;
19.02.2019;21:34:02;86261700;86239714;21986;
19.02.2019;21:35:02;86261834;86239758;22076;
19.02.2019;21:36:02;86261912;86239796;22116;
19.02.2019;21:37:02;86262115;86239837;22278;
19.02.2019;21:38:02;86262232;86239881;22351;
19.02.2019;21:39:02;86262368;86239936;22432;
19.02.2019;21:40:02;86262489;86239967;22522;
19.02.2019;21:41:01;86262599;86240011;22588;
19.02.2019;21:42:02;86262716;86240052;22664;
19.02.2019;21:43:03;86264271;86247575;16696;
19.02.2019;21:44:02;86264378;86247599;16779;
19.02.2019;21:45:02;86264510;86247624;16886;
19.02.2019;21:46:02;86264641;86247654;16987;
19.02.2019;21:47:02;86264800;86247707;17093;
19.02.2019;21:48:01;86264877;86247664;17213;
19.02.2019;21:49:02;86265018;86247692;17326;
19.02.2019;21:50:07;86265173;86247734;17439;
19.02.2019;21:51:02;86265299;86247776;17523;
19.02.2019;21:52:02;86265445;86247834;17611;
19.02.2019;21:53:02;86265578;86247863;17715;
19.02.2019;21:54:02;86265724;86247899;17825;
19.02.2019;21:55:02;86265863;86247941;17922;
19.02.2019;21:56:02;86266006;86247999;18007;
19.02.2019;21:57:02;86266152;86248043;18109;
19.02.2019;21:58:02;86266268;86248070;18198;
19.02.2019;21:59:01;86266412;86248091;18321;
19.02.2019;22:00:02;86266568;86248121;18447;
19.02.2019;22:01:02;86266705;86248159;18546;
19.02.2019;22:02:02;86266814;86248194;18620;
19.02.2019;22:03:02;86266927;86248248;18679;
19.02.2019;22:04:02;86267054;86248278;18776;
19.02.2019;22:05:02;86267164;86248317;18847;
19.02.2019;22:06:02;86267304;86248343;18961;
19.02.2019;22:07:02;86267280;86248344;18936;
19.02.2019;22:08:02;86267219;86248331;18888;
19.02.2019;22:09:02;86267295;86248338;18957;
19.02.2019;22:10:02;86267347;86248366;18981;
19.02.2019;22:11:02;86267335;86248367;18968;
19.02.2019;22:12:01;86267365;86248364;19001;
19.02.2019;22:13:02;86267413;86248372;19041;
19.02.2019;22:14:02;86267513;86248390;19123;
19.02.2019;22:15:02;86267627;86248428;19199;
19.02.2019;22:16:02;86267732;86248442;19290;
19.02.2019;22:17:02;86267823;86248465;19358;
19.02.2019;22:18:02;86267930;86248498;19432;
19.02.2019;22:19:01;86268036;86248529;19507;
19.02.2019;22:20:02;86268157;86248564;19593;
19.02.2019;22:21:02;86268248;86248589;19659;
19.02.2019;22:22:02;86268340;86248612;19728;
19.02.2019;22:23:02;86268428;86248626;19802;
19.02.2019;22:24:02;86268546;86248635;19911;
19.02.2019;22:25:02;86268678;86248668;20010;
19.02.2019;22:26:01;86268803;86248705;20098;
19.02.2019;22:27:02;86268908;86248741;20167;
19.02.2019;22:28:02;86269012;86248774;20238;
19.02.2019;22:29:02;86269138;86248818;20320;
19.02.2019;22:30:02;86269275;86248834;20441;
19.02.2019;22:31:02;86269401;86248861;20540;
19.02.2019;22:32:02;86269516;86248893;20623;
19.02.2019;22:33:02;86269610;86248919;20691;
19.02.2019;22:34:02;86269713;86248945;20768;
19.02.2019;22:35:01;86269836;86248977;20859;
19.02.2019;22:36:02;86269939;86249004;20935;
19.02.2019;22:37:02;86270054;86249036;21018;
19.02.2019;22:38:02;86270170;86249070;21100;
19.02.2019;22:39:02;86270264;86249101;21163;
19.02.2019;22:40:02;86270355;86249126;21229;
19.02.2019;22:41:02;86270472;86249144;21328;
19.02.2019;22:42:02;86270591;86249167;21424;
19.02.2019;22:43:02;86270721;86249195;21526;
19.02.2019;22:44:08;86270839;86249225;21614;
19.02.2019;22:45:02;86270944;86249246;21698;
19.02.2019;22:46:02;86271047;86249262;21785;
19.02.2019;22:47:08;86271164;86249295;21869;
19.02.2019;22:48:08;86271270;86249311;21959;
19.02.2019;22:49:02;86271406;86249335;22071;
19.02.2019;22:50:02;86271524;86249358;22166;
19.02.2019;22:51:07;86271658;86249380;22278;
19.02.2019;22:52:02;86271758;86249407;22351;
19.02.2019;22:53:02;86271876;86249431;22445;
19.02.2019;22:54:02;86271957;86249460;22497;
19.02.2019;22:55:02;86272076;86249483;22593;
19.02.2019;22:56:02;86272185;86249504;22681;
19.02.2019;22:57:02;86272304;86249526;22778;
19.02.2019;22:58:02;86272434;86249551;22883;
19.02.2019;22:59:01;86272554;86249579;22975;
19.02.2019;23:00:03;86272655;86249599;23056;
19.02.2019;23:01:01;86272757;86249624;23133;
19.02.2019;23:02:02;86272882;86249648;23234;
19.02.2019;23:03:02;86272997;86249677;23320;
19.02.2019;23:04:02;86273081;86249690;23391;
19.02.2019;23:05:03;86273183;86249720;23463;
19.02.2019;23:06:02;86273328;86249741;23587;
19.02.2019;23:07:02;86273455;86249759;23696;
19.02.2019;23:09:02;86273688;86249805;23883;
19.02.2019;23:11:08;86273901;86249847;24054;
19.02.2019;23:13:02;86274118;86249882;24236;
19.02.2019;23:14:01;86274246;86249911;24335;
19.02.2019;23:15:02;86274370;86249933;24437;
19.02.2019;23:16:07;86274478;86249957;24521;
19.02.2019;23:17:02;86274563;86249977;24586;
19.02.2019;23:18:02;86274664;86250005;24659;
19.02.2019;23:19:02;86274798;86250026;24772;
19.02.2019;23:20:02;86274919;86250054;24865;
19.02.2019;23:21:02;86275015;86250084;24931;
19.02.2019;23:22:02;86275109;86250100;25009;
19.02.2019;23:23:02;86275216;86250116;25100;
19.02.2019;23:24:01;86275324;86250133;25191;
19.02.2019;23:25:02;86275417;86250154;25263;
19.02.2019;23:26:02;86275489;86250180;25309;
19.02.2019;23:27:02;86275585;86250195;25390;
19.02.2019;23:28:02;86275675;86250223;25452;
19.02.2019;23:29:01;86275792;86250237;25555;
19.02.2019;23:30:02;86275905;86250261;25644;
19.02.2019;23:31:02;86276010;86250283;25727;
19.02.2019;23:32:02;86276100;86250314;25786;
19.02.2019;23:33:02;86276230;86250336;25894;
19.02.2019;23:34:02;86276322;86250365;25957;
19.02.2019;23:35:01;86276433;86250394;26039;
19.02.2019;23:36:03;86276532;86250412;26120;
19.02.2019;23:37:01;86276620;86250421;26199;
19.02.2019;23:38:02;86276736;86250425;26311;
19.02.2019;23:39:02;86276836;86250448;26388;
19.02.2019;23:40:02;86276931;86250475;26456;
19.02.2019;23:41:02;86277044;86250511;26533;
19.02.2019;23:42:02;86277150;86250529;26621;
19.02.2019;23:43:01;86277232;86250553;26679;
19.02.2019;23:44:02;86277322;86250565;26757;
19.02.2019;23:45:02;86277406;86250573;26833;
19.02.2019;23:46:02;86277513;86250580;26933;
19.02.2019;23:47:01;86277587;86250596;26991;
19.02.2019;23:48:02;86277690;86250608;27082;
19.02.2019;23:49:02;86277793;86250615;27178;
19.02.2019;23:50:01;86277894;86250646;27248;
19.02.2019;23:51:02;86278005;86250683;27322;
19.02.2019;23:52:02;86278097;86250703;27394;
19.02.2019;23:53:02;86278186;86250719;27467;
19.02.2019;23:54:01;86278305;86250724;27581;
19.02.2019;23:55:02;86278417;86250743;27674;
19.02.2019;23:56:02;86278505;86250763;27742;
19.02.2019;23:57:01;86278603;86250786;27817;
19.02.2019;23:58:02;86278722;86250807;27915;
19.02.2019;23:59:02;86278848;86250833;28015;
20.02.2019;00:00:01;86278930;86250853;28077;
20.02.2019;00:01:02;86278988;86250862;28126;
20.02.2019;00:02:02;86279077;86250886;28191;
20.02.2019;00:03:01;86279182;86250908;28274;
20.02.2019;00:04:02;86279282;86250927;28355;
20.02.2019;00:05:02;86279369;86250951;28418;
20.02.2019;00:06:01;86279459;86250980;28479;
20.02.2019;00:07:02;86279548;86251007;28541;
20.02.2019;00:08:02;86279608;86251031;28577;
20.02.2019;00:10:02;86279725;86251056;28669;
20.02.2019;00:11:02;86279820;86251064;28756;
20.02.2019;00:12:01;86279909;86251079;28830;
20.02.2019;00:13:02;86279974;86251106;28868;
20.02.2019;00:14:02;86280058;86251115;28943;
20.02.2019;00:15:01;86280092;86251111;28981;
20.02.2019;00:16:02;86280013;86251099;28914;
20.02.2019;00:17:02;86279863;86251087;28776;
20.02.2019;00:18:02;86279870;86251098;28772;
20.02.2019;00:19:01;86279914;86251122;28792;
20.02.2019;00:20:02;86279964;86251135;28829;
20.02.2019;00:21:02;86280064;86251162;28902;
20.02.2019;00:22:01;86280158;86251173;28985;
20.02.2019;00:23:02;86280238;86251195;29043;
20.02.2019;00:24:02;86280323;86251210;29113;
20.02.2019;00:25:01;86280412;86251224;29188;
20.02.2019;00:26:02;86280516;86251240;29276;
20.02.2019;00:27:02;86280607;86251264;29343;
20.02.2019;00:28:01;86280699;86251295;29404;
20.02.2019;00:29:02;86280784;86251328;29456;
20.02.2019;00:30:02;86280864;86251338;29526;
20.02.2019;00:31:01;86280927;86251355;29572;
20.02.2019;00:32:02;86281009;86251376;29633;
20.02.2019;00:33:02;86281099;86251395;29704;
20.02.2019;00:34:01;86281169;86251415;29754;
20.02.2019;00:35:02;86281246;86251437;29809;
20.02.2019;00:36:02;86281324;86251466;29858;
20.02.2019;00:37:01;86281426;86251481;29945;
20.02.2019;00:38:02;86281507;86251495;30012;
20.02.2019;00:39:01;86281595;86251514;30081;
20.02.2019;00:40:02;86281675;86251533;30142;
20.02.2019;00:41:02;86281773;86251551;30222;
20.02.2019;00:42:02;86281842;86251569;30273;
20.02.2019;00:43:01;86281951;86251585;30366;
20.02.2019;00:44:02;86282046;86251610;30436;
20.02.2019;00:45:02;86282141;86251634;30507;
20.02.2019;00:46:01;86282212;86251654;30558;
20.02.2019;00:47:07;86282309;86251677;30632;
20.02.2019;00:48:02;86282385;86251672;30713;
20.02.2019;00:49:01;86282467;86251658;30809;
20.02.2019;00:50:02;86282569;86251668;30901;
20.02.2019;00:51:01;86282651;86251686;30965;
20.02.2019;00:52:02;86282730;86251702;31028;
20.02.2019;00:53:02;86282825;86251714;31111;
20.02.2019;00:54:01;86282927;86251736;31191;
20.02.2019;00:55:02;86283026;86251763;31263;
20.02.2019;00:56:02;86283103;86251792;31311;
20.02.2019;00:57:02;86283192;86251819;31373;
20.02.2019;00:58:01;86283282;86251846;31436;
20.02.2019;00:59:02;86283373;86251876;31497;
20.02.2019;01:00:02;86283468;86251900;31568;
20.02.2019;01:01:01;86283561;86251923;31638;
20.02.2019;01:02:02;86283668;86251935;31733;
20.02.2019;01:03:02;86283758;86251978;31780;
20.02.2019;01:04:02;86283845;86252009;31836;
20.02.2019;01:05:01;86283922;86252031;31891;
20.02.2019;01:06:02;86284011;86252064;31947;
20.02.2019;01:07:02;86284109;86252094;32015;
20.02.2019;01:08:01;86284219;86252114;32105;
20.02.2019;01:09:02;86284307;86252141;32166;
20.02.2019;01:10:02;86284395;86252165;32230;
20.02.2019;01:11:01;86284493;86252197;32296;
20.02.2019;01:12:02;86284584;86252226;32358;
20.02.2019;01:13:02;86284666;86252258;32408;
20.02.2019;01:14:02;86284754;86252282;32472;
20.02.2019;01:15:02;86284833;86252316;32517;
20.02.2019;01:16:01;86284910;86252356;32554;
20.02.2019;01:17:02;86284985;86252376;32609;
20.02.2019;01:18:02;86285052;86252399;32653;
20.02.2019;01:19:01;86285150;86252425;32725;
20.02.2019;01:20:02;86285225;86252450;32775;
20.02.2019;01:21:02;86285319;86252486;32833;
20.02.2019;01:22:01;86285395;86252529;32866;
20.02.2019;01:23:02;86285475;86252564;32911;
20.02.2019;01:24:02;86285553;86252599;32954;
20.02.2019;01:25:02;86285637;86252641;32996;
20.02.2019;01:26:01;86285735;86252672;33063;
20.02.2019;01:27:02;86285824;86252692;33132;
20.02.2019;01:28:02;86285918;86252723;33195;
20.02.2019;01:29:01;86286002;86252751;33251;
20.02.2019;01:30:02;86286090;86252779;33311;
20.02.2019;01:31:02;86286182;86252809;33373;
20.02.2019;01:32:01;86286271;86252841;33430;
20.02.2019;01:33:02;86286347;86252866;33481;
20.02.2019;01:34:02;86286441;86252898;33543;
20.02.2019;01:35:07;86286546;86252942;33604;
20.02.2019;01:36:01;86286606;86252974;33632;
20.02.2019;01:37:02;86286693;86253024;33669;
20.02.2019;01:38:02;86286785;86253045;33740;
20.02.2019;01:39:01;86286874;86253090;33784;
20.02.2019;01:40:02;86286972;86253117;33855;
20.02.2019;01:41:01;86287054;86253153;33901;
20.02.2019;01:42:02;86287135;86253189;33946;
20.02.2019;01:43:02;86287236;86253215;34021;
20.02.2019;01:44:03;86287336;86253255;34081;
20.02.2019;01:45:01;86287420;86253284;34136;
20.02.2019;01:46:02;86287502;86253326;34176;
20.02.2019;01:47:02;86287610;86253360;34250;
20.02.2019;01:48:01;86287692;86253408;34284;
20.02.2019;01:49:02;86287773;86253452;34321;
20.02.2019;01:50:02;86287886;86253473;34413;
20.02.2019;01:51:01;86287996;86253512;34484;
20.02.2019;01:52:02;86288084;86253551;34533;
20.02.2019;01:53:02;86288191;86253584;34607;
20.02.2019;01:54:01;86288271;86253606;34665;
20.02.2019;01:55:02;86288364;86253649;34715;
20.02.2019;01:56:02;86288441;86253704;34737;
20.02.2019;01:57:01;86288539;86253746;34793;
20.02.2019;01:58:02;86288638;86253797;34841;
20.02.2019;01:59:02;86288729;86253847;34882;
20.02.2019;02:00:01;86288814;86253880;34934;
20.02.2019;02:01:02;86288906;86253926;34980;
20.02.2019;02:02:02;86289010;86253977;35033;
20.02.2019;02:03:01;86289092;86254027;35065;
20.02.2019;02:04:02;86289183;86254075;35108;
20.02.2019;02:05:02;86289174;86253890;35284;
20.02.2019;02:06:01;86289162;86253656;35506;
20.02.2019;02:07:02;86289030;86253184;35846;
20.02.2019;02:08:02;86289064;86253033;36031;
20.02.2019;02:09:01;86289135;86253027;36108;
20.02.2019;02:10:02;86289197;86253021;36176;
20.02.2019;02:11:02;86289281;86253026;36255;
20.02.2019;02:12:01;86289365;86253047;36318;
20.02.2019;02:13:02;86289446;86253069;36377;
20.02.2019;02:14:02;86289527;86253111;36416;
20.02.2019;02:15:01;86289596;86253146;36450;
20.02.2019;02:16:02;86289698;86253183;36515;
20.02.2019;02:17:02;86289806;86253225;36581;
20.02.2019;02:18:01;86289909;86253261;36648;
20.02.2019;02:19:02;86289997;86253305;36692;
20.02.2019;02:20:02;86290079;86253367;36712;
20.02.2019;02:21:01;86290153;86253412;36741;
20.02.2019;02:22:02;86290246;86253484;36762;
20.02.2019;02:23:02;86290326;86253531;36795;
20.02.2019;02:24:02;86290400;86253592;36808;
20.02.2019;02:25:01;86290492;86253633;36859;
20.02.2019;02:26:02;86290584;86253700;36884;
20.02.2019;02:27:02;86290679;86253739;36940;
20.02.2019;02:28:01;86290749;86253788;36961;
20.02.2019;02:29:02;86290840;86253865;36975;
20.02.2019;02:30:02;86290926;86253935;36991;
20.02.2019;02:31:01;86291015;86253995;37020;
20.02.2019;02:32:02;86291105;86254058;37047;
20.02.2019;02:33:02;86291189;86254113;37076;
20.02.2019;02:34:01;86291273;86254171;37102;
20.02.2019;02:35:02;86291370;86254222;37148;
20.02.2019;02:36:01;86291459;86254283;37176;
20.02.2019;02:37:02;86291538;86254351;37187;
20.02.2019;02:38:02;86291618;86254413;37205;
20.02.2019;02:39:01;86291687;86254479;37208;
20.02.2019;02:40:02;86291768;86254549;37219;
20.02.2019;02:41:02;86291856;86254619;37237;
20.02.2019;02:42:01;86291928;86254688;37240;
20.02.2019;02:43:02;86292046;86254758;37288;
20.02.2019;02:44:02;86292113;86254825;37288;
20.02.2019;02:45:01;86292215;86254896;37319;
20.02.2019;02:46:02;86292290;86254990;37300;
20.02.2019;02:47:01;86292393;86255055;37338;
20.02.2019;02:48:01;86292489;86255138;37351;
20.02.2019;02:49:02;86292600;86255201;37399;
20.02.2019;02:50:02;86292700;86255256;37444;
20.02.2019;02:51:01;86292795;86255331;37464;
20.02.2019;02:52:02;86292862;86255404;37458;
20.02.2019;02:53:01;86292940;86255485;37455;
20.02.2019;02:54:02;86293018;86255561;37457;
20.02.2019;02:55:02;86293121;86255636;37485;
20.02.2019;02:56:02;86293182;86255710;37472;
20.02.2019;02:57:01;86293270;86255795;37475;
20.02.2019;02:58:02;86293367;86255876;37491;
20.02.2019;02:59:02;86293448;86255947;37501;
20.02.2019;03:00:01;86293530;86256006;37524;
20.02.2019;03:01:02;86293603;86256100;37503;
20.02.2019;03:02:02;86293679;86256181;37498;
20.02.2019;03:03:02;86293753;86256272;37481;
20.02.2019;03:04:01;86293835;86256343;37492;
20.02.2019;03:05:02;86293938;86256414;37524;
20.02.2019;03:06:01;86294002;86256495;37507;
20.02.2019;03:07:01;86294113;86256578;37535;
20.02.2019;03:08:02;86294209;86256666;37543;
20.02.2019;03:09:01;86294305;86256759;37546;
20.02.2019;03:10:02;86294397;86256827;37570;
20.02.2019;03:11:02;86294475;86256893;37582;
20.02.2019;03:12:01;86294564;86256969;37595;
20.02.2019;03:13:01;86294635;86257054;37581;
20.02.2019;03:14:02;86294724;86257135;37589;
20.02.2019;03:15:02;86294837;86257221;37616;
20.02.2019;03:16:01;86294897;86257298;37599;
20.02.2019;03:17:02;86294991;86257387;37604;
20.02.2019;03:18:02;86295089;86257491;37598;
20.02.2019;03:19:01;86295174;86257586;37588;
20.02.2019;03:20:02;86295277;86257679;37598;
20.02.2019;03:21:02;86295374;86257758;37616;
20.02.2019;03:22:01;86295427;86257847;37580;
20.02.2019;03:23:02;86295520;86257916;37604;
20.02.2019;03:24:02;86295618;86258006;37612;
20.02.2019;03:25:01;86295695;86258096;37599;
20.02.2019;03:26:02;86295779;86258183;37596;
20.02.2019;03:27:02;86295864;86258273;37591;
20.02.2019;03:28:01;86295954;86258373;37581;
20.02.2019;03:29:02;86296023;86258483;37540;
20.02.2019;03:30:02;86296092;86258564;37528;
20.02.2019;03:31:01;86296192;86258663;37529;
20.02.2019;03:32:02;86296286;86258743;37543;
20.02.2019;03:33:02;86296380;86258811;37569;
20.02.2019;03:34:01;86296460;86258893;37567;
20.02.2019;03:35:02;86296521;86259003;37518;
20.02.2019;03:36:02;86296601;86259102;37499;
20.02.2019;03:37:01;86296682;86259195;37487;
20.02.2019;03:38:02;86296788;86259292;37496;
20.02.2019;03:39:02;86296858;86259394;37464;
20.02.2019;03:40:01;86296952;86259476;37476;
20.02.2019;03:41:02;86297035;86259565;37470;
20.02.2019;03:42:02;86297132;86259652;37480;
20.02.2019;03:43:01;86297230;86259752;37478;
20.02.2019;03:44:02;86297311;86259850;37461;
20.02.2019;03:45:02;86297397;86259953;37444;
20.02.2019;03:46:01;86297501;86260061;37440;
20.02.2019;03:47:02;86297589;86260157;37432;
20.02.2019;03:48:02;86297668;86260233;37435;
20.02.2019;03:49:01;86297759;86260326;37433;
20.02.2019;03:50:02;86297812;86260392;37420;
20.02.2019;03:51:02;86297905;86260489;37416;
20.02.2019;03:52:01;86297985;86260575;37410;
20.02.2019;03:53:02;86298062;86260669;37393;
20.02.2019;03:54:02;86298151;86260757;37394;
20.02.2019;03:55:01;86298240;86260844;37396;
20.02.2019;03:56:02;86298347;86260922;37425;
20.02.2019;03:57:01;86298421;86261017;37404;
20.02.2019;03:58:02;86298515;86261121;37394;
20.02.2019;03:59:02;86298609;86261206;37403;
20.02.2019;04:00:02;86298703;86261247;37456;
20.02.2019;04:01:01;86298795;86261394;37401;
20.02.2019;04:02:02;86298861;86261483;37378;
20.02.2019;04:03:02;86298944;86261565;37379;
20.02.2019;04:04:01;86299032;86261659;37373;
20.02.2019;04:05:02;86299047;86261727;37320;
20.02.2019;04:06:02;86299066;86261812;37254;
20.02.2019;04:07:02;86299143;86261892;37251;
20.02.2019;04:08:01;86299214;86262006;37208;
20.02.2019;04:09:02;86299224;86262102;37122;
20.02.2019;04:10:02;86299286;86262171;37115;
20.02.2019;04:11:01;86299329;86262243;37086;
20.02.2019;04:12:02;86299379;86262331;37048;
20.02.2019;04:13:02;86299445;86262443;37002;
20.02.2019;04:14:01;86299515;86262552;36963;
20.02.2019;04:15:02;86299594;86262633;36961;
20.02.2019;04:16:02;86299675;86262733;36942;
20.02.2019;04:17:01;86299755;86262818;36937;
20.02.2019;04:18:02;86299823;86262917;36906;
20.02.2019;04:19:02;86299900;86263024;36876;
20.02.2019;04:20:01;86299983;86263073;36910;
20.02.2019;04:21:01;86300028;86263167;36861;
20.02.2019;04:22:02;86300146;86263260;36886;
20.02.2019;04:23:01;86300221;86263372;36849;
20.02.2019;04:24:02;86300288;86263473;36815;
20.02.2019;04:25:02;86300362;86263555;36807;
20.02.2019;04:26:02;86300424;86263648;36776;
20.02.2019;04:27:01;86300494;86263751;36743;
20.02.2019;04:28:02;86300558;86263831;36727;
20.02.2019;04:29:02;86300638;86263923;36715;
20.02.2019;04:30:01;86300704;86264010;36694;
20.02.2019;04:31:02;86300786;86264117;36669;
20.02.2019;04:32:02;86300866;86264225;36641;
20.02.2019;04:33:01;86300947;86264301;36646;
20.02.2019;04:34:02;86301027;86264418;36609;
20.02.2019;04:35:02;86301106;86264517;36589;
20.02.2019;04:36:01;86301204;86264601;36603;
20.02.2019;04:37:02;86301278;86264704;36574;
20.02.2019;04:38:02;86301354;86264810;36544;
20.02.2019;04:39:02;86301437;86264908;36529;
20.02.2019;04:40:01;86301511;86265001;36510;
20.02.2019;04:41:02;86301587;86265092;36495;
20.02.2019;04:42:02;86301674;86265177;36497;
20.02.2019;04:43:01;86301755;86265284;36471;
20.02.2019;04:44:02;86301829;86265380;36449;
20.02.2019;04:45:02;86301915;86265479;36436;
20.02.2019;04:46:01;86301979;86265580;36399;
20.02.2019;04:47:02;86302034;86265652;36382;
20.02.2019;04:48:02;86302101;86265747;36354;
20.02.2019;04:49:01;86302185;86265849;36336;
20.02.2019;04:50:02;86302244;86265963;36281;
20.02.2019;04:51:02;86302322;86266064;36258;
20.02.2019;04:52:01;86302375;86266184;36191;
20.02.2019;04:53:02;86302456;86266307;36149;
20.02.2019;04:54:02;86302510;86266419;36091;
20.02.2019;04:55:01;86302587;86266520;36067;
20.02.2019;04:56:02;86302656;86266617;36039;
20.02.2019;04:57:02;86302733;86266727;36006;
20.02.2019;04:58:01;86302815;86266824;35991;
20.02.2019;04:59:02;86302891;86266931;35960;
20.02.2019;05:00:02;86302952;86267005;35947;
20.02.2019;05:01:01;86303040;86267107;35933;
20.02.2019;05:02:02;86303128;86267197;35931;
20.02.2019;05:03:02;86303197;86267293;35904;
20.02.2019;05:04:02;86303274;86267387;35887;
20.02.2019;05:05:01;86303350;86267504;35846;
20.02.2019;05:06:02;86303415;86267614;35801;
20.02.2019;05:07:02;86303485;86267707;35778;
20.02.2019;05:08:01;86303557;86267788;35769;
20.02.2019;05:09:02;86303623;86267903;35720;
20.02.2019;05:10:01;86303686;86268004;35682;
20.02.2019;05:11:01;86303726;86268099;35627;
20.02.2019;05:12:02;86303802;86268209;35593;
20.02.2019;05:13:01;86303875;86268302;35573;
20.02.2019;05:14:02;86303951;86268399;35552;
20.02.2019;05:15:02;86304010;86268490;35520;
20.02.2019;05:16:01;86304080;86268575;35505;
20.02.2019;05:17:02;86304149;86268678;35471;
20.02.2019;05:18:02;86304204;86268796;35408;
20.02.2019;05:19:01;86304297;86268892;35405;
20.02.2019;05:20:02;86304364;86268982;35382;
20.02.2019;05:21:02;86304431;86269078;35353;
20.02.2019;05:22:01;86304477;86269188;35289;
20.02.2019;05:23:02;86304550;86269295;35255;
20.02.2019;05:24:02;86304627;86269415;35212;
20.02.2019;05:25:01;86304690;86269513;35177;
20.02.2019;05:26:02;86304754;86269626;35128;
20.02.2019;05:27:02;86304815;86269724;35091;
20.02.2019;05:28:01;86304875;86269828;35047;
20.02.2019;05:29:02;86304963;86269920;35043;
20.02.2019;05:30:02;86305040;86270037;35003;
20.02.2019;05:31:02;86305111;86270136;34975;
20.02.2019;05:32:01;86305173;86270235;34938;
20.02.2019;05:33:02;86305256;86270361;34895;
20.02.2019;05:34:02;86305331;86270459;34872;
20.02.2019;05:35:01;86305387;86270559;34828;
20.02.2019;05:36:02;86305447;86270662;34785;
20.02.2019;05:37:02;86305517;86270766;34751;
20.02.2019;05:38:01;86305591;86270857;34734;
20.02.2019;05:39:02;86305669;86270954;34715;
20.02.2019;05:40:02;86305735;86271071;34664;
20.02.2019;05:41:01;86305801;86271189;34612;
20.02.2019;05:42:02;86305884;86271305;34579;
20.02.2019;05:43:02;86305943;86271396;34547;
20.02.2019;05:44:01;86306018;86271494;34524;
20.02.2019;05:45:02;86306080;86271601;34479;
20.02.2019;05:46:01;86306145;86271701;34444;
20.02.2019;05:47:02;86306221;86271791;34430;
20.02.2019;05:48:02;86306284;86271881;34403;
20.02.2019;05:49:02;86306347;86271993;34354;
20.02.2019;05:50:01;86306408;86272082;34326;
20.02.2019;05:51:02;86306478;86272199;34279;
20.02.2019;05:52:02;86306557;86272301;34256;
20.02.2019;05:53:01;86306622;86272405;34217;
20.02.2019;05:54:02;86306701;86272495;34206;
20.02.2019;05:55:02;86306780;86272611;34169;
20.02.2019;05:56:01;86306859;86272707;34152;
20.02.2019;05:57:02;86306926;86272838;34088;
20.02.2019;05:58:02;86306991;86272957;34034;
20.02.2019;05:59:01;86307060;86273067;33993;
20.02.2019;06:00:02;86307130;86273163;33967;
20.02.2019;06:01:02;86307198;86273258;33940;
20.02.2019;06:02:02;86307269;86273362;33907;
20.02.2019;06:03:01;86307325;86273460;33865;
20.02.2019;06:04:02;86307330;86273535;33795;
20.02.2019;06:05:02;86307222;86273563;33659;
20.02.2019;06:06:01;86307230;86273617;33613;
20.02.2019;06:07:02;86307287;86273724;33563;
20.02.2019;06:08:02;86307325;86273830;33495;
20.02.2019;06:09:01;86307391;86273901;33490;
20.02.2019;06:10:02;86307426;86274023;33403;
20.02.2019;06:11:02;86307512;86274115;33397;
20.02.2019;06:12:01;86307556;86274231;33325;
20.02.2019;06:13:02;86307615;86274348;33267;
20.02.2019;06:14:02;86307680;86274452;33228;
20.02.2019;06:15:01;86307733;86274551;33182;
20.02.2019;06:16:02;86307781;86274668;33113;
20.02.2019;06:17:02;86307844;86274782;33062;
20.02.2019;06:18:01;86307905;86274869;33036;
20.02.2019;06:19:02;86307986;86274971;33015;
20.02.2019;06:20:02;86308046;86275089;32957;
20.02.2019;06:21:01;86308113;86275188;32925;
20.02.2019;06:22:02;86308184;86275288;32896;
20.02.2019;06:23:02;86308254;86275391;32863;
20.02.2019;06:24:01;86308334;86275497;32837;
20.02.2019;06:25:02;86308389;86275623;32766;
20.02.2019;06:26:02;86308467;86275728;32739;
20.02.2019;06:27:01;86308532;86275829;32703;
20.02.2019;06:28:02;86308588;86275936;32652;
20.02.2019;06:29:02;86308650;86276049;32601;
20.02.2019;06:30:02;86308701;86276155;32546;
20.02.2019;06:31:01;86308760;86276245;32515;
20.02.2019;06:32:02;86308823;86276346;32477;
20.02.2019;06:33:01;86308883;86276441;32442;
20.02.2019;06:34:01;86308939;86276530;32409;
20.02.2019;06:35:02;86308992;86276653;32339;
20.02.2019;06:36:01;86309063;86276757;32306;
20.02.2019;06:37:02;86309122;86276843;32279;
20.02.2019;06:38:02;86309177;86276969;32208;
20.02.2019;06:39:01;86309223;86277072;32151;
20.02.2019;06:40:02;86309301;86277181;32120;
20.02.2019;06:41:02;86309352;86277303;32049;
20.02.2019;06:42:02;86309413;86277408;32005;
20.02.2019;06:43:01;86309481;86277518;31963;
20.02.2019;06:44:02;86309522;86277629;31893;
20.02.2019;06:45:02;86309582;86277743;31839;
20.02.2019;06:46:02;86309669;86277861;31808;
20.02.2019;06:47:01;86309733;86277957;31776;
20.02.2019;06:48:01;86309797;86278054;31743;
20.02.2019;06:49:02;86309856;86278150;31706;
20.02.2019;06:50:02;86309916;86278271;31645;
20.02.2019;06:51:01;86309979;86278381;31598;
20.02.2019;06:52:02;86310036;86278480;31556;
20.02.2019;06:53:02;86310052;86278504;31548;
20.02.2019;06:54:04;86310111;86278600;31511;
20.02.2019;06:55:02;86310184;86278688;31496;
20.02.2019;06:56:02;86310232;86278814;31418;
20.02.2019;06:57:02;86310302;86278927;31375;
20.02.2019;06:58:01;86310354;86279059;31295;
20.02.2019;06:59:02;86310387;86279169;31218;
20.02.2019;07:00:02;86310434;86279270;31164;
20.02.2019;07:01:02;86310506;86279359;31147;
20.02.2019;07:02:02;86310553;86279482;31071;
20.02.2019;07:03:02;86310606;86279593;31013;
20.02.2019;07:05:02;86310736;86279847;30889;
20.02.2019;07:07:01;86310851;86280076;30775;
20.02.2019;07:08:02;86310911;86280187;30724;
20.02.2019;07:09:02;86310966;86280298;30668;
20.02.2019;07:10:02;86311020;86280409;30611;
20.02.2019;07:12:01;86311152;86280581;30571;
20.02.2019;07:13:02;86311224;86280710;30514;
20.02.2019;07:14:02;86311270;86280819;30451;
20.02.2019;07:16:02;86311397;86281031;30366;
20.02.2019;07:17:02;86311472;86281120;30352;
20.02.2019;07:18:02;86311539;86281224;30315;
20.02.2019;07:19:02;86311595;86281321;30274;
20.02.2019;07:20:02;86311639;86281420;30219;
20.02.2019;07:21:02;86311693;86281527;30166;
20.02.2019;07:22:02;86311761;86281644;30117;
20.02.2019;07:23:01;86311835;86281745;30090;
20.02.2019;07:24:02;86311872;86281860;30012;
20.02.2019;07:25:02;86311948;86281958;29990;
20.02.2019;07:26:02;86312002;86282084;29918;
20.02.2019;07:27:02;86312059;86282175;29884;
20.02.2019;07:28:01;86312122;86282276;29846;
20.02.2019;07:29:02;86312182;86282381;29801;
20.02.2019;07:30:02;86312264;86282504;29760;
20.02.2019;07:31:02;86312327;86282597;29730;
20.02.2019;07:32:01;86312377;86282734;29643;
20.02.2019;07:33:02;86312431;86282859;29572;
20.02.2019;07:34:02;86312465;86282959;29506;
20.02.2019;07:35:01;86312506;86283046;29460;
20.02.2019;07:36:02;86312554;86283142;29412;
20.02.2019;07:37:02;86312603;86283238;29365;
20.02.2019;07:38:01;86312654;86283348;29306;
20.02.2019;07:39:02;86312703;86283415;29288;
20.02.2019;07:40:02;86312770;86283515;29255;
20.02.2019;07:41:01;86312819;86283626;29193;
20.02.2019;07:42:02;86312882;86283735;29147;
20.02.2019;07:43:02;86312921;86283826;29095;
20.02.2019;07:44:01;86312974;86283951;29023;
20.02.2019;07:45:02;86313026;86284082;28944;
20.02.2019;07:46:02;86313091;86284182;28909;
20.02.2019;07:47:02;86313149;86284310;28839;
20.02.2019;07:48:01;86313209;86284449;28760;
20.02.2019;07:49:02;86313271;86284575;28696;
20.02.2019;07:50:02;86313319;86284669;28650;
20.02.2019;07:51:01;86313363;86284803;28560;
20.02.2019;07:52:02;86313420;86284898;28522;
20.02.2019;07:53:02;86313469;86285024;28445;
20.02.2019;07:54:01;86313530;86285122;28408;
20.02.2019;07:55:02;86313592;86285241;28351;
20.02.2019;07:56:02;86313647;86285324;28323;
20.02.2019;07:57:01;86313708;86285436;28272;
20.02.2019;07:58:02;86313772;86285563;28209;
20.02.2019;07:59:02;86313819;86285655;28164;
20.02.2019;08:00:02;86313874;86285756;28118;
20.02.2019;08:01:01;86313942;86285841;28101;
20.02.2019;08:02:02;86313975;86285944;28031;
20.02.2019;08:03:02;86314026;86286044;27982;
20.02.2019;08:04:02;86314073;86286181;27892;
20.02.2019;08:05:01;86314114;86286273;27841;
20.02.2019;08:06:02;86314055;86286308;27747;
20.02.2019;08:07:02;86313985;86286338;27647;
20.02.2019;08:08:01;86314017;86286436;27581;
20.02.2019;08:09:02;86314054;86286557;27497;
20.02.2019;08:10:02;86314094;86286656;27438;
20.02.2019;08:11:01;86314124;86286763;27361;
20.02.2019;08:12:02;86314168;86286856;27312;
20.02.2019;08:13:02;86314192;86286958;27234;
20.02.2019;08:14:01;86314291;86287069;27222;
20.02.2019;08:15:02;86314343;86287170;27173;
20.02.2019;08:16:02;86314406;86287281;27125;
20.02.2019;08:17:01;86314463;86287385;27078;
20.02.2019;08:18:02;86314523;86287484;27039;
20.02.2019;08:19:02;86314586;86287598;26988;
20.02.2019;08:20:02;86314649;86287695;26954;
20.02.2019;08:21:01;86314693;86287801;26892;
20.02.2019;08:22:02;86314736;86287937;26799;
20.02.2019;08:23:02;86314770;86288054;26716;
20.02.2019;08:24:02;86314814;86288146;26668;
20.02.2019;08:25:02;86314852;86288276;26576;
20.02.2019;08:26:01;86314930;86288387;26543;
20.02.2019;08:27:02;86314970;86288489;26481;
20.02.2019;08:28:02;86315019;86288593;26426;
20.02.2019;08:29:02;86315063;86288712;26351;
20.02.2019;08:30:02;86315096;86288838;26258;
20.02.2019;08:31:01;86315158;86288948;26210;
20.02.2019;08:32:02;86315211;86289078;26133;
20.02.2019;08:33:02;86315262;86289170;26092;
20.02.2019;08:34:02;86315302;86289285;26017;
20.02.2019;08:35:01;86315357;86289389;25968;
20.02.2019;08:36:02;86315420;86289490;25930;
20.02.2019;08:37:02;86315482;86289590;25892;
20.02.2019;08:38:02;86315523;86289695;25828;
20.02.2019;08:39:02;86315591;86289794;25797;
20.02.2019;08:40:01;86315650;86289902;25748;
20.02.2019;08:41:02;86315692;86290000;25692;
20.02.2019;08:42:02;86315739;86290109;25630;
20.02.2019;08:43:01;86315778;86290193;25585;
20.02.2019;08:44:02;86315844;86290309;25535;
20.02.2019;08:45:02;86315915;86290437;25478;
20.02.2019;08:46:01;86315968;86290540;25428;
20.02.2019;08:47:02;86316023;86290641;25382;
20.02.2019;08:48:02;86316072;86290771;25301;
20.02.2019;08:49:01;86316122;86290869;25253;
20.02.2019;08:50:02;86316187;86290996;25191;
20.02.2019;08:51:02;86316239;86291110;25129;
20.02.2019;08:52:01;86316292;86291234;25058;
20.02.2019;08:53:02;86316347;86291341;25006;
20.02.2019;08:54:02;86316393;86291461;24932;
20.02.2019;08:55:01;86316454;86291582;24872;
20.02.2019;08:56:02;86316508;86291697;24811;
20.02.2019;08:57:02;86316565;86291810;24755;
20.02.2019;08:58:01;86316619;86291964;24655;
20.02.2019;08:59:02;86316679;86292088;24591;
20.02.2019;09:00:02;86316730;86292191;24539;
20.02.2019;09:01:01;86316764;86292315;24449;
20.02.2019;09:02:02;86316812;86292454;24358;
20.02.2019;09:03:02;86316866;86292535;24331;
20.02.2019;09:04:01;86316916;86292622;24294;
20.02.2019;09:05:02;86316978;86292725;24253;
20.02.2019;09:06:02;86317043;86292828;24215;
20.02.2019;09:07:02;86317118;86292942;24176;
20.02.2019;09:08:01;86317174;86293070;24104;
20.02.2019;09:09:02;86317234;86293173;24061;
20.02.2019;09:10:02;86317297;86293273;24024;
20.02.2019;09:11:01;86317350;86293376;23974;
20.02.2019;09:12:02;86317408;86293473;23935;
20.02.2019;09:13:01;86317451;86293588;23863;
20.02.2019;09:14:02;86317513;86293699;23814;
20.02.2019;09:15:02;86317567;86293789;23778;
20.02.2019;09:16:01;86317631;86293894;23737;
20.02.2019;09:17:02;86317681;86293989;23692;
20.02.2019;09:18:02;86317753;86294120;23633;
20.02.2019;09:19:01;86317801;86294233;23568;
20.02.2019;09:20:02;86317873;86294341;23532;
20.02.2019;09:21:02;86317935;86294442;23493;
20.02.2019;09:22:01;86317979;86294541;23438;
20.02.2019;09:23:02;86318030;86294650;23380;
20.02.2019;09:24:02;86318074;86294775;23299;
20.02.2019;09:25:01;86318130;86294893;23237;
20.02.2019;09:26:02;86318200;86294995;23205;
20.02.2019;09:27:02;86318256;86295116;23140;
20.02.2019;09:28:02;86318313;86295237;23076;
20.02.2019;09:30:01;86318405;86295461;22944;
20.02.2019;09:31:02;86318466;86295573;22893;
20.02.2019;09:32:02;86318509;86295665;22844;
20.02.2019;09:33:02;86318570;86295747;22823;
20.02.2019;09:34:01;86318623;86295886;22737;
20.02.2019;09:35:02;86318681;86296003;22678;
20.02.2019;09:36:02;86318743;86296131;22612;
20.02.2019;09:37:01;86318786;86296254;22532;
20.02.2019;09:38:02;86318857;86296368;22489;
20.02.2019;09:39:02;86318914;86296476;22438;
20.02.2019;09:40:01;86318974;86296583;22391;
20.02.2019;09:41:02;86319014;86296714;22300;
20.02.2019;09:42:02;86319073;86296838;22235;
20.02.2019;09:43:01;86319129;86296966;22163;
20.02.2019;09:44:02;86319160;86297021;22139;
20.02.2019;09:45:02;86319193;86297132;22061;
20.02.2019;09:46:01;86319241;86297248;21993;
20.02.2019;09:47:02;86319308;86297352;21956;
20.02.2019;09:48:02;86319377;86297478;21899;
20.02.2019;09:49:01;86319422;86297578;21844;
20.02.2019;09:50:02;86319465;86297694;21771;
20.02.2019;09:51:02;86319537;86297805;21732;
20.02.2019;09:52:01;86319589;86297907;21682;
20.02.2019;09:53:02;86319648;86298027;21621;
20.02.2019;09:54:02;86319707;86298148;21559;
20.02.2019;09:55:01;86319763;86298267;21496;
20.02.2019;09:56:02;86319808;86298396;21412;
20.02.2019;09:57:02;86319868;86298514;21354;
20.02.2019;09:58:01;86319938;86298661;21277;
20.02.2019;09:59:02;86319998;86298772;21226;
20.02.2019;10:00:02;86320057;86298869;21188;
20.02.2019;10:01:01;86320109;86298971;21138;
20.02.2019;10:02:02;86320173;86299080;21093;
20.02.2019;10:03:02;86320230;86299209;21021;
20.02.2019;10:04:06;86320302;86299361;20941;
20.02.2019;10:05:01;86320368;86299475;20893;
20.02.2019;10:06:02;86320417;86299568;20849;
20.02.2019;10:07:02;86320454;86299650;20804;
20.02.2019;10:08:01;86320493;86299777;20716;
20.02.2019;10:09:02;86320554;86299917;20637;
20.02.2019;10:10:02;86320624;86300025;20599;
20.02.2019;10:11:01;86320669;86300104;20565;
20.02.2019;10:12:02;86320715;86300204;20511;
20.02.2019;10:13:02;86320721;86300291;20430;
20.02.2019;10:14:01;86320753;86300402;20351;
20.02.2019;10:15:02;86320776;86300499;20277;
20.02.2019;10:16:02;86320796;86300607;20189;
20.02.2019;10:17:01;86320840;86300687;20153;
20.02.2019;10:18:02;86320867;86300765;20102;
20.02.2019;10:19:02;86320903;86300853;20050;
20.02.2019;10:20:02;86320957;86300976;19981;
20.02.2019;10:21:01;86321018;86301090;19928;
20.02.2019;10:22:07;86321100;86301206;19894;
20.02.2019;10:23:02;86321176;86301308;19868;
20.02.2019;10:24:01;86321236;86301421;19815;
20.02.2019;10:25:02;86321287;86301540;19747;
20.02.2019;10:26:02;86321361;86301640;19721;
20.02.2019;10:27:02;86321436;86301732;19704;
20.02.2019;10:28:01;86321500;86301859;19641;
20.02.2019;10:29:02;86321558;86302001;19557;
20.02.2019;10:30:02;86321622;86302148;19474;
20.02.2019;10:31:01;86321672;86302281;19391;
20.02.2019;10:32:02;86321735;86302392;19343;
20.02.2019;10:33:02;86321784;86302503;19281;
20.02.2019;10:34:01;86321834;86302631;19203;
20.02.2019;10:35:02;86321900;86302748;19152;
20.02.2019;10:36:02;86321959;86302875;19084;
20.02.2019;10:37:02;86322001;86302994;19007;
20.02.2019;10:38:01;86322061;86303131;18930;
20.02.2019;10:39:02;86322125;86303249;18876;
20.02.2019;10:40:02;86322170;86303344;18826;
20.02.2019;10:41:01;86322240;86303485;18755;
20.02.2019;10:42:02;86322318;86303626;18692;
20.02.2019;10:43:02;86322395;86303752;18643;
20.02.2019;10:44:02;86322455;86303875;18580;
20.02.2019;10:45:02;86322520;86304007;18513;
20.02.2019;10:46:01;86322576;86304100;18476;
20.02.2019;10:47:02;86322641;86304211;18430;
20.02.2019;10:48:02;86322696;86304313;18383;
20.02.2019;10:49:01;86322754;86304411;18343;
20.02.2019;10:50:02;86322790;86304532;18258;
20.02.2019;10:51:03;86322858;86304629;18229;
20.02.2019;10:52:02;86322931;86304760;18171;
20.02.2019;10:53:01;86322972;86304859;18113;
20.02.2019;10:54:02;86323059;86304980;18079;
20.02.2019;10:55:02;86323129;86305094;18035;
20.02.2019;10:56:02;86323203;86305197;18006;
20.02.2019;10:57:02;86323285;86305319;17966;
20.02.2019;10:58:02;86323346;86305443;17903;
20.02.2019;10:59:02;86323439;86305602;17837;
20.02.2019;11:00:02;86323497;86305716;17781;
20.02.2019;11:01:02;86323564;86305841;17723;
20.02.2019;11:02:01;86323626;86305984;17642;
20.02.2019;11:03:02;86323686;86306113;17573;
20.02.2019;11:04:02;86323737;86306247;17490;
20.02.2019;11:05:02;86323792;86306348;17444;
20.02.2019;11:06:02;86323848;86306459;17389;
20.02.2019;11:07:02;86323908;86306608;17300;
20.02.2019;11:08:02;86323966;86306744;17222;
20.02.2019;11:09:02;86324035;86306860;17175;
20.02.2019;11:10:02;86324095;86306965;17130;
20.02.2019;11:11:02;86324161;86307078;17083;
20.02.2019;11:12:02;86324229;86307208;17021;
20.02.2019;11:13:01;86324296;86307316;16980;
20.02.2019;11:14:01;86324356;86307450;16906;
20.02.2019;11:15:02;86324432;86307566;16866;
20.02.2019;11:16:02;86324503;86307697;16806;
20.02.2019;11:17:02;86324568;86307811;16757;
20.02.2019;11:18:02;86324640;86307948;16692;
20.02.2019;11:19:01;86324717;86308069;16648;
20.02.2019;11:20:02;86324790;86308205;16585;
20.02.2019;11:21:02;86324837;86308305;16532;
20.02.2019;11:22:02;86324905;86308427;16478;
20.02.2019;11:23:02;86324979;86308546;16433;
20.02.2019;11:24:02;86325031;86308649;16382;
20.02.2019;11:25:02;86325105;86308776;16329;
20.02.2019;11:26:01;86325176;86308893;16283;
20.02.2019;11:27:02;86325249;86309015;16234;
20.02.2019;11:28:02;86325313;86309167;16146;
20.02.2019;11:29:02;86325382;86309289;16093;
20.02.2019;11:30:02;86325441;86309406;16035;
20.02.2019;11:31:02;86325496;86309520;15976;
20.02.2019;11:32:01;86325566;86309641;15925;
20.02.2019;11:33:03;86325656;86309762;15894;
20.02.2019;11:34:01;86325729;86309874;15855;
20.02.2019;11:35:02;86325816;86309961;15855;
20.02.2019;11:36:02;86325880;86310027;15853;
20.02.2019;11:37:02;86325945;86310114;15831;
20.02.2019;11:38:02;86326006;86310206;15800;
20.02.2019;11:39:01;86326093;86310279;15814;
20.02.2019;11:40:02;86326164;86310361;15803;
20.02.2019;11:41:02;86326236;86310470;15766;
20.02.2019;11:43:02;86326373;86310667;15706;
20.02.2019;11:44:01;86326444;86310765;15679;
20.02.2019;11:45:02;86326520;86310851;15669;
20.02.2019;11:46:02;86326601;86310971;15630;
20.02.2019;11:47:02;86326663;86311051;15612;
20.02.2019;11:48:01;86326724;86311165;15559;
20.02.2019;11:49:02;86326822;86311274;15548;
20.02.2019;11:50:02;86326872;86311380;15492;
20.02.2019;11:51:01;86326946;86311498;15448;
20.02.2019;11:52:02;86327018;86311608;15410;
20.02.2019;11:53:02;86327090;86311719;15371;
20.02.2019;11:54:02;86327145;86311834;15311;
20.02.2019;11:55:02;86327224;86311940;15284;
20.02.2019;11:56:01;86327288;86312023;15265;
20.02.2019;11:57:02;86327354;86312142;15212;
20.02.2019;11:58:02;86327422;86312258;15164;
20.02.2019;11:59:01;86327493;86312380;15113;
20.02.2019;12:00:02;86327549;86312489;15060;
20.02.2019;12:01:02;86327631;86312609;15022;
20.02.2019;12:02:01;86327706;86312727;14979;
20.02.2019;12:03:02;86327769;86312852;14917;
20.02.2019;12:04:02;86327836;86312943;14893;
20.02.2019;12:05:01;86327903;86313080;14823;
20.02.2019;12:06:02;86327976;86313234;14742;
20.02.2019;12:07:02;86328048;86313333;14715;
20.02.2019;12:08:01;86328048;86313393;14655;
20.02.2019;12:09:02;86328073;86313427;14646;
20.02.2019;12:10:02;86328067;86313481;14586;
20.02.2019;12:11:02;86328069;86313548;14521;
20.02.2019;12:12:01;86328118;86313645;14473;
20.02.2019;12:13:01;86328172;86313766;14406;
20.02.2019;12:14:02;86328243;86313908;14335;
20.02.2019;12:15:02;86328320;86313998;14322;
20.02.2019;12:16:01;86328384;86314101;14283;
20.02.2019;12:17:02;86328469;86314216;14253;
20.02.2019;12:18:02;86328532;86314338;14194;
20.02.2019;12:19:01;86328613;86314450;14163;
20.02.2019;12:20:02;86328687;86314567;14120;
20.02.2019;12:21:02;86328795;86314667;14128;
20.02.2019;12:22:02;86328872;86314770;14102;
20.02.2019;12:23:02;86328937;86314896;14041;
20.02.2019;12:24:02;86329015;86315015;14000;
20.02.2019;12:25:02;86329084;86315150;13934;
20.02.2019;12:26:02;86329158;86315291;13867;
20.02.2019;12:27:02;86329231;86315404;13827;
20.02.2019;12:28:07;86329307;86315539;13768;
20.02.2019;12:29:01;86329372;86315654;13718;
20.02.2019;12:30:02;86329456;86315791;13665;
20.02.2019;12:31:04;86329530;86315890;13640;
20.02.2019;12:32:06;86329617;86316008;13609;
20.02.2019;12:33:02;86329678;86316129;13549;
20.02.2019;12:34:02;86329758;86316251;13507;
20.02.2019;12:35:01;86329834;86316403;13431;
20.02.2019;12:36:02;86329911;86316518;13393;
20.02.2019;12:37:02;86329995;86316611;13384;
20.02.2019;12:38:02;86330079;86316717;13362;
20.02.2019;12:39:01;86330152;86316832;13320;
20.02.2019;12:40:02;86330249;86316972;13277;
20.02.2019;12:41:02;86330247;86316987;13260;
20.02.2019;12:42:02;86329846;86316290;13556;
20.02.2019;12:43:01;86329857;86316326;13531;
20.02.2019;12:44:02;86329951;86316453;13498;
20.02.2019;12:45:02;86330025;86316557;13468;
20.02.2019;12:46:02;86330092;86316663;13429;
20.02.2019;12:47:02;86330164;86316790;13374;
20.02.2019;12:48:01;86330222;86316904;13318;
20.02.2019;12:49:02;86330305;86317031;13274;
20.02.2019;12:50:02;86330399;86317117;13282;
20.02.2019;12:51:01;86330487;86317247;13240;
20.02.2019;12:52:02;86330566;86317352;13214;
20.02.2019;12:53:02;86330639;86317475;13164;
20.02.2019;12:54:02;86330728;86317625;13103;
20.02.2019;12:55:01;86330796;86317735;13061;
20.02.2019;12:56:02;86330889;86317852;13037;
20.02.2019;12:57:02;86330966;86317956;13010;
20.02.2019;12:58:01;86331057;86318092;12965;
20.02.2019;12:59:02;86331145;86318223;12922;
20.02.2019;13:00:02;86331238;86318360;12878;
20.02.2019;13:01:03;86331327;86318490;12837;
20.02.2019;13:02:02;86331400;86318614;12786;
20.02.2019;13:03:01;86331481;86318734;12747;
20.02.2019;13:04:02;86331573;86318875;12698;
20.02.2019;13:05:02;86331671;86318985;12686;
20.02.2019;13:06:01;86331754;86319103;12651;
20.02.2019;13:07:02;86331855;86319220;12635;
20.02.2019;13:08:02;86331945;86319315;12630;
20.02.2019;13:09:01;86332023;86319436;12587;
20.02.2019;13:10:02;86332110;86319534;12576;
20.02.2019;13:11:02;86332206;86319638;12568;
20.02.2019;13:13:02;86332338;86319888;12450;
20.02.2019;13:14:02;86332423;86320012;12411;
20.02.2019;13:15:01;86332500;86320144;12356;
20.02.2019;13:16:02;86332572;86320242;12330;
20.02.2019;13:17:02;86332665;86320383;12282;
20.02.2019;13:18:01;86332753;86320493;12260;
20.02.2019;13:19:02;86332834;86320634;12200;
20.02.2019;13:20:02;86332942;86320770;12172;
20.02.2019;13:21:02;86333012;86320873;12139;
20.02.2019;13:22:02;86333096;86320990;12106;
20.02.2019;13:23:01;86333158;86321109;12049;
20.02.2019;13:24:03;86333253;86321229;12024;
20.02.2019;13:25:02;86333350;86321343;12007;
20.02.2019;13:26:02;86333439;86321453;11986;
20.02.2019;13:27:02;86333523;86321584;11939;
20.02.2019;13:29:02;86333722;86321838;11884;
20.02.2019;13:30:01;86333824;86321962;11862;
20.02.2019;13:31:02;86333934;86322101;11833;
20.02.2019;13:32:02;86334040;86322234;11806;
20.02.2019;13:33:02;86334153;86322347;11806;
20.02.2019;13:34:01;86334258;86322483;11775;
20.02.2019;13:35:02;86334352;86322590;11762;
20.02.2019;13:36:02;86334470;86322697;11773;
20.02.2019;13:37:02;86334544;86322821;11723;
20.02.2019;13:38:02;86334648;86322924;11724;
20.02.2019;13:39:02;86334740;86323045;11695;
20.02.2019;13:40:02;86334838;86323178;11660;
20.02.2019;13:41:02;86334909;86323303;11606;
20.02.2019;13:42:02;86334993;86323416;11577;
20.02.2019;13:43:02;86335084;86323552;11532;
20.02.2019;13:44:02;86335171;86323682;11489;
20.02.2019;13:45:01;86335267;86323834;11433;
20.02.2019;13:46:02;86335360;86323943;11417;
20.02.2019;13:47:02;86335452;86324049;11403;
20.02.2019;13:48:02;86335564;86324175;11389;
20.02.2019;13:49:02;86335691;86324282;11409;
20.02.2019;13:50:02;86335791;86324367;11424;
20.02.2019;13:51:02;86335901;86324476;11425;
20.02.2019;13:52:01;86335992;86324611;11381;
20.02.2019;13:53:03;86336108;86324747;11361;
20.02.2019;13:54:01;86336205;86324864;11341;
20.02.2019;13:55:02;86336310;86325024;11286;
20.02.2019;13:56:02;86336404;86325156;11248;
20.02.2019;13:57:02;86336500;86325274;11226;
20.02.2019;13:58:02;86336618;86325407;11211;
20.02.2019;13:59:02;86336721;86325522;11199;
20.02.2019;14:00:02;86336844;86325653;11191;
20.02.2019;14:01:02;86336949;86325787;11162;
20.02.2019;14:02:02;86337050;86325908;11142;
20.02.2019;14:03:02;86337140;86326021;11119;
20.02.2019;14:04:01;86337239;86326136;11103;
20.02.2019;14:05:02;86337360;86326247;11113;
20.02.2019;14:06:02;86337455;86326380;11075;
20.02.2019;14:07:02;86337562;86326497;11065;
20.02.2019;14:08:02;86337667;86326608;11059;
20.02.2019;14:09:01;86337763;86326736;11027;
20.02.2019;14:10:02;86337862;86326873;10989;
20.02.2019;14:11:02;86337931;86327005;10926;
20.02.2019;14:12:03;86338007;86327110;10897;
20.02.2019;14:13:01;86338089;86327187;10902;
20.02.2019;14:14:02;86338182;86327304;10878;
20.02.2019;14:15:02;86338268;86327424;10844;
20.02.2019;14:16:02;86338351;86327575;10776;
20.02.2019;14:17:02;86338423;86327687;10736;
20.02.2019;14:18:03;86338532;86327803;10729;
20.02.2019;14:19:01;86338594;86327917;10677;
20.02.2019;14:20:02;86338665;86328012;10653;
20.02.2019;14:21:02;86338738;86328122;10616;
20.02.2019;14:22:02;86338817;86328259;10558;
20.02.2019;14:23:02;86338889;86328363;10526;
20.02.2019;14:24:02;86338986;86328487;10499;
20.02.2019;14:25:02;86339074;86328615;10459;
20.02.2019;14:26:02;86339160;86328724;10436;
20.02.2019;14:27:01;86339221;86328832;10389;
20.02.2019;14:28:02;86339320;86328970;10350;
20.02.2019;14:29:02;86339435;86329093;10342;
20.02.2019;14:30:02;86339535;86329256;10279;
20.02.2019;14:31:02;86339648;86329382;10266;
20.02.2019;14:32:02;86339768;86329527;10241;
20.02.2019;14:33:02;86339860;86329661;10199;
20.02.2019;14:34:02;86339983;86329819;10164;
20.02.2019;14:35:01;86340102;86329962;10140;
20.02.2019;14:36:02;86340200;86330071;10129;
20.02.2019;14:37:02;86340312;86330200;10112;
20.02.2019;14:38:02;86340405;86330339;10066;
20.02.2019;14:39:02;86340526;86330472;10054;
20.02.2019;14:40:02;86340662;86330575;10087;
20.02.2019;14:41:02;86340777;86330720;10057;
20.02.2019;14:42:02;86340905;86330874;10031;
20.02.2019;14:43:02;86341006;86330994;10012;
20.02.2019;14:44:03;86341137;86331128;10009;
20.02.2019;14:45:02;86341298;86331246;10052;
20.02.2019;14:46:02;86341424;86331388;10036;
20.02.2019;14:47:01;86341527;86331526;10001;
20.02.2019;14:48:03;86341644;86331677;9967;
20.02.2019;14:49:02;86341772;86331847;9925;
20.02.2019;14:50:02;86341929;86332016;9913;
20.02.2019;14:51:02;86342087;86332190;9897;
20.02.2019;14:52:02;86342233;86332340;9893;
20.02.2019;14:53:01;86342371;86332499;9872;
20.02.2019;14:54:02;86342517;86332649;9868;
20.02.2019;14:55:02;86342646;86332820;9826;
20.02.2019;14:56:01;86342773;86332967;9806;
20.02.2019;14:57:02;86342923;86333152;9771;
20.02.2019;14:58:02;86343039;86333288;9751;
20.02.2019;14:59:02;86343176;86333427;9749;
20.02.2019;15:00:02;86343302;86333570;9732;
20.02.2019;15:01:01;86343432;86333686;9746;
20.02.2019;15:02:02;86343520;86333852;9668;
20.02.2019;15:03:02;86343701;86334026;9675;
20.02.2019;15:04:02;86343822;86334173;9649;
20.02.2019;15:05:05;86343964;86334322;9642;
20.02.2019;15:06:02;86344109;86334450;9659;
20.02.2019;15:07:02;86344221;86334595;9626;
20.02.2019;15:08:01;86344340;86334737;9603;
20.02.2019;15:09:02;86344459;86334893;9566;
20.02.2019;15:10:02;86344568;86335041;9527;
20.02.2019;15:11:02;86344710;86335230;9480;
20.02.2019;15:12:02;86344866;86335397;9469;
20.02.2019;15:13:01;86345005;86335540;9465;
20.02.2019;15:14:02;86345156;86335657;9499;
20.02.2019;15:15:02;86345293;86335812;9481;
20.02.2019;15:16:02;86345425;86335950;9475;
20.02.2019;15:17:02;86345571;86336107;9464;
20.02.2019;15:18:01;86345689;86336260;9429;
20.02.2019;15:19:02;86345836;86336396;9440;
20.02.2019;15:20:02;86345982;86336559;9423;
20.02.2019;15:21:02;86346136;86336697;9439;
20.02.2019;15:22:02;86346298;86336864;9434;
20.02.2019;15:23:02;86346440;86337022;9418;
20.02.2019;15:24:02;86346595;86337191;9404;
20.02.2019;15:25:01;86346739;86337351;9388;
20.02.2019;15:26:02;86346864;86337494;9370;
20.02.2019;15:27:02;86346994;86337662;9332;
20.02.2019;15:28:02;86347101;86337804;9297;
20.02.2019;15:29:02;86347249;86337994;9255;
20.02.2019;15:30:02;86347366;86338193;9173;
20.02.2019;15:31:02;86347510;86338347;9163;
20.02.2019;15:32:01;86347620;86338505;9115;
20.02.2019;15:33:02;86347743;86338679;9064;
20.02.2019;15:34:02;86347886;86338854;9032;
20.02.2019;15:35:02;86348049;86339021;9028;
20.02.2019;15:36:01;86348207;86339182;9025;
20.02.2019;15:37:02;86348383;86339352;9031;
20.02.2019;15:38:02;86348558;86339515;9043;
20.02.2019;15:39:02;86348732;86339687;9045;
20.02.2019;15:40:01;86348880;86339869;9011;
20.02.2019;15:41:01;86349023;86340034;8989;
20.02.2019;15:42:02;86349190;86340193;8997;
20.02.2019;15:43:02;86349369;86340327;9042;
20.02.2019;15:44:02;86349549;86340484;9065;
20.02.2019;15:45:02;86349679;86340652;9027;
20.02.2019;15:46:02;86349840;86340828;9012;
20.02.2019;15:47:02;86350012;86340994;9018;
20.02.2019;15:48:02;86350179;86341150;9029;
20.02.2019;15:49:01;86350325;86341316;9009;
20.02.2019;15:50:02;86350478;86341472;9006;
20.02.2019;15:51:02;86350630;86341648;8982;
20.02.2019;15:52:02;86350787;86341819;8968;
20.02.2019;15:53:02;86350943;86341991;8952;
20.02.2019;15:54:02;86351075;86342151;8924;
20.02.2019;15:55:02;86351228;86342303;8925;
20.02.2019;15:56:01;86351359;86342493;8866;
20.02.2019;15:57:02;86351513;86342688;8825;
20.02.2019;15:58:02;86351645;86342844;8801;
20.02.2019;15:59:02;86351756;86343002;8754;
20.02.2019;16:00:02;86351989;86343170;8819;
20.02.2019;16:01:02;86352179;86343309;8870;
20.02.2019;16:02:02;86352339;86343493;8846;
20.02.2019;16:03:02;86352487;86343652;8835;
20.02.2019;16:04:06;86352631;86343808;8823;
20.02.2019;16:05:02;86352772;86343972;8800;
20.02.2019;16:06:02;86352921;86344113;8808;
20.02.2019;16:07:02;86353060;86344269;8791;
20.02.2019;16:08:02;86353222;86344436;8786;
20.02.2019;16:09:02;86353355;86344574;8781;
20.02.2019;16:10:02;86353488;86344739;8749;
20.02.2019;16:11:02;86353630;86344891;8739;
20.02.2019;16:12:02;86353737;86344998;8739;
20.02.2019;16:13:02;86353851;86345141;8710;
20.02.2019;16:14:02;86353975;86345318;8657;
20.02.2019;16:15:02;86354104;86345477;8627;
20.02.2019;16:16:02;86354232;86345629;8603;
20.02.2019;16:17:02;86354385;86345807;8578;
20.02.2019;16:18:01;86354522;86345973;8549;
20.02.2019;16:19:02;86354650;86346134;8516;
20.02.2019;16:20:02;86354808;86346281;8527;
20.02.2019;16:21:03;86354955;86346466;8489;
20.02.2019;16:22:02;86355057;86346638;8419;
20.02.2019;16:23:02;86355211;86346863;8348;
20.02.2019;16:24:01;86355355;86347029;8326;
20.02.2019;16:25:02;86355481;86347181;8300;
20.02.2019;16:26:02;86355587;86347343;8244;
20.02.2019;16:27:02;86355757;86347497;8260;
20.02.2019;16:28:02;86355913;86347669;8244;
20.02.2019;16:29:01;86356081;86347905;8176;
20.02.2019;16:30:03;86356233;86348167;8066;
20.02.2019;16:31:01;86356367;86348396;7971;
20.02.2019;16:32:02;86356523;86348591;7932;
20.02.2019;16:33:03;86356690;86348785;7905;
20.02.2019;16:34:02;86356819;86348930;7889;
20.02.2019;16:35:02;86356959;86349120;7839;
20.02.2019;16:36:02;86357130;86349291;7839;
20.02.2019;16:37:01;86357306;86349476;7830;
20.02.2019;16:38:02;86357461;86349652;7809;
20.02.2019;16:39:02;86357613;86349807;7806;
20.02.2019;16:40:02;86357796;86350037;7759;
20.02.2019;16:41:02;86358001;86350256;7745;
20.02.2019;16:42:02;86358150;86350486;7664;
20.02.2019;16:43:02;86358317;86350724;7593;
20.02.2019;16:44:22;86358564;86350959;7605;
20.02.2019;16:45:23;86358763;86351158;7605;
20.02.2019;16:47:02;86359081;86351474;7607;
20.02.2019;16:48:02;86359265;86351684;7581;
20.02.2019;16:49:02;86359447;86351870;7577;
20.02.2019;16:50:02;86359627;86352040;7587;
20.02.2019;16:51:02;86359818;86352223;7595;
20.02.2019;16:52:02;86360036;86352411;7625;
20.02.2019;16:53:01;86360259;86352584;7675;
20.02.2019;16:54:02;86360466;86352775;7691;
20.02.2019;16:55:02;86360659;86352978;7681;
20.02.2019;16:56:02;86360842;86353155;7687;
20.02.2019;16:57:01;86360991;86353342;7649;
20.02.2019;16:58:02;86361166;86353554;7612;
20.02.2019;16:59:02;86361341;86353774;7567;
20.02.2019;17:00:02;86361526;86353943;7583;
20.02.2019;17:01:02;86361665;86354135;7530;
20.02.2019;17:02:02;86361814;86354306;7508;
20.02.2019;17:03:02;86361985;86354493;7492;
20.02.2019;17:04:01;86362137;86354688;7449;
20.02.2019;17:05:02;86362321;86354852;7469;
20.02.2019;17:06:16;86362535;86355056;7479;
20.02.2019;17:07:02;86362702;86355221;7481;
20.02.2019;17:08:02;86362900;86355415;7485;
20.02.2019;17:09:02;86363116;86355588;7528;
20.02.2019;17:10:18;86363415;86355814;7601;
20.02.2019;17:11:02;86363588;86355934;7654;
20.02.2019;17:12:02;86363835;86356105;7730;
20.02.2019;17:13:05;86364081;86356272;7809;
20.02.2019;17:14:02;86364340;86356446;7894;
20.02.2019;17:15:02;86364556;86356639;7917;
20.02.2019;17:16:01;86364735;86356795;7940;
20.02.2019;17:17:02;86364944;86356949;7995;
20.02.2019;17:18:02;86365140;86357118;8022;
20.02.2019;17:19:02;86365314;86357304;8010;
20.02.2019;17:20:02;86365504;86357485;8019;
20.02.2019;17:21:02;86365731;86357680;8051;
20.02.2019;17:22:01;86365911;86357882;8029;
20.02.2019;17:23:02;86366106;86358054;8052;
20.02.2019;17:24:02;86366296;86358241;8055;
20.02.2019;17:25:01;86366469;86358429;8040;
20.02.2019;17:26:02;86366656;86358623;8033;
20.02.2019;17:27:02;86366820;86358795;8025;
20.02.2019;17:28:02;86367003;86358982;8021;
20.02.2019;17:29:01;86367167;86359192;7975;
20.02.2019;17:30:02;86367368;86359390;7978;
20.02.2019;17:31:02;86367548;86359458;8090;
20.02.2019;17:32:02;86367762;86359701;8061;
20.02.2019;17:33:02;86367975;86359899;8076;
20.02.2019;17:34:02;86368143;86360096;8047;
20.02.2019;17:35:01;86368335;86360281;8054;
20.02.2019;17:36:02;86368532;86360460;8072;
20.02.2019;17:37:02;86368732;86360650;8082;
20.02.2019;17:38:02;86368900;86360813;8087;
20.02.2019;17:39:01;86369069;86360981;8088;
20.02.2019;17:40:02;86369247;86361129;8118;
20.02.2019;17:41:02;86369442;86361303;8139;
20.02.2019;17:42:01;86369592;86361482;8110;
20.02.2019;17:43:02;86369764;86361606;8158;
20.02.2019;17:44:02;86369937;86361781;8156;
20.02.2019;17:45:02;86370113;86361956;8157;
20.02.2019;17:46:01;86370288;86362115;8173;
20.02.2019;17:47:02;86370481;86362282;8199;
20.02.2019;17:48:02;86370653;86362447;8206;
20.02.2019;17:49:02;86370844;86362607;8237;
20.02.2019;17:50:01;86370999;86362797;8202;
20.02.2019;17:51:02;86371164;86362991;8173;
20.02.2019;17:52:03;86371340;86363169;8171;
20.02.2019;17:53:01;86371495;86363337;8158;
20.02.2019;17:54:02;86371644;86363506;8138;
20.02.2019;17:55:02;86371840;86363668;8172;
20.02.2019;17:56:02;86371986;86363842;8144;
20.02.2019;17:57:02;86372158;86364013;8145;
20.02.2019;17:58:01;86372347;86364193;8154;
20.02.2019;17:59:02;86372548;86364362;8186;
20.02.2019;18:00:02;86372704;86364514;8190;
20.02.2019;18:01:02;86372873;86364700;8173;
20.02.2019;18:02:01;86373054;86364868;8186;
20.02.2019;18:03:02;86373204;86365018;8186;
20.02.2019;18:04:02;86373352;86365198;8154;
20.02.2019;18:05:01;86373510;86365337;8173;
20.02.2019;18:06:02;86373636;86365484;8152;
20.02.2019;18:07:02;86373777;86365637;8140;
20.02.2019;18:08:02;86373959;86365741;8218;
20.02.2019;18:09:01;86374089;86365881;8208;
20.02.2019;18:10:02;86374193;86366037;8156;
20.02.2019;18:11:02;86374295;86366156;8139;
20.02.2019;18:12:02;86374406;86366293;8113;
20.02.2019;18:13:01;86374546;86366406;8140;
20.02.2019;18:14:02;86374700;86366511;8189;
20.02.2019;18:15:02;86374823;86366603;8220;
20.02.2019;18:16:04;86374980;86366773;8207;
20.02.2019;18:17:03;86375082;86366904;8178;
20.02.2019;18:18:02;86375213;86367050;8163;
20.02.2019;18:19:02;86375325;86367187;8138;
20.02.2019;18:20:01;86375444;86367374;8070;
20.02.2019;18:21:02;86375598;86367517;8081;
20.02.2019;18:22:02;86375758;86367655;8103;
20.02.2019;18:23:02;86375872;86367788;8084;
20.02.2019;18:24:02;86376007;86367925;8082;
20.02.2019;18:25:02;86376159;86368055;8104;
20.02.2019;18:26:02;86376331;86368200;8131;
20.02.2019;18:27:03;86376518;86368317;8201;
20.02.2019;18:28:02;86376693;86368429;8264;
20.02.2019;18:29:02;86376861;86368541;8320;
20.02.2019;18:30:02;86377008;86368653;8355;
20.02.2019;18:31:01;86377161;86368766;8395;
20.02.2019;18:32:02;86377331;86368877;8454;
20.02.2019;18:33:02;86377466;86369016;8450;
20.02.2019;18:34:02;86377618;86369140;8478;
20.02.2019;18:35:01;86377751;86369269;8482;
20.02.2019;18:36:02;86377898;86369359;8539;
20.02.2019;18:37:02;86378010;86369490;8520;
20.02.2019;18:38:02;86378113;86369610;8503;
20.02.2019;18:39:01;86378273;86369713;8560;
20.02.2019;18:40:02;86378420;86369820;8600;
20.02.2019;18:41:02;86378552;86369938;8614;
20.02.2019;18:42:01;86378679;86370028;8651;
20.02.2019;18:43:02;86378790;86370136;8654;
20.02.2019;18:44:05;86378927;86370254;8673;
20.02.2019;18:45:02;86379017;86370359;8658;
20.02.2019;18:46:06;86379160;86370465;8695;
20.02.2019;18:47:02;86379304;86370587;8717;
20.02.2019;18:48:03;86379488;86370719;8769;
20.02.2019;18:49:04;86379644;86370842;8802;
20.02.2019;18:50:06;86379814;86370990;8824;
20.02.2019;18:51:03;86379964;86371104;8860;
20.02.2019;18:52:10;86380154;86371249;8905;
20.02.2019;18:53:12;86380345;86371392;8953;
20.02.2019;18:54:15;86380538;86371545;8993;
20.02.2019;18:55:14;86380702;86371694;9008;
20.02.2019;18:56:09;86380873;86371824;9049;
20.02.2019;18:57:12;86381014;86371961;9053;
20.02.2019;18:58:14;86381192;86372104;9088;
20.02.2019;18:59:15;86381389;86372271;9118;
20.02.2019;19:00:17;86381589;86372404;9185;
20.02.2019;19:01:18;86381779;86372539;9240;
20.02.2019;19:02:12;86381920;86372649;9271;
20.02.2019;19:03:14;86382082;86372791;9291;
20.02.2019;19:04:11;86382264;86372889;9375;
20.02.2019;19:05:09;86382434;86373022;9412;
20.02.2019;19:06:10;86382620;86373119;9501;
20.02.2019;19:07:06;86382771;86373214;9557;
20.02.2019;19:08:10;86382893;86373249;9644;
20.02.2019;19:09:08;86383010;86373361;9649;
20.02.2019;19:10:06;86383042;86373460;9582;
20.02.2019;19:11:07;86383163;86373582;9581;
20.02.2019;19:12:07;86383324;86373731;9593;
20.02.2019;19:13:07;86383477;86373843;9634;
20.02.2019;19:14:03;86383674;86373975;9699;
20.02.2019;19:15:07;86383877;86374084;9793;
20.02.2019;19:16:08;86384087;86374192;9895;
20.02.2019;19:17:06;86384247;86374297;9950;
20.02.2019;19:18:06;86384375;86374398;9977;
20.02.2019;19:19:03;86384639;86374509;10130;
20.02.2019;19:20:03;86384836;86374624;10212;
20.02.2019;19:21:08;86384992;86374753;10239;
20.02.2019;19:22:07;86385168;86374874;10294;
20.02.2019;19:23:05;86385338;86374937;10401;
20.02.2019;19:24:02;86385531;86375071;10460;
20.02.2019;19:25:07;86385715;86375179;10536;
20.02.2019;19:26:05;86385917;86375250;10667;
20.02.2019;19:27:04;86386089;86375338;10751;
20.02.2019;19:28:05;86386279;86375421;10858;
20.02.2019;19:29:09;86386473;86375534;10939;
20.02.2019;19:30:11;86386658;86375645;11013;
20.02.2019;19:31:14;86386880;86375739;11141;
20.02.2019;19:32:21;86387085;86375838;11247;
20.02.2019;19:33:09;86387238;86375929;11309;
20.02.2019;19:34:13;86387444;86376014;11430;
20.02.2019;19:35:10;86387645;86376119;11526;
20.02.2019;19:36:02;86387802;86376219;11583;
20.02.2019;19:37:02;86387983;86376309;11674;
20.02.2019;19:38:02;86388144;86376372;11772;
20.02.2019;19:39:02;86388311;86376469;11842;
20.02.2019;19:40:01;86388477;86376550;11927;
20.02.2019;19:41:02;86388688;86376642;12046;
20.02.2019;19:42:02;86388900;86376730;12170;
20.02.2019;19:43:02;86389066;86376799;12267;
20.02.2019;19:44:02;86389246;86376897;12349;
20.02.2019;19:45:01;86389436;86376971;12465;
20.02.2019;19:46:01;86389622;86377058;12564;
20.02.2019;19:47:02;86389812;86377151;12661;
20.02.2019;19:48:02;86389964;86377242;12722;
20.02.2019;19:49:02;86390117;86377307;12810;
20.02.2019;19:50:01;86390315;86377366;12949;
20.02.2019;19:51:02;86390454;86377443;13011;
20.02.2019;19:52:02;86390646;86377537;13109;
20.02.2019;19:53:02;86390810;86377634;13176;
20.02.2019;19:54:02;86390957;86377689;13268;
20.02.2019;19:55:02;86391139;86377759;13380;
20.02.2019;19:56:01;86391330;86377851;13479;
20.02.2019;19:57:02;86391525;86377937;13588;
20.02.2019;19:58:02;86391735;86377987;13748;
20.02.2019;19:59:02;86391873;86378100;13773;
20.02.2019;20:00:02;86392107;86378158;13949;
20.02.2019;20:01:02;86392300;86378233;14067;
20.02.2019;20:02:02;86392454;86378291;14163;
20.02.2019;20:03:01;86392654;86378362;14292;
20.02.2019;20:04:02;86392787;86378442;14345;
20.02.2019;20:05:02;86393009;86378503;14506;
20.02.2019;20:06:02;86393173;86378578;14595;
20.02.2019;20:07:02;86393341;86378644;14697;
20.02.2019;20:08:02;86393492;86378723;14769;
20.02.2019;20:09:02;86393668;86378806;14862;
20.02.2019;20:10:02;86393831;86378853;14978;
20.02.2019;20:11:02;86393976;86378945;15031;
20.02.2019;20:12:02;86394111;86378999;15112;
20.02.2019;20:13:01;86394253;86379072;15181;
20.02.2019;20:14:02;86394238;86379065;15173;
20.02.2019;20:15:02;86394121;86378995;15126;
20.02.2019;20:16:02;86393995;86378965;15030;
20.02.2019;20:17:02;86394082;86379000;15082;
20.02.2019;20:18:02;86394216;86379065;15151;
20.02.2019;20:19:02;86394361;86379129;15232;
20.02.2019;20:20:01;86394512;86379185;15327;
20.02.2019;20:21:01;86394629;86379242;15387;
20.02.2019;20:22:02;86394778;86379304;15474;
20.02.2019;20:23:02;86394943;86379355;15588;
20.02.2019;20:24:02;86395086;86379403;15683;
20.02.2019;20:25:02;86395209;86379472;15737;
20.02.2019;20:26:01;86395341;86379527;15814;
20.02.2019;20:27:03;86395461;86379598;15863;
20.02.2019;20:28:02;86395625;86379655;15970;
20.02.2019;20:29:02;86395763;86379726;16037;
20.02.2019;20:30:02;86395900;86379787;16113;
20.02.2019;20:31:02;86396042;86379831;16211;
20.02.2019;20:32:02;86396182;86379891;16291;
20.02.2019;20:33:01;86396319;86379935;16384;
20.02.2019;20:34:02;86396460;86379985;16475;
20.02.2019;20:35:02;86396602;86380050;16552;
20.02.2019;20:36:02;86396745;86380116;16629;
20.02.2019;20:37:02;86396880;86380193;16687;
20.02.2019;20:38:02;86397043;86380256;16787;
20.02.2019;20:39:02;86397212;86380319;16893;
20.02.2019;20:40:02;86397377;86380378;16999;
20.02.2019;20:41:01;86397522;86380429;17093;
20.02.2019;20:42:02;86397649;86380501;17148;
20.02.2019;20:43:02;86397787;86380561;17226;
20.02.2019;20:44:02;86397928;86380609;17319;
20.02.2019;20:45:02;86398085;86380657;17428;
20.02.2019;20:46:02;86398251;86380707;17544;
20.02.2019;20:47:01;86398399;86380774;17625;
20.02.2019;20:48:02;86398577;86380827;17750;
20.02.2019;20:49:02;86398700;86380882;17818;
20.02.2019;20:50:02;86398840;86380918;17922;
20.02.2019;20:51:02;86399009;86380983;18026;
20.02.2019;20:52:02;86399144;86381039;18105;
20.02.2019;20:53:02;86399322;86381094;18228;
20.02.2019;20:54:01;86399480;86381158;18322;
20.02.2019;20:55:02;86399626;86381201;18425;
20.02.2019;20:56:02;86399758;86381240;18518;
20.02.2019;20:57:02;86399910;86381282;18628;
20.02.2019;20:58:02;86400054;86381327;18727;
20.02.2019;20:59:02;86400201;86381372;18829;
20.02.2019;21:00:01;86400365;86381410;18955;
20.02.2019;21:01:02;86400499;86381466;19033;
20.02.2019;21:02:02;86400666;86381508;19158;
20.02.2019;21:03:02;86400819;86381562;19257;
20.02.2019;21:04:02;86400985;86381606;19379;
20.02.2019;21:05:01;86401114;86381664;19450;
20.02.2019;21:06:02;86401264;86381707;19557;
20.02.2019;21:07:02;86401400;86381758;19642;
20.02.2019;21:08:02;86401551;86381809;19742;
20.02.2019;21:09:02;86401679;86381852;19827;
20.02.2019;21:10:02;86401823;86381902;19921;
20.02.2019;21:11:02;86402001;86381952;20049;
20.02.2019;21:12:02;86402143;86382000;20143;
20.02.2019;21:13:02;86402296;86382052;20244;
20.02.2019;21:14:02;86402431;86382114;20317;
20.02.2019;21:15:01;86402565;86382157;20408;
20.02.2019;21:16:02;86402693;86382200;20493;
20.02.2019;21:17:02;86402819;86382256;20563;
20.02.2019;21:18:02;86402942;86382297;20645;
20.02.2019;21:19:02;86403085;86382331;20754;
20.02.2019;21:20:02;86403208;86382388;20820;
20.02.2019;21:21:02;86403369;86382425;20944;
20.02.2019;21:22:02;86403492;86382459;21033;
20.02.2019;21:23:02;86403623;86382505;21118;
20.02.2019;21:24:01;86403732;86382538;21194;
20.02.2019;21:25:02;86403888;86382603;21285;
20.02.2019;21:26:02;86404022;86382649;21373;
20.02.2019;21:27:02;86404130;86382691;21439;
20.02.2019;21:28:02;86404260;86382746;21514;
20.02.2019;21:29:01;86404410;86382770;21640;
20.02.2019;21:30:02;86404530;86382811;21719;
20.02.2019;21:31:02;86404685;86382847;21838;
20.02.2019;21:32:02;86404817;86382908;21909;
20.02.2019;21:33:01;86404953;86382937;22016;
20.02.2019;21:34:01;86405074;86382998;22076;
20.02.2019;21:35:02;86405201;86383051;22150;
20.02.2019;21:36:02;86405321;86383093;22228;
20.02.2019;21:37:02;86405451;86383146;22305;
20.02.2019;21:38:01;86405578;86383183;22395;
20.02.2019;21:39:02;86405700;86383213;22487;
20.02.2019;21:40:02;86405842;86383241;22601;
20.02.2019;21:41:02;86405954;86383298;22656;
20.02.2019;21:42:02;86406082;86383332;22750;
20.02.2019;21:43:01;86406203;86383386;22817;
20.02.2019;21:44:05;86406349;86383427;22922;
20.02.2019;21:45:02;86406457;86383454;23003;
20.02.2019;21:46:01;86406569;86383486;23083;
20.02.2019;21:47:03;86406671;86383502;23169;
20.02.2019;21:48:01;86406764;86383540;23224;
20.02.2019;21:49:02;86406892;86383577;23315;
20.02.2019;21:50:02;86407002;86383609;23393;
20.02.2019;21:51:02;86407110;86383625;23485;
20.02.2019;21:52:02;86407233;86383672;23561;
20.02.2019;21:53:02;86407319;86383713;23606;
20.02.2019;21:54:02;86407492;86383746;23746;
20.02.2019;21:55:02;86407604;86383787;23817;
20.02.2019;21:56:02;86407733;86383817;23916;
20.02.2019;21:57:02;86407870;86383844;24026;
20.02.2019;21:58:02;86407995;86383875;24120;
20.02.2019;21:59:01;86408125;86383894;24231;
20.02.2019;22:00:03;86408263;86383929;24334;
20.02.2019;22:01:02;86408390;86383959;24431;
20.02.2019;22:02:02;86408453;86383927;24526;
20.02.2019;22:03:02;86408597;86383951;24646;
20.02.2019;22:04:02;86408698;86384000;24698;
20.02.2019;22:05:02;86408807;86384030;24777;
20.02.2019;22:06:01;86408940;86384048;24892;
20.02.2019;22:07:02;86409084;86384088;24996;
20.02.2019;22:08:03;86409178;86384093;25085;
20.02.2019;22:09:01;86409049;86384071;24978;
20.02.2019;22:10:02;86408852;86384060;24792;
20.02.2019;22:11:02;86408913;86384075;24838;
20.02.2019;22:12:02;86408985;86384104;24881;
20.02.2019;22:13:02;86408945;86384110;24835;
20.02.2019;22:14:02;86408952;86384134;24818;
20.02.2019;22:15:02;86408970;86384155;24815;
20.02.2019;22:16:02;86409062;86384185;24877;
20.02.2019;22:17:02;86409138;86384223;24915;
20.02.2019;22:18:02;86409237;86384242;24995;
20.02.2019;22:19:02;86409337;86384281;25056;
20.02.2019;22:20:02;86409417;86384312;25105;
20.02.2019;22:21:02;86409506;86384343;25163;
20.02.2019;22:22:02;86409605;86384382;25223;
20.02.2019;22:23:02;86409699;86384406;25293;
20.02.2019;22:24:02;86409806;86384428;25378;
20.02.2019;22:25:02;86409930;86384453;25477;
20.02.2019;22:26:02;86410041;86384482;25559;
20.02.2019;22:27:02;86410146;86384514;25632;
20.02.2019;22:28:02;86410253;86384543;25710;
20.02.2019;22:29:02;86410383;86384573;25810;
20.02.2019;22:30:02;86410487;86384613;25874;
20.02.2019;22:31:02;86410589;86384641;25948;
20.02.2019;22:32:02;86410720;86384673;26047;
20.02.2019;22:33:02;86410833;86384692;26141;
20.02.2019;22:34:02;86410931;86384730;26201;
20.02.2019;22:35:02;86411034;86384758;26276;
20.02.2019;22:36:02;86411142;86384785;26357;
20.02.2019;22:37:02;86411277;86384812;26465;
20.02.2019;22:38:02;86411386;86384838;26548;
20.02.2019;22:39:02;86411500;86384855;26645;
20.02.2019;22:40:01;86411590;86384881;26709;
20.02.2019;22:41:02;86411692;86384895;26797;
20.02.2019;22:42:02;86411800;86384923;26877;
20.02.2019;22:43:02;86411896;86384952;26944;
20.02.2019;22:44:02;86412001;86384985;27016;
20.02.2019;22:45:01;86412109;86384998;27111;
20.02.2019;22:46:02;86412228;86385031;27197;
20.02.2019;22:47:02;86412333;86385073;27260;
20.02.2019;22:48:02;86412425;86385097;27328;
20.02.2019;22:49:02;86412531;86385130;27401;
20.02.2019;22:50:01;86412649;86385155;27494;
20.02.2019;22:51:02;86412788;86385189;27599;
20.02.2019;22:52:02;86412905;86385232;27673;
20.02.2019;22:53:02;86413025;86385259;27766;
20.02.2019;22:54:02;86413096;86385276;27820;
20.02.2019;22:55:02;86413211;86385311;27900;
20.02.2019;22:56:02;86413306;86385332;27974;
20.02.2019;22:58:02;86413546;86385381;28165;
20.02.2019;22:58:06;86413546;86385383;28163;
20.02.2019;22:59:02;86413655;86385420;28235;
20.02.2019;23:00:02;86413775;86385446;28329;
20.02.2019;23:01:02;86413886;86385471;28415;
20.02.2019;23:02:02;86413978;86385496;28482;
20.02.2019;23:03:02;86414078;86385517;28561;
20.02.2019;23:04:02;86414204;86385543;28661;
20.02.2019;23:05:02;86414332;86385568;28764;
20.02.2019;23:06:01;86414438;86385593;28845;
20.02.2019;23:07:02;86414555;86385620;28935;
20.02.2019;23:08:03;86414670;86385648;29022;
20.02.2019;23:09:01;86414799;86385671;29128;
20.02.2019;23:10:02;86414928;86385701;29227;
20.02.2019;23:11:02;86415039;86385733;29306;
20.02.2019;23:12:02;86415187;86385750;29437;
20.02.2019;23:13:02;86415311;86385765;29546;
20.02.2019;23:14:02;86415433;86385781;29652;
20.02.2019;23:15:02;86415576;86385810;29766;
20.02.2019;23:16:02;86415714;86385831;29883;
20.02.2019;23:17:01;86415821;86385856;29965;
20.02.2019;23:18:02;86415953;86385886;30067;
20.02.2019;23:19:02;86416093;86385909;30184;
20.02.2019;23:20:02;86416239;86385941;30298;
20.02.2019;23:21:02;86416362;86385979;30383;
20.02.2019;23:22:02;86416483;86385988;30495;
20.02.2019;23:23:02;86416629;86386021;30608;
20.02.2019;23:24:02;86416779;86386051;30728;
20.02.2019;23:25:01;86416910;86386074;30836;
20.02.2019;23:26:02;86417026;86386103;30923;
20.02.2019;23:27:02;86417163;86386142;31021;
20.02.2019;23:28:02;86417294;86386149;31145;
20.02.2019;23:29:01;86417423;86386197;31226;
20.02.2019;23:30:02;86417531;86386216;31315;
20.02.2019;23:31:03;86417672;86386240;31432;
20.02.2019;23:32:01;86417792;86386256;31536;
20.02.2019;23:33:02;86417927;86386283;31644;
20.02.2019;23:34:02;86418052;86386307;31745;
20.02.2019;23:35:02;86418193;86386336;31857;
20.02.2019;23:36:02;86418339;86386359;31980;
20.02.2019;23:37:02;86418490;86386381;32109;
20.02.2019;23:38:02;86418597;86386415;32182;
20.02.2019;23:39:02;86418729;86386420;32309;
20.02.2019;23:40:02;86418858;86386453;32405;
20.02.2019;23:42:07;86419129;86386491;32638;
20.02.2019;23:43:02;86419264;86386514;32750;
20.02.2019;23:44:01;86419412;86386528;32884;
20.02.2019;23:45:02;86419560;86386553;33007;
20.02.2019;23:46:02;86419694;86386579;33115;
20.02.2019;23:47:02;86419816;86386601;33215;
20.02.2019;23:48:02;86419941;86386621;33320;
20.02.2019;23:49:01;86420051;86386651;33400;
20.02.2019;23:50:02;86420198;86386667;33531;
20.02.2019;23:51:02;86420309;86386688;33621;
20.02.2019;23:52:01;86420426;86386715;33711;
20.02.2019;23:53:02;86420590;86386735;33855;
20.02.2019;23:54:02;86420695;86386766;33929;
20.02.2019;23:55:02;86420829;86386779;34050;
20.02.2019;23:56:01;86420950;86386806;34144;
20.02.2019;23:57:02;86421065;86386827;34238;
20.02.2019;23:58:02;86421199;86386853;34346;
20.02.2019;23:59:02;86421323;86386891;34432;
21.02.2019;00:00:02;86421451;86386917;34534;
21.02.2019;00:01:02;86421585;86386938;34647;
21.02.2019;00:02:02;86421740;86386965;34775;
21.02.2019;00:03:02;86421873;86386982;34891;
21.02.2019;00:04:02;86421994;86387003;34991;
21.02.2019;00:05:02;86422124;86387032;35092;
21.02.2019;00:06:02;86422260;86387055;35205;
21.02.2019;00:07:01;86422403;86387082;35321;
21.02.2019;00:08:02;86422504;86387093;35411;
21.02.2019;00:09:02;86422394;86387068;35326;
21.02.2019;00:10:02;86422266;86387060;35206;
21.02.2019;00:11:02;86422304;86387066;35238;
21.02.2019;00:12:02;86422422;86387075;35347;
21.02.2019;00:13:01;86422507;86387101;35406;
21.02.2019;00:14:02;86422567;86387126;35441;
21.02.2019;00:15:02;86422702;86387149;35553;
21.02.2019;00:16:02;86422842;86387168;35674;
21.02.2019;00:17:01;86422970;86387183;35787;
21.02.2019;00:18:02;86423091;86387221;35870;
21.02.2019;00:19:02;86423214;86387243;35971;
21.02.2019;00:20:02;86423319;86387264;36055;
21.02.2019;00:21:02;86423451;86387278;36173;
21.02.2019;00:22:01;86423564;86387298;36266;
21.02.2019;00:23:02;86423674;86387316;36358;
21.02.2019;00:24:02;86423809;86387331;36478;
21.02.2019;00:25:02;86423930;86387369;36561;
21.02.2019;00:26:01;86424038;86387392;36646;
21.02.2019;00:27:02;86424177;86387413;36764;
21.02.2019;00:28:02;86424299;86387445;36854;
21.02.2019;00:29:01;86424422;86387458;36964;
21.02.2019;00:30:02;86424534;86387481;37053;
21.02.2019;00:31:02;86424651;86387508;37143;
21.02.2019;00:32:02;86424765;86387528;37237;
21.02.2019;00:33:02;86424870;86387547;37323;
21.02.2019;00:34:02;86424964;86387575;37389;
21.02.2019;00:35:01;86425069;86387603;37466;
21.02.2019;00:36:02;86425177;86387619;37558;
21.02.2019;00:37:02;86425277;86387642;37635;
21.02.2019;00:38:01;86425385;86387658;37727;
21.02.2019;00:39:02;86425512;86387682;37830;
21.02.2019;00:40:02;86425628;86387702;37926;
21.02.2019;00:41:01;86425745;86387726;38019;
21.02.2019;00:42:02;86425869;86387753;38116;
21.02.2019;00:43:02;86425978;86387774;38204;
21.02.2019;00:44:02;86426092;86387793;38299;
21.02.2019;00:45:01;86426208;86387827;38381;
21.02.2019;00:46:02;86426304;86387854;38450;
21.02.2019;00:47:02;86426429;86387863;38566;
21.02.2019;00:48:02;86426555;86387889;38666;
21.02.2019;00:49:01;86426677;86387919;38758;
21.02.2019;00:50:02;86426794;86387949;38845;
21.02.2019;00:51:02;86426935;86387972;38963;
21.02.2019;00:52:02;86427062;86387985;39077;
21.02.2019;00:53:02;86427169;86388005;39164;
21.02.2019;00:54:02;86427289;86388034;39255;
21.02.2019;00:55:01;86427396;86388057;39339;
21.02.2019;00:56:01;86427510;86388081;39429;
21.02.2019;00:57:02;86427617;86388115;39502;
21.02.2019;00:58:02;86427721;86388137;39584;
21.02.2019;00:59:02;86427819;86388164;39655;
21.02.2019;01:00:02;86427912;86388180;39732;
21.02.2019;01:01:02;86428013;86388198;39815;
21.02.2019;01:02:02;86428121;86388224;39897;
21.02.2019;01:03:01;86428235;86388258;39977;
21.02.2019;01:04:02;86428341;86388288;40053;
21.02.2019;01:05:02;86428451;86388308;40143;
21.02.2019;01:06:01;86428531;86388273;40258;
21.02.2019;01:07:02;86428628;86388315;40313;
21.02.2019;01:08:02;86428735;86388339;40396;
21.02.2019;01:09:01;86428844;86388371;40473;
21.02.2019;01:10:02;86428960;86388404;40556;
21.02.2019;01:11:02;86429093;86388425;40668;
21.02.2019;01:12:02;86429220;86388463;40757;
21.02.2019;01:13:01;86429315;86388486;40829;
21.02.2019;01:14:08;86429438;86388513;40925;
21.02.2019;01:15:02;86429511;86388536;40975;
21.02.2019;01:16:02;86429645;86388563;41082;
21.02.2019;01:17:02;86429805;86388587;41218;
21.02.2019;01:18:02;86429928;86388616;41312;
21.02.2019;01:19:02;86430056;86388647;41409;
21.02.2019;01:20:02;86430181;86388664;41517;
21.02.2019;01:21:02;86430259;86388687;41572;
21.02.2019;01:22:02;86430368;86388725;41643;
21.02.2019;01:23:02;86430473;86388765;41708;
21.02.2019;01:24:02;86430589;86388788;41801;
21.02.2019;01:25:02;86430687;86388813;41874;
21.02.2019;01:26:01;86430798;86388839;41959;
21.02.2019;01:27:02;86430888;86388886;42002;
21.02.2019;01:28:02;86431002;86388930;42072;
21.02.2019;01:29:01;86431094;86388969;42125;
21.02.2019;01:30:02;86431200;86389003;42197;
21.02.2019;01:31:02;86431303;86389053;42250;
21.02.2019;01:32:01;86431413;86389087;42326;
21.02.2019;01:33:02;86431524;86389117;42407;
21.02.2019;01:34:02;86431635;86389152;42483;
21.02.2019;01:35:01;86431754;86389190;42564;
21.02.2019;01:36:02;86431844;86389224;42620;
21.02.2019;01:37:02;86431909;86389255;42654;
21.02.2019;01:38:01;86432012;86389312;42700;
21.02.2019;01:39:02;86432120;86389347;42773;
21.02.2019;01:40:02;86432225;86389384;42841;
21.02.2019;01:41:02;86432320;86389424;42896;
21.02.2019;01:42:01;86432415;86389461;42954;
21.02.2019;01:43:02;86432513;86389492;43021;
21.02.2019;01:44:02;86432597;86389531;43066;
21.02.2019;01:45:02;86432703;86389558;43145;
21.02.2019;01:46:01;86432791;86389590;43201;
21.02.2019;01:47:02;86432888;86389636;43252;
21.02.2019;01:48:02;86432976;86389669;43307;
21.02.2019;01:49:02;86433069;86389713;43356;
21.02.2019;01:50:01;86433186;86389758;43428;
21.02.2019;01:51:02;86433287;86389813;43474;
21.02.2019;01:52:02;86433352;86389881;43471;
21.02.2019;01:53:01;86433501;86389926;43575;
21.02.2019;01:54:02;86433607;86389974;43633;
21.02.2019;01:55:02;86433696;86390026;43670;
21.02.2019;01:56:02;86433803;86390075;43728;
21.02.2019;01:57:01;86433902;86390103;43799;
21.02.2019;01:58:02;86434025;86390154;43871;
21.02.2019;01:59:02;86434130;86390192;43938;
21.02.2019;02:00:02;86434243;86390243;44000;
21.02.2019;02:01:01;86434310;86390288;44022;
21.02.2019;02:02:02;86434420;86390322;44098;
21.02.2019;02:03:02;86434520;86390360;44160;
21.02.2019;02:04:02;86434612;86390403;44209;
21.02.2019;02:05:01;86434685;86390462;44223;
21.02.2019;02:06:02;86434770;86390503;44267;
21.02.2019;02:07:01;86434866;86390538;44328;
21.02.2019;02:08:02;86434955;86390603;44352;
21.02.2019;02:09:02;86435049;86390653;44396;
21.02.2019;02:10:01;86435158;86390693;44465;
21.02.2019;02:11:02;86435225;86390730;44495;
21.02.2019;02:12:02;86435133;86390730;44403;
21.02.2019;02:13:01;86435140;86390758;44382;
21.02.2019;02:14:02;86435189;86390815;44374;
21.02.2019;02:15:01;86435270;86390875;44395;
21.02.2019;02:16:02;86435384;86390930;44454;
21.02.2019;02:17:02;86435486;86390989;44497;
21.02.2019;02:18:01;86435578;86391042;44536;
21.02.2019;02:19:02;86435676;86391082;44594;
21.02.2019;02:20:02;86435741;86391129;44612;
21.02.2019;02:21:01;86435859;86391175;44684;
21.02.2019;02:22:02;86435965;86391229;44736;
21.02.2019;02:23:02;86436082;86391277;44805;
21.02.2019;02:24:01;86436197;86391320;44877;
21.02.2019;02:25:02;86436311;86391402;44909;
21.02.2019;02:26:02;86436405;86391457;44948;
21.02.2019;02:27:02;86436488;86391518;44970;
21.02.2019;02:28:01;86436591;86391571;45020;
21.02.2019;02:29:02;86436701;86391635;45066;
21.02.2019;02:30:02;86436788;86391692;45096;
21.02.2019;02:31:01;86436902;86391751;45151;
21.02.2019;02:32:02;86437007;86391789;45218;
21.02.2019;02:33:01;86437098;86391836;45262;
21.02.2019;02:34:02;86437186;86391900;45286;
21.02.2019;02:35:02;86437301;86391948;45353;
21.02.2019;02:36:02;86437399;86392003;45396;
21.02.2019;02:37:01;86437495;86392062;45433;
21.02.2019;02:38:02;86437595;86392131;45464;
21.02.2019;02:39:02;86437689;86392203;45486;
21.02.2019;02:40:01;86437782;86392272;45510;
21.02.2019;02:41:02;86437880;86392329;45551;
21.02.2019;02:42:02;86437982;86392397;45585;
21.02.2019;02:43:01;86438080;86392463;45617;
21.02.2019;02:44:02;86438176;86392525;45651;
21.02.2019;02:45:02;86438264;86392597;45667;
21.02.2019;02:46:01;86438346;86392664;45682;
21.02.2019;02:47:02;86438452;86392717;45735;
21.02.2019;02:48:02;86438542;86392802;45740;
21.02.2019;02:49:01;86438624;86392861;45763;
21.02.2019;02:50:02;86438764;86392935;45829;
21.02.2019;02:51:01;86438865;86393018;45847;
21.02.2019;02:52:02;86438956;86393076;45880;
21.02.2019;02:53:02;86439044;86393136;45908;
21.02.2019;02:54:01;86439121;86393202;45919;
21.02.2019;02:55:02;86439225;86393285;45940;
21.02.2019;02:56:02;86439286;86393361;45925;
21.02.2019;02:57:01;86439400;86393428;45972;
21.02.2019;02:58:02;86439496;86393514;45982;
21.02.2019;02:59:02;86439630;86393615;46015;
21.02.2019;03:00:01;86439730;86393702;46028;
21.02.2019;03:01:02;86439831;86393792;46039;
21.02.2019;03:02:01;86439943;86393854;46089;
21.02.2019;03:03:01;86440048;86393942;46106;
21.02.2019;03:04:02;86440135;86394036;46099;
21.02.2019;03:05:01;86440257;86394129;46128;
21.02.2019;03:06:02;86440360;86394197;46163;
21.02.2019;03:07:02;86440463;86394287;46176;
21.02.2019;03:08:01;86440570;86394370;46200;
21.02.2019;03:09:02;86440654;86394464;46190;
21.02.2019;03:10:02;86440754;86394536;46218;
21.02.2019;03:11:01;86440868;86394648;46220;
21.02.2019;03:12:02;86440975;86394724;46251;
21.02.2019;03:13:02;86441095;86394799;46296;
21.02.2019;03:14:01;86441200;86394865;46335;
21.02.2019;03:15:02;86441307;86394946;46361;
21.02.2019;03:16:02;86441442;86395021;46421;
21.02.2019;03:17:01;86441548;86395089;46459;
21.02.2019;03:18:02;86441633;86395161;46472;
21.02.2019;03:19:01;86441739;86395243;46496;
21.02.2019;03:20:02;86441857;86395320;46537;
21.02.2019;03:21:02;86441962;86395406;46556;
21.02.2019;03:22:01;86442078;86395478;46600;
21.02.2019;03:23:02;86442184;86395575;46609;
21.02.2019;03:24:01;86442293;86395673;46620;
21.02.2019;03:25:02;86442416;86395737;46679;
21.02.2019;03:26:02;86442500;86395793;46707;
21.02.2019;03:27:02;86442585;86395914;46671;
21.02.2019;03:28:01;86442689;86395999;46690;
21.02.2019;03:29:02;86442791;86396088;46703;
21.02.2019;03:30:01;86442898;86396189;46709;
21.02.2019;03:31:02;86443019;86396273;46746;
21.02.2019;03:32:02;86443123;86396355;46768;
21.02.2019;03:33:02;86443230;86396462;46768;
21.02.2019;03:34:01;86443323;86396557;46766;
21.02.2019;03:35:02;86443416;86396648;46768;
21.02.2019;03:36:01;86443498;86396732;46766;
21.02.2019;03:37:02;86443608;86396834;46774;
21.02.2019;03:38:02;86443706;86396930;46776;
21.02.2019;03:39:01;86443795;86397017;46778;
21.02.2019;03:40:02;86443884;86397109;46775;
21.02.2019;03:41:02;86443993;86397191;46802;
21.02.2019;03:42:01;86444069;86397285;46784;
21.02.2019;03:43:02;86444163;86397387;46776;
21.02.2019;03:44:01;86444256;86397469;46787;
21.02.2019;03:45:02;86444372;86397542;46830;
21.02.2019;03:46:02;86444476;86397638;46838;
21.02.2019;03:47:01;86444576;86397719;46857;
21.02.2019;03:48:02;86444642;86397829;46813;
21.02.2019;03:49:02;86444772;86397917;46855;
21.02.2019;03:50:01;86444876;86398012;46864;
21.02.2019;03:51:02;86444985;86398112;46873;
21.02.2019;03:52:02;86445088;86398208;46880;
21.02.2019;03:53:01;86445177;86398301;46876;
21.02.2019;03:54:02;86445276;86398390;46886;
21.02.2019;03:55:02;86445364;86398488;46876;
21.02.2019;03:56:01;86445474;86398584;46890;
21.02.2019;03:57:02;86445566;86398666;46900;
21.02.2019;03:58:02;86445619;86398714;46905;
21.02.2019;03:59:01;86445715;86398793;46922;
21.02.2019;04:00:02;86445790;86398888;46902;
21.02.2019;04:01:02;86445880;86398981;46899;
21.02.2019;04:02:01;86445954;86399079;46875;
21.02.2019;04:03:02;86446036;86399177;46859;
21.02.2019;04:04:02;86446142;86399273;46869;
21.02.2019;04:05:01;86446194;86399342;46852;
21.02.2019;04:06:02;86446246;86399434;46812;
21.02.2019;04:07:02;86446272;86399510;46762;
21.02.2019;04:08:01;86446238;86399585;46653;
21.02.2019;04:09:02;86446279;86399667;46612;
21.02.2019;04:10:02;86446336;86399762;46574;
21.02.2019;04:11:01;86446376;86399838;46538;
21.02.2019;04:12:02;86446423;86399924;46499;
21.02.2019;04:13:02;86446491;86400001;46490;
21.02.2019;04:14:01;86446574;86400092;46482;
21.02.2019;04:15:02;86446664;86400191;46473;
21.02.2019;04:16:01;86446739;86400281;46458;
21.02.2019;04:17:02;86446836;86400357;46479;
21.02.2019;04:18:02;86446945;86400425;46520;
21.02.2019;04:19:01;86447029;86400519;46510;
21.02.2019;04:20:02;86447117;86400615;46502;
21.02.2019;04:21:02;86447207;86400717;46490;
21.02.2019;04:22:01;86447303;86400817;46486;
21.02.2019;04:23:02;86447416;86400906;46510;
21.02.2019;04:24:02;86447485;86401015;46470;
21.02.2019;04:25:01;86447607;86401100;46507;
21.02.2019;04:26:02;86447703;86401211;46492;
21.02.2019;04:27:02;86447792;86401329;46463;
21.02.2019;04:28:02;86447881;86401432;46449;
21.02.2019;04:29:01;86447961;86401512;46449;
21.02.2019;04:30:02;86448046;86401634;46412;
21.02.2019;04:31:02;86448157;86401736;46421;
21.02.2019;04:32:01;86448257;86401830;46427;
21.02.2019;04:33:02;86448344;86401943;46401;
21.02.2019;04:34:02;86448416;86402042;46374;
21.02.2019;04:35:01;86448509;86402133;46376;
21.02.2019;04:36:02;86448590;86402239;46351;
21.02.2019;04:37:02;86448690;86402322;46368;
21.02.2019;04:38:01;86448789;86402413;46376;
21.02.2019;04:39:02;86448896;86402518;46378;
21.02.2019;04:40:02;86448979;86402621;46358;
21.02.2019;04:41:01;86449072;86402707;46365;
21.02.2019;04:42:02;86449161;86402803;46358;
21.02.2019;04:43:02;86449232;86402905;46327;
21.02.2019;04:44:01;86449326;86402984;46342;
21.02.2019;04:45:02;86449419;86403093;46326;
21.02.2019;04:46:02;86449520;86403197;46323;
21.02.2019;04:47:01;86449617;86403299;46318;
21.02.2019;04:48:02;86449725;86403408;46317;
21.02.2019;04:49:02;86449836;86403506;46330;
21.02.2019;04:50:01;86449937;86403619;46318;
21.02.2019;04:51:02;86450053;86403728;46325;
21.02.2019;04:52:02;86450131;86403844;46287;
21.02.2019;04:53:02;86450219;86403956;46263;
21.02.2019;04:54:01;86450307;86404038;46269;
21.02.2019;04:55:02;86450411;86404146;46265;
21.02.2019;04:56:02;86450497;86404248;46249;
21.02.2019;04:57:01;86450599;86404362;46237;
21.02.2019;04:58:02;86450696;86404449;46247;
21.02.2019;04:59:02;86450741;86404566;46175;
21.02.2019;05:00:01;86450856;86404661;46195;
21.02.2019;05:01:02;86450924;86404781;46143;
21.02.2019;05:02:01;86451031;86404837;46194;
21.02.2019;05:03:01;86451112;86404932;46180;
21.02.2019;05:04:02;86451207;86405033;46174;
21.02.2019;05:05:01;86451312;86405144;46168;
21.02.2019;05:06:02;86451403;86405243;46160;
21.02.2019;05:07:02;86451498;86405330;46168;
21.02.2019;05:08:01;86451590;86405435;46155;
21.02.2019;05:09:02;86451699;86405537;46162;
21.02.2019;05:10:02;86451784;86405649;46135;
21.02.2019;05:11:01;86451868;86405769;46099;
21.02.2019;05:12:02;86451953;86405858;46095;
21.02.2019;05:13:01;86452026;86405963;46063;
21.02.2019;05:14:01;86452105;86406077;46028;
21.02.2019;05:15:02;86452189;86406171;46018;
21.02.2019;05:16:02;86452278;86406266;46012;
21.02.2019;05:17:01;86452348;86406375;45973;
21.02.2019;05:18:02;86452438;86406466;45972;
21.02.2019;05:19:01;86452515;86406568;45947;
21.02.2019;05:20:02;86452604;86406669;45935;
21.02.2019;05:21:02;86452673;86406802;45871;
21.02.2019;05:22:01;86452753;86406926;45827;
21.02.2019;05:23:02;86452835;86407019;45816;
21.02.2019;05:24:02;86452922;86407102;45820;
21.02.2019;05:25:02;86453024;86407206;45818;
21.02.2019;05:26:01;86453086;86407313;45773;
21.02.2019;05:27:02;86453173;86407412;45761;
21.02.2019;05:28:01;86453256;86407539;45717;
21.02.2019;05:29:02;86453341;86407638;45703;
21.02.2019;05:30:02;86453415;86407736;45679;
21.02.2019;05:31:01;86453498;86407829;45669;
21.02.2019;05:32:02;86453575;86407954;45621;
21.02.2019;05:33:02;86453642;86408048;45594;
21.02.2019;05:34:01;86453710;86408153;45557;
21.02.2019;05:35:02;86453787;86408258;45529;
21.02.2019;05:36:02;86453890;86408363;45527;
21.02.2019;05:37:02;86453972;86408466;45506;
21.02.2019;05:38:01;86454045;86408559;45486;
21.02.2019;05:39:02;86454109;86408670;45439;
21.02.2019;05:40:01;86454176;86408790;45386;
21.02.2019;05:41:02;86454252;86408883;45369;
21.02.2019;05:42:02;86454343;86409004;45339;
21.02.2019;05:43:01;86454409;86409106;45303;
21.02.2019;05:44:02;86454495;86409213;45282;
21.02.2019;05:45:02;86454573;86409303;45270;
21.02.2019;05:46:02;86454627;86409422;45205;
21.02.2019;05:47:01;86454679;86409517;45162;
21.02.2019;05:48:02;86454772;86409649;45123;
21.02.2019;05:49:01;86454847;86409751;45096;
21.02.2019;05:50:02;86454941;86409864;45077;
21.02.2019;05:51:02;86455023;86409989;45034;
21.02.2019;05:52:01;86455116;86410098;45018;
21.02.2019;05:53:02;86455191;86410198;44993;
21.02.2019;05:54:02;86455284;86410299;44985;
21.02.2019;05:55:01;86455335;86410401;44934;
21.02.2019;05:56:02;86455424;86410519;44905;
21.02.2019;05:57:02;86455520;86410652;44868;
21.02.2019;05:58:01;86455584;86410748;44836;
21.02.2019;05:59:02;86455669;86410884;44785;
21.02.2019;06:00:01;86455737;86410998;44739;
21.02.2019;06:01:02;86455813;86411117;44696;
21.02.2019;06:02:02;86455899;86411220;44679;
21.02.2019;06:03:01;86455974;86411312;44662;
21.02.2019;06:04:02;86456043;86411412;44631;
21.02.2019;06:05:02;86456119;86411504;44615;
21.02.2019;06:06:01;86456201;86411624;44577;
21.02.2019;06:07:02;86456265;86411751;44514;
21.02.2019;06:08:01;86456360;86411874;44486;
21.02.2019;06:09:02;86456443;86411991;44452;
21.02.2019;06:10:02;86456517;86412089;44428;
21.02.2019;06:11:01;86456577;86412197;44380;
21.02.2019;06:12:02;86456580;86412265;44315;
21.02.2019;06:13:02;86456477;86412290;44187;
21.02.2019;06:14:01;86456477;86412369;44108;
21.02.2019;06:15:02;86456509;86412479;44030;
21.02.2019;06:16:02;86456553;86412569;43984;
21.02.2019;06:17:01;86456610;86412659;43951;
21.02.2019;06:18:02;86456656;86412781;43875;
21.02.2019;06:19:01;86456716;86412889;43827;
21.02.2019;06:20:02;86456776;86412983;43793;
21.02.2019;06:21:02;86456852;86413109;43743;
21.02.2019;06:22:01;86456926;86413203;43723;
21.02.2019;06:23:02;86456980;86413304;43676;
21.02.2019;06:24:02;86457014;86413396;43618;
21.02.2019;06:25:02;86457084;86413521;43563;
21.02.2019;06:26:01;86457152;86413640;43512;
21.02.2019;06:27:02;86457219;86413731;43488;
21.02.2019;06:28:01;86457296;86413832;43464;
21.02.2019;06:29:02;86457362;86413917;43445;
21.02.2019;06:30:02;86457423;86414004;43419;
21.02.2019;06:31:02;86457503;86414097;43406;
21.02.2019;06:32:01;86457579;86414189;43390;
21.02.2019;06:33:02;86457661;86414302;43359;
21.02.2019;06:34:01;86457721;86414414;43307;
21.02.2019;06:35:02;86457782;86414523;43259;
21.02.2019;06:36:02;86457861;86414623;43238;
21.02.2019;06:37:01;86457950;86414721;43229;
21.02.2019;06:38:02;86458010;86414827;43183;
21.02.2019;06:39:02;86458082;86414915;43167;
21.02.2019;06:40:01;86458154;86415042;43112;
21.02.2019;06:41:02;86458221;86415145;43076;
21.02.2019;06:42:02;86458309;86415249;43060;
21.02.2019;06:43:02;86458373;86415360;43013;
21.02.2019;06:44:01;86458457;86415446;43011;
21.02.2019;06:45:02;86458549;86415571;42978;
21.02.2019;06:46:02;86458603;86415679;42924;
21.02.2019;06:47:01;86458689;86415785;42904;
21.02.2019;06:48:02;86458736;86415884;42852;
21.02.2019;06:49:02;86458788;86416007;42781;
21.02.2019;06:50:01;86458859;86416117;42742;
21.02.2019;06:51:02;86458916;86416234;42682;
21.02.2019;06:52:02;86459005;86416335;42670;
21.02.2019;06:53:01;86459060;86416469;42591;
21.02.2019;06:54:02;86459114;86416582;42532;
21.02.2019;06:55:02;86459189;86416688;42501;
21.02.2019;06:56:01;86459251;86416771;42480;
21.02.2019;06:57:02;86459311;86416847;42464;
21.02.2019;06:58:02;86459365;86416916;42449;
21.02.2019;06:59:01;86459450;86417015;42435;
21.02.2019;07:00:12;86459539;86417148;42391;
21.02.2019;07:01:02;86459593;86417233;42360;
21.02.2019;07:02:02;86459657;86417355;42302;
21.02.2019;07:03:01;86459723;86417448;42275;
21.02.2019;07:04:02;86459783;86417570;42213;
21.02.2019;07:05:02;86459838;86417693;42145;
21.02.2019;07:06:01;86459903;86417818;42085;
21.02.2019;07:07:02;86459977;86417956;42021;
21.02.2019;07:08:02;86460022;86418074;41948;
21.02.2019;07:09:01;86460084;86418193;41891;
21.02.2019;07:10:02;86460145;86418324;41821;
21.02.2019;07:11:02;86460217;86418444;41773;
21.02.2019;07:12:02;86460288;86418537;41751;
21.02.2019;07:13:01;86460366;86418636;41730;
21.02.2019;07:14:02;86460428;86418743;41685;
21.02.2019;07:15:02;86460495;86418860;41635;
21.02.2019;07:16:01;86460555;86418987;41568;
21.02.2019;07:17:02;86460633;86419093;41540;
21.02.2019;07:18:02;86460703;86419214;41489;
21.02.2019;07:19:01;86460768;86419328;41440;
21.02.2019;07:20:02;86460835;86419437;41398;
21.02.2019;07:21:02;86460898;86419542;41356;
21.02.2019;07:22:01;86460962;86419647;41315;
21.02.2019;07:23:02;86461028;86419759;41269;
21.02.2019;07:24:02;86461096;86419879;41217;
21.02.2019;07:25:01;86461154;86420004;41150;
21.02.2019;07:26:02;86461209;86420125;41084;
21.02.2019;07:27:02;86461271;86420239;41032;
21.02.2019;07:28:01;86461337;86420345;40992;
21.02.2019;07:29:02;86461405;86420475;40930;
21.02.2019;07:30:02;86461468;86420590;40878;
21.02.2019;07:31:01;86461546;86420681;40865;
21.02.2019;07:32:02;86461621;86420792;40829;
21.02.2019;07:33:02;86461702;86420902;40800;
21.02.2019;07:34:02;86461761;86421014;40747;
21.02.2019;07:35:01;86461815;86421131;40684;
21.02.2019;07:36:02;86461877;86421244;40633;
21.02.2019;07:37:01;86461946;86421357;40589;
21.02.2019;07:38:02;86462031;86421455;40576;
21.02.2019;07:39:02;86462092;86421571;40521;
21.02.2019;07:40:01;86462152;86421675;40477;
21.02.2019;07:41:02;86462226;86421770;40456;
21.02.2019;07:42:02;86462316;86421882;40434;
21.02.2019;07:43:01;86462377;86422000;40377;
21.02.2019;07:44:02;86462411;86422109;40302;
21.02.2019;07:45:02;86462508;86422213;40295;
21.02.2019;07:46:01;86462572;86422317;40255;
21.02.2019;07:47:02;86462626;86422423;40203;
21.02.2019;07:48:01;86462676;86422517;40159;
21.02.2019;07:49:02;86462742;86422612;40130;
21.02.2019;07:50:02;86462808;86422718;40090;
21.02.2019;07:51:01;86462875;86422844;40031;
21.02.2019;07:52:02;86462923;86422975;39948;
21.02.2019;07:53:02;86462964;86423109;39855;
21.02.2019;07:54:01;86463034;86423228;39806;
21.02.2019;07:55:02;86463095;86423323;39772;
21.02.2019;07:56:02;86463164;86423430;39734;
21.02.2019;07:57:01;86463223;86423545;39678;
21.02.2019;07:58:02;86463281;86423633;39648;
21.02.2019;07:59:02;86463350;86423756;39594;
21.02.2019;08:00:01;86463419;86423874;39545;
21.02.2019;08:01:02;86463479;86423992;39487;
21.02.2019;08:02:02;86463538;86424093;39445;
21.02.2019;08:03:01;86463597;86424194;39403;
21.02.2019;08:04:01;86463651;86424306;39345;
21.02.2019;08:05:02;86463716;86424404;39312;
21.02.2019;08:06:02;86463750;86424499;39251;
21.02.2019;08:07:01;86463796;86424597;39199;
21.02.2019;08:08:02;86463837;86424677;39160;
21.02.2019;08:09:02;86463870;86424742;39128;
21.02.2019;08:10:01;86463902;86424844;39058;
21.02.2019;08:11:02;86463927;86424940;38987;
21.02.2019;08:12:02;86463946;86425020;38926;
21.02.2019;08:13:01;86463986;86425119;38867;
21.02.2019;08:14:02;86464027;86425208;38819;
21.02.2019;08:15:02;86464078;86425301;38777;
21.02.2019;08:16:02;86464116;86425392;38724;
21.02.2019;08:17:01;86464158;86425483;38675;
21.02.2019;08:18:02;86464211;86425584;38627;
21.02.2019;08:19:02;86464275;86425672;38603;
21.02.2019;08:20:01;86464334;86425769;38565;
21.02.2019;08:21:02;86464395;86425888;38507;
21.02.2019;08:22:02;86464437;86425998;38439;
21.02.2019;08:23:01;86464497;86426097;38400;
21.02.2019;08:24:02;86464558;86426199;38359;
21.02.2019;08:25:02;86464617;86426309;38308;
21.02.2019;08:26:01;86464675;86426418;38257;
21.02.2019;08:27:02;86464733;86426527;38206;
21.02.2019;08:28:02;86464796;86426625;38171;
21.02.2019;08:29:02;86464859;86426724;38135;
21.02.2019;08:30:02;86464911;86426818;38093;
21.02.2019;08:31:01;86464956;86426901;38055;
21.02.2019;08:32:02;86465000;86427011;37989;
21.02.2019;08:33:02;86465059;86427117;37942;
21.02.2019;08:34:01;86465121;86427209;37912;
21.02.2019;08:35:02;86465176;86427340;37836;
21.02.2019;08:36:02;86465229;86427422;37807;
21.02.2019;08:37:02;86465282;86427472;37810;
21.02.2019;08:38:01;86465338;86427541;37797;
21.02.2019;08:39:02;86465393;86427638;37755;
21.02.2019;08:40:02;86465432;86427726;37706;
21.02.2019;08:41:02;86465503;86427808;37695;
21.02.2019;08:42:02;86465555;86427891;37664;
21.02.2019;08:43:01;86465602;86427985;37617;
21.02.2019;08:44:02;86465663;86428093;37570;
21.02.2019;08:45:02;86465716;86428184;37532;
21.02.2019;08:46:01;86465772;86428302;37470;
21.02.2019;08:47:02;86465836;86428404;37432;
21.02.2019;08:48:02;86465906;86428491;37415;
21.02.2019;08:49:01;86465970;86428588;37382;
21.02.2019;08:50:02;86466022;86428677;37345;
21.02.2019;08:51:02;86466092;86428785;37307;
21.02.2019;08:52:02;86466161;86428896;37265;
21.02.2019;08:53:01;86466224;86429014;37210;
21.02.2019;08:54:02;86466285;86429110;37175;
21.02.2019;08:55:02;86466333;86429223;37110;
21.02.2019;08:56:02;86466391;86429319;37072;
21.02.2019;08:57:02;86466458;86429430;37028;
21.02.2019;08:58:01;86466517;86429527;36990;
21.02.2019;08:59:02;86466588;86429628;36960;
21.02.2019;09:00:02;86466671;86429726;36945;
21.02.2019;09:01:01;86466712;86429837;36875;
21.02.2019;09:02:02;86466780;86429916;36864;
21.02.2019;09:03:02;86466836;86430007;36829;
21.02.2019;09:04:01;86466900;86430102;36798;
21.02.2019;09:05:02;86466947;86430228;36719;
21.02.2019;09:06:02;86467021;86430322;36699;
21.02.2019;09:07:02;86467066;86430439;36627;
21.02.2019;09:08:01;86467127;86430567;36560;
21.02.2019;09:09:02;86467183;86430669;36514;
21.02.2019;09:10:02;86467251;86430777;36474;
21.02.2019;09:11:02;86467305;86430880;36425;
21.02.2019;09:12:01;86467353;86430984;36369;
21.02.2019;09:13:02;86467420;86431079;36341;
21.02.2019;09:14:02;86467469;86431178;36291;
21.02.2019;09:15:02;86467523;86431276;36247;
21.02.2019;09:16:01;86467596;86431378;36218;
21.02.2019;09:17:02;86467657;86431480;36177;
21.02.2019;09:18:02;86467714;86431589;36125;
21.02.2019;09:19:01;86467768;86431676;36092;
21.02.2019;09:20:02;86467844;86431767;36077;
21.02.2019;09:21:02;86467889;86431857;36032;
21.02.2019;09:22:02;86467940;86431979;35961;
21.02.2019;09:23:01;86467989;86432124;35865;
21.02.2019;09:24:02;86468037;86432228;35809;
21.02.2019;09:25:07;86468095;86432347;35748;
21.02.2019;09:26:01;86468144;86432457;35687;
21.02.2019;09:27:02;86468199;86432563;35636;
21.02.2019;09:28:02;86468278;86432665;35613;
21.02.2019;09:29:01;86468340;86432783;35557;
21.02.2019;09:30:01;86468413;86432893;35520;
21.02.2019;09:31:02;86468475;86432998;35477;
21.02.2019;09:32:02;86468540;86433131;35409;
21.02.2019;09:33:01;86468585;86433235;35350;
21.02.2019;09:34:02;86468657;86433302;35355;
21.02.2019;09:35:02;86468725;86433401;35324;
21.02.2019;09:36:01;86468768;86433517;35251;
21.02.2019;09:37:02;86468817;86433647;35170;
21.02.2019;09:38:02;86468883;86433741;35142;
21.02.2019;09:39:02;86468932;86433823;35109;
21.02.2019;09:40:01;86468988;86433920;35068;
21.02.2019;09:41:02;86469043;86434028;35015;
21.02.2019;09:42:02;86469110;86434120;34990;
21.02.2019;09:43:02;86469160;86434223;34937;
21.02.2019;09:44:02;86469230;86434297;34933;
21.02.2019;09:45:02;86469303;86434426;34877;
21.02.2019;09:46:02;86469371;86434499;34872;
21.02.2019;09:47:02;86469433;86434601;34832;
21.02.2019;09:48:02;86469480;86434717;34763;
21.02.2019;09:49:02;86469534;86434810;34724;
21.02.2019;09:50:02;86469594;86434938;34656;
21.02.2019;09:51:02;86469658;86435054;34604;
21.02.2019;09:52:03;86469711;86435164;34547;
21.02.2019;09:53:02;86469758;86435271;34487;
21.02.2019;09:54:02;86469828;86435368;34460;
21.02.2019;09:55:03;86469889;86435483;34406;
21.02.2019;09:56:02;86469948;86435576;34372;
21.02.2019;09:57:02;86469983;86435626;34357;
21.02.2019;09:58:02;86470042;86435708;34334;
21.02.2019;09:59:02;86470093;86435813;34280;
21.02.2019;10:00:07;86470152;86435939;34213;
21.02.2019;10:01:02;86470198;86436030;34168;
21.02.2019;10:02:02;86470272;86436138;34134;
21.02.2019;10:03:03;86470343;86436245;34098;
21.02.2019;10:04:02;86470394;86436351;34043;
21.02.2019;10:05:02;86470448;86436470;33978;
21.02.2019;10:06:02;86470506;86436596;33910;
21.02.2019;10:07:02;86470573;86436706;33867;
21.02.2019;10:08:02;86470648;86436841;33807;
21.02.2019;10:09:02;86470714;86436955;33759;
21.02.2019;10:10:01;86470759;86437042;33717;
21.02.2019;10:11:02;86470779;86437136;33643;
21.02.2019;10:12:02;86470812;86437211;33601;
21.02.2019;10:13:01;86470862;86437305;33557;
21.02.2019;10:14:02;86470897;86437415;33482;
21.02.2019;10:15:03;86470910;86437495;33415;
21.02.2019;10:16:01;86470955;86437584;33371;
21.02.2019;10:17:02;86470990;86437680;33310;
21.02.2019;10:18:02;86471046;86437773;33273;
21.02.2019;10:19:01;86471110;86437884;33226;
21.02.2019;10:20:02;86471166;86437988;33178;
21.02.2019;10:21:02;86471221;86438105;33116;
21.02.2019;10:22:01;86471287;86438224;33063;
21.02.2019;10:23:02;86471349;86438319;33030;
21.02.2019;10:24:02;86471414;86438418;32996;
21.02.2019;10:25:01;86471484;86438508;32976;
21.02.2019;10:26:02;86471520;86438628;32892;
21.02.2019;10:27:02;86471589;86438746;32843;
21.02.2019;10:28:01;86471632;86438891;32741;
21.02.2019;10:29:02;86471706;86439021;32685;
21.02.2019;10:30:02;86471790;86439147;32643;
21.02.2019;10:31:02;86471852;86439265;32587;
21.02.2019;10:32:01;86471911;86439391;32520;
21.02.2019;10:33:02;86471989;86439512;32477;
21.02.2019;10:34:01;86472056;86439613;32443;
21.02.2019;10:35:02;86472119;86439738;32381;
21.02.2019;10:36:02;86472185;86439838;32347;
21.02.2019;10:37:02;86472241;86439953;32288;
21.02.2019;10:38:01;86472298;86440067;32231;
21.02.2019;10:39:02;86472372;86440176;32196;
21.02.2019;10:40:02;86472442;86440301;32141;
21.02.2019;10:41:01;86472519;86440416;32103;
21.02.2019;10:42:02;86472582;86440534;32048;
21.02.2019;10:43:02;86472655;86440676;31979;
21.02.2019;10:44:01;86472726;86440800;31926;
21.02.2019;10:45:02;86472809;86440921;31888;
21.02.2019;10:46:02;86472886;86441025;31861;
21.02.2019;10:47:01;86472950;86441149;31801;
21.02.2019;10:48:02;86473012;86441265;31747;
21.02.2019;10:49:02;86473088;86441379;31709;
21.02.2019;10:50:01;86473127;86441483;31644;
21.02.2019;10:51:02;86473176;86441597;31579;
21.02.2019;10:52:02;86473249;86441725;31524;
21.02.2019;10:53:02;86473320;86441820;31500;
21.02.2019;10:54:01;86473386;86441915;31471;
21.02.2019;10:55:02;86473450;86442037;31413;
21.02.2019;10:56:02;86473511;86442130;31381;
21.02.2019;10:57:01;86473571;86442224;31347;
21.02.2019;10:58:02;86473652;86442343;31309;
21.02.2019;10:59:02;86473706;86442473;31233;
21.02.2019;11:00:01;86473757;86442603;31154;
21.02.2019;11:01:02;86473852;86442719;31133;
21.02.2019;11:02:02;86473923;86442841;31082;
21.02.2019;11:03:02;86473981;86442953;31028;
21.02.2019;11:04:01;86474038;86443061;30977;
21.02.2019;11:05:02;86474105;86443172;30933;
21.02.2019;11:06:02;86474170;86443292;30878;
21.02.2019;11:07:01;86474232;86443395;30837;
21.02.2019;11:08:02;86474293;86443533;30760;
21.02.2019;11:09:02;86474364;86443635;30729;
21.02.2019;11:10:01;86474424;86443753;30671;
21.02.2019;11:11:02;86474478;86443865;30613;
21.02.2019;11:12:02;86474551;86443977;30574;
21.02.2019;11:13:01;86474617;86444084;30533;
21.02.2019;11:14:02;86474682;86444208;30474;
21.02.2019;11:15:02;86474745;86444320;30425;
21.02.2019;11:16:02;86474814;86444436;30378;
21.02.2019;11:17:01;86474876;86444561;30315;
21.02.2019;11:18:02;86474949;86444687;30262;
21.02.2019;11:19:02;86475021;86444814;30207;
21.02.2019;11:20:01;86475078;86444937;30141;
21.02.2019;11:21:02;86475153;86445068;30085;
21.02.2019;11:22:02;86475210;86445180;30030;
21.02.2019;11:23:02;86475286;86445288;29998;
21.02.2019;11:24:01;86475348;86445409;29939;
21.02.2019;11:25:02;86475413;86445525;29888;
21.02.2019;11:26:02;86475480;86445661;29819;
21.02.2019;11:27:01;86475549;86445756;29793;
21.02.2019;11:28:02;86475609;86445876;29733;
21.02.2019;11:29:02;86475677;86446002;29675;
21.02.2019;11:30:01;86475728;86446083;29645;
21.02.2019;11:31:02;86475810;86446178;29632;
21.02.2019;11:32:02;86475876;86446291;29585;
21.02.2019;11:33:02;86475951;86446404;29547;
21.02.2019;11:34:02;86475994;86446514;29480;
21.02.2019;11:35:01;86476061;86446636;29425;
21.02.2019;11:36:02;86476140;86446747;29393;
21.02.2019;11:37:02;86476210;86446857;29353;
21.02.2019;11:38:02;86476270;86446986;29284;
21.02.2019;11:39:02;86476324;86447070;29254;
21.02.2019;11:40:02;86476382;86447170;29212;
21.02.2019;11:41:01;86476446;86447284;29162;
21.02.2019;11:42:02;86476500;86447409;29091;
21.02.2019;11:43:02;86476543;86447520;29023;
21.02.2019;11:44:02;86476602;86447629;28973;
21.02.2019;11:45:01;86476673;86447748;28925;
21.02.2019;11:46:02;86476762;86447828;28934;
21.02.2019;11:47:03;86476848;86447939;28909;
21.02.2019;11:48:02;86476917;86448056;28861;
21.02.2019;11:49:02;86476988;86448169;28819;
21.02.2019;11:50:01;86477054;86448290;28764;
21.02.2019;11:51:02;86477123;86448397;28726;
21.02.2019;11:52:02;86477194;86448539;28655;
21.02.2019;11:53:02;86477261;86448647;28614;
21.02.2019;11:54:01;86477326;86448765;28561;
21.02.2019;11:55:02;86477406;86448884;28522;
21.02.2019;11:56:02;86477484;86449017;28467;
21.02.2019;11:57:01;86477557;86449122;28435;
21.02.2019;11:58:02;86477628;86449230;28398;
21.02.2019;11:59:03;86477689;86449358;28331;
21.02.2019;12:00:02;86477748;86449506;28242;
21.02.2019;12:01:01;86477819;86449607;28212;
21.02.2019;12:02:02;86477880;86449737;28143;
21.02.2019;12:03:02;86477939;86449864;28075;
21.02.2019;12:04:02;86477997;86449964;28033;
21.02.2019;12:05:01;86478022;86450029;27993;
21.02.2019;12:06:02;86478009;86450117;27892;
21.02.2019;12:07:02;86478022;86450173;27849;
21.02.2019;12:08:01;86478054;86450261;27793;
21.02.2019;12:09:02;86478099;86450345;27754;
21.02.2019;12:10:01;86478169;86450431;27738;
21.02.2019;12:11:02;86478239;86450539;27700;
21.02.2019;12:12:02;86478305;86450669;27636;
21.02.2019;12:13:01;86478379;86450804;27575;
21.02.2019;12:14:02;86478474;86450929;27545;
21.02.2019;12:15:02;86478546;86451031;27515;
21.02.2019;12:16:01;86478613;86451130;27483;
21.02.2019;12:17:02;86478688;86451246;27442;
21.02.2019;12:18:02;86478763;86451376;27387;
21.02.2019;12:19:01;86478841;86451500;27341;
21.02.2019;12:20:02;86478905;86451630;27275;
21.02.2019;12:21:07;86478990;86451764;27226;
21.02.2019;12:22:01;86479053;86451873;27180;
21.02.2019;12:23:02;86479123;86451997;27126;
21.02.2019;12:24:02;86479196;86452121;27075;
21.02.2019;12:25:01;86479272;86452244;27028;
21.02.2019;12:26:02;86479333;86452371;26962;
21.02.2019;12:27:02;86479418;86452491;26927;
21.02.2019;12:28:02;86479494;86452608;26886;
21.02.2019;12:29:01;86479561;86452734;26827;
21.02.2019;12:30:02;86479638;86452823;26815;
21.02.2019;12:31:07;86479727;86452917;26810;
21.02.2019;12:32:01;86479806;86453008;26798;
21.02.2019;12:33:02;86479891;86453121;26770;
21.02.2019;12:34:01;86479967;86453252;26715;
21.02.2019;12:35:02;86480046;86453379;26667;
21.02.2019;12:36:02;86480138;86453497;26641;
21.02.2019;12:37:01;86480210;86453625;26585;
21.02.2019;12:38:02;86480293;86453736;26557;
21.02.2019;12:39:02;86480361;86453865;26496;
21.02.2019;12:40:01;86480428;86453973;26455;
21.02.2019;12:41:02;86480520;86454084;26436;
21.02.2019;12:42:02;86480615;86454212;26403;
21.02.2019;12:43:01;86480715;86454328;26387;
21.02.2019;12:44:02;86480783;86454459;26324;
21.02.2019;12:45:02;86480889;86454587;26302;
21.02.2019;12:46:02;86480967;86454692;26275;
21.02.2019;12:47:02;86480870;86454650;26220;
21.02.2019;12:48:02;86480555;86453995;26560;
21.02.2019;12:49:02;86480633;86454090;26543;
21.02.2019;12:50:01;86480685;86454176;26509;
21.02.2019;12:51:02;86480770;86454300;26470;
21.02.2019;12:52:02;86480851;86454419;26432;
21.02.2019;12:53:01;86480937;86454517;26420;
21.02.2019;12:54:02;86481028;86454636;26392;
21.02.2019;12:55:02;86481124;86454749;26375;
21.02.2019;12:56:01;86481214;86454891;26323;
21.02.2019;12:57:02;86481308;86454999;26309;
21.02.2019;12:58:02;86481381;86455115;26266;
21.02.2019;12:59:01;86481471;86455229;26242;
21.02.2019;13:00:02;86481543;86455344;26199;
21.02.2019;13:01:02;86481627;86455483;26144;
21.02.2019;13:02:01;86481696;86455594;26102;
21.02.2019;13:03:02;86481787;86455712;26075;
21.02.2019;13:04:02;86481883;86455845;26038;
21.02.2019;13:05:01;86481975;86455974;26001;
21.02.2019;13:06:02;86482069;86456105;25964;
21.02.2019;13:07:02;86482153;86456231;25922;
21.02.2019;13:08:01;86482231;86456333;25898;
21.02.2019;13:09:02;86482301;86456457;25844;
21.02.2019;13:10:02;86482397;86456593;25804;
21.02.2019;13:11:01;86482466;86456683;25783;
21.02.2019;13:12:02;86482557;86456796;25761;
21.02.2019;13:13:02;86482634;86456916;25718;
21.02.2019;13:14:01;86482724;86457027;25697;
21.02.2019;13:15:02;86482830;86457158;25672;
21.02.2019;13:16:02;86482920;86457281;25639;
21.02.2019;13:17:02;86483006;86457384;25622;
21.02.2019;13:18:01;86483110;86457518;25592;
21.02.2019;13:19:02;86483190;86457653;25537;
21.02.2019;13:20:02;86483267;86457786;25481;
21.02.2019;13:21:01;86483347;86457916;25431;
21.02.2019;13:22:02;86483439;86458045;25394;
21.02.2019;13:23:02;86483543;86458158;25385;
21.02.2019;13:24:02;86483633;86458260;25373;
21.02.2019;13:25:01;86483721;86458369;25352;
21.02.2019;13:26:02;86483806;86458505;25301;
21.02.2019;13:27:02;86483888;86458646;25242;
21.02.2019;13:28:01;86483975;86458791;25184;
21.02.2019;13:29:02;86484059;86458913;25146;
21.02.2019;13:30:02;86484154;86459037;25117;
21.02.2019;13:31:02;86484229;86459161;25068;
21.02.2019;13:32:01;86484331;86459285;25046;
21.02.2019;13:33:02;86484396;86459414;24982;
21.02.2019;13:34:02;86484496;86459535;24961;
21.02.2019;13:35:01;86484596;86459650;24946;
21.02.2019;13:36:02;86484697;86459773;24924;
21.02.2019;13:37:02;86484795;86459881;24914;
21.02.2019;13:38:06;86484886;86460012;24874;
21.02.2019;13:39:02;86484983;86460116;24867;
21.02.2019;13:40:02;86485067;86460218;24849;
21.02.2019;13:41:01;86485150;86460354;24796;
21.02.2019;13:42:02;86485243;86460480;24763;
21.02.2019;13:43:02;86485344;86460603;24741;
21.02.2019;13:44:01;86485437;86460743;24694;
21.02.2019;13:45:02;86485547;86460868;24679;
21.02.2019;13:46:02;86485648;86460992;24656;
21.02.2019;13:47:01;86485754;86461123;24631;
21.02.2019;13:48:02;86485840;86461237;24603;
21.02.2019;13:49:02;86485929;86461358;24571;
21.02.2019;13:50:01;86486004;86461487;24517;
21.02.2019;13:51:02;86486125;86461607;24518;
21.02.2019;13:52:02;86486237;86461716;24521;
21.02.2019;13:53:02;86486328;86461842;24486;
21.02.2019;13:54:01;86486423;86461953;24470;
21.02.2019;13:55:02;86486528;86462099;24429;
21.02.2019;13:56:02;86486632;86462204;24428;
21.02.2019;13:57:01;86486726;86462323;24403;
21.02.2019;13:58:02;86486844;86462448;24396;
21.02.2019;13:59:02;86486940;86462577;24363;
21.02.2019;14:00:01;86487035;86462690;24345;
21.02.2019;14:01:02;86487137;86462816;24321;
21.02.2019;14:02:02;86487214;86462957;24257;
21.02.2019;14:03:01;86487315;86463065;24250;
21.02.2019;14:04:02;86487433;86463176;24257;
21.02.2019;14:05:02;86487548;86463284;24264;
21.02.2019;14:06:02;86487631;86463411;24220;
21.02.2019;14:07:02;86487740;86463524;24216;
21.02.2019;14:08:01;86487852;86463645;24207;
21.02.2019;14:09:02;86487968;86463777;24191;
21.02.2019;14:10:02;86488074;86463910;24164;
21.02.2019;14:11:02;86488183;86464031;24152;
21.02.2019;14:12:02;86488294;86464126;24168;
21.02.2019;14:13:01;86488374;86464241;24133;
21.02.2019;14:14:03;86488474;86464376;24098;
21.02.2019;14:15:01;86488563;86464508;24055;
21.02.2019;14:16:02;86488657;86464598;24059;
21.02.2019;14:17:02;86488724;86464735;23989;
21.02.2019;14:18:01;86488810;86464843;23967;
21.02.2019;14:19:02;86488893;86464957;23936;
21.02.2019;14:20:02;86488975;86465079;23896;
21.02.2019;14:21:02;86489017;86465199;23818;
21.02.2019;14:22:01;86489109;86465339;23770;
21.02.2019;14:23:02;86489200;86465454;23746;
21.02.2019;14:24:02;86489280;86465579;23701;
21.02.2019;14:25:02;86489374;86465699;23675;
21.02.2019;14:26:02;86489452;86465823;23629;
21.02.2019;14:27:01;86489514;86465934;23580;
21.02.2019;14:28:02;86489599;86466064;23535;
21.02.2019;14:29:02;86489672;86466188;23484;
21.02.2019;14:30:01;86489805;86466334;23471;
21.02.2019;14:31:02;86489910;86466477;23433;
21.02.2019;14:32:02;86490009;86466585;23424;
21.02.2019;14:33:02;86490098;86466722;23376;
21.02.2019;14:34:01;86490192;86466841;23351;
21.02.2019;14:35:02;86490297;86466945;23352;
21.02.2019;14:36:02;86490374;86467073;23301;
21.02.2019;14:37:02;86490472;86467234;23238;
21.02.2019;14:38:01;86490578;86467365;23213;
21.02.2019;14:39:02;86490689;86467498;23191;
21.02.2019;14:40:02;86490796;86467637;23159;
21.02.2019;14:41:02;86490913;86467766;23147;
21.02.2019;14:42:01;86491015;86467909;23106;
21.02.2019;14:43:02;86491115;86468062;23053;
21.02.2019;14:44:02;86491197;86468175;23022;
21.02.2019;14:45:02;86491290;86468308;22982;
21.02.2019;14:46:02;86491407;86468444;22963;
21.02.2019;14:47:01;86491519;86468585;22934;
21.02.2019;14:48:02;86491622;86468745;22877;
21.02.2019;14:49:02;86491729;86468885;22844;
21.02.2019;14:50:01;86491847;86469003;22844;
21.02.2019;14:51:02;86491969;86469143;22826;
21.02.2019;14:52:02;86492078;86469294;22784;
21.02.2019;14:53:02;86492169;86469431;22738;
21.02.2019;14:54:02;86492271;86469556;22715;
21.02.2019;14:55:02;86492368;86469707;22661;
21.02.2019;14:56:02;86492476;86469855;22621;
21.02.2019;14:57:02;86492581;86469984;22597;
21.02.2019;14:58:01;86492711;86470111;22600;
21.02.2019;14:59:01;86492858;86470263;22595;
21.02.2019;15:00:02;86492979;86470379;22600;
21.02.2019;15:01:02;86493068;86470498;22570;
21.02.2019;15:02:02;86493174;86470644;22530;
21.02.2019;15:03:02;86493282;86470799;22483;
21.02.2019;15:04:02;86493375;86470949;22426;
21.02.2019;15:05:02;86493466;86471069;22397;
21.02.2019;15:06:01;86493556;86471190;22366;
21.02.2019;15:07:02;86493650;86471360;22290;
21.02.2019;15:08:02;86493757;86471514;22243;
21.02.2019;15:09:02;86493853;86471654;22199;
21.02.2019;15:10:01;86493956;86471780;22176;
21.02.2019;15:11:02;86494064;86471897;22167;
21.02.2019;15:12:02;86494179;86472057;22122;
21.02.2019;15:13:02;86494263;86472201;22062;
21.02.2019;15:14:02;86494361;86472341;22020;
21.02.2019;15:15:02;86494474;86472461;22013;
21.02.2019;15:16:02;86494584;86472599;21985;
21.02.2019;15:17:01;86494694;86472741;21953;
21.02.2019;15:18:02;86494797;86472872;21925;
21.02.2019;15:19:02;86494907;86473005;21902;
21.02.2019;15:20:02;86495021;86473150;21871;
21.02.2019;15:21:01;86495130;86473309;21821;
21.02.2019;15:22:02;86495248;86473484;21764;
21.02.2019;15:23:02;86495338;86473623;21715;
21.02.2019;15:24:02;86495434;86473775;21659;
21.02.2019;15:25:01;86495538;86473904;21634;
21.02.2019;15:26:02;86495667;86474041;21626;
21.02.2019;15:27:02;86495773;86474185;21588;
21.02.2019;15:28:01;86495884;86474327;21557;
21.02.2019;15:29:02;86495977;86474441;21536;
21.02.2019;15:30:02;86496068;86474652;21416;
21.02.2019;15:31:02;86496183;86474826;21357;
21.02.2019;15:32:01;86496278;86474954;21324;
21.02.2019;15:33:02;86496382;86475095;21287;
21.02.2019;15:34:02;86496491;86475239;21252;
21.02.2019;15:35:02;86496593;86475382;21211;
21.02.2019;15:36:02;86496681;86475505;21176;
21.02.2019;15:37:02;86496782;86475623;21159;
21.02.2019;15:38:02;86496886;86475766;21120;
21.02.2019;15:39:01;86496983;86475916;21067;
21.02.2019;15:40:02;86497082;86476052;21030;
21.02.2019;15:41:02;86497167;86476184;20983;
21.02.2019;15:42:01;86497281;86476299;20982;
21.02.2019;15:43:02;86497373;86476440;20933;
21.02.2019;15:44:02;86497468;86476608;20860;
21.02.2019;15:45:02;86497577;86476779;20798;
21.02.2019;15:46:02;86497666;86476943;20723;
21.02.2019;15:47:02;86497798;86477102;20696;
21.02.2019;15:48:01;86497894;86477251;20643;
21.02.2019;15:49:02;86498017;86477378;20639;
21.02.2019;15:50:02;86498124;86477560;20564;
21.02.2019;15:51:02;86498225;86477703;20522;
21.02.2019;15:52:01;86498317;86477852;20465;
21.02.2019;15:53:02;86498458;86478033;20425;
21.02.2019;15:54:02;86498558;86478206;20352;
21.02.2019;15:55:01;86498670;86478365;20305;
21.02.2019;15:56:02;86498777;86478530;20247;
21.02.2019;15:57:02;86498879;86478674;20205;
21.02.2019;15:58:02;86498981;86478797;20184;
21.02.2019;15:59:02;86499072;86478969;20103;
21.02.2019;16:00:01;86499181;86479121;20060;
21.02.2019;16:01:02;86499284;86479245;20039;
21.02.2019;16:02:02;86499406;86479397;20009;
21.02.2019;16:03:02;86499525;86479547;19978;
21.02.2019;16:04:01;86499649;86479706;19943;
21.02.2019;16:05:02;86499755;86479848;19907;
21.02.2019;16:06:02;86499900;86479995;19905;
21.02.2019;16:07:02;86500015;86480120;19895;
21.02.2019;16:08:02;86500124;86480268;19856;
21.02.2019;16:09:01;86500238;86480402;19836;
21.02.2019;16:10:02;86500337;86480589;19748;
21.02.2019;16:11:02;86500418;86480742;19676;
21.02.2019;16:12:02;86500515;86480897;19618;
21.02.2019;16:13:02;86500604;86481003;19601;
21.02.2019;16:14:02;86500707;86481155;19552;
21.02.2019;16:15:02;86500808;86481316;19492;
21.02.2019;16:16:02;86500905;86481439;19466;
21.02.2019;16:17:01;86501034;86481571;19463;
21.02.2019;16:18:02;86501143;86481695;19448;
21.02.2019;16:19:02;86501218;86481836;19382;
21.02.2019;16:20:02;86501308;86481976;19332;
21.02.2019;16:21:03;86501411;86482087;19324;
21.02.2019;16:22:02;86501521;86482224;19297;
21.02.2019;16:23:02;86501615;86482358;19257;
21.02.2019;16:24:02;86501716;86482505;19211;
21.02.2019;16:25:02;86501827;86482643;19184;
21.02.2019;16:26:02;86501935;86482781;19154;
21.02.2019;16:27:02;86502048;86482910;19138;
21.02.2019;16:28:02;86502129;86483046;19083;
21.02.2019;16:29:02;86502248;86483202;19046;
21.02.2019;16:30:02;86502345;86483358;18987;
21.02.2019;16:31:02;86502454;86483480;18974;
21.02.2019;16:32:02;86502554;86483604;18950;
21.02.2019;16:33:01;86502670;86483768;18902;
21.02.2019;16:34:01;86502759;86483941;18818;
21.02.2019;16:35:02;86502859;86484109;18750;
21.02.2019;16:36:02;86502955;86484247;18708;
21.02.2019;16:37:02;86503062;86484407;18655;
21.02.2019;16:38:02;86503168;86484576;18592;
21.02.2019;16:39:02;86503270;86484711;18559;
21.02.2019;16:40:02;86503386;86484835;18551;
21.02.2019;16:41:02;86503489;86484993;18496;
21.02.2019;16:42:03;86503602;86485127;18475;
21.02.2019;16:43:01;86503719;86485255;18464;
21.02.2019;16:44:02;86503835;86485447;18388;
21.02.2019;16:45:02;86503936;86485580;18356;
21.02.2019;16:46:02;86504055;86485740;18315;
21.02.2019;16:47:02;86504128;86485902;18226;
21.02.2019;16:48:02;86504248;86486081;18167;
21.02.2019;16:49:02;86504392;86486219;18173;
21.02.2019;16:50:02;86504508;86486376;18132;
21.02.2019;16:51:02;86504617;86486563;18054;
21.02.2019;16:52:02;86504743;86486727;18016;
21.02.2019;16:53:02;86504844;86486884;17960;
21.02.2019;16:54:02;86504938;86487063;17875;
21.02.2019;16:55:02;86505036;86487209;17827;
21.02.2019;16:56:01;86505148;86487356;17792;
21.02.2019;16:57:03;86505241;86487531;17710;
21.02.2019;16:58:02;86505348;86487687;17661;
21.02.2019;16:59:02;86505477;86487803;17674;
21.02.2019;17:00:01;86505583;86487953;17630;
21.02.2019;17:01:02;86505704;86488108;17596;
21.02.2019;17:02:02;86505834;86488254;17580;
21.02.2019;17:03:02;86505923;86488404;17519;
21.02.2019;17:04:02;86506004;86488557;17447;
21.02.2019;17:05:02;86506121;86488704;17417;
21.02.2019;17:06:02;86506217;86488857;17360;
21.02.2019;17:07:02;86506330;86489028;17302;
21.02.2019;17:08:02;86506434;86489137;17297;
21.02.2019;17:09:02;86506527;86489293;17234;
21.02.2019;17:10:01;86506636;86489431;17205;
21.02.2019;17:11:02;86506742;86489598;17144;
21.02.2019;17:12:03;86506863;86489759;17104;
21.02.2019;17:13:01;86506947;86489889;17058;
21.02.2019;17:14:02;86507083;86490067;17016;
21.02.2019;17:15:02;86507194;86490200;16994;
21.02.2019;17:16:02;86507277;86490365;16912;
21.02.2019;17:17:01;86507388;86490509;16879;
21.02.2019;17:18:02;86507505;86490657;16848;
21.02.2019;17:19:02;86507609;86490804;16805;
21.02.2019;17:20:02;86507694;86490980;16714;
21.02.2019;17:21:02;86507823;86491149;16674;
21.02.2019;17:22:02;86507937;86491309;16628;
21.02.2019;17:23:01;86508040;86491452;16588;
21.02.2019;17:24:02;86508166;86491648;16518;
21.02.2019;17:25:02;86508293;86491797;16496;
21.02.2019;17:26:01;86508418;86491965;16453;
21.02.2019;17:27:02;86508538;86492121;16417;
21.02.2019;17:28:02;86508636;86492264;16372;
21.02.2019;17:29:02;86508753;86492411;16342;
21.02.2019;17:30:02;86508859;86492575;16284;
21.02.2019;17:31:02;86508960;86492728;16232;
21.02.2019;17:32:02;86509064;86492878;16186;
21.02.2019;17:33:02;86509181;86493023;16158;
21.02.2019;17:34:02;86509298;86493167;16131;
21.02.2019;17:35:02;86509424;86493331;16093;
21.02.2019;17:36:01;86509533;86493426;16107;
21.02.2019;17:37:02;86509635;86493635;16000;
21.02.2019;17:38:02;86509715;86493759;15956;
21.02.2019;17:39:02;86509850;86493913;15937;
21.02.2019;17:40:01;86509953;86494075;15878;
21.02.2019;17:41:02;86510093;86494241;15852;
21.02.2019;17:42:02;86510190;86494379;15811;
21.02.2019;17:43:02;86510286;86494515;15771;
21.02.2019;17:44:02;86510394;86494656;15738;
21.02.2019;17:45:01;86510509;86494802;15707;
21.02.2019;17:46:02;86510610;86494960;15650;
21.02.2019;17:47:02;86510723;86495107;15616;
21.02.2019;17:48:02;86510817;86495163;15654;
21.02.2019;17:49:02;86510946;86495426;15520;
21.02.2019;17:50:01;86511054;86495548;15506;
21.02.2019;17:51:02;86511160;86495717;15443;
21.02.2019;17:52:02;86511273;86495863;15410;
21.02.2019;17:53:01;86511391;86496028;15363;
21.02.2019;17:54:02;86511515;86496179;15336;
21.02.2019;17:55:02;86511632;86496322;15310;
21.02.2019;17:56:02;86511751;86496467;15284;
21.02.2019;17:57:03;86511866;86496610;15256;
21.02.2019;17:58:02;86511985;86496749;15236;
21.02.2019;17:59:03;86512107;86496904;15203;
21.02.2019;18:00:02;86512232;86497028;15204;
21.02.2019;18:01:01;86512320;86497155;15165;
21.02.2019;18:02:02;86512428;86497302;15126;
21.02.2019;18:03:02;86512547;86497439;15108;
21.02.2019;18:04:02;86512639;86497564;15075;
21.02.2019;18:05:01;86512739;86497710;15029;
21.02.2019;18:06:02;86512868;86497845;15023;
21.02.2019;18:07:02;86512999;86497968;15031;
21.02.2019;18:08:02;86513108;86498116;14992;
21.02.2019;18:09:02;86513226;86498252;14974;
21.02.2019;18:10:02;86513361;86498370;14991;
21.02.2019;18:11:04;86513454;86498526;14928;
21.02.2019;18:12:02;86513583;86498669;14914;
21.02.2019;18:13:02;86513697;86498812;14885;
21.02.2019;18:14:01;86513766;86498940;14826;
21.02.2019;18:15:02;86513857;86499074;14783;
21.02.2019;18:16:02;86513956;86499190;14766;
21.02.2019;18:17:02;86514011;86499327;14684;
21.02.2019;18:18:01;86514092;86499435;14657;
21.02.2019;18:19:02;86514163;86499592;14571;
21.02.2019;18:20:02;86514229;86499709;14520;
21.02.2019;18:21:05;86514296;86499838;14458;
21.02.2019;18:22:02;86514400;86499951;14449;
21.02.2019;18:23:02;86514494;86500088;14406;
21.02.2019;18:24:01;86514562;86500240;14322;
21.02.2019;18:25:02;86514672;86500386;14286;
21.02.2019;18:26:02;86514784;86500509;14275;
21.02.2019;18:27:01;86514895;86500612;14283;
21.02.2019;18:28:02;86514988;86500741;14247;
21.02.2019;18:29:02;86515090;86500882;14208;
21.02.2019;18:30:02;86515168;86501027;14141;
21.02.2019;18:31:01;86515268;86501139;14129;
21.02.2019;18:32:06;86515373;86501296;14077;
21.02.2019;18:33:01;86515472;86501425;14047;
21.02.2019;18:34:02;86515564;86501552;14012;
21.02.2019;18:35:02;86515678;86501659;14019;
21.02.2019;18:36:02;86515782;86501775;14007;
21.02.2019;18:37:01;86515889;86501876;14013;
21.02.2019;18:38:02;86515982;86501996;13986;
21.02.2019;18:39:02;86516076;86502133;13943;
21.02.2019;18:40:01;86516165;86502252;13913;
21.02.2019;18:41:02;86516264;86502373;13891;
21.02.2019;18:42:02;86516374;86502510;13864;
21.02.2019;18:43:01;86516498;86502632;13866;
21.02.2019;18:44:02;86516611;86502778;13833;
21.02.2019;18:45:02;86516708;86502915;13793;
21.02.2019;18:46:02;86516838;86503033;13805;
21.02.2019;18:47:01;86516966;86503147;13819;
21.02.2019;18:48:02;86517063;86503283;13780;
21.02.2019;18:49:02;86517159;86503429;13730;
21.02.2019;18:50:01;86517265;86503525;13740;
21.02.2019;18:51:01;86517383;86503661;13722;
21.02.2019;18:52:02;86517497;86503771;13726;
21.02.2019;18:53:02;86517619;86503892;13727;
21.02.2019;18:54:01;86517739;86504012;13727;
21.02.2019;18:55:02;86517862;86504123;13739;
21.02.2019;18:56:02;86517996;86504254;13742;
21.02.2019;18:57:02;86518104;86504364;13740;
21.02.2019;18:58:01;86518251;86504476;13775;
21.02.2019;18:59:02;86518360;86504596;13764;
21.02.2019;19:00:02;86518483;86504678;13805;
21.02.2019;19:01:02;86518578;86504798;13780;
21.02.2019;19:02:02;86518706;86504894;13812;
21.02.2019;19:03:01;86518812;86504997;13815;
21.02.2019;19:04:02;86518956;86505101;13855;
21.02.2019;19:05:02;86519084;86505219;13865;
21.02.2019;19:06:02;86519162;86505252;13910;
21.02.2019;19:07:02;86519262;86505375;13887;
21.02.2019;19:08:01;86519380;86505479;13901;
21.02.2019;19:09:02;86519510;86505588;13922;
21.02.2019;19:10:02;86519643;86505687;13956;
21.02.2019;19:11:02;86519755;86505798;13957;
21.02.2019;19:12:01;86519870;86505901;13969;
21.02.2019;19:13:02;86519968;86506012;13956;
21.02.2019;19:14:02;86520084;86506106;13978;
21.02.2019;19:15:01;86520183;86506208;13975;
21.02.2019;19:16:02;86520292;86506298;13994;
21.02.2019;19:17:02;86520381;86506398;13983;
21.02.2019;19:18:01;86520504;86506489;14015;
21.02.2019;19:19:02;86520633;86506607;14026;
21.02.2019;19:20:02;86520735;86506713;14022;
21.02.2019;19:21:02;86520852;86506821;14031;
21.02.2019;19:22:01;86520965;86506893;14072;
21.02.2019;19:23:02;86521073;86507002;14071;
21.02.2019;19:24:02;86521180;86507103;14077;
21.02.2019;19:25:02;86521295;86507209;14086;
21.02.2019;19:26:02;86521411;86507298;14113;
21.02.2019;19:27:01;86521539;86507387;14152;
21.02.2019;19:28:02;86521651;86507483;14168;
21.02.2019;19:29:02;86521740;86507575;14165;
21.02.2019;19:30:02;86521855;86507673;14182;
21.02.2019;19:31:01;86521950;86507762;14188;
21.02.2019;19:32:02;86522073;86507857;14216;
21.02.2019;19:33:02;86522174;86507951;14223;
21.02.2019;19:34:02;86522281;86508050;14231;
21.02.2019;19:35:02;86522373;86508142;14231;
21.02.2019;19:36:02;86522445;86508245;14200;
21.02.2019;19:37:01;86522543;86508328;14215;
21.02.2019;19:38:02;86522662;86508406;14256;
21.02.2019;19:39:02;86522760;86508498;14262;
21.02.2019;19:40:02;86522850;86508576;14274;
21.02.2019;19:41:02;86522933;86508649;14284;
21.02.2019;19:42:02;86523027;86508741;14286;
21.02.2019;19:43:01;86523132;86508834;14298;
21.02.2019;19:44:02;86523250;86508933;14317;
21.02.2019;19:45:02;86523359;86509035;14324;
21.02.2019;19:46:02;86523448;86509128;14320;
21.02.2019;19:47:01;86523539;86509198;14341;
21.02.2019;19:48:02;86523657;86509286;14371;
21.02.2019;19:49:02;86523759;86509366;14393;
21.02.2019;19:50:02;86523864;86509445;14419;
21.02.2019;19:51:01;86523952;86509527;14425;
21.02.2019;19:52:02;86524045;86509611;14434;
21.02.2019;19:53:02;86524140;86509695;14445;
21.02.2019;19:54:02;86524230;86509776;14454;
21.02.2019;19:55:02;86524355;86509851;14504;
21.02.2019;19:56:02;86524459;86509930;14529;
21.02.2019;19:57:01;86524547;86510016;14531;
21.02.2019;19:58:02;86524627;86510092;14535;
21.02.2019;19:59:02;86524738;86510155;14583;
21.02.2019;20:00:02;86524842;86510243;14599;
21.02.2019;20:01:02;86524939;86510309;14630;
21.02.2019;20:02:01;86525041;86510385;14656;
21.02.2019;20:03:02;86525141;86510465;14676;
21.02.2019;20:04:02;86525219;86510536;14683;
21.02.2019;20:05:02;86525278;86510616;14662;
21.02.2019;20:06:02;86525301;86510704;14597;
21.02.2019;20:07:02;86525349;86510775;14574;
21.02.2019;20:08:02;86525413;86510843;14570;
21.02.2019;20:09:02;86525489;86510918;14571;
21.02.2019;20:10:02;86525538;86511009;14529;
21.02.2019;20:11:01;86525605;86511090;14515;
21.02.2019;20:12:02;86525694;86511162;14532;
21.02.2019;20:13:02;86525796;86511235;14561;
21.02.2019;20:14:02;86525872;86511312;14560;
21.02.2019;20:15:01;86525953;86511392;14561;
21.02.2019;20:16:02;86526060;86511478;14582;
21.02.2019;20:17:02;86526139;86511551;14588;
21.02.2019;20:18:02;86526225;86511641;14584;
21.02.2019;20:19:01;86526305;86511665;14640;
21.02.2019;20:20:02;86526372;86511781;14591;
21.02.2019;20:21:02;86526457;86511832;14625;
21.02.2019;20:22:02;86526527;86511875;14652;
21.02.2019;20:23:02;86526614;86511934;14680;
21.02.2019;20:24:01;86526696;86512014;14682;
21.02.2019;20:25:02;86526771;86512087;14684;
21.02.2019;20:26:02;86526864;86512157;14707;
21.02.2019;20:27:02;86526910;86512202;14708;
21.02.2019;20:28:01;86526950;86512260;14690;
21.02.2019;20:29:02;86526985;86512324;14661;
21.02.2019;20:30:02;86527039;86512355;14684;
21.02.2019;20:31:02;86527094;86512407;14687;
21.02.2019;20:32:02;86527140;86512445;14695;
21.02.2019;20:33:02;86527181;86512497;14684;
21.02.2019;20:34:02;86527240;86512558;14682;
21.02.2019;20:35:02;86527291;86512588;14703;
21.02.2019;20:36:01;86527345;86512622;14723;
21.02.2019;20:37:02;86527397;86512663;14734;
21.02.2019;20:38:02;86527462;86512721;14741;
21.02.2019;20:39:02;86527527;86512769;14758;
21.02.2019;20:40:07;86527576;86512816;14760;
21.02.2019;20:41:01;86527600;86512853;14747;
21.02.2019;20:42:03;86527703;86512916;14787;
21.02.2019;20:43:01;86527791;86512969;14822;
21.02.2019;20:44:02;86527856;86513017;14839;
21.02.2019;20:45:02;86527939;86513072;14867;
21.02.2019;20:46:02;86528001;86513129;14872;
21.02.2019;20:47:02;86528068;86513195;14873;
21.02.2019;20:48:02;86528143;86513249;14894;
21.02.2019;20:49:01;86528235;86513291;14944;
21.02.2019;20:50:02;86528330;86513352;14978;
21.02.2019;20:51:02;86528380;86513398;14982;
21.02.2019;20:52:02;86528456;86513474;14982;
21.02.2019;20:53:02;86528559;86513521;15038;
21.02.2019;20:54:02;86528637;86513572;15065;
21.02.2019;20:55:02;86528710;86513612;15098;
21.02.2019;20:56:02;86528784;86513667;15117;
21.02.2019;20:57:02;86528849;86513730;15119;
21.02.2019;20:58:02;86528943;86513794;15149;
21.02.2019;20:59:02;86529035;86513850;15185;
21.02.2019;21:00:02;86529122;86513901;15221;
21.02.2019;21:01:02;86529191;86513956;15235;
21.02.2019;21:02:01;86529274;86514006;15268;
21.02.2019;21:03:02;86529367;86514050;15317;
21.02.2019;21:04:02;86529438;86514120;15318;
21.02.2019;21:05:05;86529555;86514169;15386;
21.02.2019;21:06:04;86529621;86514213;15408;
21.02.2019;21:07:02;86529723;86514264;15459;
21.02.2019;21:08:02;86529818;86514326;15492;
21.02.2019;21:09:01;86529882;86514378;15504;
21.02.2019;21:10:01;86529995;86514415;15580;
21.02.2019;21:11:02;86530078;86514461;15617;
21.02.2019;21:12:02;86530159;86514507;15652;
21.02.2019;21:13:02;86530252;86514551;15701;
21.02.2019;21:14:02;86530350;86514618;15732;
21.02.2019;21:15:02;86530430;86514675;15755;
21.02.2019;21:16:03;86530522;86514715;15807;
21.02.2019;21:17:01;86530582;86514776;15806;
21.02.2019;21:18:02;86530659;86514834;15825;
21.02.2019;21:19:02;86530740;86514871;15869;
21.02.2019;21:20:02;86530841;86514924;15917;
21.02.2019;21:22:02;86531035;86515013;16022;
21.02.2019;21:23:02;86531110;86515079;16031;
21.02.2019;21:24:02;86531214;86515139;16075;
21.02.2019;21:25:01;86531298;86515186;16112;
21.02.2019;21:26:02;86531421;86515239;16182;
21.02.2019;21:27:02;86531523;86515279;16244;
21.02.2019;21:28:02;86531614;86515308;16306;
21.02.2019;21:29:01;86531687;86515339;16348;
21.02.2019;21:30:02;86531775;86515386;16389;
21.02.2019;21:31:02;86531849;86515428;16421;
21.02.2019;21:32:02;86531954;86515464;16490;
21.02.2019;21:33:02;86532020;86515502;16518;
21.02.2019;21:34:01;86532124;86515544;16580;
21.02.2019;21:35:02;86532210;86515590;16620;
21.02.2019;21:36:02;86532299;86515631;16668;
21.02.2019;21:37:01;86532411;86515673;16738;
21.02.2019;21:38:02;86532486;86515716;16770;
21.02.2019;21:39:02;86532524;86515733;16791;
21.02.2019;21:40:02;86532583;86515752;16831;
21.02.2019;21:41:01;86532652;86515783;16869;
21.02.2019;21:42:02;86532720;86515816;16904;
21.02.2019;21:43:02;86532793;86515857;16936;
21.02.2019;21:44:02;86532876;86515895;16981;
21.02.2019;21:45:01;86532971;86515929;17042;
21.02.2019;21:46:02;86533057;86515966;17091;
21.02.2019;21:47:02;86533150;86515995;17155;
21.02.2019;21:48:02;86533253;86516050;17203;
21.02.2019;21:49:02;86533343;86516099;17244;
21.02.2019;21:50:01;86533424;86516135;17289;
21.02.2019;21:51:02;86533524;86516170;17354;
21.02.2019;21:52:02;86533602;86516208;17394;
21.02.2019;21:53:01;86533654;86516241;17413;
21.02.2019;21:54:02;86533741;86516281;17460;
21.02.2019;21:55:02;86533842;86516312;17530;
21.02.2019;21:56:02;86533932;86516358;17574;
21.02.2019;21:57:02;86534027;86516375;17652;
21.02.2019;21:58:02;86534112;86516391;17721;
21.02.2019;21:59:01;86534245;86516445;17800;
21.02.2019;22:00:02;86534354;86516468;17886;
21.02.2019;22:01:02;86534455;86516488;17967;
21.02.2019;22:02:02;86534475;86516453;18022;
21.02.2019;22:03:02;86534567;86516493;18074;
21.02.2019;22:04:02;86534665;86516533;18132;
21.02.2019;22:05:02;86534753;86516557;18196;
21.02.2019;22:06:02;86534834;86516592;18242;
21.02.2019;22:07:02;86534931;86516620;18311;
21.02.2019;22:08:02;86535015;86516654;18361;
21.02.2019;22:09:01;86535100;86516696;18404;
21.02.2019;22:10:02;86535189;86516730;18459;
21.02.2019;22:11:02;86535284;86516768;18516;
21.02.2019;22:12:02;86535352;86516797;18555;
21.02.2019;22:13:02;86535438;86516834;18604;
21.02.2019;22:14:01;86535528;86516862;18666;
21.02.2019;22:15:02;86535625;86516885;18740;
21.02.2019;22:16:02;86535687;86516919;18768;
21.02.2019;22:17:02;86535769;86516954;18815;
21.02.2019;22:18:02;86535871;86516992;18879;
21.02.2019;22:19:01;86535961;86517023;18938;
21.02.2019;22:20:02;86536017;86517043;18974;
21.02.2019;22:21:02;86536089;86517074;19015;
21.02.2019;22:22:02;86536184;86517087;19097;
21.02.2019;22:23:01;86536259;86517105;19154;
21.02.2019;22:24:02;86536329;86517139;19190;
21.02.2019;22:25:02;86536421;86517158;19263;
21.02.2019;22:26:01;86536494;86517186;19308;
21.02.2019;22:27:02;86536566;86517222;19344;
21.02.2019;22:28:02;86536617;86517257;19360;
21.02.2019;22:29:02;86536702;86517289;19413;
21.02.2019;22:30:01;86536742;86517318;19424;
21.02.2019;22:31:02;86536780;86517340;19440;
21.02.2019;22:32:02;86536892;86517366;19526;
21.02.2019;22:33:02;86536945;86517396;19549;
21.02.2019;22:34:01;86536995;86517432;19563;
21.02.2019;22:35:02;86537065;86517457;19608;
21.02.2019;22:36:02;86537144;86517483;19661;
21.02.2019;22:37:02;86537231;86517508;19723;
21.02.2019;22:38:01;86537282;86517537;19745;
21.02.2019;22:39:02;86537351;86517569;19782;
21.02.2019;22:40:02;86537422;86517604;19818;
21.02.2019;22:41:01;86537476;86517627;19849;
21.02.2019;22:42:02;86537553;86517647;19906;
21.02.2019;22:43:02;86537627;86517669;19958;
21.02.2019;22:44:01;86537714;86517699;20015;
21.02.2019;22:45:02;86537801;86517729;20072;
21.02.2019;22:46:02;86537874;86517763;20111;
21.02.2019;22:47:01;86537935;86517794;20141;
21.02.2019;22:48:02;86537996;86517820;20176;
21.02.2019;22:49:02;86538085;86517855;20230;
21.02.2019;22:50:01;86538114;86517874;20240;
21.02.2019;22:51:02;86538141;86517896;20245;
21.02.2019;22:52:02;86538168;86517917;20251;
21.02.2019;22:53:02;86538248;86517952;20296;
21.02.2019;22:54:01;86538321;86517973;20348;
21.02.2019;22:55:02;86538424;86518000;20424;
21.02.2019;22:56:02;86538501;86518034;20467;
21.02.2019;22:57:02;86538588;86518051;20537;
21.02.2019;22:58:02;86538662;86518061;20601;
21.02.2019;22:59:01;86538734;86518091;20643;
21.02.2019;23:00:02;86538825;86518113;20712;
21.02.2019;23:01:03;86538917;86518148;20769;
21.02.2019;23:02:04;86538965;86518175;20790;
21.02.2019;23:03:02;86539054;86518201;20853;
21.02.2019;23:04:02;86539116;86518227;20889;
21.02.2019;23:05:02;86539186;86518255;20931;
21.02.2019;23:06:02;86539277;86518276;21001;
21.02.2019;23:07:01;86539371;86518309;21062;
21.02.2019;23:08:02;86539461;86518335;21126;
21.02.2019;23:09:02;86539544;86518361;21183;
21.02.2019;23:10:01;86539641;86518378;21263;
21.02.2019;23:11:02;86539730;86518404;21326;
21.02.2019;23:12:02;86539830;86518449;21381;
21.02.2019;23:13:01;86539909;86518484;21425;
21.02.2019;23:14:02;86539983;86518512;21471;
21.02.2019;23:15:02;86540054;86518538;21516;
21.02.2019;23:16:01;86540130;86518576;21554;
21.02.2019;23:17:02;86540211;86518594;21617;
21.02.2019;23:18:01;86540282;86518608;21674;
21.02.2019;23:19:02;86540377;86518627;21750;
21.02.2019;23:20:02;86540473;86518664;21809;
21.02.2019;23:21:01;86540545;86518692;21853;
21.02.2019;23:23:02;86540738;86518757;21981;
21.02.2019;23:24:02;86540823;86518786;22037;
21.02.2019;23:25:01;86540911;86518809;22102;
21.02.2019;23:26:02;86540991;86518841;22150;
21.02.2019;23:27:02;86541058;86518863;22195;
21.02.2019;23:28:02;86541137;86518886;22251;
21.02.2019;23:29:02;86541209;86518909;22300;
21.02.2019;23:30:02;86541282;86518924;22358;
21.02.2019;23:31:02;86541340;86518973;22367;
21.02.2019;23:32:01;86541436;86519010;22426;
21.02.2019;23:33:02;86541505;86519029;22476;
21.02.2019;23:34:01;86541552;86519061;22491;
21.02.2019;23:35:01;86541640;86519090;22550;
21.02.2019;23:36:02;86541724;86519125;22599;
21.02.2019;23:37:01;86541794;86519157;22637;
21.02.2019;23:38:02;86541879;86519173;22706;
21.02.2019;23:39:01;86541972;86519193;22779;
21.02.2019;23:40:01;86542072;86519223;22849;
21.02.2019;23:41:02;86542116;86519243;22873;
21.02.2019;23:42:01;86542225;86519270;22955;
21.02.2019;23:43:02;86542294;86519295;22999;
21.02.2019;23:44:01;86542373;86519322;23051;
21.02.2019;23:45:02;86542469;86519339;23130;
21.02.2019;23:46:02;86542541;86519385;23156;
21.02.2019;23:47:01;86542628;86519413;23215;
21.02.2019;23:48:02;86542699;86519444;23255;
21.02.2019;23:49:02;86542761;86519466;23295;
21.02.2019;23:50:01;86542824;86519490;23334;
21.02.2019;23:51:02;86542902;86519525;23377;
21.02.2019;23:52:01;86542953;86519559;23394;
21.02.2019;23:53:02;86543031;86519574;23457;
21.02.2019;23:54:02;86543101;86519590;23511;
21.02.2019;23:55:01;86543166;86519622;23544;
21.02.2019;23:56:02;86543245;86519650;23595;
21.02.2019;23:57:02;86543324;86519681;23643;
21.02.2019;23:58:02;86543426;86519705;23721;
21.02.2019;23:59:01;86543504;86519729;23775;
22.02.2019;00:00:02;86543599;86519749;23850;
22.02.2019;00:01:01;86543677;86519770;23907;
22.02.2019;00:02:02;86543746;86519782;23964;
22.02.2019;00:03:02;86543833;86519801;24032;
22.02.2019;00:04:01;86543905;86519835;24070;
22.02.2019;00:05:02;86543962;86519843;24119;
22.02.2019;00:06:02;86544011;86519854;24157;
22.02.2019;00:07:02;86544071;86519871;24200;
22.02.2019;00:08:01;86544138;86519887;24251;
22.02.2019;00:09:02;86544200;86519903;24297;
22.02.2019;00:10:01;86544267;86519920;24347;
22.02.2019;00:11:02;86544314;86519942;24372;
22.02.2019;00:12:02;86544388;86519938;24450;
22.02.2019;00:13:01;86544414;86519941;24473;
22.02.2019;00:14:02;86544497;86519962;24535;
22.02.2019;00:15:02;86544521;86519971;24550;
22.02.2019;00:16:01;86544576;86519993;24583;
22.02.2019;00:17:02;86544628;86519994;24634;
22.02.2019;00:18:01;86544659;86520017;24642;
22.02.2019;00:19:02;86544703;86520032;24671;
22.02.2019;00:20:01;86544731;86520057;24674;
22.02.2019;00:21:02;86544784;86520067;24717;
22.02.2019;00:22:01;86544846;86520087;24759;
22.02.2019;00:23:02;86544926;86520109;24817;
22.02.2019;00:24:02;86545003;86520127;24876;
22.02.2019;00:25:01;86545071;86520150;24921;
22.02.2019;00:26:02;86545134;86520163;24971;
22.02.2019;00:27:01;86545211;86520184;25027;
22.02.2019;00:28:02;86545285;86520198;25087;
22.02.2019;00:29:02;86545377;86520218;25159;
22.02.2019;00:30:01;86545437;86520245;25192;
22.02.2019;00:31:02;86545502;86520263;25239;
22.02.2019;00:32:01;86545577;86520293;25284;
22.02.2019;00:33:07;86545651;86520317;25334;
22.02.2019;00:34:02;86545729;86520335;25394;
22.02.2019;00:35:01;86545798;86520361;25437;
22.02.2019;00:36:02;86545889;86520388;25501;
22.02.2019;00:37:01;86545962;86520411;25551;
22.02.2019;00:38:02;86546041;86520446;25595;
22.02.2019;00:39:02;86546114;86520468;25646;
22.02.2019;00:40:01;86546182;86520488;25694;
22.02.2019;00:41:02;86546244;86520521;25723;
22.02.2019;00:42:01;86546311;86520545;25766;
22.02.2019;00:43:02;86546393;86520566;25827;
22.02.2019;00:44:02;86546452;86520583;25869;
22.02.2019;00:45:01;86546504;86520607;25897;
22.02.2019;00:46:02;86546573;86520644;25929;
22.02.2019;00:47:02;86546653;86520670;25983;
22.02.2019;00:48:01;86546713;86520695;26018;
22.02.2019;00:49:02;86546781;86520717;26064;
22.02.2019;00:50:01;86546854;86520749;26105;
22.02.2019;00:51:02;86546936;86520783;26153;
22.02.2019;00:52:02;86546979;86520803;26176;
22.02.2019;00:53:01;86547078;86520819;26259;
22.02.2019;00:54:02;86547132;86520840;26292;
22.02.2019;00:55:02;86547188;86520872;26316;
22.02.2019;00:56:01;86547256;86520891;26365;
22.02.2019;00:57:02;86547322;86520920;26402;
22.02.2019;00:58:02;86547393;86520950;26443;
22.02.2019;00:59:01;86547449;86520968;26481;
22.02.2019;01:00:02;86547505;86520997;26508;
22.02.2019;01:01:01;86547575;86521019;26556;
22.02.2019;01:02:02;86547645;86521035;26610;
22.02.2019;01:03:02;86547712;86521056;26656;
22.02.2019;01:04:01;86547790;86521080;26710;
22.02.2019;01:05:02;86547869;86521114;26755;
22.02.2019;01:06:01;86547915;86521145;26770;
22.02.2019;01:07:02;86548001;86521175;26826;
22.02.2019;01:08:02;86548080;86521196;26884;
22.02.2019;01:09:01;86548100;86521164;26936;
22.02.2019;01:10:02;86548159;86521193;26966;
22.02.2019;01:11:02;86548241;86521231;27010;
22.02.2019;01:12:01;86548310;86521256;27054;
22.02.2019;01:13:02;86548390;86521279;27111;
22.02.2019;01:14:02;86548472;86521312;27160;
22.02.2019;01:15:01;86548553;86521340;27213;
22.02.2019;01:16:02;86548618;86521366;27252;
22.02.2019;01:17:02;86548671;86521407;27264;
22.02.2019;01:18:01;86548734;86521436;27298;
22.02.2019;01:19:02;86548790;86521464;27326;
22.02.2019;01:20:02;86548861;86521510;27351;
22.02.2019;01:21:01;86548926;86521548;27378;
22.02.2019;01:22:02;86549053;86521569;27484;
22.02.2019;01:23:02;86549123;86521598;27525;
22.02.2019;01:24:01;86549201;86521642;27559;
22.02.2019;01:25:02;86549271;86521673;27598;
22.02.2019;01:26:02;86549331;86521717;27614;
22.02.2019;01:27:01;86549402;86521749;27653;
22.02.2019;01:28:02;86549475;86521779;27696;
22.02.2019;01:29:01;86549565;86521817;27748;
22.02.2019;01:30:02;86549636;86521842;27794;
22.02.2019;01:31:02;86549668;86521872;27796;
22.02.2019;01:32:01;86549772;86521909;27863;
22.02.2019;01:33:02;86549847;86521945;27902;
22.02.2019;01:34:02;86549928;86521990;27938;
22.02.2019;01:35:01;86550059;86522031;28028;
22.02.2019;01:36:02;86550158;86522062;28096;
22.02.2019;01:37:02;86550269;86522084;28185;
22.02.2019;01:38:01;86550395;86522128;28267;
22.02.2019;01:39:02;86550518;86522169;28349;
22.02.2019;01:40:02;86550661;86522223;28438;
22.02.2019;01:41:01;86550780;86522261;28519;
22.02.2019;01:42:02;86550911;86522299;28612;
22.02.2019;01:43:01;86551033;86522347;28686;
22.02.2019;01:44:02;86551181;86522384;28797;
22.02.2019;01:45:02;86551308;86522414;28894;
22.02.2019;01:46:01;86551414;86522438;28976;
22.02.2019;01:47:02;86551531;86522480;29051;
22.02.2019;01:48:02;86551678;86522533;29145;
22.02.2019;01:49:01;86551806;86522582;29224;
22.02.2019;01:50:02;86551939;86522634;29305;
22.02.2019;01:51:02;86552076;86522691;29385;
22.02.2019;01:52:01;86552196;86522740;29456;
22.02.2019;01:53:02;86552314;86522777;29537;
22.02.2019;01:54:02;86552472;86522822;29650;
22.02.2019;01:55:01;86552592;86522867;29725;
22.02.2019;01:56:02;86552748;86522911;29837;
22.02.2019;01:57:01;86552871;86522958;29913;
22.02.2019;01:58:02;86552987;86523012;29975;
22.02.2019;01:59:02;86553125;86523053;30072;
22.02.2019;02:00:01;86553233;86523100;30133;
22.02.2019;02:01:02;86553366;86523149;30217;
22.02.2019;02:02:01;86553492;86523196;30296;
22.02.2019;02:03:02;86553639;86523250;30389;
22.02.2019;02:04:02;86553787;86523321;30466;
22.02.2019;02:05:01;86553929;86523367;30562;
22.02.2019;02:06:02;86554034;86523419;30615;
22.02.2019;02:07:02;86554158;86523470;30688;
22.02.2019;02:08:01;86554291;86523517;30774;
22.02.2019;02:09:02;86554426;86523578;30848;
22.02.2019;02:10:02;86554545;86523640;30905;
22.02.2019;02:11:01;86554664;86523700;30964;
22.02.2019;02:12:02;86554809;86523747;31062;
22.02.2019;02:13:02;86554927;86523802;31125;
22.02.2019;02:14:01;86555027;86523863;31164;
22.02.2019;02:15:02;86555145;86523933;31212;
22.02.2019;02:16:02;86555240;86523970;31270;
22.02.2019;02:17:01;86555344;86524039;31305;
22.02.2019;02:18:02;86555431;86524095;31336;
22.02.2019;02:19:02;86555521;86524145;31376;
22.02.2019;02:20:01;86555620;86524186;31434;
22.02.2019;02:21:02;86555720;86524246;31474;
22.02.2019;02:22:02;86555824;86524299;31525;
22.02.2019;02:23:01;86555903;86524350;31553;
22.02.2019;02:24:02;86555998;86524421;31577;
22.02.2019;02:25:02;86556100;86524466;31634;
22.02.2019;02:26:01;86556196;86524488;31708;
22.02.2019;02:27:02;86556297;86524541;31756;
22.02.2019;02:28:01;86556383;86524597;31786;
22.02.2019;02:29:02;86556491;86524669;31822;
22.02.2019;02:30:02;86556589;86524735;31854;
22.02.2019;02:31:01;86556684;86524770;31914;
22.02.2019;02:32:02;86556761;86524811;31950;
22.02.2019;02:33:02;86556836;86524865;31971;
22.02.2019;02:34:01;86556900;86524927;31973;
22.02.2019;02:35:02;86557012;86524990;32022;
22.02.2019;02:36:02;86557123;86525056;32067;
22.02.2019;02:37:01;86557171;86525116;32055;
22.02.2019;02:38:02;86557310;86525178;32132;
22.02.2019;02:39:02;86557423;86525252;32171;
22.02.2019;02:40:01;86557521;86525330;32191;
22.02.2019;02:41:02;86557619;86525372;32247;
22.02.2019;02:42:01;86557698;86525460;32238;
22.02.2019;02:43:01;86557794;86525525;32269;
22.02.2019;02:44:02;86557890;86525620;32270;
22.02.2019;02:45:02;86557985;86525671;32314;
22.02.2019;02:46:01;86558087;86525749;32338;
22.02.2019;02:47:02;86558171;86525830;32341;
22.02.2019;02:48:01;86558249;86525904;32345;
22.02.2019;02:49:01;86558341;86525982;32359;
22.02.2019;02:50:02;86558453;86526045;32408;
22.02.2019;02:51:01;86558554;86526111;32443;
22.02.2019;02:52:02;86558655;86526174;32481;
22.02.2019;02:53:02;86558745;86526259;32486;
22.02.2019;02:54:01;86558846;86526343;32503;
22.02.2019;02:55:02;86558915;86526434;32481;
22.02.2019;02:56:02;86559018;86526509;32509;
22.02.2019;02:57:01;86559104;86526577;32527;
22.02.2019;02:58:02;86559199;86526641;32558;
22.02.2019;02:59:01;86559302;86526717;32585;
22.02.2019;03:00:02;86559404;86526804;32600;
22.02.2019;03:01:02;86559487;86526879;32608;
22.02.2019;03:02:01;86559599;86526962;32637;
22.02.2019;03:03:02;86559686;86527040;32646;
22.02.2019;03:04:02;86559783;86527129;32654;
22.02.2019;03:05:01;86559872;86527198;32674;
22.02.2019;03:06:02;86559973;86527276;32697;
22.02.2019;03:07:02;86560073;86527330;32743;
22.02.2019;03:08:01;86560174;86527423;32751;
22.02.2019;03:09:02;86560259;86527513;32746;
22.02.2019;03:10:01;86560346;86527586;32760;
22.02.2019;03:11:01;86560463;86527671;32792;
22.02.2019;03:12:02;86560563;86527758;32805;
22.02.2019;03:13:01;86560625;86527844;32781;
22.02.2019;03:14:02;86560707;86527927;32780;
22.02.2019;03:15:02;86560797;86528031;32766;
22.02.2019;03:16:01;86560886;86528086;32800;
22.02.2019;03:17:02;86560981;86528173;32808;
22.02.2019;03:18:01;86561070;86528252;32818;
22.02.2019;03:19:02;86561135;86528340;32795;
22.02.2019;03:20:02;86561213;86528410;32803;
22.02.2019;03:21:01;86561325;86528502;32823;
22.02.2019;03:22:02;86561420;86528578;32842;
22.02.2019;03:23:02;86561522;86528681;32841;
22.02.2019;03:24:01;86561610;86528752;32858;
22.02.2019;03:25:02;86561713;86528841;32872;
22.02.2019;03:26:01;86561808;86528931;32877;
22.02.2019;03:27:01;86561874;86529029;32845;
22.02.2019;03:28:02;86561950;86529114;32836;
22.02.2019;03:29:01;86562039;86529210;32829;
22.02.2019;03:30:02;86562129;86529290;32839;
22.02.2019;03:31:02;86562213;86529369;32844;
22.02.2019;03:32:01;86562311;86529464;32847;
22.02.2019;03:33:02;86562398;86529565;32833;
22.02.2019;03:34:02;86562472;86529655;32817;
22.02.2019;03:35:01;86562551;86529747;32804;
22.02.2019;03:36:02;86562619;86529835;32784;
22.02.2019;03:37:01;86562691;86529917;32774;
22.02.2019;03:39:01;86562892;86530106;32786;
22.02.2019;03:40:02;86562990;86530193;32797;
22.02.2019;03:41:02;86563046;86530272;32774;
22.02.2019;03:42:01;86563142;86530377;32765;
22.02.2019;03:43:02;86563226;86530465;32761;
22.02.2019;03:44:01;86563320;86530578;32742;
22.02.2019;03:45:02;86563411;86530677;32734;
22.02.2019;03:46:02;86563509;86530785;32724;
22.02.2019;03:47:02;86563596;86530900;32696;
22.02.2019;03:48:01;86563714;86530994;32720;
22.02.2019;03:49:02;86563796;86531095;32701;
22.02.2019;03:50:02;86563883;86531188;32695;
22.02.2019;03:51:01;86563972;86531301;32671;
22.02.2019;03:52:02;86564057;86531402;32655;
22.02.2019;03:53:02;86564169;86531490;32679;
22.02.2019;03:54:01;86564238;86531602;32636;
22.02.2019;03:55:02;86564338;86531698;32640;
22.02.2019;03:56:01;86564444;86531784;32660;
22.02.2019;03:57:02;86564517;86531880;32637;
22.02.2019;03:58:02;86564593;86531982;32611;
22.02.2019;03:59:01;86564675;86532088;32587;
22.02.2019;04:00:02;86564757;86532193;32564;
22.02.2019;04:01:01;86564817;86532237;32580;
22.02.2019;04:02:02;86564917;86532354;32563;
22.02.2019;04:03:02;86565008;86532461;32547;
22.02.2019;04:04:01;86565082;86532566;32516;
22.02.2019;04:05:02;86565178;86532668;32510;
22.02.2019;04:06:02;86565282;86532775;32507;
22.02.2019;04:07:01;86565388;86532864;32524;
22.02.2019;04:08:02;86565481;86532963;32518;
22.02.2019;04:09:01;86565562;86533058;32504;
22.02.2019;04:10:02;86565649;86533158;32491;
22.02.2019;04:11:02;86565721;86533269;32452;
22.02.2019;04:12:01;86565807;86533364;32443;
22.02.2019;04:13:02;86565904;86533466;32438;
22.02.2019;04:14:01;86566000;86533557;32443;
22.02.2019;04:15:02;86566090;86533659;32431;
22.02.2019;04:16:02;86566196;86533747;32449;
22.02.2019;04:17:01;86566265;86533841;32424;
22.02.2019;04:18:02;86566335;86533928;32407;
22.02.2019;04:19:02;86566398;86534013;32385;
22.02.2019;04:20:01;86566480;86534097;32383;
22.02.2019;04:21:02;86566546;86534194;32352;
22.02.2019;04:22:01;86566629;86534268;32361;
22.02.2019;04:23:02;86566697;86534359;32338;
22.02.2019;04:24:02;86566749;86534447;32302;
22.02.2019;04:25:01;86566809;86534543;32266;
22.02.2019;04:26:02;86566858;86534633;32225;
22.02.2019;04:27:02;86566917;86534702;32215;
22.02.2019;04:28:01;86566970;86534795;32175;
22.02.2019;04:29:02;86567049;86534881;32168;
22.02.2019;04:30:02;86567096;86534984;32112;
22.02.2019;04:31:01;86567160;86535086;32074;
22.02.2019;04:32:02;86567247;86535190;32057;
22.02.2019;04:33:02;86567319;86535277;32042;
22.02.2019;04:34:01;86567432;86535376;32056;
22.02.2019;04:35:02;86567513;86535470;32043;
22.02.2019;04:36:02;86567577;86535577;32000;
22.02.2019;04:37:01;86567632;86535670;31962;
22.02.2019;04:38:02;86567699;86535754;31945;
22.02.2019;04:39:02;86567773;86535843;31930;
22.02.2019;04:40:02;86567855;86535930;31925;
22.02.2019;04:41:01;86567928;86536039;31889;
22.02.2019;04:42:02;86568000;86536121;31879;
22.02.2019;04:43:01;86568062;86536203;31859;
22.02.2019;04:44:02;86568154;86536307;31847;
22.02.2019;04:45:02;86568215;86536429;31786;
22.02.2019;04:46:01;86568280;86536525;31755;
22.02.2019;04:47:02;86568347;86536618;31729;
22.02.2019;04:48:02;86568435;86536697;31738;
22.02.2019;04:49:01;86568523;86536792;31731;
22.02.2019;04:50:02;86568600;86536896;31704;
22.02.2019;04:51:02;86568662;86536980;31682;
22.02.2019;04:52:01;86568733;86537088;31645;
22.02.2019;04:53:02;86568838;86537173;31665;
22.02.2019;04:54:02;86568928;86537256;31672;
22.02.2019;04:55:01;86569004;86537363;31641;
22.02.2019;04:56:02;86569090;86537445;31645;
22.02.2019;04:57:01;86569185;86537545;31640;
22.02.2019;04:58:02;86569281;86537664;31617;
22.02.2019;04:59:02;86569366;86537768;31598;
22.02.2019;05:00:01;86569462;86537862;31600;
22.02.2019;05:01:02;86569547;86537945;31602;
22.02.2019;05:02:01;86569632;86538032;31600;
22.02.2019;05:03:02;86569693;86538146;31547;
22.02.2019;05:04:02;86569789;86538251;31538;
22.02.2019;05:05:01;86569864;86538350;31514;
22.02.2019;05:07:02;86570015;86538529;31486;
22.02.2019;05:08:02;86570093;86538620;31473;
22.02.2019;05:09:01;86570179;86538709;31470;
22.02.2019;05:10:02;86570241;86538810;31431;
22.02.2019;05:11:01;86570324;86538909;31415;
22.02.2019;05:12:01;86570414;86539038;31376;
22.02.2019;05:13:02;86570500;86539135;31365;
22.02.2019;05:14:01;86570595;86539239;31356;
22.02.2019;05:15:02;86570687;86539329;31358;
22.02.2019;05:16:02;86570769;86539443;31326;
22.02.2019;05:17:01;86570847;86539535;31312;
22.02.2019;05:18:02;86570933;86539656;31277;
22.02.2019;05:19:01;86571018;86539776;31242;
22.02.2019;05:20:02;86571081;86539877;31204;
22.02.2019;05:21:02;86571168;86539985;31183;
22.02.2019;05:22:01;86571257;86540094;31163;
22.02.2019;05:23:02;86571342;86540208;31134;
22.02.2019;05:24:02;86571422;86540306;31116;
22.02.2019;05:25:01;86571467;86540438;31029;
22.02.2019;05:26:02;86571548;86540529;31019;
22.02.2019;05:27:01;86571629;86540624;31005;
22.02.2019;05:28:02;86571704;86540735;30969;
22.02.2019;05:29:02;86571774;86540849;30925;
22.02.2019;05:30:01;86571849;86540944;30905;
22.02.2019;05:31:02;86571936;86541059;30877;
22.02.2019;05:32:01;86571999;86541114;30885;
22.02.2019;05:33:02;86572056;86541272;30784;
22.02.2019;05:34:02;86572161;86541370;30791;
22.02.2019;05:35:01;86572233;86541467;30766;
22.02.2019;05:36:02;86572303;86541583;30720;
22.02.2019;05:37:02;86572389;86541696;30693;
22.02.2019;05:38:01;86572466;86541783;30683;
22.02.2019;05:39:02;86572557;86541894;30663;
22.02.2019;05:40:01;86572624;86542013;30611;
22.02.2019;05:41:02;86572686;86542136;30550;
22.02.2019;05:42:02;86572753;86542237;30516;
22.02.2019;05:43:01;86572826;86542354;30472;
22.02.2019;05:44:02;86572889;86542485;30404;
22.02.2019;05:45:02;86572976;86542592;30384;
22.02.2019;05:46:01;86573029;86542707;30322;
22.02.2019;05:47:02;86573112;86542818;30294;
22.02.2019;05:48:01;86573184;86542914;30270;
22.02.2019;05:49:02;86573256;86543022;30234;
22.02.2019;05:50:02;86573325;86543112;30213;
22.02.2019;05:51:01;86573403;86543210;30193;
22.02.2019;05:52:02;86573471;86543328;30143;
22.02.2019;05:53:02;86573548;86543423;30125;
22.02.2019;05:54:01;86573606;86543535;30071;
22.02.2019;05:55:02;86573650;86543646;30004;
22.02.2019;05:56:01;86573758;86543745;30013;
22.02.2019;05:57:02;86573820;86543824;29996;
22.02.2019;05:58:02;86573883;86543941;29942;
22.02.2019;05:59:01;86573940;86544046;29894;
22.02.2019;06:00:02;86574016;86544154;29862;
22.02.2019;06:01:02;86574098;86544266;29832;
22.02.2019;06:02:01;86574170;86544375;29795;
22.02.2019;06:03:02;86574223;86544477;29746;
22.02.2019;06:04:02;86574287;86544579;29708;
22.02.2019;06:05:01;86574320;86544677;29643;
22.02.2019;06:06:02;86574369;86544779;29590;
22.02.2019;06:07:02;86574426;86544868;29558;
22.02.2019;06:08:01;86574467;86544980;29487;
22.02.2019;06:09:02;86574514;86545081;29433;
22.02.2019;06:10:01;86574567;86545185;29382;
22.02.2019;06:11:02;86574604;86545276;29328;
22.02.2019;06:12:02;86574639;86545371;29268;
22.02.2019;06:13:01;86574686;86545447;29239;
22.02.2019;06:14:02;86574745;86545559;29186;
22.02.2019;06:15:01;86574783;86545653;29130;
22.02.2019;06:16:02;86574827;86545761;29066;
22.02.2019;06:17:02;86574852;86545888;28964;
22.02.2019;06:18:01;86574893;86546000;28893;
22.02.2019;06:19:07;86574950;86546124;28826;
22.02.2019;06:20:02;86574994;86546229;28765;
22.02.2019;06:21:01;86575043;86546349;28694;
22.02.2019;06:22:02;86575087;86546455;28632;
22.02.2019;06:23:01;86575158;86546553;28605;
22.02.2019;06:24:02;86575203;86546654;28549;
22.02.2019;06:25:02;86575262;86546752;28510;
22.02.2019;06:26:01;86575307;86546860;28447;
22.02.2019;06:27:02;86575367;86546956;28411;
22.02.2019;06:28:02;86575440;86547075;28365;
22.02.2019;06:29:01;86575516;86547183;28333;
22.02.2019;06:30:02;86575594;86547303;28291;
22.02.2019;06:31:02;86575657;86547412;28245;
22.02.2019;06:32:01;86575713;86547519;28194;
22.02.2019;06:33:02;86575766;86547620;28146;
22.02.2019;06:34:01;86575842;86547718;28124;
22.02.2019;06:35:01;86575916;86547775;28141;
22.02.2019;06:36:02;86575979;86547950;28029;
22.02.2019;06:37:01;86576039;86548074;27965;
22.02.2019;06:38:02;86576111;86548188;27923;
22.02.2019;06:39:02;86576175;86548277;27898;
22.02.2019;06:40:01;86576230;86548384;27846;
22.02.2019;06:41:02;86576287;86548491;27796;
22.02.2019;06:42:02;86576360;86548599;27761;
22.02.2019;06:43:01;86576426;86548689;27737;
22.02.2019;06:44:02;86576490;86548823;27667;
22.02.2019;06:45:02;86576546;86548932;27614;
22.02.2019;06:46:01;86576612;86549049;27563;
22.02.2019;06:47:02;86576677;86549106;27571;
22.02.2019;06:48:01;86576753;86549274;27479;
22.02.2019;06:49:02;86576825;86549371;27454;
22.02.2019;06:50:02;86576889;86549503;27386;
22.02.2019;06:51:01;86576962;86549617;27345;
22.02.2019;06:52:01;86577016;86549731;27285;
22.02.2019;06:53:02;86577070;86549840;27230;
22.02.2019;06:54:01;86577120;86549956;27164;
22.02.2019;06:55:02;86577184;86550098;27086;
22.02.2019;06:56:07;86577255;86550211;27044;
22.02.2019;06:59:02;86577439;86550527;26912;
22.02.2019;07:00:02;86577506;86550638;26868;
22.02.2019;07:02:02;86577627;86550890;26737;
22.02.2019;07:03:01;86577683;86550983;26700;
22.02.2019;07:04:02;86577749;86551092;26657;
22.02.2019;07:05:02;86577781;86551196;26585;
22.02.2019;07:06:02;86577871;86551293;26578;
22.02.2019;07:08:02;86578020;86551515;26505;
22.02.2019;07:09:02;86578061;86551617;26444;
22.02.2019;07:11:03;86578186;86551850;26336;
22.02.2019;07:12:02;86578212;86551851;26361;
22.02.2019;07:14:02;86578341;86552099;26242;
22.02.2019;07:15:03;86578403;86552225;26178;
22.02.2019;07:17:07;86578558;86552424;26134;
22.02.2019;07:19:02;86578661;86552628;26033;
22.02.2019;07:20:02;86578714;86552712;26002;
22.02.2019;07:21:01;86578772;86552809;25963;
22.02.2019;07:22:02;86578835;86552910;25925;
22.02.2019;07:23:02;86578899;86553007;25892;
22.02.2019;07:24:01;86578958;86553109;25849;
22.02.2019;07:25:02;86579022;86553247;25775;
22.02.2019;07:26:02;86579076;86553374;25702;
22.02.2019;07:27:01;86579149;86553457;25692;
22.02.2019;07:28:02;86579224;86553568;25656;
22.02.2019;07:29:02;86579291;86553659;25632;
22.02.2019;07:30:01;86579373;86553784;25589;
22.02.2019;07:31:02;86579440;86553836;25604;
22.02.2019;07:32:01;86579490;86553923;25567;
22.02.2019;07:33:02;86579566;86554022;25544;
22.02.2019;07:34:02;86579622;86554138;25484;
22.02.2019;07:35:02;86579685;86554228;25457;
22.02.2019;07:36:01;86579740;86554315;25425;
22.02.2019;07:37:02;86579798;86554414;25384;
22.02.2019;07:38:01;86579851;86554498;25353;
22.02.2019;07:39:02;86579922;86554603;25319;
22.02.2019;07:40:01;86579988;86554690;25298;
22.02.2019;07:41:02;86580064;86554801;25263;
22.02.2019;07:42:01;86580131;86554892;25239;
22.02.2019;07:43:02;86580183;86554992;25191;
22.02.2019;07:44:02;86580244;86555089;25155;
22.02.2019;07:45:01;86580294;86555200;25094;
22.02.2019;07:46:02;86580357;86555301;25056;
22.02.2019;07:47:01;86580416;86555399;25017;
22.02.2019;07:48:02;86580486;86555518;24968;
22.02.2019;07:49:02;86580530;86555602;24928;
22.02.2019;07:50:01;86580586;86555694;24892;
22.02.2019;07:51:02;86580645;86555805;24840;
22.02.2019;07:52:01;86580710;86555936;24774;
22.02.2019;07:53:03;86580757;86556052;24705;
22.02.2019;07:54:01;86580825;86556147;24678;
22.02.2019;07:55:02;86580872;86556264;24608;
22.02.2019;07:56:01;86580937;86556377;24560;
22.02.2019;07:57:02;86581007;86556475;24532;
22.02.2019;07:58:01;86581079;86556578;24501;
22.02.2019;07:59:02;86581154;86556683;24471;
22.02.2019;08:00:02;86581210;86556795;24415;
22.02.2019;08:01:01;86581283;86556872;24411;
22.02.2019;08:02:02;86581341;86557001;24340;
22.02.2019;08:03:01;86581404;86557118;24286;
22.02.2019;08:04:01;86581441;86557220;24221;
22.02.2019;08:05:02;86581499;86557339;24160;
22.02.2019;08:06:01;86581572;86557463;24109;
22.02.2019;08:07:02;86581623;86557599;24024;
22.02.2019;08:08:02;86581687;86557710;23977;
22.02.2019;08:09:01;86581755;86557832;23923;
22.02.2019;08:10:02;86581795;86557935;23860;
22.02.2019;08:11:02;86581831;86558043;23788;
22.02.2019;08:12:01;86581862;86558154;23708;
22.02.2019;08:13:02;86581911;86558241;23670;
22.02.2019;08:14:01;86581943;86558345;23598;
22.02.2019;08:15:02;86581987;86558438;23549;
22.02.2019;08:16:02;86581997;86558541;23456;
22.02.2019;08:17:01;86582031;86558650;23381;
22.02.2019;08:18:02;86582083;86558773;23310;
22.02.2019;08:19:02;86582114;86558859;23255;
22.02.2019;08:20:01;86582166;86558969;23197;
22.02.2019;08:21:02;86582180;86559093;23087;
22.02.2019;08:22:01;86582248;86559199;23049;
22.02.2019;08:23:02;86582294;86559326;22968;
22.02.2019;08:24:02;86582348;86559410;22938;
22.02.2019;08:25:01;86582391;86559575;22816;
22.02.2019;08:26:02;86582467;86559714;22753;
22.02.2019;08:27:02;86582519;86559834;22685;
22.02.2019;08:28:01;86582577;86559961;22616;
22.02.2019;08:29:02;86582639;86560097;22542;
22.02.2019;08:30:01;86582686;86560218;22468;
22.02.2019;08:31:02;86582753;86560343;22410;
22.02.2019;08:32:02;86582819;86560469;22350;
22.02.2019;08:33:01;86582879;86560582;22297;
22.02.2019;08:34:02;86582940;86560723;22217;
22.02.2019;08:35:02;86583006;86560857;22149;
22.02.2019;08:36:01;86583059;86560944;22115;
22.02.2019;08:37:02;86583112;86561067;22045;
22.02.2019;08:38:01;86583157;86561220;21937;
22.02.2019;08:39:02;86583203;86561362;21841;
22.02.2019;08:40:02;86583257;86561470;21787;
22.02.2019;08:41:01;86583325;86561608;21717;
22.02.2019;08:42:02;86583371;86561714;21657;
22.02.2019;08:43:02;86583465;86561841;21624;
22.02.2019;08:44:01;86583533;86561955;21578;
22.02.2019;08:45:02;86583595;86562101;21494;
22.02.2019;08:46:01;86583658;86562206;21452;
22.02.2019;08:47:02;86583708;86562318;21390;
22.02.2019;08:48:02;86583777;86562458;21319;
22.02.2019;08:49:01;86583852;86562573;21279;
22.02.2019;08:50:02;86583921;86562691;21230;
22.02.2019;08:51:02;86583985;86562816;21169;
22.02.2019;08:52:01;86584049;86562921;21128;
22.02.2019;08:53:02;86584111;86563050;21061;
22.02.2019;08:54:01;86584199;86563127;21072;
22.02.2019;08:55:02;86584271;86563231;21040;
22.02.2019;08:56:02;86584332;86563343;20989;
22.02.2019;08:57:01;86584404;86563460;20944;
22.02.2019;08:58:02;86584481;86563575;20906;
22.02.2019;08:59:01;86584533;86563688;20845;
22.02.2019;09:00:02;86584587;86563799;20788;
22.02.2019;09:01:01;86584637;86563917;20720;
22.02.2019;09:02:02;86584696;86564046;20650;
22.02.2019;09:03:02;86584753;86564161;20592;
22.02.2019;09:04:01;86584814;86564289;20525;
22.02.2019;09:05:02;86584861;86564418;20443;
22.02.2019;09:06:02;86584914;86564526;20388;
22.02.2019;09:07:01;86584984;86564623;20361;
22.02.2019;09:08:02;86585042;86564734;20308;
22.02.2019;09:09:01;86585108;86564834;20274;
22.02.2019;09:10:02;86585171;86564947;20224;
22.02.2019;09:11:02;86585218;86565084;20134;
22.02.2019;09:12:01;86585288;86565212;20076;
22.02.2019;09:13:02;86585347;86565364;19983;
22.02.2019;09:14:01;86585402;86565482;19920;
22.02.2019;09:15:02;86585469;86565612;19857;
22.02.2019;09:16:02;86585532;86565732;19800;
22.02.2019;09:17:01;86585594;86565860;19734;
22.02.2019;09:18:02;86585664;86566000;19664;
22.02.2019;09:19:01;86585732;86566103;19629;
22.02.2019;09:20:02;86585795;86566213;19582;
22.02.2019;09:21:02;86585849;86566314;19535;
22.02.2019;09:22:01;86585915;86566451;19464;
22.02.2019;09:23:02;86585987;86566577;19410;
22.02.2019;09:24:02;86586065;86566713;19352;
22.02.2019;09:25:06;86586109;86566858;19251;
22.02.2019;09:26:02;86586191;86566966;19225;
22.02.2019;09:27:01;86586245;86567071;19174;
22.02.2019;09:28:02;86586317;86567199;19118;
22.02.2019;09:29:02;86586369;86567338;19031;
22.02.2019;09:30:01;86586440;86567454;18986;
22.02.2019;09:31:02;86586489;86567558;18931;
22.02.2019;09:32:01;86586570;86567665;18905;
22.02.2019;09:33:02;86586614;86567763;18851;
22.02.2019;09:34:02;86586727;86567889;18838;
22.02.2019;09:35:01;86586782;86568006;18776;
22.02.2019;09:36:02;86586848;86568112;18736;
22.02.2019;09:37:01;86586907;86568216;18691;
22.02.2019;09:38:02;86586960;86568336;18624;
22.02.2019;09:39:01;86587029;86568484;18545;
22.02.2019;09:40:02;86587081;86568623;18458;
22.02.2019;09:41:02;86587137;86568743;18394;
22.02.2019;09:42:01;86587188;86568836;18352;
22.02.2019;09:43:02;86587256;86568985;18271;
22.02.2019;09:44:01;86587331;86569117;18214;
22.02.2019;09:45:02;86587381;86569248;18133;
22.02.2019;09:46:01;86587449;86569365;18084;
22.02.2019;09:47:02;86587516;86569484;18032;
22.02.2019;09:48:02;86587578;86569612;17966;
22.02.2019;09:49:01;86587641;86569755;17886;
22.02.2019;09:50:02;86587694;86569868;17826;
22.02.2019;09:51:01;86587761;86570008;17753;
22.02.2019;09:52:02;86587824;86570113;17711;
22.02.2019;09:53:01;86587891;86570254;17637;
22.02.2019;09:54:02;86587970;86570378;17592;
22.02.2019;09:55:02;86588027;86570502;17525;
22.02.2019;09:56:01;86588069;86570595;17474;
22.02.2019;09:57:02;86588096;86570648;17448;
22.02.2019;09:58:01;86588160;86570779;17381;
22.02.2019;09:59:02;86588230;86570883;17347;
22.02.2019;10:00:12;86588277;86571013;17264;
22.02.2019;10:01:01;86588334;86571119;17215;
22.02.2019;10:02:02;86588384;86571238;17146;
22.02.2019;10:03:01;86588409;86571322;17087;
22.02.2019;10:04:02;86588455;86571434;17021;
22.02.2019;10:05:02;86588506;86571559;16947;
22.02.2019;10:06:01;86588565;86571683;16882;
22.02.2019;10:07:02;86588613;86571819;16794;
22.02.2019;10:08:02;86588656;86571941;16715;
22.02.2019;10:09:02;86588702;86572069;16633;
22.02.2019;10:10:01;86588718;86572158;16560;
22.02.2019;10:11:02;86588749;86572279;16470;
22.02.2019;10:12:02;86588786;86572383;16403;
22.02.2019;10:13:01;86588835;86572478;16357;
22.02.2019;10:14:02;86588889;86572596;16293;
22.02.2019;10:15:02;86588946;86572699;16247;
22.02.2019;10:16:01;86588971;86572806;16165;
22.02.2019;10:17:02;86589040;86572946;16094;
22.02.2019;10:18:02;86589067;86573064;16003;
22.02.2019;10:19:01;86589141;86573177;15964;
22.02.2019;10:20:02;86589189;86573305;15884;
22.02.2019;10:21:02;86589238;86573446;15792;
22.02.2019;10:22:01;86589299;86573561;15738;
22.02.2019;10:23:02;86589367;86573681;15686;
22.02.2019;10:24:01;86589417;86573792;15625;
22.02.2019;10:25:02;86589474;86573918;15556;
22.02.2019;10:26:02;86589552;86574065;15487;
22.02.2019;10:27:01;86589627;86574216;15411;
22.02.2019;10:28:02;86589699;86574357;15342;
22.02.2019;10:29:02;86589768;86574488;15280;
22.02.2019;10:30:01;86589822;86574618;15204;
22.02.2019;10:31:02;86589886;86574740;15146;
22.02.2019;10:32:02;86589953;86574864;15089;
22.02.2019;10:33:01;86590009;86574960;15049;
22.02.2019;10:34:02;86590093;86575083;15010;
22.02.2019;10:35:01;86590167;86575211;14956;
22.02.2019;10:36:02;86590219;86575353;14866;
22.02.2019;10:37:02;86590262;86575489;14773;
22.02.2019;10:38:01;86590320;86575617;14703;
22.02.2019;10:39:02;86590399;86575765;14634;
22.02.2019;10:40:01;86590470;86575904;14566;
22.02.2019;10:41:02;86590541;86576063;14478;
22.02.2019;10:42:02;86590593;86576225;14368;
22.02.2019;10:43:01;86590667;86576378;14289;
22.02.2019;10:44:02;86590724;86576515;14209;
22.02.2019;10:45:01;86590775;86576631;14144;
22.02.2019;10:46:02;86590836;86576767;14069;
22.02.2019;10:47:02;86590894;86576893;14001;
22.02.2019;10:48:01;86590967;86576996;13971;
22.02.2019;10:49:02;86591041;86577122;13919;
22.02.2019;10:50:07;86591117;86577275;13842;
22.02.2019;10:51:01;86591179;86577375;13804;
22.02.2019;10:52:02;86591233;86577506;13727;
22.02.2019;10:53:01;86591301;86577653;13648;
22.02.2019;10:54:02;86591354;86577772;13582;
22.02.2019;10:55:02;86591417;86577884;13533;
22.02.2019;10:56:01;86591476;86578033;13443;
22.02.2019;10:57:02;86591553;86578160;13393;
22.02.2019;10:58:02;86591626;86578286;13340;
22.02.2019;10:59:01;86591692;86578422;13270;
22.02.2019;11:00:02;86591762;86578572;13190;
22.02.2019;11:01:02;86591820;86578701;13119;
22.02.2019;11:02:01;86591892;86578838;13054;
22.02.2019;11:03:02;86591964;86578985;12979;
22.02.2019;11:04:01;86592034;86579109;12925;
22.02.2019;11:05:02;86592075;86579255;12820;
22.02.2019;11:06:02;86592151;86579385;12766;
22.02.2019;11:07:01;86592213;86579523;12690;
22.02.2019;11:08:02;86592287;86579662;12625;
22.02.2019;11:09:01;86592356;86579795;12561;
22.02.2019;11:10:02;86592415;86579948;12467;
22.02.2019;11:11:01;86592476;86580095;12381;
22.02.2019;11:12:02;86592551;86580208;12343;
22.02.2019;11:13:01;86592601;86580385;12216;
22.02.2019;11:14:02;86592668;86580511;12157;
22.02.2019;11:15:02;86592748;86580606;12142;
22.02.2019;11:16:01;86592834;86580774;12060;
22.02.2019;11:17:02;86592916;86580924;11992;
22.02.2019;11:18:01;86592977;86581060;11917;
22.02.2019;11:19:02;86593035;86581195;11840;
22.02.2019;11:20:07;86593097;86581355;11742;
22.02.2019;11:21:01;86593169;86581483;11686;
22.02.2019;11:22:07;86593264;86581629;11635;
22.02.2019;11:23:01;86593318;86581742;11576;
22.02.2019;11:24:02;86593402;86581866;11536;
22.02.2019;11:25:07;86593484;86581995;11489;
22.02.2019;11:26:01;86593552;86582124;11428;
22.02.2019;11:27:02;86593620;86582257;11363;
22.02.2019;11:28:01;86593688;86582378;11310;
22.02.2019;11:29:02;86593766;86582508;11258;
22.02.2019;11:30:07;86593835;86582638;11197;
22.02.2019;11:31:01;86593906;86582750;11156;
22.02.2019;11:32:02;86593979;86582863;11116;
22.02.2019;11:33:02;86594057;86582968;11089;
22.02.2019;11:34:01;86594132;86583069;11063;
22.02.2019;11:35:07;86594220;86583177;11043;
22.02.2019;11:36:01;86594286;86583279;11007;
22.02.2019;11:37:02;86594363;86583424;10939;
22.02.2019;11:38:02;86594448;86583536;10912;
22.02.2019;11:39:01;86594502;86583646;10856;
22.02.2019;11:40:02;86594585;86583756;10829;
22.02.2019;11:41:01;86594661;86583857;10804;
22.02.2019;11:42:02;86594756;86583963;10793;
22.02.2019;11:43:02;86594844;86584085;10759;
22.02.2019;11:44:01;86594920;86584228;10692;
22.02.2019;11:45:02;86595018;86584339;10679;
22.02.2019;11:46:02;86595090;86584475;10615;
22.02.2019;11:47:01;86595166;86584605;10561;
22.02.2019;11:48:02;86595256;86584736;10520;
22.02.2019;11:49:02;86595333;86584815;10518;
22.02.2019;11:50:01;86595412;86584955;10457;
22.02.2019;11:51:02;86595486;86585049;10437;
22.02.2019;11:52:01;86595584;86585155;10429;
22.02.2019;11:53:02;86595691;86585252;10439;
22.02.2019;11:54:02;86595757;86585343;10414;
22.02.2019;11:55:01;86595838;86585460;10378;
22.02.2019;11:56:02;86595930;86585573;10357;
22.02.2019;11:57:01;86595992;86585693;10299;
22.02.2019;11:58:02;86596088;86585792;10296;
22.02.2019;11:59:02;86596160;86585920;10240;
22.02.2019;12:00:01;86596245;86586040;10205;
22.02.2019;12:01:02;86596322;86586165;10157;
22.02.2019;12:02:01;86596403;86586277;10126;
22.02.2019;12:03:02;86596492;86586398;10094;
22.02.2019;12:04:02;86596563;86586517;10046;
22.02.2019;12:05:01;86596624;86586652;9972;
22.02.2019;12:06:02;86596706;86586767;9939;
22.02.2019;12:07:01;86596805;86586890;9915;
22.02.2019;12:08:02;86596873;86586985;9888;
22.02.2019;12:09:01;86596939;86587081;9858;
22.02.2019;12:10:02;86597023;86587198;9825;
22.02.2019;12:11:02;86597109;86587312;9797;
22.02.2019;12:12:01;86597065;86587315;9750;
22.02.2019;12:13:02;86597054;86587326;9728;
22.02.2019;12:14:02;86597092;86587401;9691;
22.02.2019;12:15:01;86597175;86587549;9626;
22.02.2019;12:16:02;86597279;86587630;9649;
22.02.2019;12:17:01;86597378;86587747;9631;
22.02.2019;12:18:02;86597475;86587860;9615;
22.02.2019;12:19:02;86597546;86587947;9599;
22.02.2019;12:20:01;86597613;86588074;9539;
22.02.2019;12:21:02;86597728;86588197;9531;
22.02.2019;12:22:01;86597807;86588307;9500;
22.02.2019;12:23:02;86597903;86588423;9480;
22.02.2019;12:24:02;86597999;86588545;9454;
22.02.2019;12:25:01;86598082;86588680;9402;
22.02.2019;12:26:02;86598195;86588822;9373;
22.02.2019;12:27:01;86598296;86588940;9356;
22.02.2019;12:28:02;86598397;86589072;9325;
22.02.2019;12:29:02;86598504;86589183;9321;
22.02.2019;12:30:01;86598594;86589333;9261;
22.02.2019;12:31:02;86598686;86589466;9220;
22.02.2019;12:32:02;86598796;86589592;9204;
22.02.2019;12:33:01;86598899;86589704;9195;
22.02.2019;12:34:02;86598969;86589849;9120;
22.02.2019;12:35:02;86599084;86589964;9120;
22.02.2019;12:36:02;86599185;86590098;9087;
22.02.2019;12:37:02;86599274;86590231;9043;
22.02.2019;12:38:02;86599363;86590359;9004;
22.02.2019;12:39:01;86599448;86590495;8953;
22.02.2019;12:40:02;86599497;86590618;8879;
22.02.2019;12:41:02;86599589;86590762;8827;
22.02.2019;12:42:01;86599701;86590904;8797;
22.02.2019;12:43:02;86599813;86591049;8764;
22.02.2019;12:44:02;86599917;86591184;8733;
22.02.2019;12:45:02;86600040;86591319;8721;
22.02.2019;12:46:02;86600150;86591441;8709;
22.02.2019;12:47:01;86600254;86591589;8665;
22.02.2019;12:48:02;86600361;86591698;8663;
22.02.2019;12:49:02;86600449;86591816;8633;
22.02.2019;12:50:01;86600455;86591757;8698;
22.02.2019;12:51:03;86600143;86591172;8971;
22.02.2019;12:52:02;86600174;86591186;8988;
22.02.2019;12:53:02;86600280;86591314;8966;
22.02.2019;12:54:01;86600394;86591415;8979;
22.02.2019;12:55:03;86600531;86591553;8978;
22.02.2019;12:56:01;86600659;86591726;8933;
22.02.2019;12:57:03;86600787;86591837;8950;
22.02.2019;12:58:02;86600891;86591942;8949;
22.02.2019;12:59:01;86600998;86592082;8916;
22.02.2019;13:00:02;86601097;86592199;8898;
22.02.2019;13:01:01;86601216;86592342;8874;
22.02.2019;13:02:02;86601338;86592501;8837;
22.02.2019;13:03:02;86601446;86592631;8815;
22.02.2019;13:04:01;86601539;86592762;8777;
22.02.2019;13:05:02;86601658;86592896;8762;
22.02.2019;13:06:02;86601753;86593011;8742;
22.02.2019;13:07:01;86601868;86593157;8711;
22.02.2019;13:08:02;86601966;86593286;8680;
22.02.2019;13:09:02;86602061;86593429;8632;
22.02.2019;13:10:02;86602166;86593592;8574;
22.02.2019;13:11:02;86602258;86593720;8538;
22.02.2019;13:12:02;86602371;86593846;8525;
22.02.2019;13:13:02;86602462;86593997;8465;
22.02.2019;13:14:02;86602566;86594175;8391;
22.02.2019;13:15:01;86602674;86594311;8363;
22.02.2019;13:16:02;86602781;86594436;8345;
22.02.2019;13:17:02;86602921;86594588;8333;
22.02.2019;13:18:02;86603035;86594710;8325;
22.02.2019;13:19:01;86603161;86594842;8319;
22.02.2019;13:20:02;86603264;86594991;8273;
22.02.2019;13:21:01;86603377;86595129;8248;
22.02.2019;13:22:02;86603496;86595255;8241;
22.02.2019;13:23:02;86603612;86595419;8193;
22.02.2019;13:24:02;86603709;86595561;8148;
22.02.2019;13:25:01;86603828;86595698;8130;
22.02.2019;13:26:02;86603956;86595845;8111;
22.02.2019;13:27:02;86604066;86595956;8110;
22.02.2019;13:28:01;86604189;86596061;8128;
22.02.2019;13:29:02;86604308;86596208;8100;
22.02.2019;13:30:02;86604427;86596360;8067;
22.02.2019;13:31:02;86604543;86596491;8052;
22.02.2019;13:32:01;86604662;86596639;8023;
22.02.2019;13:33:02;86604802;86596807;7995;
22.02.2019;13:34:02;86604933;86596943;7990;
22.02.2019;13:35:02;86605064;86597096;7968;
22.02.2019;13:36:02;86605172;86597240;7932;
22.02.2019;13:37:01;86605306;86597382;7924;
22.02.2019;13:38:02;86605408;86597544;7864;
22.02.2019;13:39:02;86605533;86597689;7844;
22.02.2019;13:40:01;86605668;86597841;7827;
22.02.2019;13:41:02;86605793;86597997;7796;
22.02.2019;13:42:01;86605898;86598078;7820;
22.02.2019;13:43:02;86606031;86598280;7751;
22.02.2019;13:44:02;86606165;86598417;7748;
22.02.2019;13:45:02;86606306;86598568;7738;
22.02.2019;13:46:02;86606435;86598711;7724;
22.02.2019;13:47:02;86606546;86598852;7694;
22.02.2019;13:48:01;86606671;86598990;7681;
22.02.2019;13:49:02;86606798;86599123;7675;
22.02.2019;13:50:03;86606933;86599272;7661;
22.02.2019;13:51:01;86607069;86599421;7648;
22.02.2019;13:52:02;86607194;86599558;7636;
22.02.2019;13:53:02;86607325;86599711;7614;
22.02.2019;13:54:06;86607453;86599884;7569;
22.02.2019;13:55:02;86607580;86600014;7566;
22.02.2019;13:56:02;86607723;86600175;7548;
22.02.2019;13:57:02;86607870;86600325;7545;
22.02.2019;13:58:02;86608019;86600477;7542;
22.02.2019;13:59:01;86608173;86600632;7541;
22.02.2019;14:00:01;86608311;86600776;7535;
22.02.2019;14:01:02;86608485;86600910;7575;
22.02.2019;14:02:02;86608624;86601043;7581;
22.02.2019;14:03:01;86608753;86601219;7534;
22.02.2019;14:04:02;86608741;86601250;7491;
22.02.2019;14:05:02;86608669;86601213;7456;
22.02.2019;14:06:02;86608766;86601336;7430;
22.02.2019;14:07:02;86608895;86601480;7415;
22.02.2019;14:08:01;86609042;86601634;7408;
22.02.2019;14:09:02;86609152;86601782;7370;
22.02.2019;14:10:02;86609291;86601944;7347;
22.02.2019;14:11:02;86609402;86602087;7315;
22.02.2019;14:12:05;86609534;86602260;7274;
22.02.2019;14:13:02;86609669;86602423;7246;
22.02.2019;14:14:02;86609827;86602548;7279;
22.02.2019;14:15:02;86609937;86602723;7214;
22.02.2019;14:16:02;86610061;86602868;7193;
22.02.2019;14:17:01;86610164;86603030;7134;
22.02.2019;14:18:02;86610358;86603191;7167;
22.02.2019;14:19:02;86610515;86603369;7146;
22.02.2019;14:20:01;86610679;86603514;7165;
22.02.2019;14:21:01;86610853;86603681;7172;
22.02.2019;14:22:02;86611031;86603839;7192;
22.02.2019;14:23:02;86611198;86603984;7214;
22.02.2019;14:24:01;86611370;86604153;7217;
22.02.2019;14:25:02;86611542;86604281;7261;
22.02.2019;14:26:02;86611715;86604454;7261;
22.02.2019;14:27:01;86611874;86604615;7259;
22.02.2019;14:28:02;86612014;86604770;7244;
22.02.2019;14:29:02;86612142;86604907;7235;
22.02.2019;14:30:02;86612291;86605039;7252;
22.02.2019;14:31:01;86612442;86605197;7245;
22.02.2019;14:32:03;86612559;86605328;7231;
22.02.2019;14:33:01;86612682;86605479;7203;
22.02.2019;14:34:02;86612828;86605672;7156;
22.02.2019;14:35:02;86612965;86605844;7121;
22.02.2019;14:36:01;86613090;86605994;7096;
22.02.2019;14:37:02;86613257;86606152;7105;
22.02.2019;14:38:02;86613388;86606302;7086;
22.02.2019;14:39:02;86613512;86606492;7020;
22.02.2019;14:40:01;86613648;86606639;7009;
22.02.2019;14:41:02;86613820;86606796;7024;
22.02.2019;14:42:02;86613976;86606947;7029;
22.02.2019;14:43:01;86614165;86607086;7079;
22.02.2019;14:44:02;86614316;86607229;7087;
22.02.2019;14:45:01;86614471;86607390;7081;
22.02.2019;14:46:02;86614614;86607554;7060;
22.02.2019;14:47:02;86614769;86607721;7048;
22.02.2019;14:48:01;86614919;86607909;7010;
22.02.2019;14:49:02;86615063;86608071;6992;
22.02.2019;14:50:02;86615263;86608214;7049;
22.02.2019;14:51:01;86615462;86608417;7045;
22.02.2019;14:52:02;86615616;86608590;7026;
22.02.2019;14:53:02;86615766;86608778;6988;
22.02.2019;14:54:02;86615924;86608966;6958;
22.02.2019;14:55:01;86616108;86609131;6977;
22.02.2019;14:56:07;86616278;86609296;6982;
22.02.2019;14:57:02;86616425;86609443;6982;
22.02.2019;14:58:02;86616600;86609629;6971;
22.02.2019;14:59:01;86616746;86609783;6963;
22.02.2019;15:00:02;86616921;86609934;6987;
22.02.2019;15:01:02;86617095;86610101;6994;
22.02.2019;15:02:02;86617278;86610288;6990;
22.02.2019;15:03:02;86617446;86610463;6983;
22.02.2019;15:04:01;86617613;86610608;7005;
22.02.2019;15:05:02;86617760;86610774;6986;
22.02.2019;15:06:02;86617919;86610940;6979;
22.02.2019;15:07:02;86618085;86611128;6957;
22.02.2019;15:08:01;86618208;86611312;6896;
22.02.2019;15:09:02;86618369;86611477;6892;
22.02.2019;15:10:02;86618537;86611654;6883;
22.02.2019;15:11:02;86618691;86611803;6888;
22.02.2019;15:12:01;86618865;86611957;6908;
22.02.2019;15:13:02;86619018;86612155;6863;
22.02.2019;15:14:02;86619192;86612304;6888;
22.02.2019;15:15:01;86619349;86612481;6868;
22.02.2019;15:16:02;86619505;86612666;6839;
22.02.2019;15:17:02;86619675;86612807;6868;
22.02.2019;15:18:02;86619801;86612982;6819;
22.02.2019;15:19:01;86619930;86613100;6830;
22.02.2019;15:20:02;86620087;86613297;6790;
22.02.2019;15:21:04;86620265;86613457;6808;
22.02.2019;15:22:02;86620406;86613640;6766;
22.02.2019;15:23:01;86620533;86613801;6732;
22.02.2019;15:24:02;86620707;86613972;6735;
22.02.2019;15:25:02;86620873;86614166;6707;
22.02.2019;15:26:02;86621007;86614355;6652;
22.02.2019;15:27:02;86621189;86614519;6670;
22.02.2019;15:28:01;86621381;86614689;6692;
22.02.2019;15:29:02;86621530;86614855;6675;
22.02.2019;15:30:02;86621704;86615040;6664;
22.02.2019;15:31:07;86621913;86615224;6689;
22.02.2019;15:32:02;86622047;86615414;6633;
22.02.2019;15:33:01;86622212;86615586;6626;
22.02.2019;15:34:02;86622367;86615778;6589;
22.02.2019;15:35:02;86622524;86615953;6571;
22.02.2019;15:36:02;86622713;86616129;6584;
22.02.2019;15:37:02;86622898;86616316;6582;
22.02.2019;15:38:02;86623046;86616478;6568;
22.02.2019;15:39:02;86623235;86616648;6587;
22.02.2019;15:40:02;86623383;86616830;6553;
22.02.2019;15:41:01;86623553;86617010;6543;
22.02.2019;15:42:02;86623692;86617178;6514;
22.02.2019;15:43:02;86623833;86617386;6447;
22.02.2019;15:44:02;86623971;86617558;6413;
22.02.2019;15:45:01;86624112;86617750;6362;
22.02.2019;15:46:02;86624269;86617925;6344;
22.02.2019;15:47:02;86624451;86618125;6326;
22.02.2019;15:48:02;86624618;86618276;6342;
22.02.2019;15:49:02;86624781;86618466;6315;
22.02.2019;15:50:02;86624944;86618646;6298;
22.02.2019;15:51:02;86625119;86618846;6273;
22.02.2019;15:52:02;86625298;86619030;6268;
22.02.2019;15:53:01;86625475;86619226;6249;
22.02.2019;15:54:02;86625648;86619392;6256;
22.02.2019;15:55:02;86625812;86619590;6222;
22.02.2019;15:56:01;86625973;86619782;6191;
22.02.2019;15:57:02;86626126;86619978;6148;
22.02.2019;15:58:02;86626313;86620173;6140;
22.02.2019;15:59:01;86626481;86620346;6135;
22.02.2019;16:00:02;86626668;86620549;6119;
22.02.2019;16:01:02;86626859;86620777;6082;
22.02.2019;16:02:01;86627076;86620967;6109;
22.02.2019;16:03:02;86627261;86621166;6095;
22.02.2019;16:04:01;86627406;86621336;6070;
22.02.2019;16:05:02;86627565;86621548;6017;
22.02.2019;16:06:02;86627730;86621707;6023;
22.02.2019;16:07:01;86627884;86621913;5971;
22.02.2019;16:08:02;86628051;86622102;5949;
22.02.2019;16:09:02;86628251;86622303;5948;
22.02.2019;16:10:01;86628454;86622487;5967;
22.02.2019;16:11:02;86628655;86622698;5957;
22.02.2019;16:12:02;86628863;86622886;5977;
22.02.2019;16:13:02;86629045;86623062;5983;
22.02.2019;16:14:01;86629222;86623255;5967;
22.02.2019;16:15:02;86629414;86623425;5989;
22.02.2019;16:16:02;86629619;86623617;6002;
22.02.2019;16:17:01;86629775;86623772;6003;
22.02.2019;16:18:02;86629955;86623951;6004;
22.02.2019;16:19:02;86630123;86624139;5984;
22.02.2019;16:20:02;86630281;86624315;5966;
22.02.2019;16:21:01;86630442;86624468;5974;
22.02.2019;16:22:02;86630631;86624628;6003;
22.02.2019;16:23:02;86630783;86624881;5902;
22.02.2019;16:24:01;86630960;86625150;5810;
22.02.2019;16:25:02;86631141;86625369;5772;
22.02.2019;16:26:02;86631315;86625559;5756;
22.02.2019;16:27:02;86631493;86625725;5768;
22.02.2019;16:28:01;86631658;86625854;5804;
22.02.2019;16:29:02;86631858;86626100;5758;
22.02.2019;16:30:02;86632058;86626286;5772;
22.02.2019;16:31:02;86632209;86626503;5706;
22.02.2019;16:32:02;86632264;86626655;5609;
22.02.2019;16:33:01;86632276;86626739;5537;
22.02.2019;16:34:02;86632461;86626931;5530;
22.02.2019;16:35:02;86632629;86627082;5547;
22.02.2019;16:36:02;86632819;86627256;5563;
22.02.2019;16:37:02;86632988;86627455;5533;
22.02.2019;16:38:01;86633174;86627660;5514;
22.02.2019;16:39:02;86633380;86627833;5547;
22.02.2019;16:40:02;86633558;86628027;5531;
22.02.2019;16:41:01;86633752;86628232;5520;
22.02.2019;16:42:02;86633931;86628443;5488;
22.02.2019;16:43:02;86634141;86628639;5502;
22.02.2019;16:44:02;86634312;86628852;5460;
22.02.2019;16:45:01;86634545;86629056;5489;
22.02.2019;16:46:02;86634749;86629281;5468;
22.02.2019;16:47:02;86634939;86629497;5442;
22.02.2019;16:48:02;86635148;86629724;5424;
22.02.2019;16:49:01;86635346;86629947;5399;
22.02.2019;16:50:02;86635553;86630165;5388;
22.02.2019;16:51:02;86635781;86630366;5415;
22.02.2019;16:52:01;86635992;86630573;5419;
22.02.2019;16:53:01;86636195;86630776;5419;
22.02.2019;16:54:02;86636415;86631006;5409;
22.02.2019;16:55:03;86636656;86631221;5435;
22.02.2019;16:56:01;86636852;86631459;5393;
22.02.2019;16:57:02;86637063;86631668;5395;
22.02.2019;16:58:02;86637274;86631894;5380;
22.02.2019;16:59:02;86637472;86632111;5361;
22.02.2019;17:00:02;86637682;86632332;5350;
22.02.2019;17:01:01;86637869;86632532;5337;
22.02.2019;17:02:02;86638063;86632779;5284;
22.02.2019;17:03:02;86638252;86632961;5291;
22.02.2019;17:04:01;86638427;86633175;5252;
22.02.2019;17:05:02;86638650;86633393;5257;
22.02.2019;17:06:02;86638842;86633588;5254;
22.02.2019;17:07:02;86638861;86633823;5038;
22.02.2019;17:08:02;86639249;86633955;5294;
22.02.2019;17:09:01;86639467;86634256;5211;
22.02.2019;17:10:02;86639653;86634481;5172;
22.02.2019;17:11:02;86639882;86634674;5208;
22.02.2019;17:12:01;86640127;86634899;5228;
22.02.2019;17:13:02;86640341;86635097;5244;
22.02.2019;17:14:01;86640551;86635324;5227;
22.02.2019;17:15:02;86640764;86635538;5226;
22.02.2019;17:16:02;86640978;86635770;5208;
22.02.2019;17:17:01;86641175;86636014;5161;
22.02.2019;17:18:02;86641388;86636232;5156;
22.02.2019;17:19:02;86641597;86636449;5148;
22.02.2019;17:20:02;86641822;86636650;5172;
22.02.2019;17:21:01;86642024;86636866;5158;
22.02.2019;17:22:02;86642254;86637093;5161;
22.02.2019;17:23:02;86642469;86637353;5116;
22.02.2019;17:24:01;86642707;86637603;5104;
22.02.2019;17:25:02;86642940;86637836;5104;
22.02.2019;17:26:02;86643147;86638065;5082;
22.02.2019;17:27:01;86643376;86638278;5098;
22.02.2019;17:28:02;86643622;86638506;5116;
22.02.2019;17:29:02;86643864;86638706;5158;
22.02.2019;17:30:01;86644068;86638931;5137;
22.02.2019;17:31:02;86644270;86639169;5101;
22.02.2019;17:32:02;86644484;86639430;5054;
22.02.2019;17:33:02;86644720;86639640;5080;
22.02.2019;17:34:01;86644957;86639861;5096;
22.02.2019;17:35:02;86645192;86640081;5111;
22.02.2019;17:36:02;86645402;86640320;5082;
22.02.2019;17:37:02;86645613;86640545;5068;
22.02.2019;17:38:01;86645861;86640766;5095;
22.02.2019;17:39:02;86646097;86640999;5098;
22.02.2019;17:40:02;86646276;86641242;5034;
22.02.2019;17:41:01;86646502;86641442;5060;
22.02.2019;17:42:02;86646726;86641648;5078;
22.02.2019;17:43:02;86646938;86641853;5085;
22.02.2019;17:44:02;86647195;86642112;5083;
22.02.2019;17:45:02;86647397;86642355;5042;
22.02.2019;17:46:01;86647617;86642599;5018;
22.02.2019;17:47:02;86647839;86642811;5028;
22.02.2019;17:48:02;86648067;86643011;5056;
22.02.2019;17:49:02;86648321;86643183;5138;
22.02.2019;17:50:01;86648556;86643428;5128;
22.02.2019;17:51:02;86648825;86643684;5141;
22.02.2019;17:52:02;86649042;86643926;5116;
22.02.2019;17:53:01;86649268;86644168;5100;
22.02.2019;17:54:02;86649473;86644389;5084;
22.02.2019;17:55:02;86649669;86644613;5056;
22.02.2019;17:56:02;86649874;86644807;5067;
22.02.2019;17:57:02;86650115;86645041;5074;
22.02.2019;17:58:01;86650311;86645235;5076;
22.02.2019;17:59:02;86650536;86645451;5085;
22.02.2019;18:00:02;86650716;86645651;5065;
22.02.2019;18:01:02;86650953;86645883;5070;
22.02.2019;18:02:02;86651174;86646101;5073;
22.02.2019;18:03:02;86651417;86646332;5085;
22.02.2019;18:04:02;86651622;86646527;5095;
22.02.2019;18:05:01;86651837;86646729;5108;
22.02.2019;18:06:02;86652096;86646914;5182;
22.02.2019;18:07:04;86652309;86647109;5200;
22.02.2019;18:08:02;86652552;86647334;5218;
22.02.2019;18:09:02;86652777;86647502;5275;
22.02.2019;18:10:02;86652938;86647665;5273;
22.02.2019;18:11:01;86653110;86647837;5273;
22.02.2019;18:12:02;86653289;86648016;5273;
22.02.2019;18:13:02;86653474;86648198;5276;
22.02.2019;18:14:02;86653670;86648388;5282;
22.02.2019;18:15:02;86653852;86648554;5298;
22.02.2019;18:16:01;86654010;86648735;5275;
22.02.2019;18:17:02;86654184;86648895;5289;
22.02.2019;18:18:02;86654349;86649069;5280;
22.02.2019;18:19:02;86654496;86649262;5234;
22.02.2019;18:20:02;86654672;86649439;5233;
22.02.2019;18:21:01;86654824;86649613;5211;
22.02.2019;18:22:02;86654998;86649786;5212;
22.02.2019;18:23:02;86655161;86649944;5217;
22.02.2019;18:24:02;86655333;86650098;5235;
22.02.2019;18:25:04;86655508;86650285;5223;
22.02.2019;18:26:02;86655690;86650438;5252;
22.02.2019;18:27:02;86655898;86650578;5320;
22.02.2019;18:28:01;86656087;86650755;5332;
22.02.2019;18:29:02;86656258;86650918;5340;
22.02.2019;18:30:02;86656457;86651085;5372;
22.02.2019;18:31:01;86656634;86651250;5384;
22.02.2019;18:32:02;86656800;86651420;5380;
22.02.2019;18:33:02;86656987;86651549;5438;
22.02.2019;18:34:02;86657177;86651710;5467;
22.02.2019;18:35:01;86657389;86651861;5528;
22.02.2019;18:36:02;86657576;86652002;5574;
22.02.2019;18:37:02;86657766;86652133;5633;
22.02.2019;18:38:01;86657930;86652259;5671;
22.02.2019;18:39:02;86658071;86652401;5670;
22.02.2019;18:40:02;86658226;86652545;5681;
22.02.2019;18:41:02;86658394;86652681;5713;
22.02.2019;18:42:02;86658553;86652792;5761;
22.02.2019;18:43:01;86658778;86652917;5861;
22.02.2019;18:44:02;86658935;86653056;5879;
22.02.2019;18:45:02;86659116;86653200;5916;
22.02.2019;18:46:02;86659277;86653355;5922;
22.02.2019;18:47:02;86659465;86653487;5978;
22.02.2019;18:48:01;86659629;86653606;6023;
22.02.2019;18:49:02;86659759;86653736;6023;
22.02.2019;18:50:02;86659958;86653846;6112;
22.02.2019;18:51:02;86660201;86654008;6193;
22.02.2019;18:52:02;86660551;86654158;6393;
22.02.2019;18:53:01;86660955;86654290;6665;
22.02.2019;18:54:02;86661448;86654410;7038;
22.02.2019;18:55:02;86661856;86654541;7315;
22.02.2019;18:56:02;86662175;86654659;7516;
22.02.2019;18:57:02;86662476;86654836;7640;
22.02.2019;18:58:02;86662833;86654995;7838;
22.02.2019;18:59:01;86663134;86655102;8032;
22.02.2019;19:00:02;86663410;86655225;8185;
22.02.2019;19:01:02;86663690;86655355;8335;
22.02.2019;19:02:06;86664009;86655503;8506;
22.02.2019;19:03:02;86664380;86655630;8750;
22.02.2019;19:04:02;86664711;86655777;8934;
22.02.2019;19:05:01;86665002;86655909;9093;
22.02.2019;19:06:02;86665233;86656018;9215;
22.02.2019;19:07:02;86665454;86656143;9311;
22.02.2019;19:08:01;86665724;86656271;9453;
22.02.2019;19:09:02;86665968;86656388;9580;
22.02.2019;19:10:02;86666209;86656499;9710;
22.02.2019;19:11:02;86666588;86656608;9980;
22.02.2019;19:12:01;86666847;86656708;10139;
22.02.2019;19:13:02;86667090;86656846;10244;
22.02.2019;19:14:05;86667358;86656971;10387;
22.02.2019;19:15:02;86667617;86657085;10532;
22.02.2019;19:16:01;86667867;86657193;10674;
22.02.2019;19:17:02;86668077;86657322;10755;
22.02.2019;19:18:02;86668350;86657434;10916;
22.02.2019;19:19:02;86668624;86657527;11097;
22.02.2019;19:20:02;86668894;86657621;11273;
22.02.2019;19:21:02;86669200;86657773;11427;
22.02.2019;19:22:02;86669462;86657886;11576;
22.02.2019;19:23:01;86669669;86657963;11706;
22.02.2019;19:24:02;86669899;86658103;11796;
22.02.2019;19:25:02;86670086;86658219;11867;
22.02.2019;19:26:02;86670282;86658304;11978;
22.02.2019;19:27:01;86670527;86658396;12131;
22.02.2019;19:28:02;86670736;86658484;12252;
22.02.2019;19:29:02;86670987;86658579;12408;
22.02.2019;19:30:01;86671176;86658691;12485;
22.02.2019;19:31:02;86671443;86658797;12646;
22.02.2019;19:32:02;86671698;86658903;12795;
22.02.2019;19:33:02;86671945;86659017;12928;
22.02.2019;19:34:01;86672142;86659086;13056;
22.02.2019;19:35:02;86672392;86659190;13202;
22.02.2019;19:36:02;86672650;86659295;13355;
22.02.2019;19:37:01;86672850;86659385;13465;
22.02.2019;19:38:01;86673047;86659483;13564;
22.02.2019;19:39:02;86673234;86659562;13672;
22.02.2019;19:40:02;86673409;86659640;13769;
22.02.2019;19:42:02;86673851;86659834;14017;
22.02.2019;19:43:02;86674021;86659924;14097;
22.02.2019;19:44:01;86674237;86660022;14215;
22.02.2019;19:45:02;86674487;86660147;14340;
22.02.2019;19:46:02;86674678;86660251;14427;
22.02.2019;19:47:02;86674836;86660348;14488;
22.02.2019;19:48:01;86675015;86660393;14622;
22.02.2019;19:49:02;86675236;86660507;14729;
22.02.2019;19:50:02;86675448;86660606;14842;
22.02.2019;19:51:01;86675662;86660685;14977;
22.02.2019;19:52:02;86675837;86660768;15069;
22.02.2019;19:53:02;86675996;86660847;15149;
22.02.2019;19:54:02;86676163;86660942;15221;
22.02.2019;19:55:01;86676340;86661034;15306;
22.02.2019;19:56:02;86676489;86661112;15377;
22.02.2019;19:57:02;86676651;86661191;15460;
22.02.2019;19:58:02;86676801;86661259;15542;
22.02.2019;19:59:01;86676950;86661354;15596;
22.02.2019;20:00:01;86677091;86661428;15663;
22.02.2019;20:01:02;86677244;86661504;15740;
22.02.2019;20:02:02;86677392;86661576;15816;
22.02.2019;20:03:01;86677535;86661652;15883;
22.02.2019;20:04:01;86677672;86661738;15934;
22.02.2019;20:05:02;86677785;86661798;15987;
22.02.2019;20:06:02;86677894;86661884;16010;
22.02.2019;20:07:01;86678015;86661941;16074;
22.02.2019;20:08:02;86678138;86662032;16106;
22.02.2019;20:09:02;86678259;86662096;16163;
22.02.2019;20:10:01;86678390;86662171;16219;
22.02.2019;20:11:02;86678519;86662234;16285;
22.02.2019;20:12:02;86678632;86662284;16348;
22.02.2019;20:13:02;86678735;86662343;16392;
22.02.2019;20:14:01;86678832;86662409;16423;
22.02.2019;20:15:02;86678965;86662467;16498;
22.02.2019;20:16:02;86679059;86662526;16533;
22.02.2019;20:17:02;86679175;86662604;16571;
22.02.2019;20:18:01;86679285;86662676;16609;
22.02.2019;20:19:02;86679408;86662753;16655;
22.02.2019;20:20:02;86679530;86662826;16704;
22.02.2019;20:21:02;86679639;86662921;16718;
22.02.2019;20:22:01;86679758;86662986;16772;
22.02.2019;20:23:02;86679880;86663053;16827;
22.02.2019;20:24:02;86680021;86663125;16896;
22.02.2019;20:25:02;86680125;86663197;16928;
22.02.2019;20:26:01;86680249;86663284;16965;
22.02.2019;20:27:02;86680372;86663358;17014;
22.02.2019;20:28:02;86680486;86663437;17049;
22.02.2019;20:29:02;86680598;86663503;17095;
22.02.2019;20:30:01;86680643;86663547;17096;
22.02.2019;20:31:02;86680678;86663586;17092;
22.02.2019;20:32:02;86680687;86663620;17067;
22.02.2019;20:33:02;86680752;86663674;17078;
22.02.2019;20:34:01;86680821;86663692;17129;
22.02.2019;20:35:02;86680896;86663719;17177;
22.02.2019;20:36:02;86680962;86663757;17205;
22.02.2019;20:37:01;86681046;86663789;17257;
22.02.2019;20:38:02;86681099;86663807;17292;
22.02.2019;20:39:02;86681164;86663848;17316;
22.02.2019;20:40:01;86681205;86663906;17299;
22.02.2019;20:41:02;86681257;86663939;17318;
22.02.2019;20:42:02;86681316;86663986;17330;
22.02.2019;20:43:02;86681369;86664021;17348;
22.02.2019;20:44:01;86681432;86664052;17380;
22.02.2019;20:45:02;86681508;86664085;17423;
22.02.2019;20:46:02;86681539;86664113;17426;
22.02.2019;20:47:02;86681579;86664174;17405;
22.02.2019;20:48:01;86681646;86664221;17425;
22.02.2019;20:49:02;86681715;86664236;17479;
22.02.2019;20:50:02;86681767;86664275;17492;
22.02.2019;20:51:01;86681845;86664302;17543;
22.02.2019;20:52:02;86681858;86664320;17538;
22.02.2019;20:53:02;86681766;86664323;17443;
22.02.2019;20:54:02;86681483;86664268;17215;
22.02.2019;20:55:01;86681370;86664274;17096;
22.02.2019;20:56:02;86681423;86664313;17110;
22.02.2019;20:57:02;86681492;86664358;17134;
22.02.2019;20:58:02;86681551;86664394;17157;
22.02.2019;20:59:02;86681637;86664455;17182;
22.02.2019;21:00:01;86681725;86664515;17210;
22.02.2019;21:01:02;86681829;86664553;17276;
22.02.2019;21:02:03;86681914;86664623;17291;
22.02.2019;21:03:02;86682008;86664661;17347;
22.02.2019;21:04:02;86682098;86664701;17397;
22.02.2019;21:05:01;86682214;86664747;17467;
22.02.2019;21:06:02;86682315;86664802;17513;
22.02.2019;21:07:02;86682409;86664847;17562;
22.02.2019;21:08:02;86682478;86664903;17575;
22.02.2019;21:09:01;86682575;86664933;17642;
22.02.2019;21:10:02;86682665;86664981;17684;
22.02.2019;21:11:02;86682751;86665024;17727;
22.02.2019;21:12:02;86682874;86665067;17807;
22.02.2019;21:13:01;86682961;86665109;17852;
22.02.2019;21:14:02;86683074;86665174;17900;
22.02.2019;21:15:02;86683195;86665227;17968;
22.02.2019;21:16:02;86683304;86665267;18037;
22.02.2019;21:17:01;86683446;86665326;18120;
22.02.2019;21:18:02;86683552;86665367;18185;
22.02.2019;21:19:02;86683676;86665414;18262;
22.02.2019;21:20:02;86683827;86665454;18373;
22.02.2019;21:21:01;86683949;86665490;18459;
22.02.2019;21:22:02;86684060;86665542;18518;
22.02.2019;21:23:02;86684167;86665606;18561;
22.02.2019;21:24:02;86684278;86665649;18629;
22.02.2019;21:25:02;86684387;86665702;18685;
22.02.2019;21:26:01;86684539;86665739;18800;
22.02.2019;21:27:02;86684679;86665790;18889;
22.02.2019;21:28:02;86684838;86665836;19002;
22.02.2019;21:29:02;86684953;86665874;19079;
22.02.2019;21:30:01;86685066;86665919;19147;
22.02.2019;21:31:02;86685199;86665969;19230;
22.02.2019;21:32:02;86685338;86665998;19340;
22.02.2019;21:33:02;86685467;86666053;19414;
22.02.2019;21:34:01;86685611;86666091;19520;
22.02.2019;21:35:02;86685726;86666122;19604;
22.02.2019;21:36:02;86685832;86666176;19656;
22.02.2019;21:37:02;86685920;86666204;19716;
22.02.2019;21:38:02;86686050;86666253;19797;
22.02.2019;21:39:01;86686175;86666282;19893;
22.02.2019;21:40:02;86686300;86666326;19974;
22.02.2019;21:41:02;86686413;86666366;20047;
22.02.2019;21:42:02;86686533;86666406;20127;
22.02.2019;21:43:02;86686651;86666450;20201;
22.02.2019;21:44:01;86686777;86666492;20285;
22.02.2019;21:45:02;86686919;86666527;20392;
22.02.2019;21:46:02;86687060;86666567;20493;
22.02.2019;21:47:02;86687193;86666621;20572;
22.02.2019;21:48:01;86687339;86666663;20676;
22.02.2019;21:49:02;86687456;86666695;20761;
22.02.2019;21:50:02;86687603;86666735;20868;
22.02.2019;21:51:02;86687767;86666770;20997;
22.02.2019;21:52:01;86687910;86666803;21107;
22.02.2019;21:53:02;86688046;86666836;21210;
22.02.2019;21:54:02;86688183;86666874;21309;
22.02.2019;21:55:02;86688284;86666909;21375;
22.02.2019;21:56:01;86688396;86666936;21460;
22.02.2019;21:57:02;86688503;86666978;21525;
22.02.2019;21:58:02;86688593;86666946;21647;
22.02.2019;21:59:02;86688712;86666975;21737;
22.02.2019;22:00:02;86688856;86667010;21846;
22.02.2019;22:01:01;86688998;86667047;21951;
22.02.2019;22:02:02;86689137;86667091;22046;
22.02.2019;22:03:03;86689276;86671470;17806;
22.02.2019;22:04:02;86689430;86671499;17931;
22.02.2019;22:05:01;86669479;86671536;-2057;
22.02.2019;22:06:02;86669651;86671588;-1937;
22.02.2019;22:07:02;86669843;86671645;-1802;
22.02.2019;22:08:02;86670095;86671683;-1588;
22.02.2019;22:09:01;86670402;86671738;-1336;
22.02.2019;22:10:02;86670776;86671794;-1018;
22.02.2019;22:11:02;86671263;86671850;-587;
22.02.2019;22:12:02;86671918;86671933;-15;
22.02.2019;22:13:02;86672617;86672019;598;
22.02.2019;22:14:02;86673308;86672114;1194;
22.02.2019;22:15:02;86673986;86672182;1804;
22.02.2019;22:16:01;86674618;86672257;2361;
22.02.2019;22:17:02;86675201;86672322;2879;
22.02.2019;22:18:02;86675752;86672408;3344;
22.02.2019;22:19:02;86676290;86672476;3814;
22.02.2019;22:20:02;86676825;86672533;4292;
22.02.2019;22:21:01;86677330;86672598;4732;
22.02.2019;22:22:02;86677806;86672662;5144;
22.02.2019;22:23:02;86678255;86672728;5527;
22.02.2019;22:24:02;86678678;86672776;5902;
22.02.2019;22:25:02;86679118;86672842;6276;
22.02.2019;22:26:01;86679619;86672896;6723;
22.02.2019;22:27:02;86680010;86672924;7086;
22.02.2019;22:28:02;86680367;86672986;7381;
22.02.2019;22:29:02;86680721;86673047;7674;
22.02.2019;22:30:02;86681053;86673104;7949;
22.02.2019;22:31:02;86681423;86673147;8276;
22.02.2019;22:32:01;86681748;86673204;8544;
22.02.2019;22:33:02;86682120;86673246;8874;
22.02.2019;22:34:02;86682474;86673304;9170;
22.02.2019;22:35:02;86682811;86673343;9468;
22.02.2019;22:36:01;86683152;86673385;9767;
22.02.2019;22:37:01;86683485;86673427;10058;
22.02.2019;22:38:02;86683826;86673466;10360;
22.02.2019;22:39:02;86684134;86673488;10646;
22.02.2019;22:40:01;86684483;86673511;10972;
22.02.2019;22:41:02;86684793;86673570;11223;
22.02.2019;22:42:02;86685158;86673606;11552;
22.02.2019;22:43:02;86685482;86673624;11858;
22.02.2019;22:44:02;86685834;86673656;12178;
22.02.2019;22:45:02;86686116;86673695;12421;
22.02.2019;22:46:02;86686414;86673722;12692;
22.02.2019;22:47:02;86686683;86673756;12927;
22.02.2019;22:48:01;86686977;86673797;13180;
22.02.2019;22:49:02;86687270;86673833;13437;
22.02.2019;22:50:02;86687531;86673862;13669;
22.02.2019;22:51:02;86687725;86673911;13814;
22.02.2019;22:52:01;86687991;86673949;14042;
22.02.2019;22:53:02;86688265;86673978;14287;
22.02.2019;22:54:02;86688510;86674015;14495;
22.02.2019;22:55:02;86688775;86674030;14745;
22.02.2019;22:56:01;86688984;86674073;14911;
22.02.2019;22:57:02;86689239;86674099;15140;
22.02.2019;22:58:02;86689469;86674126;15343;
22.02.2019;22:59:02;86689729;86674176;15553;
22.02.2019;23:00:01;86689963;86674209;15754;
22.02.2019;23:01:02;86690225;86674244;15981;
22.02.2019;23:02:02;86690463;86674272;16191;
22.02.2019;23:03:02;86690707;86674315;16392;
22.02.2019;23:04:01;86690924;86674342;16582;
22.02.2019;23:05:02;86691170;86674364;16806;
22.02.2019;23:06:02;86691394;86674402;16992;
22.02.2019;23:07:01;86691640;86674420;17220;
22.02.2019;23:08:02;86691854;86674465;17389;
22.02.2019;23:09:02;86692063;86674496;17567;
22.02.2019;23:10:02;86692196;86674539;17657;
22.02.2019;23:11:02;86692534;86674571;17963;
22.02.2019;23:12:02;86692742;86674613;18129;
22.02.2019;23:13:02;86692944;86674649;18295;
22.02.2019;23:14:01;86693115;86674684;18431;
